,시도,구시군,읍면동명,투표구명,선거인수,투표수,더불어민주당이재명,국민의힘김문수,개혁신당이준석,민주노동당권영국,무소속송진호,계,무효투표수,기권자수,더불어민주당이재명_지지율,국민의힘김문수_지지율,개혁신당이준석_지지율,민주노동당권영국_지지율,무소속송진호_지지율
0,서울특별시,종로구,거소·선상투표,,148,140,64,44,27,1,0,136,4,8,47.05882352941176,32.35294117647059,19.852941176470587,0.7352941176470588,0.0
1,서울특별시,종로구,관외사전투표,,13110,13108,7527,3378,1810,260,12,12987,121,2,57.95795795795796,26.01062601062601,13.937013937013937,2.002002002002002,0.09240009240009239
2,서울특별시,종로구,재외투표,,2073,1592,1033,363,148,37,1,1582,10,481,65.29709228824274,22.945638432364095,9.355246523388116,2.338811630847029,0.06321112515802782
3,서울특별시,종로구,청운효자동,관내사전투표,3190,3190,2175,689,211,92,4,3171,19,0,68.5903500473037,21.7281614632608,6.654052349416588,2.901292967518133,0.12614317250078838
4,서울특별시,종로구,청운효자동,청운효자동제1투,2074,1410,454,789,117,37,1,1398,12,664,32.474964234620884,56.437768240343345,8.369098712446352,2.6466380543633763,0.07153075822603719
5,서울특별시,종로구,청운효자동,청운효자동제2투,1731,1122,369,638,79,28,0,1114,8,609,33.123877917414724,57.27109515260324,7.091561938958707,2.5134649910233393,0.0
6,서울특별시,종로구,청운효자동,청운효자동제3투,1852,1300,481,673,96,33,3,1286,14,552,37.40279937791602,52.332814930015545,7.4650077760497675,2.5660964230171075,0.23328149300155523
7,서울특별시,종로구,사직동,관내사전투표,1769,1769,1057,492,160,47,2,1758,11,0,60.12514220705347,27.986348122866893,9.101251422070535,2.6734926052332195,0.11376564277588168
8,서울특별시,종로구,사직동,사직동제1투,1546,1053,357,577,84,22,4,1044,9,493,34.195402298850574,55.26819923371647,8.045977011494253,2.10727969348659,0.38314176245210724
9,서울특별시,종로구,사직동,사직동제2투,3622,2340,516,1569,186,45,1,2317,23,1282,22.270176952956408,67.71687526974536,8.027621924902892,1.9421665947345708,0.04315925766076824
10,서울특별시,종로구,삼청동,관내사전투표,539,539,325,148,49,14,1,537,2,0,60.52141527001862,27.560521415270017,9.124767225325884,2.60707635009311,0.186219739292365
11,서울특별시,종로구,삼청동,삼청동투표소,1180,750,222,463,47,14,0,746,4,430,29.75871313672922,62.06434316353887,6.3002680965147455,1.876675603217158,0.0
12,서울특별시,종로구,부암동,관내사전투표,1834,1833,1262,440,95,27,0,1824,9,1,69.18859649122807,24.12280701754386,5.208333333333334,1.4802631578947367,0.0
13,서울특별시,종로구,부암동,부암동제1투,1452,942,300,558,60,13,0,931,11,510,32.2234156820623,59.93555316863588,6.44468313641246,1.3963480128893664,0.0
14,서울특별시,종로구,부암동,부암동제2투,1753,1240,496,641,76,19,0,1232,8,513,40.25974025974026,52.02922077922077,6.1688311688311686,1.5422077922077921,0.0
15,서울특별시,종로구,부암동,부암동제3투,1755,1189,371,697,80,34,0,1182,7,566,31.387478849407785,58.967851099830796,6.768189509306261,2.8764805414551606,0.0
16,서울특별시,종로구,평창동,관내사전투표,3035,3035,1922,876,169,44,2,3013,22,0,63.79024228343844,29.074012612014606,5.609027547295055,1.4603385330235645,0.06637902422834385
17,서울특별시,종로구,평창동,평창동제1투,1980,1281,341,820,90,24,1,1276,5,699,26.72413793103448,64.26332288401254,7.053291536050156,1.8808777429467085,0.07836990595611285
18,서울특별시,종로구,평창동,평창동제2투,2897,1939,389,1396,118,22,2,1927,12,958,20.186818889465492,72.44421380384016,6.123508043591074,1.1416709911779968,0.10378827192527244
19,서울특별시,종로구,평창동,평창동제3투,1714,1226,373,737,85,26,0,1221,5,488,30.548730548730546,60.36036036036037,6.961506961506962,2.1294021294021293,0.0
20,서울특별시,종로구,평창동,평창동제4투,1620,1145,398,624,92,19,1,1134,11,475,35.09700176366843,55.026455026455025,8.112874779541446,1.6754850088183422,0.08818342151675485
21,서울특별시,종로구,평창동,평창동제5투,1679,1162,297,770,70,19,1,1157,5,517,25.66983578219533,66.5514261019879,6.050129645635264,1.6421780466724287,0.08643042350907519
22,서울특별시,종로구,무악동,관내사전투표,2006,2006,1300,486,181,31,1,1999,7,0,65.03251625812906,24.312156078039017,9.054527263631815,1.5507753876938468,0.05002501250625312
23,서울특별시,종로구,무악동,무악동제1투,1679,1272,416,690,123,28,2,1259,13,407,33.04209690230341,54.805401111993646,9.76965845909452,2.2239872915011913,0.15885623510722796
24,서울특별시,종로구,무악동,무악동제2투,2175,1548,517,860,117,38,0,1532,16,627,33.746736292428196,56.13577023498695,7.637075718015667,2.4804177545691903,0.0
25,서울특별시,종로구,교남동,관내사전투표,2195,2195,1438,534,165,43,0,2180,15,0,65.96330275229357,24.4954128440367,7.568807339449542,1.9724770642201837,0.0
26,서울특별시,종로구,교남동,교남동제1투,1348,852,331,442,54,15,2,844,8,496,39.21800947867299,52.3696682464455,6.398104265402843,1.7772511848341233,0.23696682464454977
27,서울특별시,종로구,교남동,교남동제2투,1226,820,252,472,73,16,0,813,7,406,30.996309963099634,58.05658056580566,8.979089790897909,1.968019680196802,0.0
28,서울특별시,종로구,교남동,교남동제3투,2568,2024,564,1166,252,29,2,2013,11,544,28.017883755588674,57.92349726775956,12.518628912071536,1.4406358668653751,0.09935419771485346
29,서울특별시,종로구,가회동,관내사전투표,1288,1288,900,267,89,22,2,1280,8,0,70.3125,20.859375,6.953125,1.7187500000000002,0.15625
30,서울특별시,종로구,가회동,가회동투표소,1957,1209,387,699,73,35,4,1198,11,748,32.30383973288814,58.347245409015024,6.093489148580968,2.921535893155259,0.333889816360601
31,서울특별시,종로구,종로1·2·3·4가동,관내사전투표,1589,1589,998,446,120,16,1,1581,8,0,63.12460468058191,28.20999367488931,7.590132827324478,1.0120177103099304,0.06325110689437065
32,서울특별시,종로구,종로1·2·3·4가동,종로1·2·3·4가동제1투,1739,939,252,581,92,8,1,934,5,800,26.98072805139186,62.20556745182013,9.850107066381156,0.8565310492505354,0.10706638115631692
33,서울특별시,종로구,종로1·2·3·4가동,종로1·2·3·4가동제2투,2224,1237,356,748,108,17,1,1230,7,987,28.943089430894307,60.8130081300813,8.780487804878048,1.3821138211382114,0.08130081300813008
34,서울특별시,종로구,종로5·6가동,관내사전투표,1253,1253,788,330,114,13,1,1246,7,0,63.242375601926156,26.484751203852326,9.149277688603531,1.043338683788122,0.08025682182985554
35,서울특별시,종로구,종로5·6가동,종로5·6가동제1투,1790,1099,348,546,172,22,3,1091,8,691,31.897341888175983,50.04582951420715,15.765352887259395,2.016498625114574,0.27497708524289644
36,서울특별시,종로구,종로5·6가동,종로5·6가동제2투,1170,687,225,402,48,6,1,682,5,483,32.99120234604106,58.94428152492669,7.038123167155426,0.8797653958944283,0.1466275659824047
37,서울특별시,종로구,이화동,관내사전투표,2273,2273,1423,524,265,43,1,2256,17,0,63.076241134751776,23.22695035460993,11.74645390070922,1.9060283687943262,0.044326241134751775
38,서울특별시,종로구,이화동,이화동제1투,1977,1319,489,647,144,26,2,1308,11,658,37.38532110091743,49.464831804281346,11.009174311926607,1.9877675840978593,0.1529051987767584
39,서울특별시,종로구,이화동,이화동제2투,1891,1241,411,642,148,19,3,1223,18,650,33.60588716271464,52.49386753883892,12.101390024529843,1.553556827473426,0.24529844644317253
40,서울특별시,종로구,혜화동,관내사전투표,4304,4304,2667,866,606,115,1,4255,49,0,62.6792009400705,20.35252643948296,14.242068155111633,2.7027027027027026,0.023501762632197415
41,서울특별시,종로구,혜화동,혜화동제1투,2035,1391,495,707,143,30,1,1376,15,644,35.973837209302324,51.38081395348837,10.392441860465116,2.1802325581395348,0.07267441860465117
42,서울특별시,종로구,혜화동,혜화동제2투,2018,1350,425,715,169,28,2,1339,11,668,31.74010455563854,53.398058252427184,12.62135922330097,2.0911127707244215,0.14936519790888725
43,서울특별시,종로구,혜화동,혜화동제3투,1835,1222,346,655,180,26,0,1207,15,613,28.66611433305717,54.266777133388565,14.91300745650373,2.1541010770505387,0.0
44,서울특별시,종로구,혜화동,혜화동제4투,1430,962,306,477,152,14,0,949,13,468,32.24446786090622,50.26343519494204,16.01685985247629,1.4752370916754478,0.0
45,서울특별시,종로구,혜화동,혜화동제5투,1263,821,299,387,104,20,2,812,9,442,36.82266009852217,47.66009852216749,12.807881773399016,2.4630541871921183,0.24630541871921183
46,서울특별시,종로구,창신제1동,관내사전투표,2107,2107,1437,474,152,30,1,2094,13,0,68.62464183381088,22.636103151862464,7.25883476599809,1.4326647564469914,0.04775549188156638
47,서울특별시,종로구,창신제1동,창신제1동제1투,663,323,125,182,15,0,1,323,0,340,38.69969040247678,56.34674922600619,4.643962848297214,0.0,0.30959752321981426
48,서울특별시,종로구,창신제1동,창신제1동제2투,1836,1207,476,583,120,13,2,1194,13,629,39.86599664991625,48.82747068676717,10.050251256281408,1.0887772194304857,0.16750418760469013
49,서울특별시,종로구,창신제2동,관내사전투표,1925,1925,1435,391,82,3,3,1914,11,0,74.97387669801464,20.42842215256008,4.284221525600835,0.1567398119122257,0.1567398119122257
50,서울특별시,종로구,창신제2동,창신제2동제1투,999,590,232,302,44,4,0,582,8,409,39.86254295532646,51.890034364261176,7.560137457044673,0.6872852233676976,0.0
51,서울특별시,종로구,창신제2동,창신제2동제2투,1667,1045,459,505,56,14,1,1035,10,622,44.34782608695652,48.792270531400966,5.4106280193236715,1.3526570048309179,0.0966183574879227
52,서울특별시,종로구,창신제2동,창신제2동제3투,1395,794,328,384,65,9,1,787,7,601,41.67725540025413,48.792884371029224,8.259212198221093,1.1435832274459974,0.12706480304955528
53,서울특별시,종로구,창신제3동,관내사전투표,1625,1625,1144,369,88,18,0,1619,6,0,70.66090179122916,22.79184681902409,5.435453983940705,1.1117974058060531,0.0
54,서울특별시,종로구,창신제3동,창신제3동제1투,1165,714,303,346,61,3,0,713,1,451,42.49649368863955,48.5273492286115,8.55539971949509,0.42075736325385693,0.0
55,서울특별시,종로구,창신제3동,창신제3동제2투,2093,1478,533,766,159,10,1,1469,9,615,36.283185840707965,52.14431586113002,10.823689584751532,0.6807351940095302,0.06807351940095302
56,서울특별시,종로구,숭인제1동,관내사전투표,1433,1433,995,321,87,21,0,1424,9,0,69.87359550561798,22.542134831460675,6.109550561797753,1.4747191011235954,0.0
57,서울특별시,종로구,숭인제1동,숭인제1동제1투,1692,993,338,545,92,7,3,985,8,699,34.31472081218274,55.32994923857868,9.34010152284264,0.7106598984771574,0.3045685279187817
58,서울특별시,종로구,숭인제1동,숭인제1동제2투,1343,851,326,435,75,11,2,849,2,492,38.39811542991755,51.23674911660777,8.8339222614841,1.2956419316843346,0.23557126030624262
59,서울특별시,종로구,숭인제2동,관내사전투표,2264,2264,1542,494,186,24,1,2247,17,0,68.62483311081442,21.984868713840676,8.277703604806408,1.0680907877169559,0.04450378282153983
60,서울특별시,종로구,숭인제2동,숭인제2동제1투,2627,1706,618,794,240,28,1,1681,25,921,36.763831052944674,47.23378941106484,14.277215942891136,1.665675193337299,0.0594883997620464
61,서울특별시,종로구,숭인제2동,숭인제2동제2투,1746,1062,388,558,92,11,1,1050,12,684,36.952380952380956,53.142857142857146,8.761904761904763,1.0476190476190477,0.09523809523809523
62,서울특별시,종로구,숭인제2동,숭인제2동제3투,1535,938,394,454,71,11,2,932,6,597,42.27467811158798,48.712446351931334,7.618025751072961,1.1802575107296138,0.2145922746781116
63,서울특별시,종로구,잘못 투입·구분된 투표지,,0,0,0,0,0,0,0,0,0,0,0.0,0.0,0.0,0.0,0.0
0,서울특별시,중구,거소·선상투표,,122,113,60,32,14,0,0,106,7,9,56.60377358490566,30.18867924528302,13.20754716981132,0.0,0.0
1,서울특별시,중구,관외사전투표,,11815,11815,6774,3223,1516,176,12,11701,114,0,57.892487821553715,27.54465430305102,12.95615759336809,1.5041449448765063,0.10255533715067089
2,서울특별시,중구,재외투표,,1476,1084,665,296,98,15,1,1075,9,392,61.86046511627907,27.53488372093023,9.11627906976744,1.3953488372093024,0.09302325581395349
3,서울특별시,중구,소공동,관내사전투표,540,540,335,126,65,12,0,538,2,0,62.26765799256505,23.42007434944238,12.0817843866171,2.2304832713754648,0.0
4,서울특별시,중구,소공동,소공동제1투,327,175,54,96,19,5,0,174,1,152,31.03448275862069,55.172413793103445,10.919540229885058,2.8735632183908044,0.0
5,서울특별시,중구,소공동,소공동제2투,988,706,209,404,71,14,1,699,7,282,29.89985693848355,57.79685264663805,10.157367668097281,2.0028612303290414,0.14306151645207438
6,서울특별시,중구,회현동,관내사전투표,949,949,576,284,75,8,1,944,5,0,61.016949152542374,30.08474576271186,7.944915254237288,0.847457627118644,0.1059322033898305
7,서울특별시,중구,회현동,회현동제1투,2154,1292,332,834,99,10,1,1276,16,862,26.01880877742947,65.36050156739812,7.758620689655173,0.7836990595611284,0.07836990595611285
8,서울특별시,중구,회현동,회현동제2투,470,230,69,143,10,3,1,226,4,240,30.53097345132743,63.27433628318584,4.424778761061947,1.3274336283185841,0.4424778761061947
9,서울특별시,중구,명동,관내사전투표,626,626,396,186,34,6,0,622,4,0,63.665594855305464,29.903536977491964,5.466237942122187,0.964630225080386,0.0
10,서울특별시,중구,명동,명동제1투,1184,725,146,520,51,5,1,723,2,459,20.193637621023512,71.9225449515906,7.053941908713693,0.6915629322268326,0.13831258644536654
11,서울특별시,중구,명동,명동제2투,84,39,10,25,2,1,0,38,1,45,26.31578947368421,65.78947368421053,5.263157894736842,2.631578947368421,0.0
12,서울특별시,중구,필동,관내사전투표,1711,1711,1098,364,214,17,0,1693,18,0,64.8552864737153,21.500295333727113,12.640283520378027,1.004134672179563,0.0
13,서울특별시,중구,필동,필동제1투,1144,759,216,451,67,15,1,750,9,385,28.799999999999997,60.13333333333334,8.933333333333334,2.0,0.13333333333333333
14,서울특별시,중구,필동,필동제2투,1390,912,252,525,119,6,0,902,10,478,27.93791574279379,58.2039911308204,13.19290465631929,0.6651884700665188,0.0
15,서울특별시,중구,장충동,관내사전투표,1124,1124,738,247,111,10,2,1108,16,0,66.60649819494586,22.292418772563177,10.018050541516246,0.9025270758122743,0.18050541516245489
16,서울특별시,중구,장충동,장충동제1투,1366,896,273,507,92,16,1,889,7,470,30.708661417322837,57.03037120359955,10.348706411698538,1.799775028121485,0.11248593925759282
17,서울특별시,중구,장충동,장충동제2투,1398,916,281,439,162,16,1,899,17,482,31.25695216907675,48.83203559510567,18.020022246941046,1.7797552836484982,0.11123470522803114
18,서울특별시,중구,광희동,관내사전투표,973,973,570,264,110,17,0,961,12,0,59.31321540062435,27.471383975026015,11.446409989594173,1.768990634755463,0.0
19,서울특별시,중구,광희동,광희동제1투,1151,650,187,367,73,12,0,639,11,501,29.26447574334898,57.43348982785602,11.424100156494523,1.8779342723004695,0.0
20,서울특별시,중구,광희동,광희동제2투,2327,1567,461,881,189,21,0,1552,15,760,29.70360824742268,56.76546391752577,12.177835051546392,1.3530927835051547,0.0
21,서울특별시,중구,을지로동,관내사전투표,926,926,539,221,133,27,0,920,6,0,58.58695652173913,24.02173913043478,14.456521739130434,2.9347826086956523,0.0
22,서울특별시,중구,을지로동,을지로동제1투,1312,897,249,482,146,10,1,888,9,415,28.040540540540544,54.27927927927928,16.441441441441444,1.1261261261261262,0.11261261261261261
23,서울특별시,중구,을지로동,을지로동제2투,521,334,121,185,22,2,0,330,4,187,36.666666666666664,56.060606060606055,6.666666666666667,0.6060606060606061,0.0
24,서울특별시,중구,신당동,관내사전투표,2175,2175,1475,520,145,22,2,2164,11,0,68.16081330868762,24.029574861367838,6.700554528650647,1.0166358595194085,0.09242144177449169
25,서울특별시,중구,신당동,신당동제1투,1475,862,312,479,59,2,0,852,10,613,36.61971830985916,56.2206572769953,6.924882629107981,0.2347417840375587,0.0
26,서울특별시,중구,신당동,신당동제2투,1623,1097,384,587,108,7,0,1086,11,526,35.35911602209944,54.05156537753223,9.94475138121547,0.6445672191528545,0.0
27,서울특별시,중구,신당동,신당동제3투,1341,873,323,452,78,11,1,865,8,468,37.34104046242774,52.2543352601156,9.017341040462428,1.2716763005780347,0.11560693641618498
28,서울특별시,중구,다산동,관내사전투표,2152,2152,1426,537,158,18,0,2139,13,0,66.66666666666666,25.105189340813467,7.3866292660121555,0.8415147265077139,0.0
29,서울특별시,중구,다산동,다산동제1투,1782,1151,379,633,113,14,0,1139,12,631,33.274802458296755,55.57506584723442,9.920983318700614,1.2291483757682178,0.0
30,서울특별시,중구,다산동,다산동제2투,2157,1457,533,757,135,21,0,1446,11,700,36.860304287690184,52.35131396957124,9.336099585062241,1.4522821576763485,0.0
31,서울특별시,중구,다산동,다산동제3투,1594,1042,394,516,109,12,3,1034,8,552,38.10444874274662,49.90328820116054,10.541586073500966,1.160541586073501,0.2901353965183753
32,서울특별시,중구,다산동,다산동제4투,1897,1256,474,659,97,17,2,1249,7,641,37.950360288230584,52.76220976781425,7.766212970376301,1.3610888710968776,0.16012810248198558
33,서울특별시,중구,약수동,관내사전투표,3545,3545,2251,967,257,48,3,3526,19,0,63.84004537719796,27.424844015882023,7.288712422007941,1.3613159387407827,0.08508224617129892
34,서울특별시,중구,약수동,약수동제1투,1250,764,250,429,70,7,0,756,8,486,33.06878306878307,56.74603174603175,9.25925925925926,0.9259259259259258,0.0
35,서울특별시,중구,약수동,약수동제2투,1452,1022,413,503,80,17,0,1013,9,430,40.76999012833169,49.65449160908194,7.897334649555774,1.678183613030602,0.0
36,서울특별시,중구,약수동,약수동제3투,2550,1884,543,1104,196,28,0,1871,13,666,29.021913415285944,59.00587920897915,10.47568145376804,1.4965259219668627,0.0
37,서울특별시,중구,약수동,약수동제4투,2379,1827,550,1055,169,38,1,1813,14,552,30.336458907887483,58.19084390512962,9.321566464423608,2.095973524544953,0.05515719801434087
38,서울특별시,중구,약수동,약수동제5투,1851,1231,493,667,53,10,2,1225,6,620,40.244897959183675,54.44897959183673,4.326530612244897,0.8163265306122449,0.163265306122449
39,서울특별시,중구,청구동,관내사전투표,1961,1961,1316,469,137,27,0,1949,12,0,67.52180605438687,24.06362237044638,7.029245767060031,1.3853258081067215,0.0
40,서울특별시,중구,청구동,청구동제1투,497,285,103,153,17,4,1,278,7,212,37.05035971223021,55.03597122302158,6.115107913669065,1.4388489208633095,0.3597122302158274
41,서울특별시,중구,청구동,청구동제2투,1220,740,218,433,69,8,2,730,10,480,29.863013698630137,59.31506849315068,9.452054794520548,1.095890410958904,0.273972602739726
42,서울특별시,중구,청구동,청구동제3투,1863,1476,454,864,135,13,2,1468,8,387,30.92643051771117,58.855585831062676,9.196185286103542,0.8855585831062671,0.13623978201634876
43,서울특별시,중구,청구동,청구동제4투,1396,1049,383,556,90,11,1,1041,8,347,36.79154658981748,53.41018251681076,8.645533141210375,1.0566762728146013,0.09606147934678194
44,서울특별시,중구,청구동,청구동제5투,2101,1638,588,883,139,17,0,1627,11,463,36.140135218192995,54.271665642286415,8.543331284572833,1.0448678549477566,0.0
45,서울특별시,중구,신당제5동,관내사전투표,2791,2791,1852,684,214,19,3,2772,19,0,66.8109668109668,24.675324675324674,7.72005772005772,0.6854256854256854,0.10822510822510822
46,서울특별시,중구,신당제5동,신당제5동제1투,1575,937,326,486,104,9,2,927,10,638,35.16720604099245,52.42718446601942,11.21898597626753,0.9708737864077669,0.2157497303128371
47,서울특별시,중구,신당제5동,신당제5동제2투,2394,1537,501,848,152,17,3,1521,16,857,32.938856015779095,55.75279421433268,9.993425378040763,1.1176857330703485,0.19723865877712032
48,서울특별시,중구,신당제5동,신당제5동제3투,1572,1035,389,528,98,8,1,1024,11,537,37.98828125,51.5625,9.5703125,0.78125,0.09765625
49,서울특별시,중구,동화동,관내사전투표,2566,2565,1671,694,161,27,0,2553,12,1,65.4524089306698,27.183705444575008,6.306306306306306,1.0575793184488838,0.0
50,서울특별시,중구,동화동,동화동제1투,899,650,193,395,50,6,0,644,6,249,29.96894409937888,61.33540372670807,7.763975155279502,0.9316770186335404,0.0
51,서울특별시,중구,동화동,동화동제2투,1436,1071,290,665,93,17,0,1065,6,365,27.230046948356808,62.441314553990615,8.732394366197182,1.5962441314553992,0.0
52,서울특별시,중구,동화동,동화동제3투,1693,1224,363,728,111,12,0,1214,10,469,29.901153212520594,59.96705107084019,9.14332784184514,0.9884678747940692,0.0
53,서울특별시,중구,동화동,동화동제4투,1254,829,295,440,69,11,2,817,12,425,36.1077111383109,53.85556915544676,8.445532435740514,1.346389228886169,0.24479804161566704
54,서울특별시,중구,황학동,관내사전투표,2661,2661,1713,650,243,31,3,2640,21,0,64.88636363636363,24.62121212121212,9.204545454545453,1.174242424242424,0.11363636363636363
55,서울특별시,중구,황학동,황학동제1투,3059,1921,610,1038,222,33,0,1903,18,1138,32.054650551760375,54.54545454545454,11.665790856542301,1.7341040462427744,0.0
56,서울특별시,중구,황학동,황학동제2투,2192,1405,492,699,175,20,1,1387,18,787,35.47224224945926,50.396539293439076,12.617159336697908,1.4419610670511895,0.07209805335255948
57,서울특별시,중구,황학동,황학동제3투,2657,1995,768,1014,179,21,2,1984,11,662,38.70967741935484,51.108870967741936,9.02217741935484,1.0584677419354838,0.10080645161290322
58,서울특별시,중구,중림동,관내사전투표,2236,2236,1425,569,198,31,0,2223,13,0,64.1025641025641,25.59604138551507,8.906882591093117,1.3945119208277104,0.0
59,서울특별시,중구,중림동,중림동제1투,2157,1577,511,846,183,25,0,1565,12,580,32.6517571884984,54.05750798722045,11.69329073482428,1.5974440894568689,0.0
60,서울특별시,중구,중림동,중림동제2투,2406,1568,576,800,144,27,1,1548,20,838,37.2093023255814,51.67958656330749,9.30232558139535,1.744186046511628,0.06459948320413438
61,서울특별시,중구,중림동,중림동제3투,2294,1718,634,893,148,30,0,1705,13,576,37.184750733137825,52.37536656891496,8.680351906158359,1.7595307917888565,0.0
62,서울특별시,중구,잘못 투입·구분된 투표지,,0,0,0,0,0,0,0,0,0,0,0.0,0.0,0.0,0.0,0.0
0,서울특별시,용산구,거소·선상투표,,225,214,79,87,38,4,0,208,6,11,37.980769230769226,41.82692307692308,18.269230769230766,1.9230769230769231,0.0
1,서울특별시,용산구,관외사전투표,,20350,20347,10843,6286,2642,368,15,20154,193,3,53.80073434553935,31.189838245509577,13.109060236181403,1.8259402599980152,0.07442691277165824
2,서울특별시,용산구,재외투표,,2860,2178,1205,685,225,44,4,2163,15,682,55.709662505779015,31.668978270920018,10.402219140083217,2.034211742949607,0.18492834026814609
3,서울특별시,용산구,후암동,관내사전투표,3496,3496,2325,822,272,55,1,3475,21,0,66.90647482014388,23.654676258992804,7.827338129496403,1.5827338129496402,0.028776978417266185
4,서울특별시,용산구,후암동,후암동제1투,2444,1622,587,842,154,23,3,1609,13,822,36.482287134866375,52.33064014916097,9.571162212554382,1.4294592914853945,0.18645121193287756
5,서울특별시,용산구,후암동,후암동제2투,1848,1100,382,594,91,23,1,1091,9,748,35.01374885426215,54.44546287809349,8.340971585701192,2.1081576535288726,0.09165902841429881
6,서울특별시,용산구,후암동,후암동제3투,1979,1273,447,700,96,23,0,1266,7,706,35.308056872037916,55.29225908372828,7.5829383886255926,1.8167456556082147,0.0
7,서울특별시,용산구,후암동,후암동제4투,2191,1478,507,800,130,23,0,1460,18,713,34.726027397260275,54.794520547945204,8.904109589041095,1.5753424657534247,0.0
8,서울특별시,용산구,용산2가동,관내사전투표,2283,2283,1456,599,164,39,2,2260,23,0,64.42477876106196,26.50442477876106,7.256637168141593,1.7256637168141593,0.08849557522123894
9,서울특별시,용산구,용산2가동,용산2가동제1투,1527,924,280,538,78,15,2,913,11,603,30.66812705366922,58.92661555312158,8.543263964950713,1.642935377875137,0.21905805038335158
10,서울특별시,용산구,용산2가동,용산2가동제2투,1238,749,237,420,75,11,0,743,6,489,31.897711978465683,56.527590847913864,10.094212651413189,1.4804845222072678,0.0
11,서울특별시,용산구,용산2가동,용산2가동제3투,983,586,192,315,55,17,2,581,5,397,33.04647160068847,54.21686746987952,9.46643717728055,2.9259896729776247,0.34423407917383825
12,서울특별시,용산구,용산2가동,용산2가동제4투,1138,683,238,354,69,15,0,676,7,455,35.20710059171598,52.366863905325445,10.207100591715976,2.2189349112426036,0.0
13,서울특별시,용산구,남영동,관내사전투표,1767,1767,1153,406,157,32,3,1751,16,0,65.84808680753855,23.186750428326672,8.966304968589379,1.8275271273557967,0.17133066818960593
14,서울특별시,용산구,남영동,남영동제1투,1983,1073,372,571,106,15,1,1065,8,910,34.92957746478873,53.6150234741784,9.953051643192488,1.4084507042253522,0.09389671361502347
15,서울특별시,용산구,남영동,남영동제2투,2302,1239,432,678,95,16,3,1224,15,1063,35.294117647058826,55.392156862745104,7.761437908496732,1.3071895424836601,0.24509803921568626
16,서울특별시,용산구,청파동,관내사전투표,3739,3739,2518,768,353,69,2,3710,29,0,67.87061994609165,20.70080862533693,9.514824797843666,1.8598382749326146,0.05390835579514825
17,서울특별시,용산구,청파동,청파동제1투,1391,873,303,464,80,15,1,863,10,518,35.11008111239861,53.76593279258402,9.269988412514484,1.738122827346466,0.11587485515643105
18,서울특별시,용산구,청파동,청파동제2투,1574,1033,463,472,82,6,1,1024,9,541,45.21484375,46.09375,8.0078125,0.5859375,0.09765625
19,서울특별시,용산구,청파동,청파동제3투,1848,1185,526,540,96,15,0,1177,8,663,44.689889549702634,45.879354290569246,8.156329651656755,1.274426508071368,0.0
20,서울특별시,용산구,청파동,청파동제4투,2292,1415,530,713,133,30,0,1406,9,877,37.69559032716928,50.71123755334281,9.45945945945946,2.1337126600284493,0.0
21,서울특별시,용산구,청파동,청파동제5투,1942,1277,460,637,142,24,3,1266,11,665,36.334913112164294,50.31595576619273,11.216429699842022,1.8957345971563981,0.23696682464454977
22,서울특별시,용산구,청파동,청파동제6투,1606,1037,405,500,91,23,2,1021,16,569,39.66699314397649,48.97159647404506,8.9128305582762,2.2526934378060726,0.1958863858961802
23,서울특별시,용산구,원효로제1동,관내사전투표,3930,3930,2454,953,412,78,3,3900,30,0,62.92307692307693,24.435897435897434,10.564102564102564,2.0,0.07692307692307693
24,서울특별시,용산구,원효로제1동,원효로제1동제1투,3087,2154,818,1033,226,50,0,2127,27,933,38.4579219558063,48.566055477197935,10.625293841090738,2.350728725905031,0.0
25,서울특별시,용산구,원효로제1동,원효로제1동제2투,2279,1583,439,955,163,19,0,1576,7,696,27.855329949238577,60.59644670050761,10.342639593908629,1.2055837563451777,0.0
26,서울특별시,용산구,원효로제1동,원효로제1동제3투,2279,1624,419,1010,160,21,2,1612,12,655,25.992555831265506,62.655086848635236,9.925558312655088,1.3027295285359801,0.12406947890818859
27,서울특별시,용산구,원효로제1동,원효로제1동제4투,2021,1475,415,864,167,18,1,1465,10,546,28.327645051194537,58.97610921501707,11.399317406143345,1.228668941979522,0.06825938566552901
28,서울특별시,용산구,원효로제2동,관내사전투표,2478,2478,1544,686,192,37,1,2460,18,0,62.764227642276424,27.88617886178862,7.804878048780488,1.5040650406504066,0.04065040650406504
29,서울특별시,용산구,원효로제2동,원효로제2동제1투,3098,2252,708,1260,213,43,5,2229,23,846,31.76312247644684,56.527590847913864,9.55585464333782,1.9291161956034097,0.22431583669807087
30,서울특별시,용산구,원효로제2동,원효로제2동제2투,2211,1595,481,907,161,27,4,1580,15,616,30.443037974683545,57.405063291139236,10.18987341772152,1.7088607594936709,0.25316455696202533
31,서울특별시,용산구,원효로제2동,원효로제2동제3투,2287,1552,545,804,167,27,0,1543,9,735,35.320803629293586,52.106286454957875,10.823071937783538,1.7498379779650033,0.0
32,서울특별시,용산구,효창동,관내사전투표,2679,2679,1732,650,223,52,1,2658,21,0,65.16177577125659,24.454477050413846,8.389766741911211,1.9563581640331076,0.037622272385252065
33,서울특별시,용산구,효창동,효창동제1투,2309,1653,525,919,167,26,1,1638,15,656,32.05128205128205,56.105006105006105,10.195360195360195,1.5873015873015872,0.06105006105006105
34,서울특별시,용산구,효창동,효창동제2투,1773,1338,402,771,134,16,3,1326,12,435,30.316742081447963,58.144796380090504,10.105580693815988,1.206636500754148,0.22624434389140274
35,서울특별시,용산구,효창동,효창동제3투,1481,1026,323,583,99,16,1,1022,4,455,31.604696673189824,57.04500978473581,9.686888454011742,1.5655577299412915,0.09784735812133072
36,서울특별시,용산구,용문동,관내사전투표,2994,2994,1930,746,249,40,2,2967,27,0,65.04887091338051,25.143242332322213,8.39231547017189,1.3481631277384565,0.06740815638692282
37,서울특별시,용산구,용문동,용문동제1투,2133,1394,499,728,127,29,3,1386,8,739,36.002886002886,52.52525252525253,9.163059163059163,2.092352092352092,0.21645021645021645
38,서울특별시,용산구,용문동,용문동제2투,1814,1231,380,702,128,10,2,1222,9,583,31.09656301145663,57.446808510638306,10.474631751227497,0.8183306055646482,0.16366612111292964
39,서울특별시,용산구,용문동,용문동제3투,2185,1687,492,970,180,24,2,1668,19,498,29.496402877697843,58.153477218225426,10.79136690647482,1.4388489208633095,0.1199040767386091
40,서울특별시,용산구,한강로동,관내사전투표,3201,3201,1656,1075,394,46,2,3173,28,0,52.19035612984557,33.87960920264734,12.417270721714466,1.4497321147179325,0.06303183107469272
41,서울특별시,용산구,한강로동,한강로동제1투,2172,1563,402,953,168,28,0,1551,12,609,25.918762088974855,61.444229529335914,10.831721470019342,1.8052869116698904,0.0
42,서울특별시,용산구,한강로동,한강로동제2투,3089,2040,350,1423,224,32,1,2030,10,1049,17.24137931034483,70.09852216748769,11.03448275862069,1.5763546798029555,0.04926108374384236
43,서울특별시,용산구,한강로동,한강로동제3투,2426,1829,599,877,295,36,1,1808,21,597,33.13053097345133,48.506637168141594,16.316371681415927,1.991150442477876,0.05530973451327434
44,서울특별시,용산구,한강로동,한강로동제4투,2784,1961,306,1470,165,12,0,1953,8,823,15.668202764976957,75.26881720430107,8.448540706605224,0.6144393241167435,0.0
45,서울특별시,용산구,한강로동,한강로동제5투,2271,1475,356,964,131,15,0,1466,9,796,24.283765347885403,65.75716234652114,8.935879945429742,1.023192360163711,0.0
46,서울특별시,용산구,이촌제1동,관내사전투표,4814,4814,2249,1990,472,72,2,4785,29,0,47.00104493207942,41.588296760710556,9.864158829676072,1.5047021943573669,0.04179728317659352
47,서울특별시,용산구,이촌제1동,이촌제1동제1투,3856,2680,478,1914,234,32,1,2659,21,1176,17.976682963520123,71.98194810078977,8.800300864986838,1.2034599473486274,0.037608123354644606
48,서울특별시,용산구,이촌제1동,이촌제1동제2투,3463,2437,334,1886,179,24,2,2425,12,1026,13.77319587628866,77.77319587628865,7.381443298969072,0.9896907216494845,0.08247422680412371
49,서울특별시,용산구,이촌제1동,이촌제1동제3투,3969,2926,444,2235,208,23,0,2910,16,1043,15.257731958762887,76.80412371134021,7.1477663230240545,0.7903780068728522,0.0
50,서울특별시,용산구,이촌제1동,이촌제1동제4투,3083,2320,445,1595,236,30,1,2307,13,763,19.28912006935414,69.13740788903337,10.22973558734287,1.3003901170351104,0.043346337234503686
51,서울특별시,용산구,이촌제2동,관내사전투표,1518,1518,890,467,123,25,0,1505,13,0,59.136212624584715,31.029900332225914,8.172757475083056,1.6611295681063125,0.0
52,서울특별시,용산구,이촌제2동,이촌제2동제1투,1375,935,256,590,65,15,1,927,8,440,27.615965480043148,63.646170442286945,7.011866235167206,1.6181229773462782,0.10787486515641855
53,서울특별시,용산구,이촌제2동,이촌제2동제2투,1380,978,223,661,77,9,1,971,7,402,22.966014418125642,68.07415036045315,7.929969104016478,0.9268795056642637,0.10298661174047373
54,서울특별시,용산구,이촌제2동,이촌제2동제3투,1928,1506,461,890,125,21,2,1499,7,422,30.753835890593727,59.37291527685124,8.338892595063376,1.400933955970647,0.13342228152101399
55,서울특별시,용산구,이태원제1동,관내사전투표,1582,1582,890,514,141,24,0,1569,13,0,56.7240280433397,32.75971956660293,8.98661567877629,1.5296367112810707,0.0
56,서울특별시,용산구,이태원제1동,이태원제1동제1투,2369,1521,362,1035,94,20,1,1512,9,848,23.941798941798943,68.45238095238095,6.216931216931217,1.3227513227513228,0.06613756613756613
57,서울특별시,용산구,이태원제1동,이태원제1동제2투,1523,871,226,553,68,11,2,860,11,652,26.27906976744186,64.30232558139535,7.906976744186046,1.2790697674418605,0.23255813953488372
58,서울특별시,용산구,이태원제2동,관내사전투표,1646,1646,988,475,134,25,1,1623,23,0,60.87492298213185,29.2667898952557,8.256315465187923,1.5403573629081946,0.06161429451632779
59,서울특별시,용산구,이태원제2동,이태원제2동제1투,1944,1196,298,792,85,15,0,1190,6,748,25.04201680672269,66.55462184873949,7.142857142857142,1.2605042016806722,0.0
60,서울특별시,용산구,이태원제2동,이태원제2동제2투,1802,1117,328,678,90,13,0,1109,8,685,29.57619477006312,61.13615870153291,8.11541929666366,1.1722272317403066,0.0
61,서울특별시,용산구,이태원제2동,이태원제2동제3투,1508,942,276,566,71,22,1,936,6,566,29.48717948717949,60.470085470085465,7.585470085470085,2.3504273504273505,0.10683760683760685
62,서울특별시,용산구,한남동,관내사전투표,1984,1984,1048,725,169,29,0,1971,13,0,53.17097919837646,36.78335870116692,8.574327752409944,1.4713343480466767,0.0
63,서울특별시,용산구,한남동,한남동제1투,1838,1233,299,817,104,8,1,1229,4,605,24.32872253864931,66.47681041497152,8.462164361269323,0.6509357200976403,0.08136696501220504
64,서울특별시,용산구,한남동,한남동제2투,1296,577,136,385,44,9,0,574,3,719,23.693379790940767,67.07317073170732,7.665505226480835,1.5679442508710801,0.0
65,서울특별시,용산구,한남동,한남동제3투,3433,2125,316,1650,132,18,0,2116,9,1308,14.933837429111533,77.9773156899811,6.238185255198488,0.8506616257088847,0.0
66,서울특별시,용산구,한남동,한남동제4투,2251,1496,299,1071,106,14,0,1490,6,755,20.06711409395973,71.87919463087248,7.114093959731544,0.9395973154362416,0.0
67,서울특별시,용산구,서빙고동,관내사전투표,1567,1567,842,585,114,11,0,1552,15,0,54.25257731958762,37.69329896907217,7.345360824742269,0.7087628865979382,0.0
68,서울특별시,용산구,서빙고동,서빙고동제1투,2102,1569,413,988,146,11,1,1559,10,533,26.491340602950608,63.373957665169975,9.364977549711353,0.7055805003207184,0.06414368184733803
69,서울특별시,용산구,서빙고동,서빙고동제2투,1419,883,229,570,69,7,2,877,6,536,26.111744583808438,64.99429874572405,7.8677309007981755,0.798175598631699,0.22805017103762829
70,서울특별시,용산구,서빙고동,서빙고동제3투,2638,1915,191,1583,119,19,0,1912,3,723,9.989539748953975,82.79288702928869,6.2238493723849375,0.9937238493723849,0.0
71,서울특별시,용산구,서빙고동,서빙고동제4투,1126,720,168,488,57,4,0,717,3,406,23.430962343096233,68.06136680613668,7.949790794979079,0.5578800557880056,0.0
72,서울특별시,용산구,보광동,관내사전투표,1930,1930,1142,602,149,26,2,1921,9,0,59.448204060385216,31.337844872462263,7.756376887038001,1.353461738677772,0.10411244143675169
73,서울특별시,용산구,보광동,보광동제1투,2112,1257,361,780,97,13,0,1251,6,855,28.85691446842526,62.35011990407674,7.753796962430055,1.0391686650679457,0.0
74,서울특별시,용산구,보광동,보광동제2투,733,450,127,285,34,3,0,449,1,283,28.28507795100223,63.474387527839646,7.57238307349666,0.6681514476614699,0.0
75,서울특별시,용산구,보광동,보광동제3투,1438,833,271,463,83,6,0,823,10,605,32.92831105710814,56.25759416767922,10.08505467800729,0.7290400972053462,0.0
76,서울특별시,용산구,잘못 투입·구분된 투표지,,0,0,0,0,0,0,0,0,0,0,0.0,0.0,0.0,0.0,0.0
0,서울특별시,성동구,거소·선상투표,,290,274,133,77,50,2,0,262,12,16,50.76335877862596,29.389312977099237,19.083969465648856,0.7633587786259541,0.0
1,서울특별시,성동구,관외사전투표,,25811,25808,14377,7245,3583,332,29,25566,242,3,56.23484315106,28.3384182116874,14.01470703277791,1.2985997027301885,0.11343190174450443
2,서울특별시,성동구,재외투표,,2457,1975,1236,493,202,33,0,1964,11,482,62.93279022403259,25.10183299389002,10.285132382892057,1.680244399185336,0.0
3,서울특별시,성동구,금호1가동,관내사전투표,2317,2317,1472,629,182,17,1,2301,16,0,63.97218600608431,27.33594089526293,7.909604519774012,0.7388092133854846,0.0434593654932638
4,서울특별시,성동구,금호1가동,금호1가동제1투,1442,893,333,482,64,7,1,887,6,549,37.54227733934611,54.34047350620068,7.215332581736189,0.7891770011273956,0.11273957158962795
5,서울특별시,성동구,금호1가동,금호1가동제2투,2418,1753,689,917,112,20,1,1739,14,665,39.620471535365155,52.731454859114436,6.440483036227718,1.1500862564692353,0.05750431282346176
6,서울특별시,성동구,금호1가동,금호1가동제3투,2705,1991,685,1103,163,25,1,1977,14,714,34.64845725847243,55.79160343955488,8.244815376833586,1.2645422357106728,0.05058168942842691
7,서울특별시,성동구,금호1가동,금호1가동제4투,1834,1281,399,730,123,17,0,1269,12,553,31.44208037825059,57.525610717100086,9.692671394799055,1.3396375098502757,0.0
8,서울특별시,성동구,금호2·3가동,관내사전투표,3730,3730,2395,1022,264,28,3,3712,18,0,64.52047413793103,27.532327586206897,7.112068965517242,0.7543103448275862,0.08081896551724138
9,서울특별시,성동구,금호2·3가동,금호2·3가동제1투,2716,1841,576,1079,148,24,2,1829,12,875,31.492618917441224,58.99398578458174,8.091853471842537,1.3121924548933843,0.10934937124111535
10,서울특별시,성동구,금호2·3가동,금호2·3가동제2투,2373,1586,581,832,142,17,2,1574,12,787,36.91232528589581,52.85895806861499,9.021601016518424,1.0800508259212198,0.12706480304955528
11,서울특별시,성동구,금호2·3가동,금호2·3가동제3투,2633,1737,645,945,122,10,6,1728,9,896,37.32638888888889,54.6875,7.060185185185184,0.5787037037037037,0.3472222222222222
12,서울특별시,성동구,금호2·3가동,금호2·3가동제4투,2152,1703,550,940,177,21,2,1690,13,449,32.544378698224854,55.62130177514793,10.47337278106509,1.242603550295858,0.1183431952662722
13,서울특별시,성동구,금호2·3가동,금호2·3가동제5투,2212,1556,517,858,158,14,0,1547,9,656,33.41952165481577,55.46218487394958,10.213316095669036,0.904977375565611,0.0
14,서울특별시,성동구,금호4가동,관내사전투표,3328,3328,2129,917,225,25,4,3300,28,0,64.51515151515152,27.78787878787879,6.8181818181818175,0.7575757575757576,0.12121212121212122
15,서울특별시,성동구,금호4가동,금호4가동제1투,1594,982,252,634,82,5,0,973,9,612,25.899280575539567,65.15930113052416,8.427543679342241,0.513874614594039,0.0
16,서울특별시,성동구,금호4가동,금호4가동제2투,2203,1592,481,938,141,24,0,1584,8,611,30.36616161616162,59.21717171717171,8.901515151515152,1.5151515151515151,0.0
17,서울특별시,성동구,금호4가동,금호4가동제3투,2069,1344,454,766,97,15,1,1333,11,725,34.058514628657164,57.464366091522876,7.276819204801201,1.1252813203300824,0.07501875468867217
18,서울특별시,성동구,금호4가동,금호4가동제4투,2161,1668,496,993,161,13,0,1663,5,493,29.825616355983165,59.71136500300661,9.68129885748647,0.7817197835237523,0.0
19,서울특별시,성동구,옥수동,관내사전투표,3868,3868,2247,1234,316,49,0,3846,22,0,58.424336973478944,32.08528341133645,8.216328653146125,1.2740509620384814,0.0
20,서울특별시,성동구,옥수동,옥수동제1투,2658,1980,560,1172,211,22,2,1967,13,678,28.46975088967972,59.58312150482969,10.72699542450432,1.1184544992374175,0.10167768174885612
21,서울특별시,성동구,옥수동,옥수동제2투,2367,1588,334,1107,120,15,2,1578,10,779,21.166032953105194,70.15209125475285,7.604562737642586,0.9505703422053232,0.12674271229404308
22,서울특별시,성동구,옥수동,옥수동제3투,2629,1929,607,1093,202,15,0,1917,12,700,31.664058424621803,57.01617110067815,10.537297861241523,0.7824726134585289,0.0
23,서울특별시,성동구,옥수동,옥수동제4투,2589,1729,395,1173,128,22,0,1718,11,860,22.9918509895227,68.27706635622818,7.450523864959255,1.2805587892898718,0.0
24,서울특별시,성동구,옥수동,옥수동제5투,2145,1676,465,1025,159,13,1,1663,13,469,27.961515333734216,61.63559831629585,9.561034275405893,0.7817197835237523,0.06013229104028864
25,서울특별시,성동구,옥수동,옥수동제6투,2979,2308,683,1377,199,37,2,2298,10,671,29.721496953872933,59.92167101827677,8.65970409051349,1.6100957354221062,0.08703220191470844
26,서울특별시,성동구,왕십리도선동,관내사전투표,4177,4177,2654,1078,383,34,2,4151,26,0,63.9364008672609,25.96964586846543,9.226692363285956,0.8190797398217298,0.0481811611659841
27,서울특별시,성동구,왕십리도선동,왕십리도선동제1투,2495,1676,612,803,226,22,2,1665,11,819,36.75675675675676,48.228228228228225,13.573573573573574,1.3213213213213213,0.12012012012012012
28,서울특별시,성동구,왕십리도선동,왕십리도선동제2투,2462,1635,671,799,138,16,2,1626,9,827,41.26691266912669,49.1389913899139,8.487084870848708,0.984009840098401,0.12300123001230012
29,서울특별시,성동구,왕십리도선동,왕십리도선동제3투,2087,1614,586,890,116,9,1,1602,12,473,36.5792759051186,55.55555555555556,7.240948813982522,0.5617977528089888,0.062421972534332085
30,서울특별시,성동구,왕십리도선동,왕십리도선동제4투,3109,2225,642,1323,216,29,2,2212,13,884,29.023508137432184,59.81012658227848,9.764918625678119,1.3110307414104883,0.09041591320072333
31,서울특별시,성동구,왕십리도선동,왕십리도선동제5투,2641,1940,597,1101,194,33,1,1926,14,701,30.99688473520249,57.165109034267914,10.07268951194185,1.7133956386292832,0.05192107995846314
32,서울특별시,성동구,왕십리도선동,왕십리도선동제6투,2400,1801,558,1024,188,18,1,1789,12,599,31.19060927892677,57.23868082727781,10.508664058133036,1.0061486864169928,0.05589714924538849
33,서울특별시,성동구,왕십리제2동,관내사전투표,4013,4013,2678,867,386,34,5,3970,43,0,67.455919395466,21.838790931989923,9.722921914357682,0.8564231738035265,0.12594458438287154
34,서울특별시,성동구,왕십리제2동,왕십리제2동제1투,2359,1461,498,778,144,22,3,1445,16,898,34.463667820069205,53.840830449826996,9.965397923875432,1.5224913494809689,0.20761245674740486
35,서울특별시,성동구,왕십리제2동,왕십리제2동제2투,2189,1475,542,730,165,20,0,1457,18,714,37.199725463280714,50.10295126973233,11.324639670555937,1.3726835964310227,0.0
36,서울특별시,성동구,왕십리제2동,왕십리제2동제3투,2099,1616,627,793,168,15,0,1603,13,483,39.11416094822208,49.46974422956956,10.480349344978166,0.9357454772301934,0.0
37,서울특별시,성동구,왕십리제2동,왕십리제2동제4투,2385,1857,709,915,190,25,2,1841,16,528,38.51167843563281,49.70124932102119,10.320478001086366,1.3579576317218904,0.10863661053775121
38,서울특별시,성동구,행당제1동,관내사전투표,3491,3491,2052,946,429,39,0,3466,25,0,59.20369301788806,27.293710328909405,12.377380265435661,1.1252163877668782,0.0
39,서울특별시,성동구,행당제1동,행당제1동제1투,2118,1405,426,796,153,17,1,1393,12,713,30.581478822684854,57.14285714285714,10.983488872936109,1.2203876525484567,0.07178750897343862
40,서울특별시,성동구,행당제1동,행당제1동제2투,2538,1902,638,1065,161,31,2,1897,5,636,33.632050606220346,56.14127569847127,8.487084870848708,1.6341591987348445,0.10542962572482868
41,서울특별시,성동구,행당제1동,행당제1동제3투,1680,1075,385,536,118,22,2,1063,12,605,36.21825023518344,50.423330197554094,11.100658513640639,2.06961429915334,0.18814675446848542
42,서울특별시,성동구,행당제1동,행당제1동제4투,1686,1352,418,762,148,11,3,1342,10,334,31.147540983606557,56.780923994038744,11.028315946348734,0.819672131147541,0.22354694485842028
43,서울특별시,성동구,행당제2동,관내사전투표,4469,4469,2956,1102,331,53,5,4447,22,0,66.47177872723185,24.780751068135825,7.443220148414661,1.1918147065437372,0.11243534967393749
44,서울특별시,성동구,행당제2동,행당제2동제1투,2711,1980,599,1144,194,26,2,1965,15,731,30.483460559796438,58.21882951653944,9.872773536895673,1.3231552162849873,0.10178117048346055
45,서울특별시,성동구,행당제2동,행당제2동제2투,2290,1577,531,835,166,26,3,1561,16,713,34.01665598975016,53.49135169762973,10.634208840486867,1.6655989750160152,0.19218449711723257
46,서울특별시,성동구,행당제2동,행당제2동제3투,2450,1754,670,922,132,18,2,1744,10,696,38.41743119266055,52.86697247706422,7.568807339449542,1.0321100917431194,0.11467889908256881
47,서울특별시,성동구,행당제2동,행당제2동제4투,2496,1946,628,1088,188,29,1,1934,12,550,32.47156153050672,56.256463288521196,9.720785935884178,1.499482936918304,0.0517063081695967
48,서울특별시,성동구,행당제2동,행당제2동제5투,2495,1903,684,1009,165,28,5,1891,12,592,36.17133791644632,53.358011634056055,8.725542041248017,1.4806980433633,0.26441036488630354
49,서울특별시,성동구,마장동,관내사전투표,3724,3724,2505,854,304,31,2,3696,28,0,67.77597402597402,23.106060606060606,8.225108225108226,0.8387445887445888,0.05411255411255411
50,서울특별시,성동구,마장동,마장동제1투,1877,1267,398,699,138,22,1,1258,9,610,31.63751987281399,55.56438791732909,10.969793322734498,1.7488076311605723,0.0794912559618442
51,서울특별시,성동구,마장동,마장동제2투,2375,1817,633,915,225,19,3,1795,22,558,35.26462395543176,50.974930362116986,12.534818941504177,1.0584958217270195,0.1671309192200557
52,서울특별시,성동구,마장동,마장동제3투,2530,1906,725,967,177,26,1,1896,10,624,38.23839662447258,51.00210970464135,9.335443037974683,1.3713080168776373,0.05274261603375527
53,서울특별시,성동구,마장동,마장동제4투,1858,1279,504,632,125,9,1,1271,8,579,39.65381589299764,49.72462627852085,9.83477576711251,0.7081038552321007,0.07867820613690008
54,서울특별시,성동구,마장동,마장동제5투,2035,1309,605,600,80,14,2,1301,8,726,46.50269023827825,46.11837048424289,6.149116064565718,1.0760953112990008,0.15372790161414296
55,서울특별시,성동구,마장동,마장동제6투,2233,1665,591,766,253,35,3,1648,17,568,35.86165048543689,46.480582524271846,15.351941747572814,2.1237864077669903,0.1820388349514563
56,서울특별시,성동구,사근동,관내사전투표,2469,2469,1344,509,544,35,4,2436,33,0,55.172413793103445,20.894909688013136,22.33169129720854,1.4367816091954022,0.16420361247947454
57,서울특별시,성동구,사근동,사근동제1투,1478,992,306,466,193,14,1,980,12,486,31.22448979591837,47.55102040816326,19.693877551020407,1.4285714285714286,0.10204081632653061
58,서울특별시,성동구,사근동,사근동제2투,1919,1247,416,599,198,17,0,1230,17,672,33.82113821138211,48.69918699186992,16.097560975609756,1.3821138211382114,0.0
59,서울특별시,성동구,사근동,사근동제3투,3655,2411,685,1175,481,39,2,2382,29,1244,28.75734676742233,49.32829554995802,20.19311502938707,1.63727959697733,0.08396305625524769
60,서울특별시,성동구,송정동,관내사전투표,1956,1956,1300,483,139,21,1,1944,12,0,66.8724279835391,24.845679012345677,7.1502057613168715,1.0802469135802468,0.051440329218107
61,서울특별시,성동구,송정동,송정동제1투,2027,1344,549,646,125,16,2,1338,6,683,41.03139013452915,48.28101644245142,9.342301943198803,1.195814648729447,0.14947683109118087
62,서울특별시,성동구,송정동,송정동제2투,1734,1147,423,603,97,12,1,1136,11,587,37.235915492957744,53.08098591549296,8.538732394366196,1.056338028169014,0.08802816901408451
63,서울특별시,성동구,송정동,송정동제3투,1794,1183,449,575,133,14,3,1174,9,611,38.24531516183987,48.9778534923339,11.328790459965928,1.192504258943782,0.2555366269165247
64,서울특별시,성동구,용답동,관내사전투표,2809,2809,1893,598,259,26,2,2778,31,0,68.1425485961123,21.52627789776818,9.323254139668826,0.9359251259899208,0.07199424046076314
65,서울특별시,성동구,용답동,용답동제1투,3355,1900,712,901,246,19,3,1881,19,1455,37.8522062732589,47.90005316321106,13.078149920255184,1.0101010101010102,0.1594896331738437
66,서울특별시,성동구,용답동,용답동제2투,2023,1309,515,624,134,19,2,1294,15,714,39.799072642967545,48.222565687789796,10.35548686244204,1.4683153013910355,0.1545595054095827
67,서울특별시,성동구,용답동,용답동제3투,1785,1175,390,617,140,10,3,1160,15,610,33.62068965517241,53.189655172413794,12.068965517241379,0.8620689655172413,0.25862068965517243
68,서울특별시,성동구,응봉동,관내사전투표,3668,3668,2337,964,300,37,3,3641,27,0,64.18566327931887,26.476242790442186,8.23949464432848,1.0162043394671794,0.08239494644328481
69,서울특별시,성동구,응봉동,응봉동제1투,2414,1548,539,842,135,23,3,1542,6,866,34.954604409857325,54.60440985732814,8.754863813229571,1.4915693904020753,0.19455252918287938
70,서울특별시,성동구,응봉동,응봉동제2투,2838,2036,670,1167,165,25,0,2027,9,802,33.05377405032067,57.57276763690182,8.140108534780465,1.23334977799704,0.0
71,서울특별시,성동구,응봉동,응봉동제3투,2690,2026,706,1101,184,26,3,2020,6,664,34.95049504950495,54.504950495049506,9.108910891089108,1.2871287128712872,0.1485148514851485
72,서울특별시,성동구,성수1가제1동,관내사전투표,2448,2448,1512,629,247,33,4,2425,23,0,62.350515463917525,25.938144329896907,10.185567010309278,1.3608247422680413,0.16494845360824742
73,서울특별시,성동구,성수1가제1동,성수1가제1동제1투,1983,1184,396,652,105,21,2,1176,8,799,33.6734693877551,55.44217687074829,8.928571428571429,1.7857142857142856,0.17006802721088435
74,서울특별시,성동구,성수1가제1동,성수1가제1동제2투,3368,2437,640,1544,223,21,1,2429,8,931,26.348291477974474,63.565253190613426,9.180732811856732,0.8645533141210375,0.04116920543433512
75,서울특별시,성동구,성수1가제1동,성수1가제1동제3투,2167,1572,382,1013,150,16,1,1562,10,595,24.455825864276566,64.8527528809219,9.603072983354673,1.0243277848911652,0.06402048655569782
76,서울특별시,성동구,성수1가제1동,성수1가제1동제4투,1644,1077,354,568,127,21,1,1071,6,567,33.0532212885154,53.034547152194214,11.858076563958916,1.9607843137254901,0.09337068160597572
77,서울특별시,성동구,성수1가제2동,관내사전투표,3516,3516,2043,1034,371,42,1,3491,25,0,58.52191349183615,29.61902033801203,10.627327413348612,1.2030936694356917,0.028645087367516472
78,서울특별시,성동구,성수1가제2동,성수1가제2동제1투,1153,759,221,443,75,11,1,751,8,394,29.427430093209058,58.988015978695074,9.986684420772303,1.4647137150466045,0.13315579227696406
79,서울특별시,성동구,성수1가제2동,성수1가제2동제2투,1400,1075,305,625,124,12,0,1066,9,325,28.611632270168858,58.630393996247655,11.632270168855536,1.125703564727955,0.0
80,서울특별시,성동구,성수1가제2동,성수1가제2동제3투,2569,1875,674,979,183,20,1,1857,18,694,36.295099623047925,52.719439956919764,9.8546042003231,1.0770059235325793,0.053850296176628974
81,서울특별시,성동구,성수1가제2동,성수1가제2동제4투,2657,2044,697,1094,199,33,5,2028,16,613,34.36883629191321,53.9447731755424,9.812623274161735,1.6272189349112427,0.2465483234714004
82,서울특별시,성동구,성수2가제1동,관내사전투표,3531,3531,2149,1019,300,29,4,3501,30,0,61.38246215367038,29.105969722936305,8.56898029134533,0.8283347614967151,0.11425307055127107
83,서울특별시,성동구,성수2가제1동,성수2가제1동제1투,1876,1243,364,739,121,9,0,1233,10,633,29.521492295214923,59.93511759935117,9.813463098134632,0.7299270072992701,0.0
84,서울특별시,성동구,성수2가제1동,성수2가제1동제2투,2217,1514,507,877,116,8,0,1508,6,703,33.62068965517241,58.15649867374005,7.6923076923076925,0.5305039787798408,0.0
85,서울특별시,성동구,성수2가제1동,성수2가제1동제3투,2085,1222,416,691,88,14,3,1212,10,863,34.32343234323432,57.01320132013201,7.2607260726072615,1.155115511551155,0.24752475247524752
86,서울특별시,성동구,성수2가제1동,성수2가제1동제4투,2012,1320,435,729,128,19,0,1311,9,692,33.18077803203661,55.60640732265446,9.763539282990084,1.4492753623188406,0.0
87,서울특별시,성동구,성수2가제3동,관내사전투표,2482,2482,1514,652,264,25,4,2459,23,0,61.56974379829199,26.51484343228955,10.736071573810491,1.01667344448963,0.16266775111834078
88,서울특별시,성동구,성수2가제3동,성수2가제3동제1투,2011,1357,442,731,155,17,3,1348,9,654,32.789317507418396,54.22848664688428,11.498516320474778,1.261127596439169,0.22255192878338279
89,서울특별시,성동구,성수2가제3동,성수2가제3동제2투,2512,1895,455,1243,157,28,3,1886,9,617,24.12513255567338,65.90668080593849,8.324496288441145,1.4846235418875928,0.15906680805938495
90,서울특별시,성동구,성수2가제3동,성수2가제3동제3투,1139,763,275,391,79,13,0,758,5,376,36.27968337730871,51.58311345646438,10.422163588390502,1.7150395778364116,0.0
91,서울특별시,성동구,잘못 투입·구분된 투표지,,0,0,0,0,0,0,0,0,0,0,0.0,0.0,0.0,0.0,0.0
0,서울특별시,광진구,거소·선상투표,,299,286,112,102,65,0,0,279,7,13,40.14336917562724,36.55913978494624,23.297491039426525,0.0,0.0
1,서울특별시,광진구,관외사전투표,,32950,32946,19116,8159,4733,480,41,32529,417,4,58.76602416305451,25.082234313996743,14.550093762488855,1.4756063819976022,0.12604137846229518
2,서울특별시,광진구,재외투표,,2554,2054,1352,450,198,39,1,2040,14,500,66.27450980392156,22.058823529411764,9.705882352941178,1.911764705882353,0.049019607843137254
3,서울특별시,광진구,중곡제1동,관내사전투표,3380,3380,2337,725,255,41,2,3360,20,0,69.55357142857143,21.577380952380953,7.5892857142857135,1.2202380952380953,0.05952380952380953
4,서울특별시,광진구,중곡제1동,중곡제1동제1투,2051,1345,491,657,156,19,0,1323,22,706,37.11262282690854,49.65986394557823,11.791383219954648,1.436130007558579,0.0
5,서울특별시,광진구,중곡제1동,중곡제1동제2투,2274,1456,552,727,142,20,2,1443,13,818,38.25363825363826,50.381150381150384,9.84060984060984,1.386001386001386,0.1386001386001386
6,서울특별시,광진구,중곡제1동,중곡제1동제3투,2271,1507,617,725,135,15,0,1492,15,764,41.35388739946381,48.59249329758713,9.048257372654156,1.0053619302949062,0.0
7,서울특별시,광진구,중곡제1동,중곡제1동제4투,2083,1377,483,715,145,23,1,1367,10,706,35.33284564740307,52.30431602048281,10.607168983174835,1.6825164594001463,0.0731528895391368
8,서울특별시,광진구,중곡제2동,관내사전투표,4404,4404,2937,1011,368,51,2,4369,35,0,67.22362096589609,23.140306706340123,8.422980086976425,1.1673151750972763,0.04577706569008926
9,서울특별시,광진구,중곡제2동,중곡제2동제1투,2179,1364,498,708,140,8,1,1355,9,815,36.75276752767528,52.25092250922509,10.33210332103321,0.5904059040590406,0.07380073800738007
10,서울특별시,광진구,중곡제2동,중곡제2동제2투,2485,1723,711,807,181,15,2,1716,7,762,41.43356643356643,47.02797202797203,10.547785547785548,0.8741258741258742,0.11655011655011654
11,서울특별시,광진구,중곡제2동,중곡제2동제3투,2807,1902,775,905,189,15,2,1886,16,905,41.092258748674446,47.98515376458112,10.02120890774125,0.7953340402969247,0.10604453870625664
12,서울특별시,광진구,중곡제2동,중곡제2동제4투,1761,1117,436,560,100,16,0,1112,5,644,39.20863309352518,50.35971223021583,8.992805755395683,1.4388489208633095,0.0
13,서울특별시,광진구,중곡제2동,중곡제2동제5투,2443,1580,616,787,140,16,3,1562,18,863,39.436619718309856,50.38412291933418,8.962868117797695,1.0243277848911652,0.19206145966709345
14,서울특별시,광진구,중곡제3동,관내사전투표,3353,3353,2263,769,263,29,1,3325,28,0,68.06015037593986,23.127819548872182,7.909774436090225,0.8721804511278195,0.03007518796992481
15,서울특별시,광진구,중곡제3동,중곡제3동제1투,1851,1319,544,606,140,14,4,1308,11,532,41.59021406727829,46.330275229357795,10.703363914373089,1.0703363914373087,0.3058103975535168
16,서울특별시,광진구,중곡제3동,중곡제3동제2투,1745,1216,480,592,110,19,1,1202,14,529,39.93344425956739,49.25124792013311,9.151414309484194,1.5806988352745424,0.08319467554076539
17,서울특별시,광진구,중곡제3동,중곡제3동제3투,1894,1234,469,623,116,16,2,1226,8,660,38.25448613376835,50.815660685154974,9.461663947797716,1.3050570962479608,0.1631321370309951
18,서울특별시,광진구,중곡제3동,중곡제3동제4투,1951,1230,446,639,114,16,2,1217,13,721,36.64749383730484,52.506162695152014,9.367296631059983,1.314708299096138,0.16433853738701726
19,서울특별시,광진구,중곡제3동,중곡제3동제5투,1696,1040,369,578,76,10,1,1034,6,656,35.686653771760156,55.89941972920697,7.35009671179884,0.9671179883945842,0.09671179883945842
20,서울특별시,광진구,중곡제4동,관내사전투표,6484,6484,4450,1543,389,62,7,6451,33,0,68.98155324755851,23.91877228336692,6.030072856921407,0.961091303673849,0.10851030847930554
21,서울특별시,광진구,중곡제4동,중곡제4동제1투,2485,1751,652,910,159,13,3,1737,14,734,37.53598157743235,52.38917674150835,9.153713298791018,0.7484168105929765,0.17271157167530224
22,서울특별시,광진구,중곡제4동,중곡제4동제2투,2643,1950,845,868,186,29,1,1929,21,693,43.80508035251426,44.997407983411094,9.642301710730948,1.503369621565578,0.05184033177812338
23,서울특별시,광진구,중곡제4동,중곡제4동제3투,1830,1200,399,678,95,16,3,1191,9,630,33.50125944584383,56.92695214105793,7.976490344248531,1.343408900083963,0.2518891687657431
24,서울특별시,광진구,중곡제4동,중곡제4동제4투,1892,1203,473,602,102,10,4,1191,12,689,39.71452560873216,50.545759865659114,8.564231738035264,0.8396305625524769,0.33585222502099077
25,서울특별시,광진구,중곡제4동,중곡제4동제5투,2375,1606,619,836,122,13,6,1596,10,769,38.7844611528822,52.38095238095239,7.644110275689223,0.8145363408521302,0.37593984962406013
26,서울특별시,광진구,중곡제4동,중곡제4동제6투,2226,1470,485,811,144,14,4,1458,12,756,33.26474622770919,55.6241426611797,9.876543209876543,0.9602194787379973,0.2743484224965706
27,서울특별시,광진구,중곡제4동,중곡제4동제7투,2429,1591,580,837,138,22,2,1579,12,838,36.73210892970234,53.008233058898035,8.739708676377454,1.3932868904369855,0.1266624445851805
28,서울특별시,광진구,능동,관내사전투표,2784,2784,1853,577,297,35,1,2763,21,0,67.0647846543612,20.88309808179515,10.749185667752444,1.2667390517553385,0.036192544335866814
29,서울특별시,광진구,능동,능동제1투,1761,1200,377,649,148,12,3,1189,11,561,31.70731707317073,54.58368376787216,12.447434819175777,1.0092514718250631,0.2523128679562658
30,서울특별시,광진구,능동,능동제2투,1991,1393,505,686,162,21,4,1378,15,598,36.64731494920174,49.782293178519595,11.756168359941945,1.5239477503628447,0.29027576197387517
31,서울특별시,광진구,능동,능동제3투,2515,1803,695,879,174,28,1,1777,26,712,39.11086100168824,49.46539110861002,9.791783905458638,1.5756893640967922,0.056274620146314014
32,서울특별시,광진구,구의제1동,관내사전투표,5657,5656,3625,1355,573,51,3,5607,49,1,64.65132869627251,24.166220795434278,10.219368646334939,0.9095773140716961,0.05350454788657035
33,서울특별시,광진구,구의제1동,구의제1동제1투,2843,1784,632,909,198,23,1,1763,21,1059,35.84798638684062,51.559841179807144,11.230856494611457,1.3045944412932502,0.05672149744753262
34,서울특별시,광진구,구의제1동,구의제1동제2투,3248,2347,841,1217,242,28,1,2329,18,901,36.109918419922714,52.25418634607127,10.390725633319022,1.2022327179046801,0.042936882782310004
35,서울특별시,광진구,구의제1동,구의제1동제3투,2504,1651,580,830,188,26,5,1629,22,853,35.60466543891958,50.951503990178026,11.540822590546346,1.596071209330878,0.3069367710251688
36,서울특별시,광진구,구의제1동,구의제1동제4투,2176,1428,532,682,188,15,1,1418,10,748,37.51763046544429,48.09590973201692,13.258110014104371,1.0578279266572637,0.07052186177715092
37,서울특별시,광진구,구의제1동,구의제1동제5투,2547,1658,560,840,204,27,4,1635,23,889,34.25076452599388,51.37614678899083,12.477064220183486,1.651376146788991,0.24464831804281345
38,서울특별시,광진구,구의제2동,관내사전투표,4927,4927,3411,1068,371,42,1,4893,34,0,69.71183323114654,21.827099938687923,7.582260371959943,0.8583690987124464,0.020437359493153485
39,서울특별시,광진구,구의제2동,구의제2동제1투,2090,1331,511,649,128,26,0,1314,17,759,38.88888888888889,49.39117199391172,9.74124809741248,1.97869101978691,0.0
40,서울특별시,광진구,구의제2동,구의제2동제2투,2088,1570,537,833,168,22,0,1560,10,518,34.42307692307692,53.3974358974359,10.76923076923077,1.4102564102564104,0.0
41,서울특별시,광진구,구의제2동,구의제2동제3투,1947,1350,530,656,136,17,1,1340,10,597,39.55223880597015,48.95522388059702,10.149253731343283,1.2686567164179103,0.0746268656716418
42,서울특별시,광진구,구의제2동,구의제2동제4투,2666,1803,768,854,146,22,2,1792,11,863,42.857142857142854,47.65625,8.147321428571429,1.2276785714285714,0.11160714285714285
43,서울특별시,광진구,구의제2동,구의제2동제5투,2560,1667,643,866,125,21,0,1655,12,893,38.85196374622357,52.32628398791541,7.552870090634441,1.2688821752265862,0.0
44,서울특별시,광진구,구의제2동,구의제2동제6투,3001,2094,927,965,158,26,3,2079,15,907,44.58874458874459,46.41654641654642,7.599807599807599,1.2506012506012507,0.1443001443001443
45,서울특별시,광진구,구의제3동,관내사전투표,6253,6253,3914,1552,640,87,4,6197,56,0,63.15959335162176,25.04437631111828,10.327577860254962,1.403905115378409,0.06454736162659351
46,서울특별시,광진구,구의제3동,구의제3동제1투,2729,2159,646,1303,179,16,1,2145,14,570,30.116550116550115,60.74592074592074,8.344988344988344,0.745920745920746,0.046620046620046623
47,서울특별시,광진구,구의제3동,구의제3동제2투,2309,1539,578,780,138,19,5,1520,19,770,38.026315789473685,51.31578947368421,9.078947368421053,1.25,0.3289473684210526
48,서울특별시,광진구,구의제3동,구의제3동제3투,2906,2051,724,1067,225,21,2,2039,12,855,35.50760176557136,52.32957332025503,11.034820990681707,1.0299166257969592,0.0980872976949485
49,서울특별시,광진구,구의제3동,구의제3동제4투,2268,1522,409,937,152,14,0,1512,10,746,27.05026455026455,61.97089947089947,10.052910052910052,0.9259259259259258,0.0
50,서울특별시,광진구,구의제3동,구의제3동제5투,2817,2104,667,1178,216,23,0,2084,20,713,32.005758157389636,56.52591170825336,10.36468330134357,1.1036468330134357,0.0
51,서울특별시,광진구,구의제3동,구의제3동제6투,2697,2163,580,1340,206,23,2,2151,12,534,26.96420269642027,62.296606229660625,9.576940957694095,1.0692701069270107,0.09298000929800093
52,서울특별시,광진구,광장동,관내사전투표,5277,5277,3352,1332,496,55,3,5238,39,0,63.993890798014505,25.42955326460481,9.469263077510501,1.0500190912562046,0.057273768613974804
53,서울특별시,광진구,광장동,광장동제1투,3606,2438,786,1388,212,32,3,2421,17,1168,32.465923172242874,57.33168112350269,8.75671210243701,1.321767864518794,0.12391573729863693
54,서울특별시,광진구,광장동,광장동제2투,2592,1866,453,1268,119,19,2,1861,5,726,24.341751746372918,68.13541106931757,6.394411606663085,1.0209564750134337,0.10746910263299302
55,서울특별시,광진구,광장동,광장동제3투,2686,2100,794,1030,242,24,0,2090,10,586,37.99043062200957,49.282296650717704,11.578947368421053,1.1483253588516746,0.0
56,서울특별시,광진구,광장동,광장동제4투,2824,2240,853,1124,225,28,1,2231,9,584,38.23397579560735,50.380995069475574,10.085163603765128,1.2550425818018824,0.04482294935006724
57,서울특별시,광진구,광장동,광장동제5투,3612,2748,979,1402,295,50,0,2726,22,864,35.91342626559061,51.43066764490095,10.821716801173881,1.834189288334556,0.0
58,서울특별시,광진구,광장동,광장동제6투,2907,2248,696,1309,210,20,0,2235,13,659,31.140939597315437,58.5682326621924,9.395973154362416,0.8948545861297539,0.0
59,서울특별시,광진구,자양제1동,관내사전투표,6147,6147,4124,1449,474,64,4,6115,32,0,67.44071954210956,23.695829926410468,7.751430907604252,1.0466067048242027,0.06541291905151267
60,서울특별시,광진구,자양제1동,자양제1동제1투,2058,1306,443,680,151,17,2,1293,13,752,34.261407579273005,52.590873936581595,11.678267594740912,1.3147718484145399,0.15467904098994587
61,서울특별시,광진구,자양제1동,자양제1동제2투,2120,1448,493,724,186,22,0,1425,23,672,34.59649122807018,50.807017543859644,13.052631578947368,1.5438596491228072,0.0
62,서울특별시,광진구,자양제1동,자양제1동제3투,2823,1822,631,925,220,29,2,1807,15,1001,34.919756502490316,51.189817376867744,12.174875484228002,1.6048699501936912,0.11068068622025456
63,서울특별시,광진구,자양제1동,자양제1동제4투,1790,1185,415,631,119,9,4,1178,7,605,35.22920203735144,53.565365025466896,10.101867572156197,0.7640067911714771,0.3395585738539898
64,서울특별시,광진구,자양제1동,자양제1동제5투,1770,1003,361,514,104,12,1,992,11,767,36.391129032258064,51.81451612903226,10.483870967741936,1.2096774193548387,0.10080645161290322
65,서울특별시,광진구,자양제1동,자양제1동제6투,1830,1198,457,587,126,14,2,1186,12,632,38.53288364249578,49.494097807757164,10.623946037099493,1.1804384485666104,0.16863406408094433
66,서울특별시,광진구,자양제2동,관내사전투표,3849,3849,2603,926,267,28,4,3828,21,0,67.99895506792059,24.1901776384535,6.974921630094045,0.7314524555903866,0.10449320794148381
67,서울특별시,광진구,자양제2동,자양제2동제1투,2411,1621,558,898,130,18,5,1609,12,790,34.67992541951523,55.81106277190801,8.079552517091361,1.1187072715972655,0.3107520198881293
68,서울특별시,광진구,자양제2동,자양제2동제2투,3200,2413,774,1310,274,29,1,2388,25,787,32.41206030150754,54.85762144053601,11.474036850921273,1.2144053601340032,0.04187604690117253
69,서울특별시,광진구,자양제2동,자양제2동제3투,2219,1481,569,741,139,19,0,1468,13,738,38.76021798365122,50.47683923705723,9.46866485013624,1.2942779291553135,0.0
70,서울특별시,광진구,자양제2동,자양제2동제4투,2032,1445,536,763,114,18,3,1434,11,587,37.37796373779637,53.207810320781036,7.949790794979079,1.2552301255230125,0.20920502092050208
71,서울특별시,광진구,자양제2동,자양제2동제5투,1960,1314,524,633,123,14,4,1298,16,646,40.36979969183359,48.7673343605547,9.476117103235747,1.078582434514638,0.30816640986132515
72,서울특별시,광진구,자양제2동,자양제2동제6투,2511,1774,750,832,155,23,1,1761,13,737,42.58943781942078,47.24588302101079,8.801817149346961,1.306076093128904,0.05678591709256105
73,서울특별시,광진구,자양제3동,관내사전투표,6343,6343,4004,1682,540,72,3,6301,42,0,63.54546897317886,26.69417552769402,8.57006824313601,1.1426757657514681,0.047611490239644505
74,서울특별시,광진구,자양제3동,자양제3동제1투,2065,1408,480,750,150,20,3,1403,5,657,34.212401995723454,53.45687811831789,10.691375623663578,1.4255167498218104,0.21382751247327159
75,서울특별시,광진구,자양제3동,자양제3동제2투,2575,1808,521,1072,184,15,0,1792,16,767,29.073660714285715,59.82142857142857,10.267857142857142,0.8370535714285714,0.0
76,서울특별시,광진구,자양제3동,자양제3동제3투,2223,1654,516,940,166,20,2,1644,10,569,31.386861313868614,57.17761557177615,10.097323600973237,1.2165450121654502,0.12165450121654502
77,서울특별시,광진구,자양제3동,자양제3동제4투,1976,1513,497,848,142,14,1,1502,11,463,33.08921438082557,56.45805592543276,9.454061251664447,0.9320905459387484,0.06657789613848203
78,서울특별시,광진구,자양제3동,자양제3동제5투,1934,1466,460,817,153,22,1,1453,13,468,31.65863730213352,56.22849277357192,10.529938059187888,1.5141087405368203,0.06882312456985547
79,서울특별시,광진구,자양제3동,자양제3동제6투,1337,881,326,424,108,13,0,871,10,456,37.42824339839265,48.679678530424795,12.399540757749714,1.4925373134328357,0.0
80,서울특별시,광진구,자양제3동,자양제3동제7투,2698,2072,376,1520,148,16,2,2062,10,626,18.234723569350145,73.71483996120271,7.177497575169737,0.7759456838021339,0.09699321047526674
81,서울특별시,광진구,자양제4동,관내사전투표,4640,4640,3030,1163,385,35,4,4617,23,0,65.62703053931124,25.1895170023825,8.338748104829977,0.7580680095299979,0.08663634394628547
82,서울특별시,광진구,자양제4동,자양제4동제1투,1599,990,319,570,86,6,0,981,9,609,32.51783893985729,58.103975535168196,8.766564729867483,0.6116207951070336,0.0
83,서울특별시,광진구,자양제4동,자양제4동제2투,2021,1444,425,850,140,16,1,1432,12,577,29.678770949720672,59.357541899441344,9.776536312849162,1.1173184357541899,0.06983240223463687
84,서울특별시,광진구,자양제4동,자양제4동제3투,2342,1602,538,858,165,20,0,1581,21,740,34.029095509171405,54.26944971537002,10.436432637571158,1.265022137887413,0.0
85,서울특별시,광진구,자양제4동,자양제4동제4투,2277,1462,494,782,163,16,3,1458,4,815,33.882030178326474,53.635116598079556,11.179698216735254,1.0973936899862824,0.205761316872428
86,서울특별시,광진구,자양제4동,자양제4동제5투,1780,1099,389,561,130,11,0,1091,8,681,35.655362053162236,51.42071494042163,11.915673693858846,1.008249312557287,0.0
87,서울특별시,광진구,자양제4동,자양제4동제6투,1942,1414,436,777,160,26,1,1400,14,528,31.142857142857146,55.50000000000001,11.428571428571429,1.8571428571428572,0.07142857142857142
88,서울특별시,광진구,화양동,관내사전투표,5320,5320,3095,1086,1004,65,2,5252,68,0,58.929931454683924,20.67783701447068,19.116527037319116,1.2376237623762376,0.03808073115003808
89,서울특별시,광진구,화양동,화양동제1투,3894,2471,780,1174,430,45,2,2431,40,1423,32.0855614973262,48.292883587001235,17.688194158782395,1.851090086384204,0.08227067050596462
90,서울특별시,광진구,화양동,화양동제2투,2339,1508,442,737,285,27,0,1491,17,831,29.64453386988598,49.4299128101945,19.114688128772634,1.8108651911468814,0.0
91,서울특별시,광진구,화양동,화양동제3투,2381,1480,483,749,210,20,3,1465,15,901,32.96928327645051,51.12627986348123,14.334470989761092,1.3651877133105803,0.20477815699658702
92,서울특별시,광진구,화양동,화양동제4투,1844,1051,317,517,170,24,3,1031,20,793,30.746847720659552,50.14548981571289,16.488845780795344,2.3278370514064015,0.2909796314258002
93,서울특별시,광진구,화양동,화양동제5투,1908,1189,418,551,179,21,1,1170,19,719,35.72649572649573,47.09401709401709,15.2991452991453,1.7948717948717947,0.08547008547008547
94,서울특별시,광진구,화양동,화양동제6투,2220,1455,442,739,234,20,0,1435,20,765,30.801393728222997,51.49825783972125,16.306620209059233,1.3937282229965158,0.0
95,서울특별시,광진구,군자동,관내사전투표,3977,3977,2605,847,439,36,4,3931,46,0,66.26812515899262,21.54668023403714,11.167641821419485,0.9157975069956754,0.10175527855507505
96,서울특별시,광진구,군자동,군자동제1투,2215,1417,457,718,202,19,1,1397,20,798,32.71295633500358,51.39584824624195,14.459556191839656,1.3600572655690766,0.07158196134574087
97,서울특별시,광진구,군자동,군자동제2투,1639,1093,384,547,138,19,0,1088,5,546,35.294117647058826,50.27573529411765,12.683823529411764,1.7463235294117647,0.0
98,서울특별시,광진구,군자동,군자동제3투,1694,1083,384,553,119,18,1,1075,8,611,35.72093023255814,51.44186046511627,11.069767441860465,1.6744186046511629,0.09302325581395349
99,서울특별시,광진구,군자동,군자동제4투,1604,1033,384,509,115,16,0,1024,9,571,37.5,49.70703125,11.23046875,1.5625,0.0
100,서울특별시,광진구,군자동,군자동제5투,1809,1298,461,688,115,17,0,1281,17,511,35.987509758001565,53.7080405932865,8.97736143637783,1.3270882123341141,0.0
101,서울특별시,광진구,군자동,군자동제6투,2108,1384,536,653,165,13,2,1369,15,724,39.152666179693206,47.699050401753105,12.052593133674215,0.9495982468955442,0.1460920379839299
102,서울특별시,광진구,잘못 투입·구분된 투표지,,0,4,2,2,0,0,0,4,0,-4,50.0,50.0,0.0,0.0,0.0
0,서울특별시,동대문구,거소·선상투표,,394,369,166,111,65,4,3,349,20,25,47.56446991404012,31.805157593123205,18.624641833810887,1.146131805157593,0.8595988538681949
1,서울특별시,동대문구,관외사전투표,,36619,36608,21374,8798,5448,547,43,36210,398,11,59.02789284727976,24.297155481911073,15.045567522783761,1.5106324219828775,0.11875172604252969
2,서울특별시,동대문구,재외투표,,2482,1932,1296,400,195,26,1,1918,14,550,67.570385818561,20.855057351407716,10.166840458811262,1.3555787278415017,0.05213764337851929
3,서울특별시,동대문구,용신동,관내사전투표,6789,6788,4414,1701,579,46,4,6744,44,1,65.45077105575326,25.222419928825623,8.58540925266904,0.6820877817319099,0.05931198102016608
4,서울특별시,동대문구,용신동,용신동제1투,2452,1554,463,920,144,14,1,1542,12,898,30.025940337224384,59.66277561608301,9.33852140077821,0.9079118028534372,0.06485084306095978
5,서울특별시,동대문구,용신동,용신동제2투,2341,1461,550,723,158,16,2,1449,12,880,37.95721187025535,49.896480331262936,10.904071773636991,1.1042097998619738,0.13802622498274672
6,서울특별시,동대문구,용신동,용신동제3투,4178,2762,991,1453,277,21,3,2745,17,1416,36.10200364298725,52.93260473588342,10.091074681238615,0.7650273224043715,0.1092896174863388
7,서울특별시,동대문구,용신동,용신동제4투,2103,1439,514,741,158,18,1,1432,7,664,35.89385474860335,51.745810055865924,11.033519553072626,1.2569832402234637,0.06983240223463687
8,서울특별시,동대문구,용신동,용신동제5투,2678,1817,654,899,221,24,3,1801,16,861,36.313159355913385,49.91671293725708,12.270960577456968,1.3325930038867295,0.1665741254858412
9,서울특별시,동대문구,용신동,용신동제6투,3688,2436,871,1201,301,39,0,2412,24,1252,36.11111111111111,49.792703150912104,12.479270315091211,1.616915422885572,0.0
10,서울특별시,동대문구,용신동,용신동제7투,2508,1719,610,873,197,22,2,1704,15,789,35.798122065727696,51.232394366197184,11.561032863849766,1.2910798122065728,0.11737089201877934
11,서울특별시,동대문구,용신동,용신동제8투,2594,1817,698,886,193,21,2,1800,17,777,38.77777777777778,49.22222222222222,10.722222222222221,1.1666666666666667,0.1111111111111111
12,서울특별시,동대문구,제기동,관내사전투표,4877,4877,2971,1350,458,55,4,4838,39,0,61.40967341876809,27.90409260024804,9.466721785861926,1.1368334022323274,0.0826787928896238
13,서울특별시,동대문구,제기동,제기동제1투,2345,1366,443,809,82,15,2,1351,15,979,32.79052553663953,59.881569207994076,6.069578090303479,1.1102886750555145,0.1480384900074019
14,서울특별시,동대문구,제기동,제기동제2투,2288,1578,510,909,121,18,4,1562,16,710,32.65044814340589,58.19462227912933,7.746478873239436,1.1523687580025608,0.2560819462227913
15,서울특별시,동대문구,제기동,제기동제3투,2319,1390,430,765,164,16,3,1378,12,929,31.204644412191584,55.51523947750363,11.901306240928882,1.1611030478955007,0.21770682148040638
16,서울특별시,동대문구,제기동,제기동제4투,2395,1601,567,779,218,22,4,1590,11,794,35.660377358490564,48.9937106918239,13.71069182389937,1.3836477987421385,0.25157232704402516
17,서울특별시,동대문구,제기동,제기동제5투,2158,1572,537,791,208,19,0,1555,17,586,34.533762057877816,50.868167202572344,13.37620578778135,1.2218649517684887,0.0
18,서울특별시,동대문구,제기동,제기동제6투,2098,1443,514,752,147,18,1,1432,11,655,35.89385474860335,52.513966480446925,10.26536312849162,1.2569832402234637,0.06983240223463687
19,서울특별시,동대문구,청량리동,관내사전투표,4545,4545,2686,1329,436,53,3,4507,38,0,59.59618371422232,29.487463944974486,9.67384069225649,1.1759485245174173,0.06656312402928778
20,서울특별시,동대문구,청량리동,청량리동제1투,1635,973,352,507,97,8,1,965,8,662,36.476683937823836,52.53886010362694,10.05181347150259,0.8290155440414507,0.10362694300518134
21,서울특별시,동대문구,청량리동,청량리동제2투,2415,1860,737,964,126,21,2,1850,10,555,39.83783783783784,52.10810810810811,6.8108108108108105,1.135135135135135,0.10810810810810811
22,서울특별시,동대문구,청량리동,청량리동제3투,988,669,234,367,48,9,1,659,10,319,35.50834597875569,55.69044006069803,7.283763277693475,1.3657056145675266,0.15174506828528073
23,서울특별시,동대문구,청량리동,청량리동제4투,1644,1038,382,581,65,5,1,1034,4,606,36.94390715667311,56.18955512572534,6.286266924564797,0.4835589941972921,0.09671179883945842
24,서울특별시,동대문구,청량리동,청량리동제5투,1969,1303,429,767,81,17,2,1296,7,666,33.101851851851855,59.1820987654321,6.25,1.3117283950617282,0.15432098765432098
25,서울특별시,동대문구,청량리동,청량리동제6투,2897,1834,449,1217,138,18,0,1822,12,1063,24.64324917672887,66.794731064764,7.574094401756312,0.9879253567508233,0.0
26,서울특별시,동대문구,회기동,관내사전투표,5173,5173,2917,1052,1050,94,2,5115,58,0,57.028347996089934,20.56695992179863,20.527859237536656,1.8377321603128056,0.039100684261974585
27,서울특별시,동대문구,회기동,회기동제1투,2371,1563,439,782,290,23,1,1535,28,808,28.599348534201958,50.94462540716612,18.892508143322477,1.498371335504886,0.06514657980456026
28,서울특별시,동대문구,회기동,회기동제2투,1967,1409,421,762,197,17,1,1398,11,558,30.11444921316166,54.506437768240346,14.091559370529328,1.2160228898426324,0.07153075822603719
29,서울특별시,동대문구,회기동,회기동제3투,1633,1034,370,500,142,12,3,1027,7,599,36.027263875365136,48.685491723466406,13.82667964946446,1.1684518013631937,0.2921129503407984
30,서울특별시,동대문구,휘경제1동,관내사전투표,2668,2668,1645,711,268,25,1,2650,18,0,62.075471698113205,26.830188679245282,10.11320754716981,0.9433962264150944,0.03773584905660377
31,서울특별시,동대문구,휘경제1동,휘경제1동제1투,2078,1429,473,782,145,19,1,1420,9,649,33.309859154929576,55.07042253521127,10.211267605633804,1.3380281690140845,0.07042253521126761
32,서울특별시,동대문구,휘경제1동,휘경제1동제2투,2562,1800,623,933,199,26,0,1781,19,762,34.98034811903425,52.386299831555306,11.173498034811903,1.4598540145985401,0.0
33,서울특별시,동대문구,휘경제1동,휘경제1동제3투,2593,1658,504,808,296,29,3,1640,18,935,30.73170731707317,49.26829268292683,18.048780487804876,1.768292682926829,0.1829268292682927
34,서울특별시,동대문구,휘경제2동,관내사전투표,2562,2562,1687,601,222,31,3,2544,18,0,66.312893081761,23.624213836477985,8.726415094339622,1.2185534591194969,0.1179245283018868
35,서울특별시,동대문구,휘경제2동,휘경제2동제1투,1864,1236,445,629,135,13,0,1222,14,628,36.41571194762684,51.47299509001637,11.04746317512275,1.0638297872340425,0.0
36,서울특별시,동대문구,휘경제2동,휘경제2동제2투,2016,1612,675,756,145,25,1,1602,10,404,42.13483146067416,47.19101123595505,9.051186017478152,1.5605493133583022,0.062421972534332085
37,서울특별시,동대문구,휘경제2동,휘경제2동제3투,3115,2121,683,948,418,45,4,2098,23,994,32.554814108674925,45.185891325071495,19.92373689227836,2.144899904671115,0.19065776930409914
38,서울특별시,동대문구,휘경제2동,휘경제2동제4투,3325,2314,784,1107,374,23,2,2290,24,1011,34.23580786026201,48.340611353711786,16.33187772925764,1.0043668122270744,0.08733624454148471
39,서울특별시,동대문구,휘경제2동,휘경제2동제5투,2368,1887,748,951,153,21,2,1875,12,481,39.89333333333333,50.72,8.16,1.1199999999999999,0.10666666666666667
40,서울특별시,동대문구,휘경제2동,휘경제2동제6투,1943,1361,533,689,110,18,0,1350,11,582,39.48148148148148,51.03703703703704,8.148148148148149,1.3333333333333335,0.0
41,서울특별시,동대문구,이문제1동,관내사전투표,2489,2489,1476,648,308,36,1,2469,20,0,59.78128797083839,26.24544349939247,12.474686107735925,1.4580801944106925,0.04050222762251924
42,서울특별시,동대문구,이문제1동,이문제1동제1투,1570,952,300,563,78,5,0,946,6,618,31.712473572938688,59.5137420718816,8.24524312896406,0.5285412262156448,0.0
43,서울특별시,동대문구,이문제1동,이문제1동제2투,2253,1798,693,825,229,32,0,1779,19,455,38.954468802698145,46.3743676222597,12.872400224845418,1.7987633501967397,0.0
44,서울특별시,동대문구,이문제1동,이문제1동제3투,1851,1393,402,722,230,23,3,1380,13,458,29.130434782608695,52.31884057971015,16.666666666666664,1.6666666666666667,0.21739130434782608
45,서울특별시,동대문구,이문제1동,이문제1동제4투,2353,1815,677,864,232,25,2,1800,15,538,37.611111111111114,48.0,12.88888888888889,1.3888888888888888,0.1111111111111111
46,서울특별시,동대문구,이문제1동,이문제1동제5투,2340,1676,608,840,179,29,2,1658,18,664,36.67068757539204,50.663449939686366,10.796139927623644,1.7490952955367913,0.12062726176115801
47,서울특별시,동대문구,이문제1동,이문제1동제6투,2386,1639,512,797,280,33,1,1623,16,747,31.54651879235983,49.106592729513245,17.25200246457178,2.033271719038817,0.06161429451632779
48,서울특별시,동대문구,이문제2동,관내사전투표,3852,3852,2609,885,297,34,2,3827,25,0,68.17350405016984,23.125163313300234,7.760648027175334,0.8884243532793311,0.052260256075254766
49,서울특별시,동대문구,이문제2동,이문제2동제1투,2309,1506,557,763,148,22,0,1490,16,803,37.38255033557047,51.20805369127517,9.93288590604027,1.476510067114094,0.0
50,서울특별시,동대문구,이문제2동,이문제2동제2투,1196,670,252,361,47,5,0,665,5,526,37.89473684210527,54.285714285714285,7.067669172932331,0.7518796992481203,0.0
51,서울특별시,동대문구,이문제2동,이문제2동제3투,2244,1667,612,883,145,18,0,1658,9,577,36.91194209891435,53.256936067551266,8.745476477683956,1.0856453558504222,0.0
52,서울특별시,동대문구,이문제2동,이문제2동제4투,2340,1857,758,942,126,23,1,1850,7,483,40.97297297297297,50.91891891891892,6.8108108108108105,1.2432432432432432,0.05405405405405406
53,서울특별시,동대문구,이문제2동,이문제2동제5투,2363,1816,731,902,147,20,2,1802,14,547,40.56603773584906,50.055493895671475,8.157602663706992,1.1098779134295227,0.11098779134295228
54,서울특별시,동대문구,전농제1동,관내사전투표,4785,4784,3022,1295,372,45,4,4738,46,1,63.782186576614606,27.332207682566484,7.851414098775855,0.9497678345293372,0.08442380751371886
55,서울특별시,동대문구,전농제1동,전농제1동제1투,1973,1137,405,637,74,12,3,1131,6,836,35.80901856763926,56.32183908045977,6.542882404951371,1.0610079575596816,0.2652519893899204
56,서울특별시,동대문구,전농제1동,전농제1동제2투,2191,1568,566,841,133,19,0,1559,9,623,36.30532392559333,53.944836433611286,8.53110968569596,1.2187299550994226,0.0
57,서울특별시,동대문구,전농제1동,전농제1동제3투,2849,1825,636,914,223,26,3,1802,23,1024,35.294117647058826,50.72142064372919,12.37513873473918,1.4428412874583796,0.1664816870144284
58,서울특별시,동대문구,전농제1동,전농제1동제4투,1876,1277,490,631,126,19,2,1268,9,599,38.64353312302839,49.76340694006309,9.936908517350158,1.498422712933754,0.15772870662460567
59,서울특별시,동대문구,전농제1동,전농제1동제5투,1818,1155,429,621,85,11,1,1147,8,663,37.401918047079334,54.14123801220575,7.410636442894507,0.959023539668701,0.08718395815170009
60,서울특별시,동대문구,전농제1동,전농제1동제6투,1596,997,375,540,64,11,1,991,6,599,37.84056508577195,54.4904137235116,6.458123107971746,1.109989909182644,0.10090817356205853
61,서울특별시,동대문구,전농제1동,전농제1동제7투,1889,1485,615,720,124,15,3,1477,8,404,41.63845633039946,48.747461069735955,8.395396073121193,1.0155721056194988,0.2031144211238998
62,서울특별시,동대문구,전농제1동,전농제1동제8투,2222,1810,675,915,192,20,0,1802,8,412,37.458379578246394,50.776914539400664,10.654827968923417,1.1098779134295227,0.0
63,서울특별시,동대문구,전농제1동,전농제1동제9투,3191,2464,948,1175,299,24,2,2448,16,727,38.72549019607843,47.998366013071895,12.2140522875817,0.9803921568627451,0.08169934640522876
64,서울특별시,동대문구,전농제2동,관내사전투표,5165,5164,3374,1304,416,42,2,5138,26,1,65.66757493188011,25.37952510704554,8.096535616971584,0.8174386920980926,0.038925652004671074
65,서울특별시,동대문구,전농제2동,전농제2동제1투,1632,1137,400,624,95,5,2,1126,11,495,35.52397868561279,55.41740674955595,8.436944937833037,0.4440497335701598,0.17761989342806395
66,서울특별시,동대문구,전농제2동,전농제2동제2투,2326,1751,658,937,131,11,2,1739,12,575,37.83783783783784,53.881541115583666,7.533064979873491,0.6325474410580794,0.11500862564692352
67,서울특별시,동대문구,전농제2동,전농제2동제3투,1588,1126,431,598,80,10,0,1119,7,462,38.51653261840929,53.440571939231454,7.149240393208221,0.8936550491510277,0.0
68,서울특별시,동대문구,전농제2동,전농제2동제4투,2610,1762,639,958,133,15,0,1745,17,848,36.618911174785104,54.899713467048706,7.621776504297994,0.8595988538681949,0.0
69,서울특별시,동대문구,전농제2동,전농제2동제5투,1529,1038,386,543,84,14,0,1027,11,491,37.58519961051607,52.872444011684514,8.179162609542356,1.3631937682570594,0.0
70,서울특별시,동대문구,답십리제1동,관내사전투표,4975,4975,3341,1171,381,48,7,4948,27,0,67.52223120452709,23.6661277283751,7.700080840743735,0.9700889248181084,0.14147130153597412
71,서울특별시,동대문구,답십리제1동,답십리제1동제1투,2174,1378,497,672,172,19,4,1364,14,796,36.43695014662757,49.266862170087975,12.609970674486803,1.3929618768328444,0.2932551319648094
72,서울특별시,동대문구,답십리제1동,답십리제1동제2투,2603,1777,675,890,183,17,0,1765,12,826,38.243626062322946,50.42492917847026,10.36827195467422,0.9631728045325779,0.0
73,서울특별시,동대문구,답십리제1동,답십리제1동제3투,1999,1620,578,850,166,11,4,1609,11,379,35.922933499067746,52.827843380981975,10.316967060285892,0.6836544437538844,0.2486016159105034
74,서울특별시,동대문구,답십리제1동,답십리제1동제4투,2032,1542,580,798,137,17,2,1534,8,490,37.809647979139505,52.02086049543677,8.930899608865712,1.108213820078227,0.1303780964797914
75,서울특별시,동대문구,답십리제1동,답십리제1동제5투,2638,1916,716,982,172,24,4,1898,18,722,37.72391991570074,51.73867228661749,9.062170706006324,1.2644889357218125,0.21074815595363539
76,서울특별시,동대문구,답십리제1동,답십리제1동제6투,1550,1121,426,574,95,13,2,1110,11,429,38.37837837837838,51.711711711711715,8.558558558558559,1.1711711711711712,0.18018018018018017
77,서울특별시,동대문구,답십리제1동,답십리제1동제7투,2817,2264,842,1107,253,43,1,2246,18,553,37.488869100623326,49.28762243989314,11.264470169189671,1.914514692787177,0.04452359750667854
78,서울특별시,동대문구,답십리제2동,관내사전투표,4775,4775,3152,1223,323,44,2,4744,31,0,66.44182124789208,25.77993254637437,6.808600337268128,0.927487352445194,0.042158516020236084
79,서울특별시,동대문구,답십리제2동,답십리제2동제1투,3050,2049,711,1060,236,23,3,2033,16,1001,34.97294638465322,52.13969503197246,11.608460403344809,1.1313330054107231,0.14756517461878996
80,서울특별시,동대문구,답십리제2동,답십리제2동제2투,1789,1243,454,678,86,13,3,1234,9,546,36.790923824959485,54.94327390599676,6.9692058346839545,1.053484602917342,0.24311183144246357
81,서울특별시,동대문구,답십리제2동,답십리제2동제3투,1660,1219,471,622,107,12,1,1213,6,441,38.82934872217642,51.27782357790602,8.821104699093157,0.9892827699917559,0.08244023083264633
82,서울특별시,동대문구,답십리제2동,답십리제2동제4투,2269,1718,680,871,133,15,4,1703,15,551,39.92953611274222,51.14503816793893,7.809747504403992,0.8807985907222547,0.23487962419260128
83,서울특별시,동대문구,답십리제2동,답십리제2동제5투,2303,1748,674,911,139,13,3,1740,8,555,38.735632183908045,52.35632183908046,7.988505747126437,0.7471264367816092,0.1724137931034483
84,서울특별시,동대문구,답십리제2동,답십리제2동제6투,2624,1993,780,1021,163,17,3,1984,9,631,39.314516129032256,51.4616935483871,8.215725806451612,0.8568548387096774,0.15120967741935484
85,서울특별시,동대문구,답십리제2동,답십리제2동제7투,2419,1537,657,743,116,9,3,1528,9,882,42.99738219895288,48.62565445026178,7.591623036649215,0.5890052356020943,0.1963350785340314
86,서울특별시,동대문구,장안제1동,관내사전투표,8029,8029,5482,1851,555,78,8,7974,55,0,68.74843240531729,23.212942061700524,6.960120391271634,0.9781790820165538,0.1003260596940055
87,서울특별시,동대문구,장안제1동,장안제1동제1투,2543,1540,589,761,154,22,1,1527,13,1003,38.572364112639164,49.836280288146696,10.085134250163721,1.4407334643091028,0.06548788474132286
88,서울특별시,동대문구,장안제1동,장안제1동제2투,2978,2023,812,1021,158,15,3,2009,14,955,40.41811846689895,50.82130413140866,7.864609258337481,0.7466401194624191,0.14932802389248384
89,서울특별시,동대문구,장안제1동,장안제1동제3투,2922,1727,660,861,165,18,1,1705,22,1195,38.70967741935484,50.49853372434018,9.67741935483871,1.0557184750733137,0.05865102639296188
90,서울특별시,동대문구,장안제1동,장안제1동제4투,3338,2293,886,1139,217,30,6,2278,15,1045,38.8937664618086,50.0,9.525899912203688,1.3169446883230904,0.2633889376646181
91,서울특별시,동대문구,장안제1동,장안제1동제5투,2187,1511,663,698,126,16,2,1505,6,676,44.053156146179404,46.37873754152824,8.372093023255815,1.06312292358804,0.132890365448505
92,서울특별시,동대문구,장안제1동,장안제1동제6투,2919,2009,823,971,177,17,2,1990,19,910,41.35678391959799,48.79396984924623,8.894472361809045,0.8542713567839196,0.10050251256281408
93,서울특별시,동대문구,장안제1동,장안제1동제7투,2412,1936,732,1024,150,18,0,1924,12,476,38.04573804573805,53.222453222453225,7.796257796257796,0.9355509355509356,0.0
94,서울특별시,동대문구,장안제1동,장안제1동제8투,2731,2235,878,1128,178,29,2,2215,20,496,39.63882618510158,50.925507900677204,8.036117381489841,1.3092550790067718,0.09029345372460496
95,서울특별시,동대문구,장안제2동,관내사전투표,6728,6728,4530,1620,480,58,5,6693,35,0,67.68265351860153,24.204392649036308,7.171671896010758,0.8665770207679665,0.07470491558344539
96,서울특별시,동대문구,장안제2동,장안제2동제1투,1451,896,338,492,54,10,1,895,1,555,37.76536312849162,54.97206703910614,6.033519553072626,1.1173184357541899,0.11173184357541899
97,서울특별시,동대문구,장안제2동,장안제2동제2투,2543,1713,661,864,160,10,3,1698,15,830,38.928150765606595,50.8833922261484,9.422850412249705,0.5889281507656066,0.17667844522968199
98,서울특별시,동대문구,장안제2동,장안제2동제3투,1691,1110,454,538,94,14,0,1100,10,581,41.27272727272727,48.90909090909091,8.545454545454545,1.2727272727272727,0.0
99,서울특별시,동대문구,장안제2동,장안제2동제4투,2072,1375,550,701,105,7,3,1366,9,697,40.26354319180088,51.317715959004396,7.686676427525622,0.5124450951683748,0.21961932650073207
100,서울특별시,동대문구,장안제2동,장안제2동제5투,4143,2790,1159,1271,295,35,3,2763,27,1353,41.94715888526964,46.000723850886715,10.67680057908071,1.2667390517553385,0.10857763300760044
101,서울특별시,동대문구,장안제2동,장안제2동제6투,1753,1211,476,623,88,12,0,1199,12,542,39.69974979149291,51.959966638865716,7.339449541284404,1.0008340283569641,0.0
102,서울특별시,동대문구,장안제2동,장안제2동제7투,3102,2450,1032,1157,210,32,2,2433,17,652,42.41676942046856,47.55445951500206,8.631319358816276,1.3152486642005754,0.08220304151253596
103,서울특별시,동대문구,장안제2동,장안제2동제8투,2204,1620,645,803,152,10,1,1611,9,584,40.03724394785848,49.84481688392302,9.435133457479825,0.6207324643078833,0.06207324643078833
104,서울특별시,동대문구,잘못 투입·구분된 투표지,,0,5,2,1,2,0,0,5,0,-5,40.0,20.0,40.0,0.0,0.0
0,서울특별시,중랑구,거소·선상투표,,493,470,231,137,81,5,3,457,13,23,50.54704595185996,29.978118161925604,17.72428884026258,1.0940919037199124,0.6564551422319475
1,서울특별시,중랑구,관외사전투표,,35819,35814,22108,8313,4480,457,42,35400,414,5,62.451977401129945,23.483050847457626,12.655367231638417,1.2909604519774012,0.11864406779661016
2,서울특별시,중랑구,재외투표,,1898,1542,1080,286,135,28,0,1529,13,356,70.63440156965338,18.705035971223023,8.829300196206672,1.831262262916939,0.0
3,서울특별시,중랑구,면목본동,관내사전투표,8188,8188,5586,1922,550,74,5,8137,51,0,68.6493793781492,23.620498955388964,6.759247880054074,0.9094260784072754,0.061447708000491576
4,서울특별시,중랑구,면목본동,면목본동제1투,3044,1740,578,974,150,22,1,1725,15,1304,33.507246376811594,56.463768115942024,8.695652173913043,1.2753623188405796,0.057971014492753624
5,서울특별시,중랑구,면목본동,면목본동제2투,2709,1676,650,823,167,22,2,1664,12,1033,39.0625,49.45913461538461,10.036057692307693,1.3221153846153846,0.1201923076923077
6,서울특별시,중랑구,면목본동,면목본동제3투,2696,1718,716,835,140,15,7,1713,5,978,41.7980151780502,48.744892002335085,8.172796263864566,0.8756567425569177,0.4086398131932283
7,서울특별시,중랑구,면목본동,면목본동제4투,2563,1519,614,758,120,13,2,1507,12,1044,40.74319840743198,50.29860650298607,7.962840079628402,0.8626410086264101,0.13271400132714
8,서울특별시,중랑구,면목본동,면목본동제5투,2374,1485,603,737,117,14,5,1476,9,889,40.853658536585364,49.93224932249323,7.926829268292683,0.9485094850948509,0.33875338753387535
9,서울특별시,중랑구,면목본동,면목본동제6투,2912,1719,634,857,182,25,1,1699,20,1193,37.316068275456146,50.44143613890524,10.712183637433785,1.4714537963507945,0.05885815185403178
10,서울특별시,중랑구,면목본동,면목본동제7투,2380,1448,597,698,116,21,1,1433,15,932,41.66085136078158,48.709002093510115,8.094905792044662,1.465457083042568,0.06978367062107467
11,서울특별시,중랑구,면목제2동,관내사전투표,4599,4599,3118,1147,272,36,1,4574,25,0,68.16790555312636,25.076519457804984,5.94665500655881,0.7870572802798426,0.021862702229995628
12,서울특별시,중랑구,면목제2동,면목제2동제1투,3037,1791,679,946,132,21,2,1780,11,1246,38.146067415730336,53.146067415730336,7.415730337078652,1.1797752808988764,0.11235955056179776
13,서울특별시,중랑구,면목제2동,면목제2동제2투,2208,1458,560,755,116,16,1,1448,10,750,38.67403314917127,52.14088397790056,8.011049723756907,1.1049723756906076,0.06906077348066297
14,서울특별시,중랑구,면목제2동,면목제2동제3투,3018,1845,763,915,134,15,1,1828,17,1173,41.739606126914666,50.054704595185996,7.330415754923414,0.8205689277899343,0.05470459518599562
15,서울특별시,중랑구,면목제2동,면목제2동제4투,2646,1634,703,795,109,14,3,1624,10,1012,43.28817733990148,48.95320197044335,6.711822660098522,0.8620689655172413,0.18472906403940886
16,서울특별시,중랑구,면목제2동,면목제2동제5투,2594,1599,651,779,137,19,0,1586,13,995,41.04665825977301,49.11727616645649,8.638083228247162,1.1979823455233292,0.0
17,서울특별시,중랑구,면목제3·8동,관내사전투표,4966,4966,3368,1177,338,47,4,4934,32,0,68.261045804621,23.854884475070936,6.850425618159709,0.9525739764896636,0.08107012565869477
18,서울특별시,중랑구,면목제3·8동,면목제3·8동제1투,2153,1256,446,660,110,21,6,1243,13,897,35.88093322606597,53.09734513274337,8.849557522123893,1.6894609814963797,0.4827031375703942
19,서울특별시,중랑구,면목제3·8동,면목제3·8동제2투,1864,1206,438,659,92,6,2,1197,9,658,36.59147869674185,55.05430242272348,7.685881370091896,0.5012531328320802,0.1670843776106934
20,서울특별시,중랑구,면목제3·8동,면목제3·8동제3투,1946,1142,433,580,99,14,5,1131,11,804,38.28470380194518,51.28205128205128,8.753315649867375,1.237842617152962,0.4420866489832007
21,서울특별시,중랑구,면목제3·8동,면목제3·8동제4투,1951,1257,461,670,107,12,1,1251,6,694,36.85051958433254,53.557154276578736,8.553157474020784,0.9592326139088728,0.07993605115907274
22,서울특별시,중랑구,면목제3·8동,면목제3·8동제5투,2399,1673,713,795,127,21,1,1657,16,726,43.02957151478576,47.978273989136994,7.664453832226917,1.2673506336753169,0.06035003017501509
23,서울특별시,중랑구,면목제3·8동,면목제3·8동제6투,1942,1182,482,577,102,10,2,1173,9,760,41.091219096334186,49.190110826939474,8.695652173913043,0.8525149190110828,0.17050298380221654
24,서울특별시,중랑구,면목제3·8동,면목제3·8동제7투,2058,1384,568,680,98,22,2,1370,14,674,41.45985401459854,49.63503649635037,7.153284671532846,1.6058394160583942,0.145985401459854
25,서울특별시,중랑구,면목제4동,관내사전투표,3995,3995,2777,928,242,32,0,3979,16,0,69.79140487559688,23.322442824830357,6.081930133199296,0.8042221663734606,0.0
26,서울특별시,중랑구,면목제4동,면목제4동제1투,1905,1137,413,600,100,7,2,1122,15,768,36.80926916221034,53.475935828877006,8.9126559714795,0.6238859180035651,0.17825311942959002
27,서울특별시,중랑구,면목제4동,면목제4동제2투,2404,1541,641,754,125,11,3,1534,7,863,41.78617992177314,49.152542372881356,8.148631029986962,0.7170795306388527,0.1955671447196871
28,서울특별시,중랑구,면목제4동,면목제4동제3투,2097,1363,550,689,103,10,3,1355,8,734,40.59040590405904,50.84870848708487,7.601476014760148,0.7380073800738007,0.22140221402214022
29,서울특별시,중랑구,면목제4동,면목제4동제4투,1993,1292,556,603,107,19,0,1285,7,701,43.268482490272376,46.9260700389105,8.326848249027236,1.4785992217898831,0.0
30,서울특별시,중랑구,면목제4동,면목제4동제5투,1800,1127,396,633,69,8,4,1110,17,673,35.67567567567568,57.027027027027025,6.216216216216217,0.7207207207207207,0.36036036036036034
31,서울특별시,중랑구,면목제5동,관내사전투표,3461,3461,2451,758,206,22,2,3439,22,0,71.27071823204419,22.041291072986333,5.990113405059611,0.639720849084036,0.05815644082582146
32,서울특별시,중랑구,면목제5동,면목제5동제1투,2398,1441,620,681,119,9,1,1430,11,957,43.35664335664335,47.62237762237762,8.321678321678322,0.6293706293706294,0.06993006993006994
33,서울특별시,중랑구,면목제5동,면목제5동제2투,2451,1519,634,731,120,17,0,1502,17,932,42.2103861517976,48.66844207723036,7.989347536617843,1.1318242343541944,0.0
34,서울특별시,중랑구,면목제5동,면목제5동제3투,2883,2285,964,1067,215,27,3,2276,9,598,42.35500878734622,46.8804920913884,9.44639718804921,1.1862917398945518,0.13181019332161686
35,서울특별시,중랑구,면목제7동,관내사전투표,5432,5432,3648,1373,328,49,5,5403,29,0,67.51804553026096,25.41180825467333,6.070701462150657,0.90690357208958,0.09254118082546733
36,서울특별시,중랑구,면목제7동,면목제7동제1투,2199,1322,515,661,121,18,0,1315,7,877,39.163498098859314,50.26615969581749,9.201520912547528,1.3688212927756656,0.0
37,서울특별시,중랑구,면목제7동,면목제7동제2투,2464,1486,571,759,129,12,3,1474,12,978,38.73812754409769,51.49253731343284,8.751696065128902,0.8141112618724559,0.20352781546811397
38,서울특별시,중랑구,면목제7동,면목제7동제3투,2059,1234,472,642,96,16,0,1226,8,825,38.499184339314844,52.36541598694943,7.830342577487764,1.3050570962479608,0.0
39,서울특별시,중랑구,면목제7동,면목제7동제4투,2410,1569,529,891,118,17,3,1558,11,841,33.95378690629012,57.18870346598203,7.573812580231065,1.0911424903722722,0.19255455712451863
40,서울특별시,중랑구,면목제7동,면목제7동제5투,2476,1782,708,860,179,21,0,1768,14,694,40.04524886877828,48.64253393665158,10.124434389140271,1.1877828054298643,0.0
41,서울특별시,중랑구,상봉제1동,관내사전투표,3916,3916,2629,951,282,29,1,3892,24,0,67.54881808838643,24.434737923946557,7.2456320657759505,0.7451181911613566,0.025693730729701953
42,서울특별시,중랑구,상봉제1동,상봉제1동제1투,2513,1499,534,785,145,21,0,1485,14,1014,35.95959595959596,52.861952861952865,9.764309764309765,1.4141414141414141,0.0
43,서울특별시,중랑구,상봉제1동,상봉제1동제2투,2933,2221,860,1103,215,24,1,2203,18,712,39.037675896504766,50.06808896958693,9.759418974126191,1.0894235133908308,0.04539264639128461
44,서울특별시,중랑구,상봉제1동,상봉제1동제3투,2758,1878,791,853,174,27,3,1848,30,880,42.803030303030305,46.15800865800866,9.415584415584416,1.461038961038961,0.16233766233766234
45,서울특별시,중랑구,상봉제1동,상봉제1동제4투,2504,1765,670,918,131,22,1,1742,23,739,38.46153846153847,52.69804822043628,7.520091848450057,1.2629161882893225,0.0574052812858783
46,서울특별시,중랑구,상봉제1동,상봉제1동제5투,1745,1301,436,728,110,16,2,1292,9,444,33.746130030959755,56.34674922600619,8.513931888544892,1.238390092879257,0.15479876160990713
47,서울특별시,중랑구,상봉제2동,관내사전투표,5023,5023,3380,1138,411,52,3,4984,39,0,67.81701444622793,22.8330658105939,8.246388443017656,1.043338683788122,0.06019261637239165
48,서울특별시,중랑구,상봉제2동,상봉제2동제1투,3218,1999,668,1032,235,28,3,1966,33,1219,33.97761953204476,52.492370295015256,11.95320447609359,1.4242115971515767,0.1525940996948118
49,서울특별시,중랑구,상봉제2동,상봉제2동제2투,3886,2605,920,1361,276,25,3,2585,20,1281,35.5899419729207,52.64990328820116,10.67698259187621,0.9671179883945842,0.11605415860735009
50,서울특별시,중랑구,상봉제2동,상봉제2동제3투,2824,1695,647,772,232,28,2,1681,14,1129,38.48899464604402,45.92504461629982,13.801308744794765,1.665675193337299,0.1189767995240928
51,서울특별시,중랑구,상봉제2동,상봉제2동제4투,2543,1464,568,693,170,14,3,1448,16,1079,39.226519337016576,47.85911602209944,11.740331491712707,0.9668508287292817,0.20718232044198895
52,서울특별시,중랑구,중화제1동,관내사전투표,3881,3881,2627,963,234,31,7,3862,19,0,68.0217503883998,24.935266701191093,6.059036768513724,0.8026929052304504,0.18125323666494045
53,서울특별시,중랑구,중화제1동,중화제1동제1투,2741,1749,608,938,169,18,3,1736,13,992,35.02304147465438,54.03225806451613,9.735023041474653,1.0368663594470047,0.1728110599078341
54,서울특별시,중랑구,중화제1동,중화제1동제2투,2664,1763,691,876,165,14,2,1748,15,901,39.53089244851258,50.11441647597255,9.439359267734554,0.8009153318077803,0.11441647597254005
55,서울특별시,중랑구,중화제1동,중화제1동제3투,2842,1854,719,910,185,22,3,1839,15,988,39.09733550842849,49.48341489940185,10.059815116911365,1.1963023382272975,0.1631321370309951
56,서울특별시,중랑구,중화제1동,중화제1동제4투,2110,1582,581,809,165,14,0,1569,13,528,37.02995538559592,51.56150414276609,10.51625239005736,0.8922880815806247,0.0
57,서울특별시,중랑구,중화제2동,관내사전투표,5169,5168,3516,1235,330,48,8,5137,31,1,68.44461748102006,24.04126922328207,6.423982869379015,0.9343975082733113,0.1557329180455519
58,서울특별시,중랑구,중화제2동,중화제2동제1투,1993,1170,443,616,91,6,3,1159,11,823,38.22260569456428,53.14926660914582,7.851596203623814,0.5176876617773942,0.2588438308886971
59,서울특별시,중랑구,중화제2동,중화제2동제2투,2506,1508,571,778,138,9,2,1498,10,998,38.11748998664887,51.93591455273698,9.212283044058744,0.6008010680907877,0.13351134846461948
60,서울특별시,중랑구,중화제2동,중화제2동제3투,2891,1869,792,893,154,17,3,1859,10,1022,42.60355029585799,48.036578805809576,8.284023668639055,0.914470145239376,0.16137708445400753
61,서울특별시,중랑구,중화제2동,중화제2동제4투,2653,1702,721,796,150,19,1,1687,15,951,42.738589211618255,47.18435091879075,8.891523414344991,1.1262596324836989,0.05927682276229994
62,서울특별시,중랑구,중화제2동,중화제2동제5투,2231,1476,592,729,124,18,2,1465,11,755,40.40955631399317,49.76109215017065,8.464163822525597,1.228668941979522,0.13651877133105803
63,서울특별시,중랑구,중화제2동,중화제2동제6투,2116,1269,483,660,102,12,3,1260,9,847,38.333333333333336,52.38095238095239,8.095238095238095,0.9523809523809524,0.2380952380952381
64,서울특별시,중랑구,묵제1동,관내사전투표,5777,5777,3861,1389,446,47,4,5747,30,0,67.18287802331652,24.16913172089786,7.760570732556116,0.8178179919958238,0.06960153123368715
65,서울특별시,중랑구,묵제1동,묵제1동제1투,2513,1774,640,911,186,19,3,1759,15,739,36.38430926662877,51.79079022171689,10.574189880613986,1.0801591813530413,0.17055144968732233
66,서울특별시,중랑구,묵제1동,묵제1동제2투,2370,1572,594,789,151,24,1,1559,13,798,38.101347017318794,50.60936497754971,9.685695958948044,1.539448364336113,0.06414368184733803
67,서울특별시,중랑구,묵제1동,묵제1동제3투,2376,1877,614,1071,157,24,0,1866,11,499,32.90460878885316,57.39549839228296,8.413719185423366,1.2861736334405145,0.0
68,서울특별시,중랑구,묵제1동,묵제1동제4투,2770,1988,833,945,168,22,6,1974,14,782,42.198581560283685,47.87234042553192,8.51063829787234,1.1144883485309016,0.303951367781155
69,서울특별시,중랑구,묵제1동,묵제1동제5투,3313,2229,882,1121,188,25,4,2220,9,1084,39.729729729729726,50.49549549549549,8.468468468468467,1.1261261261261262,0.18018018018018017
70,서울특별시,중랑구,묵제1동,묵제1동제6투,2812,2016,738,1073,174,13,2,2000,16,796,36.9,53.65,8.7,0.65,0.1
71,서울특별시,중랑구,묵제1동,묵제1동제7투,2385,1485,528,775,156,12,1,1472,13,900,35.869565217391305,52.64945652173913,10.597826086956522,0.8152173913043478,0.06793478260869565
72,서울특별시,중랑구,묵제2동,관내사전투표,5360,5360,3605,1262,404,46,2,5319,41,0,67.7758977251363,23.726264335401392,7.595412671554803,0.8648242150780222,0.037601052829479224
73,서울특별시,중랑구,묵제2동,묵제2동제1투,2668,1853,723,949,154,15,3,1844,9,815,39.208242950108456,51.46420824295011,8.351409978308027,0.8134490238611713,0.16268980477223427
74,서울특별시,중랑구,묵제2동,묵제2동제2투,2300,1371,497,726,121,11,2,1357,14,929,36.62490788504053,53.50036845983788,8.916728076639647,0.8106116433308769,0.14738393515106854
75,서울특별시,중랑구,묵제2동,묵제2동제3투,2537,1621,614,850,125,16,1,1606,15,916,38.23163138231631,52.926525529265255,7.783312577833127,0.9962640099626401,0.062266500622665005
76,서울특별시,중랑구,묵제2동,묵제2동제4투,2739,1774,715,856,161,20,3,1755,19,965,40.74074074074074,48.774928774928775,9.173789173789174,1.1396011396011396,0.17094017094017094
77,서울특별시,중랑구,망우본동,관내사전투표,7300,7300,4783,1971,438,58,7,7257,43,0,65.90877773184512,27.15998346424142,6.035551880942538,0.7992283312663636,0.09645859170456111
78,서울특별시,중랑구,망우본동,망우본동제1투,2266,1365,464,801,81,10,0,1356,9,901,34.21828908554572,59.070796460176986,5.9734513274336285,0.7374631268436578,0.0
79,서울특별시,중랑구,망우본동,망우본동제2투,3116,2123,770,1133,175,21,5,2104,19,993,36.59695817490494,53.849809885931556,8.317490494296578,0.9980988593155894,0.2376425855513308
80,서울특별시,중랑구,망우본동,망우본동제3투,2462,1723,695,845,146,23,1,1710,13,739,40.643274853801174,49.41520467836257,8.538011695906434,1.345029239766082,0.058479532163742694
81,서울특별시,중랑구,망우본동,망우본동제4투,1855,1235,434,700,76,13,0,1223,12,620,35.48650858544563,57.236304170073595,6.214227309893704,1.062959934587081,0.0
82,서울특별시,중랑구,망우본동,망우본동제5투,2005,1290,481,698,89,10,0,1278,12,715,37.63693270735524,54.61658841940532,6.964006259780908,0.7824726134585289,0.0
83,서울특별시,중랑구,망우본동,망우본동제6투,2880,1833,729,924,134,26,2,1815,18,1047,40.16528925619834,50.90909090909091,7.382920110192838,1.4325068870523416,0.11019283746556473
84,서울특별시,중랑구,망우본동,망우본동제7투,3717,2529,956,1265,250,29,3,2503,26,1188,38.19416699960048,50.539352776668004,9.98801438274071,1.1586096683979226,0.11985617259288853
85,서울특별시,중랑구,망우본동,망우본동제8투,4113,3097,1437,1269,324,39,6,3075,22,1016,46.73170731707317,41.26829268292683,10.536585365853659,1.2682926829268293,0.1951219512195122
86,서울특별시,중랑구,망우제3동,관내사전투표,5010,5010,3355,1243,341,34,3,4976,34,0,67.42363344051448,24.979903536977492,6.852893890675241,0.6832797427652734,0.060289389067524124
87,서울특별시,중랑구,망우제3동,망우제3동제1투,1797,1061,393,565,74,17,0,1049,12,736,37.464251668255486,53.86081982840801,7.0543374642516685,1.6205910390848426,0.0
88,서울특별시,중랑구,망우제3동,망우제3동제2투,2544,1546,594,803,119,10,3,1529,17,998,38.84892086330935,52.51798561151079,7.782864617396991,0.6540222367560496,0.1962066710268149
89,서울특별시,중랑구,망우제3동,망우제3동제3투,2711,1655,688,831,107,14,2,1642,13,1056,41.90012180267966,50.60901339829476,6.516443361753958,0.8526187576126675,0.12180267965895249
90,서울특별시,중랑구,망우제3동,망우제3동제4투,2112,1229,476,629,98,13,2,1218,11,883,39.08045977011494,51.64203612479474,8.045977011494253,1.0673234811165846,0.16420361247947454
91,서울특별시,중랑구,신내제1동,관내사전투표,5112,5112,3481,1191,360,49,5,5086,26,0,68.44278411325206,23.417223751474637,7.078254030672435,0.9634290208415257,0.09830908375933936
92,서울특별시,중랑구,신내제1동,신내제1동제1투,2243,1523,531,841,122,15,1,1510,13,720,35.16556291390728,55.69536423841059,8.079470198675496,0.9933774834437087,0.06622516556291391
93,서울특별시,중랑구,신내제1동,신내제1동제2투,2000,1576,611,813,133,15,2,1574,2,424,38.81829733163914,51.65184243964421,8.449809402795426,0.9529860228716646,0.12706480304955528
94,서울특별시,중랑구,신내제1동,신내제1동제3투,2068,1463,558,767,109,18,3,1455,8,605,38.35051546391753,52.71477663230241,7.491408934707904,1.2371134020618557,0.2061855670103093
95,서울특별시,중랑구,신내제1동,신내제1동제4투,3366,2418,1103,1061,200,37,3,2404,14,948,45.881863560732114,44.13477537437604,8.319467554076539,1.5391014975041597,0.12479201331114809
96,서울특별시,중랑구,신내제1동,신내제1동제5투,2377,1721,602,937,151,19,1,1710,11,656,35.2046783625731,54.795321637426895,8.830409356725147,1.1111111111111112,0.058479532163742694
97,서울특별시,중랑구,신내제1동,신내제1동제6투,1638,1079,371,607,78,9,0,1065,14,559,34.83568075117371,56.995305164319255,7.323943661971831,0.8450704225352111,0.0
98,서울특별시,중랑구,신내제1동,신내제1동제7투,2118,1607,583,861,132,16,0,1592,15,511,36.620603015075375,54.082914572864325,8.291457286432161,1.0050251256281406,0.0
99,서울특별시,중랑구,신내제1동,신내제1동제8투,2927,2224,1037,989,161,23,0,2210,14,703,46.92307692307692,44.75113122171946,7.285067873303168,1.0407239819004523,0.0
100,서울특별시,중랑구,신내제1동,신내제1동제9투,2348,1800,852,756,160,19,3,1790,10,548,47.59776536312849,42.23463687150838,8.938547486033519,1.0614525139664803,0.16759776536312848
101,서울특별시,중랑구,신내제2동,관내사전투표,8453,8453,5628,2104,596,76,9,8413,40,0,66.89646974919768,25.00891477475336,7.084274337335077,0.9033638416736003,0.10697729704029478
102,서울특별시,중랑구,신내제2동,신내제2동제1투,1953,1433,499,778,123,24,2,1426,7,520,34.9929873772791,54.55820476858345,8.625525946704068,1.6830294530154277,0.1402524544179523
103,서울특별시,중랑구,신내제2동,신내제2동제2투,2500,1909,877,802,188,27,4,1898,11,591,46.20653319283456,42.2550052687039,9.905163329820864,1.422550052687039,0.21074815595363539
104,서울특별시,중랑구,신내제2동,신내제2동제3투,2715,2061,775,1062,186,23,0,2046,15,654,37.878787878787875,51.90615835777126,9.090909090909092,1.1241446725317694,0.0
105,서울특별시,중랑구,신내제2동,신내제2동제4투,2255,1646,667,824,130,13,3,1637,9,609,40.74526572999389,50.33598045204643,7.941356139279169,0.794135613927917,0.1832620647525962
106,서울특별시,중랑구,신내제2동,신내제2동제5투,1935,1269,473,708,75,7,0,1263,6,666,37.45051464766429,56.057007125890735,5.938242280285035,0.5542359461599367,0.0
107,서울특별시,중랑구,잘못 투입·구분된 투표지,,0,1,1,0,0,0,0,1,0,-1,100.0,0.0,0.0,0.0,0.0
0,서울특별시,성북구,거소·선상투표,,446,422,169,120,103,3,3,398,24,24,42.462311557788944,30.15075376884422,25.879396984924625,0.7537688442211055,0.7537688442211055
1,서울특별시,성북구,관외사전투표,,43895,43881,26941,9981,5747,766,40,43475,406,14,61.968947671075334,22.958021851638875,13.219091431857388,1.7619321449108685,0.09200690051753882
2,서울특별시,성북구,재외투표,,3513,2822,1975,509,283,33,4,2804,18,691,70.43509272467902,18.152639087018546,10.092724679029958,1.1768901569186876,0.14265335235378032
3,서울특별시,성북구,성북동,관내사전투표,4461,4461,3010,985,338,98,2,4433,28,0,67.89984209339049,22.219715768102866,7.624633431085044,2.2106925332731784,0.04511617414843221
4,서울특별시,성북구,성북동,성북동제1투,2514,1704,611,883,152,39,1,1686,18,810,36.23962040332147,52.37247924080665,9.015421115065243,2.3131672597864767,0.05931198102016608
5,서울특별시,성북구,성북동,성북동제2투,2148,1284,423,747,84,20,1,1275,9,864,33.1764705882353,58.58823529411765,6.588235294117648,1.5686274509803921,0.0784313725490196
6,서울특별시,성북구,성북동,성북동제3투,1653,1069,312,671,67,11,0,1061,8,584,29.4062205466541,63.242224316682375,6.314797360980208,1.0367577756833177,0.0
7,서울특별시,성북구,성북동,성북동제4투,2078,1329,482,665,151,22,1,1321,8,749,36.48750946252839,50.340651021953065,11.430734292202876,1.6654049962149888,0.0757002271006813
8,서울특별시,성북구,삼선동,관내사전투표,7544,7544,4991,1608,755,138,2,7494,50,0,66.59994662396585,21.45716573258607,10.074726447824926,1.8414731785428344,0.02668801708033093
9,서울특별시,성북구,삼선동,삼선동제1투,3172,2087,746,1059,219,39,2,2065,22,1085,36.12590799031477,51.28329297820823,10.605326876513317,1.8886198547215496,0.09685230024213075
10,서울특별시,성북구,삼선동,삼선동제2투,2094,1336,562,614,124,22,2,1324,12,758,42.44712990936556,46.37462235649547,9.365558912386707,1.6616314199395772,0.1510574018126888
11,서울특별시,성북구,삼선동,삼선동제3투,2132,1599,689,726,138,29,4,1586,13,533,43.44262295081967,45.775535939470366,8.701134930643127,1.8284993694829759,0.25220680958385877
12,서울특별시,성북구,삼선동,삼선동제4투,2941,1969,769,956,180,44,1,1950,19,972,39.43589743589744,49.02564102564103,9.230769230769232,2.2564102564102564,0.05128205128205128
13,서울특별시,성북구,삼선동,삼선동제5투,2401,1487,582,696,154,35,1,1468,19,914,39.6457765667575,47.41144414168937,10.490463215258854,2.3841961852861036,0.06811989100817438
14,서울특별시,성북구,동선동,관내사전투표,3281,3281,2250,617,318,64,2,3251,30,0,69.20947400799754,18.978775761304213,9.781605659796986,1.968625038449708,0.06151953245155337
15,서울특별시,성북구,동선동,동선동제1투,1446,884,331,416,106,17,0,870,14,562,38.04597701149425,47.81609195402299,12.183908045977011,1.9540229885057472,0.0
16,서울특별시,성북구,동선동,동선동제2투,2378,1560,619,689,195,34,4,1541,19,818,40.16872160934458,44.71122647631408,12.654120700843608,2.2063595068137576,0.25957170668397145
17,서울특별시,성북구,동선동,동선동제3투,1792,1172,468,555,120,19,0,1162,10,620,40.27538726333907,47.76247848537005,10.327022375215146,1.6351118760757317,0.0
18,서울특별시,성북구,동선동,동선동제4투,2972,2085,810,956,250,47,1,2064,21,887,39.24418604651162,46.31782945736434,12.112403100775193,2.2771317829457365,0.04844961240310078
19,서울특별시,성북구,돈암제1동,관내사전투표,3424,3424,2260,807,294,43,2,3406,18,0,66.35349383440986,23.693482090428656,8.631826189078097,1.262477980035232,0.05871990604815032
20,서울특별시,성북구,돈암제1동,돈암제1동제1투,1771,1276,481,658,100,21,1,1261,15,495,38.144329896907216,52.180808881839816,7.9302141157811255,1.6653449643140366,0.07930214115781126
21,서울특별시,성북구,돈암제1동,돈암제1동제2투,1788,1261,446,657,134,14,2,1253,8,527,35.59457302474062,52.434158020750196,10.694333599361533,1.1173184357541899,0.1596169193934557
22,서울특별시,성북구,돈암제1동,돈암제1동제3투,2709,2075,746,1095,192,30,1,2064,11,634,36.143410852713174,53.05232558139535,9.30232558139535,1.4534883720930232,0.04844961240310078
23,서울특별시,성북구,돈암제1동,돈암제1동제4투,1704,1119,462,542,90,13,1,1108,11,585,41.69675090252707,48.91696750902527,8.12274368231047,1.1732851985559567,0.09025270758122744
24,서울특별시,성북구,돈암제2동,관내사전투표,4046,4046,2829,881,266,50,3,4029,17,0,70.21593447505585,21.866468106229835,6.602134524695955,1.2410027302060065,0.07446016381236038
25,서울특별시,성북구,돈암제2동,돈암제2동제1투,3014,2134,746,1156,183,32,2,2119,15,880,35.20528551203398,54.55403492213308,8.636149126946673,1.510146295422369,0.09438414346389806
26,서울특별시,성북구,돈암제2동,돈암제2동제2투,2354,1805,654,939,171,25,0,1789,16,549,36.55673560648407,52.48742314141979,9.558412520961431,1.3974287311347122,0.0
27,서울특별시,성북구,돈암제2동,돈암제2동제3투,2467,1834,848,789,146,35,3,1821,13,633,46.56781987918726,43.32784184514003,8.017572762218562,1.9220208676551345,0.16474464579901155
28,서울특별시,성북구,돈암제2동,돈암제2동제4투,2666,2018,625,1161,182,36,1,2005,13,648,31.17206982543641,57.905236907730675,9.077306733167083,1.7955112219451372,0.04987531172069825
29,서울특별시,성북구,돈암제2동,돈암제2동제5투,1986,1451,513,796,112,18,2,1441,10,535,35.60027758501041,55.23941707147814,7.772380291464261,1.2491325468424705,0.13879250520471895
30,서울특별시,성북구,안암동,관내사전투표,4452,4452,2640,813,855,93,3,4404,48,0,59.945504087193456,18.460490463215258,19.414168937329702,2.111716621253406,0.06811989100817438
31,서울특별시,성북구,안암동,안암동제1투,1771,1159,409,523,193,19,0,1144,15,612,35.75174825174825,45.71678321678322,16.87062937062937,1.6608391608391608,0.0
32,서울특별시,성북구,안암동,안암동제2투,2264,1576,404,759,354,37,1,1555,21,688,25.980707395498392,48.81028938906752,22.765273311897104,2.3794212218649515,0.06430868167202572
33,서울특별시,성북구,안암동,안암동제3투,2626,1757,583,842,275,37,3,1740,17,869,33.50574712643678,48.39080459770115,15.804597701149426,2.1264367816091956,0.1724137931034483
34,서울특별시,성북구,안암동,안암동제4투,2063,1408,457,756,158,27,1,1399,9,655,32.6661901358113,54.038598999285206,11.293781272337384,1.9299499642601858,0.07147962830593281
35,서울특별시,성북구,보문동,관내사전투표,3516,3516,2270,792,384,51,2,3499,17,0,64.87567876536153,22.63503858245213,10.974564161188912,1.4575593026579023,0.05715918833952558
36,서울특별시,성북구,보문동,보문동제1투,2718,1570,558,819,149,22,3,1551,19,1148,35.97678916827853,52.804642166344294,9.606705351386202,1.4184397163120568,0.19342359767891684
37,서울특별시,성북구,보문동,보문동제2투,2659,1763,627,888,208,27,3,1753,10,896,35.767256132344556,50.656018254421,11.865373645179691,1.540216771249287,0.17113519680547634
38,서울특별시,성북구,보문동,보문동제3투,3054,2061,786,998,225,36,0,2045,16,993,38.43520782396088,48.801955990220044,11.00244498777506,1.7603911980440097,0.0
39,서울특별시,성북구,정릉제1동,관내사전투표,4076,4076,2749,973,293,33,6,4054,22,0,67.80957079427725,24.000986679822397,7.227429699062654,0.8140108534780464,0.1480019733596448
40,서울특별시,성북구,정릉제1동,정릉제1동제1투,2323,1634,582,876,136,24,1,1619,15,689,35.948116121062384,54.10747374922792,8.400247066090179,1.4823965410747375,0.06176652254478073
41,서울특별시,성북구,정릉제1동,정릉제1동제2투,2463,1634,582,871,151,16,0,1620,14,829,35.92592592592593,53.76543209876543,9.320987654320987,0.9876543209876543,0.0
42,서울특별시,성북구,정릉제1동,정릉제1동제3투,2396,1733,727,805,150,31,5,1718,15,663,42.31664726426077,46.85681024447032,8.731082654249127,1.8044237485448196,0.2910360884749709
43,서울특별시,성북구,정릉제1동,정릉제1동제4투,2230,1742,695,833,177,21,1,1727,15,488,40.24319629415171,48.23393167342212,10.2489866821077,1.2159814707585408,0.05790387955993051
44,서울특별시,성북구,정릉제2동,관내사전투표,4862,4862,3177,1283,311,58,4,4833,29,0,65.73556797020484,26.54665839023381,6.43492654665839,1.2000827643285745,0.08276432857438444
45,서울특별시,성북구,정릉제2동,정릉제2동제1투,3001,2086,750,1107,186,31,1,2075,11,915,36.144578313253014,53.34939759036145,8.963855421686747,1.493975903614458,0.048192771084337345
46,서울특별시,성북구,정릉제2동,정릉제2동제2투,3034,1874,741,948,148,23,1,1861,13,1160,39.817302525523914,50.940354648038685,7.952713594841483,1.2358946802794197,0.05373455131649651
47,서울특별시,성북구,정릉제2동,정릉제2동제3투,2735,1689,625,890,144,12,3,1674,15,1046,37.335722819593784,53.16606929510155,8.60215053763441,0.7168458781362007,0.17921146953405018
48,서울특별시,성북구,정릉제2동,정릉제2동제4투,2906,1899,683,1047,144,18,2,1894,5,1007,36.06124604012672,55.279831045406546,7.602956705385427,0.9503695881731784,0.10559662090813093
49,서울특별시,성북구,정릉제3동,관내사전투표,3134,3134,1838,843,387,32,3,3103,31,0,59.23300032226877,27.167257492748952,12.471801482436353,1.03126007089913,0.09668063164679343
50,서울특별시,성북구,정릉제3동,정릉제3동제1투,2215,1347,433,720,165,20,0,1338,9,868,32.36173393124066,53.81165919282511,12.331838565022421,1.4947683109118086,0.0
51,서울특별시,성북구,정릉제3동,정릉제3동제2투,211,94,27,59,6,1,0,93,1,117,29.03225806451613,63.44086021505376,6.451612903225806,1.0752688172043012,0.0
52,서울특별시,성북구,정릉제3동,정릉제3동제3투,2970,1906,666,989,200,27,1,1883,23,1064,35.36909187466809,52.52257036643654,10.621348911311737,1.4338821030270845,0.05310674455655868
53,서울특별시,성북구,정릉제3동,정릉제3동제4투,1965,1227,368,676,150,15,2,1211,16,738,30.388109000825764,55.82163501238646,12.386457473162675,1.2386457473162675,0.16515276630883566
54,서울특별시,성북구,정릉제4동,관내사전투표,5350,5350,3602,1307,356,62,1,5328,22,0,67.6051051051051,24.53078078078078,6.681681681681682,1.1636636636636637,0.01876876876876877
55,서울특별시,성북구,정릉제4동,정릉제4동제1투,2344,1596,585,880,100,17,3,1585,11,748,36.90851735015773,55.520504731861195,6.309148264984227,1.0725552050473186,0.1892744479495268
56,서울특별시,성북구,정릉제4동,정릉제4동제2투,3225,1856,678,982,161,24,1,1846,10,1369,36.728060671722645,53.19609967497292,8.721560130010834,1.3001083423618636,0.054171180931744306
57,서울특별시,성북구,정릉제4동,정릉제4동제3투,2615,1741,649,913,145,27,0,1734,7,874,37.42791234140715,52.65282583621684,8.362168396770473,1.5570934256055362,0.0
58,서울특별시,성북구,정릉제4동,정릉제4동제4투,1574,1008,345,572,72,7,2,998,10,566,34.569138276553105,57.31462925851704,7.214428857715431,0.7014028056112225,0.2004008016032064
59,서울특별시,성북구,정릉제4동,정릉제4동제5투,3249,2405,994,1168,191,35,1,2389,16,844,41.60736709920469,48.89074926747593,7.994976977814986,1.4650481372959399,0.041858518208455424
60,서울특별시,성북구,길음제1동,관내사전투표,5880,5879,4165,1226,393,63,1,5848,31,1,71.22093023255815,20.964432284541722,6.7202462380300965,1.0772913816689467,0.01709986320109439
61,서울특별시,성북구,길음제1동,길음제1동제1투,2597,1993,815,964,162,40,1,1982,11,604,41.12008072653885,48.63773965691221,8.173562058526741,2.0181634712411705,0.050454086781029264
62,서울특별시,성북구,길음제1동,길음제1동제2투,3009,2290,934,1064,245,27,3,2273,17,719,41.091069071711395,46.810382754069515,10.778706555213374,1.1878574571051475,0.13198416190057194
63,서울특별시,성북구,길음제1동,길음제1동제3투,2749,1880,752,879,202,39,1,1873,7,869,40.1494927923118,46.93005872931126,10.784837159636947,2.08222103577149,0.05339028296849973
64,서울특별시,성북구,길음제1동,길음제1동제4투,3529,2611,948,1319,279,43,3,2592,19,918,36.574074074074076,50.88734567901234,10.76388888888889,1.6589506172839508,0.11574074074074073
65,서울특별시,성북구,길음제1동,길음제1동제5투,2691,2111,904,934,213,50,1,2102,9,580,43.00666032350143,44.433872502378684,10.133206470028544,2.378686964795433,0.04757373929590866
66,서울특별시,성북구,길음제1동,길음제1동제6투,1896,1541,668,666,178,23,0,1535,6,355,43.51791530944625,43.387622149837135,11.596091205211726,1.498371335504886,0.0
67,서울특별시,성북구,길음제1동,길음제1동제7투,2021,1579,645,737,166,23,0,1571,8,442,41.05665181413113,46.912794398472315,10.566518141311267,1.464035646085296,0.0
68,서울특별시,성북구,길음제2동,관내사전투표,4115,4115,2743,955,343,50,4,4095,20,0,66.98412698412697,23.32112332112332,8.376068376068375,1.221001221001221,0.09768009768009768
69,서울특별시,성북구,길음제2동,길음제2동제1투,3474,2433,844,1303,245,22,2,2416,17,1041,34.93377483443709,53.932119205298015,10.140728476821192,0.9105960264900662,0.08278145695364239
70,서울특별시,성북구,길음제2동,길음제2동제2투,3423,2687,1059,1296,286,29,2,2672,15,736,39.63323353293413,48.50299401197605,10.703592814371257,1.0853293413173652,0.07485029940119761
71,서울특별시,성북구,길음제2동,길음제2동제3투,2850,2178,928,985,220,35,3,2171,7,672,42.74527867342239,45.37079686780285,10.133578995854444,1.612160294795025,0.1381851681252879
72,서울특별시,성북구,길음제2동,길음제2동제4투,1793,1260,480,631,115,18,1,1245,15,533,38.55421686746988,50.68273092369478,9.236947791164658,1.4457831325301205,0.08032128514056225
73,서울특별시,성북구,종암동,관내사전투표,8073,8073,5409,1825,682,105,5,8026,47,0,67.39347121853974,22.73859955145776,8.497383503613257,1.3082481933715424,0.062297533017692495
74,서울특별시,성북구,종암동,종암동제1투,2830,2028,820,957,200,30,2,2009,19,802,40.816326530612244,47.63563962170234,9.955201592832255,1.4932802389248383,0.09955201592832255
75,서울특별시,성북구,종암동,종암동제2투,2817,2030,866,930,184,26,0,2006,24,787,43.17048853439681,46.360917248255234,9.172482552342972,1.296111665004985,0.0
76,서울특별시,성북구,종암동,종암동제3투,2756,1956,726,1037,146,28,3,1940,16,800,37.422680412371136,53.45360824742268,7.525773195876289,1.443298969072165,0.15463917525773196
77,서울특별시,성북구,종암동,종암동제4투,3063,2177,765,1028,310,46,1,2150,27,886,35.581395348837205,47.81395348837209,14.418604651162791,2.1395348837209305,0.046511627906976744
78,서울특별시,성북구,종암동,종암동제5투,1803,1083,362,613,88,11,1,1075,8,720,33.674418604651166,57.02325581395349,8.186046511627906,1.0232558139534882,0.09302325581395349
79,서울특별시,성북구,종암동,종암동제6투,2478,1886,759,902,173,39,1,1874,12,592,40.50160085378869,48.132337246531485,9.231590181430096,2.08110992529349,0.05336179295624333
80,서울특별시,성북구,종암동,종암동제7투,2552,1610,628,801,153,11,2,1595,15,942,39.373040752351095,50.21943573667712,9.592476489028213,0.6896551724137931,0.12539184952978058
81,서울특별시,성북구,종암동,종암동제8투,2286,1648,708,729,165,28,2,1632,16,638,43.38235294117647,44.669117647058826,10.11029411764706,1.715686274509804,0.12254901960784313
82,서울특별시,성북구,월곡제1동,관내사전투표,5617,5617,4042,1132,348,49,1,5572,45,0,72.54127781765972,20.315865039483132,6.24551328068916,0.8793969849246231,0.017946877243359655
83,서울특별시,성북구,월곡제1동,월곡제1동제1투,2159,1466,530,761,150,15,0,1456,10,693,36.4010989010989,52.26648351648352,10.302197802197801,1.0302197802197801,0.0
84,서울특별시,성북구,월곡제1동,월곡제1동제2투,1603,954,415,454,62,12,4,947,7,649,43.822597676874345,47.94086589229145,6.546990496304119,1.2671594508975714,0.42238648363252373
85,서울특별시,성북구,월곡제1동,월곡제1동제3투,2416,1541,669,703,137,14,2,1525,16,875,43.868852459016395,46.0983606557377,8.98360655737705,0.9180327868852459,0.13114754098360656
86,서울특별시,성북구,월곡제1동,월곡제1동제4투,2043,1525,701,690,108,18,2,1519,6,518,46.14878209348255,45.42462146148782,7.109940750493745,1.184990125082291,0.13166556945358787
87,서울특별시,성북구,월곡제1동,월곡제1동제5투,2370,1740,778,761,163,24,0,1726,14,630,45.07531865585168,44.09038238702202,9.44380069524913,1.3904982618771726,0.0
88,서울특별시,성북구,월곡제1동,월곡제1동제6투,2891,2188,965,946,220,41,2,2174,14,703,44.38822447102116,43.51425942962281,10.119595216191353,1.8859245630174795,0.09199632014719411
89,서울특별시,성북구,월곡제2동,관내사전투표,4512,4512,2971,1025,438,54,1,4489,23,0,66.18400534640232,22.833593227890397,9.757184228113164,1.202940521274226,0.022276676319893073
90,서울특별시,성북구,월곡제2동,월곡제2동제1투,2444,1494,596,721,130,34,0,1481,13,950,40.243079000675216,48.6833220796759,8.777852802160702,2.2957461174881835,0.0
91,서울특별시,성북구,월곡제2동,월곡제2동제2투,2460,1756,677,879,165,17,3,1741,15,704,38.88569787478461,50.4882251579552,9.477311889718552,0.9764503159103963,0.17231476163124643
92,서울특별시,성북구,월곡제2동,월곡제2동제3투,2907,1972,825,910,199,22,1,1957,15,935,42.15636177823199,46.49974450689832,10.168625447112928,1.1241696474195195,0.0510986203372509
93,서울특별시,성북구,월곡제2동,월곡제2동제4투,3134,2339,1002,1061,231,31,1,2326,13,795,43.07824591573517,45.61478933791918,9.931212381771282,1.3327601031814273,0.04299226139294927
94,서울특별시,성북구,장위제1동,관내사전투표,4339,4339,3014,983,247,56,5,4305,34,0,70.0116144018583,22.83391405342625,5.737514518002323,1.3008130081300813,0.11614401858304298
95,서울특별시,성북구,장위제1동,장위제1동제1투,2263,1384,591,624,146,15,1,1377,7,879,42.91938997821351,45.31590413943355,10.602759622367465,1.0893246187363834,0.07262164124909223
96,서울특별시,성북구,장위제1동,장위제1동제2투,2685,1730,720,837,145,16,0,1718,12,955,41.90919674039581,48.71944121071013,8.440046565774157,0.9313154831199069,0.0
97,서울특별시,성북구,장위제1동,장위제1동제3투,2157,1224,479,633,85,9,3,1209,15,933,39.619520264681555,52.357320099255574,7.030603804797353,0.7444168734491315,0.24813895781637718
98,서울특별시,성북구,장위제1동,장위제1동제4투,1354,793,296,414,61,12,1,784,9,561,37.755102040816325,52.806122448979586,7.780612244897959,1.530612244897959,0.12755102040816327
99,서울특별시,성북구,장위제1동,장위제1동제5투,1735,933,363,461,84,15,1,924,9,802,39.285714285714285,49.891774891774894,9.090909090909092,1.6233766233766231,0.10822510822510822
100,서울특별시,성북구,장위제1동,장위제1동제6투,2725,2193,975,952,214,36,2,2179,14,532,44.745296007342816,43.689765947682424,9.82101881597063,1.6521340064249657,0.09178522257916476
101,서울특별시,성북구,장위제2동,관내사전투표,2823,2823,1859,691,205,43,2,2800,23,0,66.39285714285714,24.678571428571427,7.321428571428572,1.5357142857142858,0.07142857142857142
102,서울특별시,성북구,장위제2동,장위제2동제1투,2463,1630,561,876,148,31,0,1616,14,833,34.71534653465346,54.207920792079214,9.158415841584159,1.9183168316831682,0.0
103,서울특별시,성북구,장위제2동,장위제2동제2투,1855,1242,499,630,84,18,0,1231,11,613,40.53614947197401,51.1779041429732,6.823720552396425,1.462225832656377,0.0
104,서울특별시,성북구,장위제2동,장위제2동제3투,1675,1051,411,550,76,9,1,1047,4,624,39.25501432664756,52.53104106972302,7.25883476599809,0.8595988538681949,0.09551098376313276
105,서울특별시,성북구,장위제2동,장위제2동제4투,2161,1345,498,707,113,14,2,1334,11,816,37.331334332833585,52.99850074962519,8.470764617691154,1.0494752623688157,0.14992503748125938
106,서울특별시,성북구,장위제3동,관내사전투표,3324,3324,2217,783,269,36,1,3306,18,0,67.05989110707804,23.684210526315788,8.136721113127647,1.0889292196007259,0.030248033877797946
107,서울특별시,성북구,장위제3동,장위제3동제1투,3378,2272,826,1167,220,32,3,2248,24,1106,36.743772241992886,51.91281138790036,9.786476868327403,1.4234875444839856,0.13345195729537368
108,서울특별시,성북구,장위제3동,장위제3동제2투,2984,2352,942,1136,232,33,1,2344,8,632,40.1877133105802,48.4641638225256,9.897610921501707,1.4078498293515358,0.042662116040955635
109,서울특별시,성북구,장위제3동,장위제3동제3투,2982,2268,962,1050,216,24,4,2256,12,714,42.641843971631204,46.54255319148936,9.574468085106384,1.0638297872340425,0.1773049645390071
110,서울특별시,성북구,석관동,관내사전투표,5158,5158,3468,1283,314,57,2,5124,34,0,67.68149882903981,25.039032006245122,6.128024980483997,1.1124121779859486,0.039032006245121
111,서울특별시,성북구,석관동,석관동제1투,2746,1665,603,856,160,18,2,1639,26,1081,36.790726052471015,52.22696766320928,9.762050030506407,1.0982306284319707,0.12202562538133008
112,서울특별시,성북구,석관동,석관동제2투,2352,1548,663,739,113,20,3,1538,10,804,43.107932379713915,48.04941482444733,7.347204161248374,1.3003901170351104,0.1950585175552666
113,서울특별시,성북구,석관동,석관동제3투,2860,1769,684,927,124,26,1,1762,7,1091,38.819523269012485,52.61066969353008,7.037457434733257,1.4755959137343928,0.056753688989784334
114,서울특별시,성북구,석관동,석관동제4투,2738,1979,758,968,205,34,1,1966,13,759,38.555442522889116,49.23702950152594,10.427263479145472,1.7293997965412005,0.050864699898270596
115,서울특별시,성북구,석관동,석관동제5투,3039,2348,891,1213,194,31,4,2333,15,691,38.19117016716674,51.993141877411055,8.3154736390913,1.3287612516073724,0.17145306472353192
116,서울특별시,성북구,석관동,석관동제6투,2023,1354,572,667,80,24,2,1345,9,669,42.5278810408922,49.5910780669145,5.947955390334572,1.7843866171003717,0.14869888475836432
117,서울특별시,성북구,석관동,석관동제7투,2553,1767,698,887,128,33,5,1751,16,786,39.86293546544831,50.65676756139349,7.310108509423187,1.8846373500856655,0.2855511136493432
118,서울특별시,성북구,석관동,석관동제8투,1598,1080,394,546,104,22,0,1066,14,518,36.96060037523452,51.21951219512195,9.75609756097561,2.0637898686679175,0.0
119,서울특별시,성북구,잘못 투입·구분된 투표지,,0,2,1,1,0,0,0,2,0,-2,50.0,50.0,0.0,0.0,0.0
0,서울특별시,강북구,거소·선상투표,,365,348,176,89,71,3,1,340,8,17,51.76470588235295,26.176470588235297,20.88235294117647,0.8823529411764706,0.29411764705882354
1,서울특별시,강북구,관외사전투표,,26920,26841,17186,5815,3135,395,21,26552,289,79,64.72582103043085,21.900421813799337,11.807020186803253,1.4876468815908406,0.07909008737571557
2,서울특별시,강북구,재외투표,,1740,1375,1016,233,92,23,0,1364,11,365,74.48680351906158,17.082111436950147,6.744868035190615,1.6862170087976538,0.0
3,서울특별시,강북구,삼양동,관내사전투표,5158,5158,3580,1201,315,33,5,5134,24,0,69.73120373977405,23.393065835605764,6.135566809505259,0.6427736657576938,0.09738994935722634
4,서울특별시,강북구,삼양동,삼양동제1투,2048,1338,536,657,116,12,2,1323,15,710,40.51398337112623,49.65986394557823,8.767951625094481,0.9070294784580499,0.15117157974300832
5,서울특별시,강북구,삼양동,삼양동제2투,1768,1084,446,544,72,11,4,1077,7,684,41.41132776230269,50.51067780872794,6.685236768802229,1.021355617455896,0.3714020427112349
6,서울특별시,강북구,삼양동,삼양동제3투,1468,796,304,382,82,17,2,787,9,672,38.6277001270648,48.53875476493011,10.419313850063533,2.1601016518424396,0.25412960609911056
7,서울특별시,강북구,삼양동,삼양동제4투,2124,1346,611,597,110,20,1,1339,7,778,45.63106796116505,44.58551157580284,8.215085884988797,1.4936519790888723,0.07468259895444362
8,서울특별시,강북구,삼양동,삼양동제5투,2423,1674,750,749,134,22,0,1655,19,749,45.31722054380665,45.25679758308157,8.09667673716012,1.3293051359516617,0.0
9,서울특별시,강북구,삼양동,삼양동제6투,1294,695,300,343,39,10,0,692,3,599,43.35260115606936,49.566473988439306,5.635838150289017,1.4450867052023122,0.0
10,서울특별시,강북구,삼양동,삼양동제7투,1009,618,238,323,49,4,0,614,4,391,38.762214983713356,52.60586319218241,7.980456026058631,0.6514657980456027,0.0
11,서울특별시,강북구,삼양동,삼양동제8투,1954,1483,680,653,123,19,2,1477,6,471,46.03926878808395,44.211238997968856,8.32769126607989,1.2863913337846988,0.13540961408259986
12,서울특별시,강북구,미아동,관내사전투표,6337,6337,4421,1335,471,64,7,6298,39,0,70.19688790092093,21.197205462051443,7.478564623690061,1.0161956176563989,0.11114639568116863
13,서울특별시,강북구,미아동,미아동제1투,2252,1402,575,672,120,22,1,1390,12,850,41.36690647482014,48.34532374100719,8.633093525179856,1.5827338129496402,0.07194244604316546
14,서울특별시,강북구,미아동,미아동제2투,1130,752,313,344,70,12,4,743,9,378,42.126514131897714,46.29878869448183,9.421265141318976,1.6150740242261103,0.5383580080753702
15,서울특별시,강북구,미아동,미아동제3투,3110,1961,801,947,154,36,3,1941,20,1149,41.26738794435858,48.7892838742916,7.934054611025244,1.8547140649149922,0.1545595054095827
16,서울특별시,강북구,미아동,미아동제4투,2097,1333,502,685,122,8,1,1318,15,764,38.08801213960547,51.97268588770865,9.256449165402124,0.6069802731411229,0.07587253414264036
17,서울특별시,강북구,미아동,미아동제5투,1810,1175,511,555,87,14,0,1167,8,635,43.78748928877464,47.55784061696658,7.455012853470437,1.1996572407883461,0.0
18,서울특별시,강북구,미아동,미아동제6투,1918,1110,461,520,107,9,2,1099,11,808,41.94722474977252,47.315741583257505,9.736123748862601,0.8189262966333031,0.18198362147406735
19,서울특별시,강북구,송중동,관내사전투표,4750,4750,3266,1101,319,35,2,4723,27,0,69.15096337073894,23.311454583950876,6.7541816641964845,0.7410544145670125,0.04234596654668643
20,서울특별시,강북구,송중동,송중동제1투,1783,1053,410,530,98,3,1,1042,11,730,39.34740882917466,50.8637236084453,9.404990403071018,0.28790786948176583,0.09596928982725528
21,서울특별시,강북구,송중동,송중동제2투,1920,1108,386,575,115,12,1,1089,19,812,35.44536271808999,52.80073461891644,10.560146923783286,1.1019283746556474,0.09182736455463728
22,서울특별시,강북구,송중동,송중동제3투,2126,1476,559,761,134,11,3,1468,8,650,38.079019073569484,51.839237057220714,9.128065395095367,0.7493188010899182,0.20435967302452315
23,서울특별시,강북구,송중동,송중동제4투,2150,1448,602,714,110,10,3,1439,9,702,41.83460736622654,49.61779013203614,7.644197359277276,0.6949270326615705,0.20847810979847115
24,서울특별시,강북구,송중동,송중동제5투,2282,1710,702,800,174,25,0,1701,9,572,41.269841269841265,47.031158142269256,10.229276895943562,1.4697236919459142,0.0
25,서울특별시,강북구,송중동,송중동제6투,1687,1086,441,564,68,11,0,1084,2,601,40.68265682656826,52.02952029520295,6.273062730627306,1.014760147601476,0.0
26,서울특별시,강북구,송중동,송중동제7투,2318,1548,659,734,119,16,4,1532,16,770,43.01566579634465,47.911227154047,7.7676240208877285,1.0443864229765014,0.26109660574412535
27,서울특별시,강북구,송중동,송중동제8투,1759,1011,447,457,85,12,0,1001,10,748,44.655344655344656,45.654345654345654,8.49150849150849,1.1988011988011988,0.0
28,서울특별시,강북구,송천동,관내사전투표,4923,4923,3413,1194,249,35,4,4895,28,0,69.72420837589377,24.39223697650664,5.08682328907048,0.7150153217568949,0.08171603677221655
29,서울특별시,강북구,송천동,송천동제1투,1829,972,396,490,73,7,1,967,5,857,40.95139607032058,50.67218200620476,7.549120992761117,0.7238883143743536,0.1034126163391934
30,서울특별시,강북구,송천동,송천동제2투,1366,833,341,429,48,8,1,827,6,533,41.23337363966142,51.87424425634825,5.804111245465538,0.9673518742442563,0.12091898428053204
31,서울특별시,강북구,송천동,송천동제3투,1633,1072,424,528,93,10,1,1056,16,561,40.15151515151515,50.0,8.806818181818182,0.946969696969697,0.0946969696969697
32,서울특별시,강북구,송천동,송천동제4투,1014,781,342,353,65,14,0,774,7,233,44.18604651162791,45.60723514211886,8.397932816537468,1.8087855297157622,0.0
33,서울특별시,강북구,송천동,송천동제5투,1925,1211,513,590,86,13,1,1203,8,714,42.643391521197,49.044056525353284,7.148794679966749,1.0806317539484622,0.0831255195344971
34,서울특별시,강북구,송천동,송천동제6투,1788,1099,474,527,73,17,2,1093,6,689,43.366880146386094,48.21591948764868,6.678865507776761,1.555352241537054,0.18298261665141813
35,서울특별시,강북구,송천동,송천동제7투,2236,1443,686,609,114,18,1,1428,15,793,48.03921568627451,42.64705882352941,7.9831932773109235,1.2605042016806722,0.0700280112044818
36,서울특별시,강북구,송천동,송천동제8투,1779,1137,454,588,79,3,2,1126,11,642,40.319715808170514,52.2202486678508,7.015985790408526,0.2664298401420959,0.17761989342806395
37,서울특별시,강북구,삼각산동,관내사전투표,5166,5166,3699,1044,348,48,1,5140,26,0,71.96498054474708,20.311284046692606,6.770428015564202,0.933852140077821,0.019455252918287938
38,서울특별시,강북구,삼각산동,삼각산동제1투,1891,1277,510,628,109,22,0,1269,8,614,40.189125295508276,49.48778565799842,8.58944050433412,1.7336485421591805,0.0
39,서울특별시,강북구,삼각산동,삼각산동제2투,1516,889,377,451,42,9,2,881,8,627,42.79228149829739,51.19182746878547,4.767309875141884,1.0215664018161181,0.22701475595913734
40,서울특별시,강북구,삼각산동,삼각산동제3투,2473,1913,905,797,169,29,2,1902,11,560,47.58149316508938,41.90325972660357,8.885383806519453,1.5247108307045216,0.10515247108307045
41,서울특별시,강북구,삼각산동,삼각산동제4투,1941,1565,751,651,138,17,1,1558,7,376,48.20282413350449,41.78433889602054,8.857509627727858,1.0911424903722722,0.06418485237483953
42,서울특별시,강북구,삼각산동,삼각산동제5투,2646,2148,1056,871,172,26,1,2126,22,498,49.67074317968015,40.9689557855127,8.090310442144872,1.2229539040451554,0.047036688617121354
43,서울특별시,강북구,삼각산동,삼각산동제6투,2040,1454,560,717,154,15,1,1447,7,586,38.700760193503804,49.550794747753976,10.642709053213546,1.0366275051831375,0.0691085003455425
44,서울특별시,강북구,삼각산동,삼각산동제7투,1729,1278,516,632,109,15,1,1273,5,451,40.53417124901807,49.64650432050275,8.562450903377847,1.178318931657502,0.07855459544383347
45,서울특별시,강북구,삼각산동,삼각산동제8투,2117,1628,767,693,135,20,2,1617,11,489,47.43351886209029,42.857142857142854,8.348794063079778,1.2368583797155226,0.12368583797155226
46,서울특별시,강북구,번1동,관내사전투표,3911,3911,2688,873,286,31,2,3880,31,0,69.27835051546391,22.5,7.371134020618557,0.7989690721649484,0.051546391752577324
47,서울특별시,강북구,번1동,번1동제1투,2427,1316,482,663,140,16,3,1304,12,1111,36.963190184049076,50.84355828220859,10.736196319018406,1.2269938650306749,0.23006134969325154
48,서울특별시,강북구,번1동,번1동제2투,1906,1158,443,580,107,15,1,1146,12,748,38.65619546247818,50.6108202443281,9.336823734729494,1.3089005235602094,0.08726003490401396
49,서울특별시,강북구,번1동,번1동제3투,2471,1390,487,757,114,11,1,1370,20,1081,35.54744525547445,55.25547445255474,8.321167883211679,0.8029197080291971,0.072992700729927
50,서울특별시,강북구,번1동,번1동제4투,2122,1334,544,677,84,13,1,1319,15,788,41.24336618650493,51.3267626990144,6.368460955269144,0.9855951478392722,0.0758150113722517
51,서울특별시,강북구,번1동,번1동제5투,686,433,184,212,32,5,0,433,0,253,42.494226327944574,48.96073903002309,7.390300230946882,1.1547344110854503,0.0
52,서울특별시,강북구,번2동,관내사전투표,3473,3473,2409,816,186,37,4,3452,21,0,69.7856315179606,23.638470451911935,5.388180764774044,1.0718424101969872,0.11587485515643105
53,서울특별시,강북구,번2동,번2동제1투,1978,1433,524,781,97,19,1,1422,11,545,36.849507735583686,54.922644163150494,6.821378340365682,1.3361462728551337,0.07032348804500703
54,서울특별시,강북구,번2동,번2동제2투,1221,715,277,395,34,6,0,712,3,506,38.90449438202247,55.47752808988764,4.775280898876404,0.8426966292134831,0.0
55,서울특별시,강북구,번2동,번2동제3투,2112,1317,521,682,92,14,1,1310,7,795,39.77099236641221,52.06106870229008,7.022900763358779,1.0687022900763359,0.07633587786259542
56,서울특별시,강북구,번2동,번2동제4투,1681,1087,498,474,89,13,1,1075,12,594,46.325581395348834,44.093023255813954,8.279069767441861,1.2093023255813953,0.09302325581395349
57,서울특별시,강북구,번2동,번2동제5투,1678,1119,538,477,86,12,2,1115,4,559,48.25112107623318,42.780269058295964,7.713004484304934,1.0762331838565022,0.17937219730941703
58,서울특별시,강북구,번3동,관내사전투표,3634,3634,2383,994,198,27,3,3605,29,0,66.10263522884881,27.57281553398058,5.492371705963938,0.7489597780859917,0.08321775312066575
59,서울특별시,강북구,번3동,번3동제1투,1264,697,259,390,38,7,0,694,3,567,37.319884726224785,56.195965417867434,5.475504322766571,1.0086455331412103,0.0
60,서울특별시,강북구,번3동,번3동제2투,1862,1273,506,641,98,15,2,1262,11,589,40.09508716323296,50.79239302694136,7.765451664025356,1.1885895404120443,0.15847860538827258
61,서울특별시,강북구,번3동,번3동제3투,1326,770,278,415,64,5,3,765,5,556,36.33986928104575,54.248366013071895,8.366013071895424,0.6535947712418301,0.39215686274509803
62,서울특별시,강북구,번3동,번3동제4투,2250,1574,667,781,96,19,2,1565,9,676,42.61980830670927,49.904153354632584,6.134185303514377,1.2140575079872205,0.12779552715654952
63,서울특별시,강북구,번3동,번3동제5투,2254,1565,689,736,116,14,1,1556,9,689,44.28020565552699,47.30077120822622,7.455012853470437,0.8997429305912596,0.06426735218508997
64,서울특별시,강북구,수유1동,관내사전투표,5078,5078,3612,1125,255,42,2,5036,42,0,71.72359015091342,22.33915806195393,5.063542494042891,0.8339952343129466,0.03971405877680699
65,서울특별시,강북구,수유1동,수유1동제1투,2004,1180,497,568,84,17,3,1169,11,824,42.51497005988024,48.58853721129171,7.18562874251497,1.4542343883661248,0.2566295979469632
66,서울특별시,강북구,수유1동,수유1동제2투,1951,1242,488,637,98,10,0,1233,9,709,39.57826439578264,51.662611516626114,7.948094079480941,0.8110300081103,0.0
67,서울특별시,강북구,수유1동,수유1동제3투,2129,1284,559,594,97,24,2,1276,8,845,43.808777429467085,46.55172413793103,7.601880877742946,1.8808777429467085,0.1567398119122257
68,서울특별시,강북구,수유1동,수유1동제4투,2129,1236,493,624,95,11,1,1224,12,893,40.27777777777778,50.98039215686274,7.761437908496732,0.8986928104575163,0.08169934640522876
69,서울특별시,강북구,수유1동,수유1동제5투,3204,1943,775,930,195,25,3,1928,15,1261,40.19709543568465,48.23651452282158,10.114107883817427,1.2966804979253113,0.15560165975103735
70,서울특별시,강북구,수유2동,관내사전투표,5355,5355,3560,1415,308,43,2,5328,27,0,66.81681681681681,26.55780780780781,5.7807807807807805,0.8070570570570571,0.03753753753753754
71,서울특별시,강북구,수유2동,수유2동제1투,2204,1435,463,845,95,18,3,1424,11,769,32.514044943820224,59.33988764044944,6.671348314606742,1.2640449438202246,0.21067415730337077
72,서울특별시,강북구,수유2동,수유2동제2투,2791,1713,678,858,142,21,2,1701,12,1078,39.85890652557319,50.44091710758377,8.348030570252792,1.2345679012345678,0.11757789535567313
73,서울특별시,강북구,수유2동,수유2동제3투,2062,1444,430,910,85,11,1,1437,7,618,29.923451635351427,63.32637439109256,5.915100904662491,0.7654836464857342,0.06958942240779402
74,서울특별시,강북구,수유2동,수유2동제4투,1720,1021,395,515,89,13,2,1014,7,699,38.95463510848126,50.78895463510848,8.777120315581854,1.282051282051282,0.19723865877712032
75,서울특별시,강북구,수유2동,수유2동제5투,2254,1297,473,677,106,23,2,1281,16,957,36.924277907884466,52.849336455893834,8.274785323965652,1.795472287275566,0.156128024980484
76,서울특별시,강북구,수유3동,관내사전투표,6457,6457,4399,1403,528,75,8,6413,44,0,68.59504132231406,21.87743645719632,8.233276157804461,1.169499454233588,0.12474660845158272
77,서울특별시,강북구,수유3동,수유3동제1투,1959,1104,391,562,113,21,0,1087,17,855,35.970561177552895,51.70193192272309,10.395584176632934,1.9319227230910765,0.0
78,서울특별시,강북구,수유3동,수유3동제2투,2590,1602,681,758,128,17,2,1586,16,988,42.938209331651954,47.793190416141236,8.07061790668348,1.0718789407313998,0.12610340479192939
79,서울특별시,강북구,수유3동,수유3동제3투,2503,1355,468,731,129,13,2,1343,12,1148,34.84735666418466,54.43037974683544,9.60536113179449,0.967982129560685,0.14892032762472077
80,서울특별시,강북구,수유3동,수유3동제4투,2240,1518,628,735,122,11,4,1500,18,722,41.86666666666667,49.0,8.133333333333333,0.7333333333333333,0.26666666666666666
81,서울특별시,강북구,수유3동,수유3동제5투,2479,1425,568,694,126,16,3,1407,18,1054,40.369580668088126,49.324804548685144,8.955223880597014,1.1371712864250179,0.21321961620469082
82,서울특별시,강북구,수유3동,수유3동제6투,2471,1522,616,749,135,17,0,1517,5,949,40.60646011865524,49.373764007910346,8.899143045484509,1.1206328279499012,0.0
83,서울특별시,강북구,우이동,관내사전투표,4905,4904,3442,1116,258,58,1,4875,29,1,70.60512820512821,22.892307692307693,5.292307692307692,1.1897435897435897,0.020512820512820513
84,서울특별시,강북구,우이동,우이동제1투,1643,1007,333,566,73,23,1,996,11,636,33.433734939759034,56.827309236947784,7.329317269076305,2.3092369477911645,0.1004016064257028
85,서울특별시,강북구,우이동,우이동제2투,2116,1252,485,645,93,15,1,1239,13,864,39.14447134786118,52.05811138014528,7.506053268765134,1.2106537530266344,0.08071025020177562
86,서울특별시,강북구,우이동,우이동제3투,2236,1329,482,700,107,27,3,1319,10,907,36.54283548142532,53.070507960576194,8.112206216830932,2.047005307050796,0.22744503411675512
87,서울특별시,강북구,우이동,우이동제4투,2797,1828,781,892,114,18,1,1806,22,969,43.244739756367665,49.390919158361015,6.312292358803987,0.9966777408637874,0.05537098560354374
88,서울특별시,강북구,우이동,우이동제5투,2413,1617,626,861,100,18,0,1605,12,796,39.00311526479751,53.64485981308411,6.230529595015576,1.1214953271028036,0.0
89,서울특별시,강북구,인수동,관내사전투표,6157,6157,4169,1554,336,61,3,6123,34,0,68.08753878817572,25.3797158255757,5.4875061244487995,0.996243671402907,0.04899559039686428
90,서울특별시,강북구,인수동,인수동제1투,1552,890,301,486,77,15,0,879,11,662,34.243458475540386,55.2901023890785,8.75995449374289,1.7064846416382253,0.0
91,서울특별시,강북구,인수동,인수동제2투,1563,962,287,589,66,9,1,952,10,601,30.14705882352941,61.86974789915966,6.932773109243698,0.9453781512605042,0.10504201680672269
92,서울특별시,강북구,인수동,인수동제3투,2004,1246,483,635,97,20,0,1235,11,758,39.10931174089069,51.417004048582996,7.854251012145749,1.6194331983805668,0.0
93,서울특별시,강북구,인수동,인수동제4투,1730,1089,404,606,56,20,0,1086,3,641,37.20073664825046,55.80110497237569,5.156537753222836,1.841620626151013,0.0
94,서울특별시,강북구,인수동,인수동제5투,2035,1146,448,592,81,8,1,1130,16,889,39.64601769911504,52.38938053097345,7.168141592920355,0.7079646017699115,0.08849557522123894
95,서울특별시,강북구,인수동,인수동제6투,2186,1300,497,690,93,12,1,1293,7,886,38.437741686001544,53.36426914153132,7.192575406032482,0.9280742459396751,0.07733952049497293
96,서울특별시,강북구,인수동,인수동제7투,2636,1633,752,751,107,14,1,1625,8,1003,46.276923076923076,46.215384615384615,6.584615384615384,0.8615384615384615,0.06153846153846154
97,서울특별시,강북구,인수동,인수동제8투,2450,1486,622,744,82,19,8,1475,11,964,42.16949152542373,50.4406779661017,5.5593220338983045,1.2881355932203389,0.5423728813559322
98,서울특별시,강북구,잘못 투입·구분된 투표지,,0,75,54,19,1,1,0,75,0,-75,72.0,25.333333333333336,1.3333333333333335,1.3333333333333335,0.0
0,서울특별시,도봉구,거소·선상투표,,440,416,193,137,70,3,4,407,9,24,47.420147420147416,33.660933660933665,17.1990171990172,0.7371007371007371,0.9828009828009828
1,서울특별시,도봉구,관외사전투표,,30138,30134,18840,6884,3679,391,30,29824,310,4,63.1706008583691,23.08208154506438,12.335702789699571,1.311024678111588,0.1005901287553648
2,서울특별시,도봉구,재외투표,,1866,1508,1061,276,146,18,0,1501,7,358,70.68620919387075,18.38774150566289,9.726848767488342,1.1992005329780147,0.0
3,서울특별시,도봉구,쌍문1동,관내사전투표,3897,3897,2726,913,191,39,6,3875,22,0,70.34838709677419,23.561290322580643,4.929032258064516,1.0064516129032257,0.15483870967741936
4,서울특별시,도봉구,쌍문1동,쌍문1동제1투,2232,1366,505,731,101,13,0,1350,16,866,37.407407407407405,54.148148148148145,7.481481481481482,0.962962962962963,0.0
5,서울특별시,도봉구,쌍문1동,쌍문1동제2투,2225,1322,527,654,111,18,2,1312,10,903,40.167682926829265,49.84756097560975,8.460365853658537,1.3719512195121952,0.1524390243902439
6,서울특별시,도봉구,쌍문1동,쌍문1동제3투,1993,1339,511,703,90,19,3,1326,13,654,38.5369532428356,53.01659125188537,6.787330316742081,1.4328808446455505,0.22624434389140274
7,서울특별시,도봉구,쌍문1동,쌍문1동제4투,3161,2192,956,1047,150,27,0,2180,12,969,43.853211009174316,48.027522935779814,6.8807339449541285,1.2385321100917432,0.0
8,서울특별시,도봉구,쌍문1동,쌍문1동제5투,2105,1376,539,711,95,21,1,1367,9,729,39.429407461594735,52.01170446232626,6.949524506217995,1.5362106803218727,0.0731528895391368
9,서울특별시,도봉구,쌍문2동,관내사전투표,4183,4183,2846,997,262,46,3,4154,29,0,68.51227732306211,24.00096292729899,6.307173808377467,1.1073663938372653,0.07221954742416947
10,서울특별시,도봉구,쌍문2동,쌍문2동제1투,2395,1505,569,762,139,18,2,1490,15,890,38.18791946308725,51.14093959731544,9.328859060402685,1.2080536912751678,0.1342281879194631
11,서울특별시,도봉구,쌍문2동,쌍문2동제2투,2178,1337,511,703,102,10,1,1327,10,841,38.50791258477769,52.97663903541824,7.6865109269027885,0.7535795026375283,0.07535795026375283
12,서울특별시,도봉구,쌍문2동,쌍문2동제3투,1678,1150,457,593,83,6,0,1139,11,528,40.12291483757682,52.06321334503951,7.287093942054433,0.5267778753292361,0.0
13,서울특별시,도봉구,쌍문2동,쌍문2동제4투,2162,1638,685,815,110,16,1,1627,11,524,42.1020282728949,50.09219422249539,6.760909649661954,0.9834050399508296,0.06146281499692685
14,서울특별시,도봉구,쌍문2동,쌍문2동제5투,2043,1314,556,623,106,13,3,1301,13,729,42.73635664873174,47.886241352805534,8.147578785549578,0.9992313604919293,0.23059185242121444
15,서울특별시,도봉구,쌍문3동,관내사전투표,4003,4003,2684,983,259,47,3,3976,27,0,67.50503018108652,24.72334004024145,6.514084507042253,1.1820925553319919,0.07545271629778671
16,서울특별시,도봉구,쌍문3동,쌍문3동제1투,2635,1724,666,848,175,23,2,1714,10,911,38.85647607934656,49.47491248541424,10.210035005834307,1.3418903150525088,0.11668611435239205
17,서울특별시,도봉구,쌍문3동,쌍문3동제2투,2433,1550,655,711,154,17,1,1538,12,883,42.58777633289987,46.228868660598174,10.013003901170352,1.1053315994798438,0.06501950585175553
18,서울특별시,도봉구,쌍문3동,쌍문3동제3투,2138,1394,562,669,127,21,3,1382,12,744,40.66570188133141,48.40810419681621,9.18958031837916,1.519536903039074,0.21707670043415342
19,서울특별시,도봉구,쌍문3동,쌍문3동제4투,2130,1353,494,710,111,23,4,1342,11,777,36.8107302533532,52.90611028315947,8.271236959761548,1.713859910581222,0.29806259314456035
20,서울특별시,도봉구,쌍문4동,관내사전투표,3522,3522,2380,849,227,52,0,3508,14,0,67.84492588369442,24.201824401368302,6.470923603192702,1.4823261117445838,0.0
21,서울특별시,도봉구,쌍문4동,쌍문4동제1투,2159,1483,570,749,141,16,0,1476,7,676,38.61788617886179,50.74525745257452,9.552845528455284,1.084010840108401,0.0
22,서울특별시,도봉구,쌍문4동,쌍문4동제2투,2373,1743,608,932,172,23,0,1735,8,630,35.04322766570605,53.71757925072046,9.913544668587896,1.3256484149855907,0.0
23,서울특별시,도봉구,쌍문4동,쌍문4동제3투,2278,1698,644,883,149,13,1,1690,8,580,38.10650887573965,52.248520710059175,8.816568047337277,0.7692307692307693,0.0591715976331361
24,서울특별시,도봉구,쌍문4동,쌍문4동제4투,2633,1876,678,985,173,29,0,1865,11,757,36.35388739946381,52.81501340482574,9.276139410187668,1.5549597855227881,0.0
25,서울특별시,도봉구,방학1동,관내사전투표,5120,5120,3437,1342,259,42,4,5084,36,0,67.6042486231314,26.396538158929978,5.0944138473642795,0.8261211644374508,0.07867820613690008
26,서울특별시,도봉구,방학1동,방학1동제1투,2083,1184,450,628,81,15,0,1174,10,899,38.33049403747871,53.4923339011925,6.899488926746167,1.2776831345826234,0.0
27,서울특별시,도봉구,방학1동,방학1동제2투,1910,1187,444,639,80,11,1,1175,12,723,37.787234042553195,54.38297872340425,6.808510638297872,0.9361702127659575,0.0851063829787234
28,서울특별시,도봉구,방학1동,방학1동제3투,2248,1341,534,682,96,15,0,1327,14,907,40.241145440844015,51.39412207987942,7.234363225320271,1.1303692539562924,0.0
29,서울특별시,도봉구,방학1동,방학1동제4투,2689,1814,699,971,113,15,2,1800,14,875,38.83333333333333,53.94444444444444,6.277777777777778,0.8333333333333334,0.1111111111111111
30,서울특별시,도봉구,방학1동,방학1동제5투,2804,1822,788,810,184,21,2,1805,17,982,43.65650969529086,44.87534626038781,10.193905817174516,1.1634349030470914,0.110803324099723
31,서울특별시,도봉구,방학1동,방학1동제6투,1880,1333,442,769,107,7,0,1325,8,547,33.35849056603774,58.0377358490566,8.075471698113207,0.5283018867924528,0.0
32,서울특별시,도봉구,방학1동,방학1동제7투,2040,1569,592,841,110,15,1,1559,10,471,37.97305965362412,53.944836433611286,7.055805003207184,0.9621552277100706,0.06414368184733803
33,서울특별시,도봉구,방학2동,관내사전투표,4305,4305,2933,1117,177,46,4,4277,28,0,68.57610474631751,26.11643675473463,4.138414776712649,1.0755202244563948,0.09352349777881692
34,서울특별시,도봉구,방학2동,방학2동제1투,1766,957,345,519,70,13,3,950,7,809,36.31578947368421,54.63157894736842,7.368421052631578,1.368421052631579,0.3157894736842105
35,서울특별시,도봉구,방학2동,방학2동제2투,1471,921,367,459,74,9,0,909,12,550,40.374037403740374,50.495049504950494,8.14081408140814,0.9900990099009901,0.0
36,서울특별시,도봉구,방학2동,방학2동제3투,1794,1134,445,568,99,12,2,1126,8,660,39.52042628774423,50.44404973357016,8.792184724689166,1.0657193605683837,0.17761989342806395
37,서울특별시,도봉구,방학2동,방학2동제4투,1905,1299,543,648,89,5,1,1286,13,606,42.22395023328149,50.38880248833593,6.920684292379471,0.38880248833592534,0.07776049766718507
38,서울특별시,도봉구,방학2동,방학2동제5투,1633,880,324,461,72,12,2,871,9,753,37.198622273249136,52.9276693455798,8.266360505166476,1.377726750861079,0.2296211251435132
39,서울특별시,도봉구,방학2동,방학2동제6투,1805,1105,456,575,62,7,1,1101,4,700,41.41689373297003,52.2252497729337,5.631244323342416,0.6357856494096277,0.09082652134423251
40,서울특별시,도봉구,방학3동,관내사전투표,6766,6766,4461,1781,434,59,2,6737,29,0,66.21641680273117,26.43609915392608,6.442036514769185,0.8757607243580228,0.029686804215526198
41,서울특별시,도봉구,방학3동,방학3동제1투,3330,2212,782,1210,180,22,2,2196,16,1118,35.61020036429873,55.100182149362475,8.19672131147541,1.0018214936247722,0.09107468123861566
42,서울특별시,도봉구,방학3동,방학3동제2투,2161,1543,563,816,130,22,1,1532,11,618,36.749347258485635,53.26370757180157,8.485639686684072,1.4360313315926894,0.06527415143603134
43,서울특별시,도봉구,방학3동,방학3동제3투,2540,1710,591,961,128,24,0,1704,6,830,34.683098591549296,56.39671361502347,7.511737089201878,1.4084507042253522,0.0
44,서울특별시,도봉구,방학3동,방학3동제4투,1805,1341,497,724,87,20,1,1329,12,464,37.39653875094056,54.477050413845,6.5462753950338595,1.5048908954100828,0.07524454477050413
45,서울특별시,도봉구,방학3동,방학3동제5투,1900,1486,640,706,108,20,0,1474,12,414,43.419267299864316,47.89687924016282,7.327001356852103,1.3568521031207599,0.0
46,서울특별시,도봉구,방학3동,방학3동제6투,1853,1310,530,630,122,19,1,1302,8,543,40.706605222734254,48.38709677419355,9.37019969278034,1.4592933947772657,0.07680491551459294
47,서울특별시,도봉구,창1동,관내사전투표,4389,4389,2920,1076,341,29,4,4370,19,0,66.81922196796339,24.622425629290618,7.803203661327231,0.6636155606407322,0.09153318077803205
48,서울특별시,도봉구,창1동,창1동제1투,2403,1549,483,909,124,19,1,1536,13,854,31.4453125,59.1796875,8.072916666666668,1.2369791666666665,0.06510416666666666
49,서울특별시,도봉구,창1동,창1동제2투,2093,1255,516,599,118,13,1,1247,8,838,41.37931034482759,48.03528468323977,9.46271050521251,1.0425020048115476,0.08019246190858059
50,서울특별시,도봉구,창1동,창1동제3투,2202,1457,644,663,115,19,1,1442,15,745,44.66019417475729,45.97780859916782,7.975034674063801,1.3176144244105408,0.06934812760055478
51,서울특별시,도봉구,창1동,창1동제4투,2249,1568,562,834,141,20,1,1558,10,681,36.071887034659824,53.53016688061617,9.050064184852374,1.2836970474967908,0.06418485237483953
52,서울특별시,도봉구,창1동,창1동제5투,2632,1988,840,943,168,23,4,1978,10,644,42.46713852376138,47.674418604651166,8.493427704752275,1.1627906976744187,0.20222446916076847
53,서울특별시,도봉구,창1동,창1동제6투,1780,1218,525,573,90,17,3,1208,10,562,43.46026490066225,47.43377483443709,7.450331125827815,1.4072847682119205,0.24834437086092717
54,서울특별시,도봉구,창2동,관내사전투표,6463,6463,4339,1587,431,61,6,6424,39,0,67.54358655043586,24.70423412204234,6.709215442092155,0.9495641344956414,0.09339975093399751
55,서울특별시,도봉구,창2동,창2동제1투,2184,1358,516,684,126,13,1,1340,18,826,38.50746268656716,51.04477611940299,9.402985074626866,0.9701492537313432,0.0746268656716418
56,서울특별시,도봉구,창2동,창2동제2투,2588,1592,618,821,120,16,1,1576,16,996,39.213197969543145,52.09390862944162,7.614213197969544,1.015228426395939,0.06345177664974619
57,서울특별시,도봉구,창2동,창2동제3투,2523,1794,790,807,156,24,3,1780,14,729,44.38202247191011,45.33707865168539,8.764044943820224,1.348314606741573,0.16853932584269662
58,서울특별시,도봉구,창2동,창2동제4투,2933,2027,769,1049,173,20,1,2012,15,906,38.220675944334,52.13717693836978,8.59840954274354,0.9940357852882704,0.049701789264413515
59,서울특별시,도봉구,창2동,창2동제5투,2842,1888,754,917,178,19,3,1871,17,954,40.299305184393376,49.01122394441475,9.51362907536077,1.015499732763228,0.16034206306787815
60,서울특별시,도봉구,창2동,창2동제6투,2784,1757,771,799,152,17,1,1740,17,1027,44.310344827586206,45.91954022988506,8.735632183908045,0.9770114942528736,0.05747126436781609
61,서울특별시,도봉구,창3동,관내사전투표,2816,2816,1906,713,151,26,3,2799,17,0,68.09574848160057,25.473383351196855,5.394783851375491,0.9289031797070382,0.10718113612004287
62,서울특별시,도봉구,창3동,창3동제1투,1631,935,361,504,53,13,0,931,4,696,38.775510204081634,54.13533834586466,5.692803437164339,1.3963480128893664,0.0
63,서울특별시,도봉구,창3동,창3동제2투,2099,1239,477,606,124,16,1,1224,15,860,38.970588235294116,49.50980392156863,10.130718954248366,1.3071895424836601,0.08169934640522876
64,서울특별시,도봉구,창3동,창3동제3투,1523,896,391,416,70,13,1,891,5,627,43.88327721661055,46.68911335578002,7.856341189674524,1.4590347923681257,0.11223344556677892
65,서울특별시,도봉구,창3동,창3동제4투,1999,1367,612,634,92,16,3,1357,10,632,45.09948415622697,46.720707442888724,6.779661016949152,1.1790714812085483,0.2210759027266028
66,서울특별시,도봉구,창4동,관내사전투표,5975,5975,3855,1513,503,60,3,5934,41,0,64.96461071789686,25.497135153353558,8.476575665655545,1.0111223458038423,0.05055611729019212
67,서울특별시,도봉구,창4동,창4동제1투,2241,1613,621,796,154,26,0,1597,16,628,38.885410144020035,49.84345648090169,9.643080776455855,1.6280525986224168,0.0
68,서울특별시,도봉구,창4동,창4동제2투,1958,1345,519,688,117,15,2,1341,4,613,38.702460850111855,51.30499627143923,8.724832214765101,1.1185682326621924,0.14914243102162564
69,서울특별시,도봉구,창4동,창4동제3투,2239,1583,493,942,124,16,0,1575,8,656,31.301587301587304,59.80952380952381,7.8730158730158735,1.0158730158730158,0.0
70,서울특별시,도봉구,창4동,창4동제4투,3239,2536,936,1289,255,29,0,2509,27,703,37.30569948186528,51.37504982064568,10.163411717815862,1.1558389796731765,0.0
71,서울특별시,도봉구,창4동,창4동제5투,2284,1752,720,847,157,16,4,1744,8,532,41.284403669724774,48.56651376146789,9.002293577981652,0.9174311926605505,0.22935779816513763
72,서울특별시,도봉구,창4동,창4동제6투,2944,2321,1029,1070,182,28,0,2309,12,623,44.56474664356864,46.340407102641834,7.8822000866175825,1.212646167171936,0.0
73,서울특별시,도봉구,창5동,관내사전투표,5226,5226,3357,1404,372,58,3,5194,32,0,64.63226800154024,27.031189834424335,7.162110127069695,1.1166730843280708,0.05775895263765884
74,서울특별시,도봉구,창5동,창5동제1투,2241,1564,670,746,118,18,0,1552,12,677,43.170103092783506,48.06701030927835,7.603092783505154,1.1597938144329898,0.0
75,서울특별시,도봉구,창5동,창5동제2투,1658,1165,466,585,87,14,2,1154,11,493,40.38128249566724,50.69324090121318,7.538994800693241,1.2131715771230502,0.17331022530329288
76,서울특별시,도봉구,창5동,창5동제3투,2296,1584,633,799,119,17,3,1571,13,712,40.29280712921705,50.85932527052832,7.574793125397836,1.0821133036282622,0.19096117122851686
77,서울특별시,도봉구,창5동,창5동제4투,2116,1467,508,798,130,23,2,1461,6,649,34.770704996577685,54.62012320328542,8.898015058179329,1.5742642026009581,0.13689253935660506
78,서울특별시,도봉구,창5동,창5동제5투,1335,1036,282,660,79,11,1,1033,3,299,27.299128751210066,63.891577928363986,7.647628267182963,1.0648596321393997,0.0968054211035818
79,서울특별시,도봉구,창5동,창5동제6투,1982,1502,447,915,119,13,1,1495,7,480,29.899665551839465,61.20401337792642,7.959866220735785,0.8695652173913043,0.06688963210702341
80,서울특별시,도봉구,창5동,창5동제7투,1761,1145,436,564,122,16,3,1141,4,616,38.21209465381244,49.430324276950046,10.692375109553023,1.4022787028922,0.26292725679228746
81,서울특별시,도봉구,도봉1동,관내사전투표,5329,5329,3598,1364,284,49,2,5297,32,0,67.92524070228431,25.750424768737023,5.361525391731169,0.9250519161789692,0.037757221068529356
82,서울특별시,도봉구,도봉1동,도봉1동제1투,1976,1144,387,642,86,15,2,1132,12,832,34.187279151943464,56.71378091872792,7.597173144876325,1.325088339222615,0.17667844522968199
83,서울특별시,도봉구,도봉1동,도봉1동제2투,2856,1942,760,1031,108,19,6,1924,18,914,39.5010395010395,53.58627858627859,5.613305613305614,0.9875259875259876,0.31185031185031187
84,서울특별시,도봉구,도봉1동,도봉1동제3투,1488,944,345,511,70,10,1,937,7,544,36.819637139807895,54.53575240128068,7.4706510138740665,1.0672358591248665,0.10672358591248667
85,서울특별시,도봉구,도봉1동,도봉1동제4투,1046,626,202,366,46,5,2,621,5,420,32.52818035426731,58.93719806763285,7.4074074074074066,0.8051529790660225,0.322061191626409
86,서울특별시,도봉구,도봉1동,도봉1동제5투,1852,1265,415,742,87,10,2,1256,9,587,33.04140127388535,59.076433121019114,6.926751592356688,0.7961783439490446,0.15923566878980894
87,서울특별시,도봉구,도봉1동,도봉1동제6투,2778,1768,703,907,124,17,1,1752,16,1010,40.12557077625571,51.76940639269406,7.077625570776255,0.9703196347031963,0.05707762557077625
88,서울특별시,도봉구,도봉2동,관내사전투표,5220,5220,3492,1302,349,45,1,5189,31,0,67.29620350741953,25.09153979572172,6.725766043553671,0.8672191173636539,0.01927153594141453
89,서울특별시,도봉구,도봉2동,도봉2동제1투,1205,701,308,335,42,9,0,694,7,504,44.38040345821326,48.27089337175792,6.051873198847262,1.2968299711815563,0.0
90,서울특별시,도봉구,도봉2동,도봉2동제2투,2042,1524,578,813,108,15,1,1515,9,518,38.15181518151815,53.663366336633665,7.128712871287128,0.9900990099009901,0.066006600660066
91,서울특별시,도봉구,도봉2동,도봉2동제3투,1724,998,392,515,72,10,1,990,8,726,39.5959595959596,52.02020202020202,7.2727272727272725,1.0101010101010102,0.10101010101010101
92,서울특별시,도봉구,도봉2동,도봉2동제4투,1868,1319,543,638,111,12,2,1306,13,549,41.577335375191424,48.85145482388974,8.499234303215927,0.9188361408882083,0.1531393568147014
93,서울특별시,도봉구,도봉2동,도봉2동제5투,3411,2479,944,1301,204,15,2,2466,13,932,38.280616382806166,52.75750202757502,8.27250608272506,0.6082725060827251,0.08110300081103002
94,서울특별시,도봉구,도봉2동,도봉2동제6투,2758,2198,943,1046,178,21,0,2188,10,560,43.098720292504574,47.80621572212066,8.135283363802559,0.9597806215722121,0.0
95,서울특별시,도봉구,도봉2동,도봉2동제7투,2953,2310,952,1160,153,28,3,2296,14,643,41.46341463414634,50.522648083623686,6.66376306620209,1.2195121951219512,0.13066202090592335
96,서울특별시,도봉구,잘못 투입·구분된 투표지,,0,0,0,0,0,0,0,0,0,0,0.0,0.0,0.0,0.0,0.0
0,서울특별시,노원구,거소·선상투표,,673,645,281,199,138,3,1,622,23,28,45.17684887459807,31.9935691318328,22.186495176848876,0.482315112540193,0.1607717041800643
1,서울특별시,노원구,관외사전투표,,48925,48921,29554,11316,6909,628,68,48475,446,4,60.96750902527076,23.343991748323877,14.252707581227437,1.295513151108819,0.14027849406910778
2,서울특별시,노원구,재외투표,,3142,2548,1737,482,275,42,3,2539,9,594,68.41276092949981,18.983851910200865,10.831035840882237,1.654194564789287,0.11815675462780621
3,서울특별시,노원구,월계1동,관내사전투표,5315,5315,3372,1300,569,28,6,5275,40,0,63.92417061611374,24.644549763033176,10.786729857819905,0.5308056872037914,0.1137440758293839
4,서울특별시,노원구,월계1동,월계1동제1투,2222,1494,517,773,170,17,1,1478,16,728,34.979702300405954,52.30040595399188,11.502029769959405,1.1502029769959403,0.06765899864682003
5,서울특별시,노원구,월계1동,월계1동제2투,1546,1097,373,606,97,9,1,1086,11,449,34.34622467771639,55.80110497237569,8.931860036832411,0.8287292817679558,0.09208103130755065
6,서울특별시,노원구,월계1동,월계1동제3투,2928,1985,694,1029,232,17,0,1972,13,943,35.19269776876268,52.180527383367135,11.76470588235294,0.8620689655172413,0.0
7,서울특별시,노원구,월계1동,월계1동제4투,2650,1728,631,872,195,13,1,1712,16,922,36.85747663551402,50.93457943925234,11.39018691588785,0.7593457943925234,0.05841121495327102
8,서울특별시,노원구,월계1동,월계1동제5투,2336,1623,680,756,155,17,3,1611,12,713,42.209807572936064,46.927374301675975,9.62135319677219,1.0552451893234016,0.186219739292365
9,서울특별시,노원구,월계2동,관내사전투표,4145,4145,2834,1016,235,38,3,4126,19,0,68.6863790596219,24.624333494910324,5.695588948133786,0.9209888511875909,0.07270964614638875
10,서울특별시,노원구,월계2동,월계2동제1투,2572,1655,591,895,133,23,1,1643,12,917,35.97078514911747,54.47352404138771,8.09494826536823,1.399878271454656,0.06086427267194157
11,서울특별시,노원구,월계2동,월계2동제2투,2098,1430,599,670,124,19,5,1417,13,668,42.27240649258998,47.28299223712068,8.75088214537756,1.340860973888497,0.35285815102328866
12,서울특별시,노원구,월계2동,월계2동제3투,2322,1733,673,909,118,21,1,1722,11,589,39.08246225319396,52.78745644599303,6.852497096399536,1.2195121951219512,0.05807200929152149
13,서울특별시,노원구,월계2동,월계2동제4투,3081,2192,913,1062,178,27,5,2185,7,889,41.784897025171624,48.60411899313501,8.14645308924485,1.2356979405034325,0.2288329519450801
14,서울특별시,노원구,월계2동,월계2동제5투,1992,1246,500,670,47,12,2,1231,15,746,40.61738424045491,54.42729488220959,3.8180341186027618,0.974817221770918,0.16246953696181965
15,서울특별시,노원구,월계2동,월계2동제6투,2383,1712,672,828,176,22,3,1701,11,671,39.50617283950617,48.67724867724868,10.346854791299236,1.2933568489124045,0.1763668430335097
16,서울특별시,노원구,월계3동,관내사전투표,3515,3515,2301,897,259,26,1,3484,31,0,66.04477611940298,25.74626865671642,7.43398392652124,0.7462686567164178,0.02870264064293915
17,서울특별시,노원구,월계3동,월계3동제1투,1645,1195,475,575,117,14,0,1181,14,450,40.22015241320914,48.68755292125317,9.906858594411517,1.1854360711261642,0.0
18,서울특별시,노원구,월계3동,월계3동제2투,2116,1630,696,755,138,21,4,1614,16,486,43.12267657992565,46.77819083023544,8.550185873605948,1.3011152416356877,0.24783147459727387
19,서울특별시,노원구,월계3동,월계3동제3투,1968,1462,560,753,124,14,0,1451,11,506,38.59407305306685,51.895244658855965,8.545830461750517,0.9648518263266712,0.0
20,서울특별시,노원구,월계3동,월계3동제4투,2065,1500,607,683,165,33,0,1488,12,565,40.793010752688176,45.9005376344086,11.088709677419354,2.217741935483871,0.0
21,서울특별시,노원구,월계3동,월계3동제5투,2723,2176,855,1057,224,23,0,2159,17,547,39.60166743862899,48.95785085687818,10.375173691523853,1.0653080129689672,0.0
22,서울특별시,노원구,월계3동,월계3동제6투,2635,2137,827,1075,204,18,2,2126,11,498,38.89934148635936,50.56444026340545,9.595484477892755,0.8466603951081844,0.09407337723424271
23,서울특별시,노원구,월계3동,월계3동제7투,1461,1064,440,499,110,8,1,1058,6,397,41.58790170132325,47.16446124763705,10.396975425330812,0.7561436672967864,0.0945179584120983
24,서울특별시,노원구,월계3동,월계3동제8투,1325,900,352,465,63,12,0,892,8,425,39.46188340807175,52.130044843049326,7.062780269058296,1.345291479820628,0.0
25,서울특별시,노원구,월계3동,월계3동제9투,1386,781,254,468,40,9,1,772,9,605,32.90155440414508,60.62176165803109,5.181347150259067,1.16580310880829,0.1295336787564767
26,서울특별시,노원구,공릉1동,관내사전투표,8523,8523,5457,1890,1001,101,11,8460,63,0,64.50354609929077,22.340425531914892,11.832151300236408,1.1938534278959811,0.13002364066193853
27,서울특별시,노원구,공릉1동,공릉1동제1투,2755,1838,715,871,205,26,2,1819,19,917,39.30731170973062,47.88345244639912,11.269928532160527,1.4293567894447499,0.10995052226498077
28,서울특별시,노원구,공릉1동,공릉1동제2투,3445,2485,1065,1099,247,47,6,2464,21,960,43.2224025974026,44.60227272727273,10.02435064935065,1.9074675324675323,0.2435064935064935
29,서울특별시,노원구,공릉1동,공릉1동제3투,2560,1550,465,782,271,13,5,1536,14,1010,30.2734375,50.911458333333336,17.643229166666664,0.8463541666666666,0.32552083333333337
30,서울특별시,노원구,공릉1동,공릉1동제4투,2162,1468,571,737,133,14,3,1458,10,694,39.16323731138546,50.548696844993145,9.122085048010973,0.9602194787379973,0.205761316872428
31,서울특별시,노원구,공릉1동,공릉1동제5투,1793,1234,521,594,85,11,0,1211,23,559,43.0222956234517,49.05037159372419,7.018992568125516,0.9083402146985963,0.0
32,서울특별시,노원구,공릉1동,공릉1동제6투,1402,992,406,481,85,12,1,985,7,410,41.21827411167513,48.83248730964467,8.629441624365482,1.2182741116751268,0.10152284263959391
33,서울특별시,노원구,공릉1동,공릉1동제7투,2250,1639,680,775,148,22,2,1627,12,611,41.79471419791027,47.63368162261832,9.096496619545174,1.352181929932391,0.1229256299938537
34,서울특별시,노원구,공릉1동,공릉1동제8투,2159,1560,634,750,137,21,1,1543,17,599,41.08878807517822,48.606610499027866,8.878807517822423,1.3609850939727801,0.06480881399870382
35,서울특별시,노원구,공릉1동,공릉1동제9투,2449,1944,838,885,181,23,0,1927,17,505,43.487285936689155,45.926310326933056,9.392838609237156,1.1935651271406331,0.0
36,서울특별시,노원구,공릉2동,관내사전투표,7222,7222,4904,1568,634,72,2,7180,42,0,68.3008356545961,21.838440111420613,8.83008356545961,1.0027855153203342,0.02785515320334262
37,서울특별시,노원구,공릉2동,공릉2동제1투,2379,1655,620,814,177,28,0,1639,16,724,37.82794386821233,49.664429530201346,10.799267846247712,1.7083587553386212,0.0
38,서울특별시,노원구,공릉2동,공릉2동제2투,2828,2242,943,1026,229,31,1,2230,12,586,42.28699551569507,46.00896860986547,10.269058295964125,1.390134529147982,0.04484304932735426
39,서울특별시,노원구,공릉2동,공릉2동제3투,3036,2236,876,1033,286,21,2,2218,18,800,39.49504057709648,46.573489630297566,12.894499549143374,0.9467989179440938,0.09017132551848511
40,서울특별시,노원구,공릉2동,공릉2동제4투,3231,2459,976,1155,280,25,3,2439,20,772,40.016400164001645,47.35547355473555,11.480114801148012,1.025010250102501,0.12300123001230012
41,서울특별시,노원구,공릉2동,공릉2동제5투,2692,2068,839,1018,187,17,0,2061,7,624,40.70839398350316,49.39349830179525,9.073265405143134,0.8248423095584668,0.0
42,서울특별시,노원구,공릉2동,공릉2동제6투,2507,1817,690,864,218,31,1,1804,13,690,38.248337028824835,47.893569844789354,12.084257206208427,1.7184035476718404,0.05543237250554324
43,서울특별시,노원구,공릉2동,공릉2동제7투,2424,1714,643,865,166,24,3,1701,13,710,37.801293356848916,50.852439741328624,9.75896531452087,1.4109347442680775,0.1763668430335097
44,서울특별시,노원구,공릉2동,공릉2동제8투,1312,944,307,517,95,18,0,937,7,368,32.7641408751334,55.1760939167556,10.138740661686233,1.92102454642476,0.0
45,서울특별시,노원구,공릉2동,공릉2동제9투,1864,1406,589,677,103,29,1,1399,7,458,42.101501072194424,48.39170836311651,7.36240171551108,2.0729092208720514,0.07147962830593281
46,서울특별시,노원구,하계1동,관내사전투표,4355,4355,2794,1014,444,46,5,4303,52,0,64.93144317917732,23.564954682779458,10.31838252382059,1.0690216128282592,0.11619800139437601
47,서울특별시,노원구,하계1동,하계1동제1투,2108,1547,517,818,169,22,1,1527,20,561,33.85723641126391,53.5690897184021,11.067452521283561,1.4407334643091028,0.06548788474132286
48,서울특별시,노원구,하계1동,하계1동제2투,2107,1464,607,672,150,20,2,1451,13,643,41.833218470020675,46.31288766368022,10.337698139214336,1.3783597518952446,0.13783597518952445
49,서울특별시,노원구,하계1동,하계1동제3투,2400,1561,559,855,115,12,5,1546,15,839,36.15782664941785,55.30401034928849,7.438551099611902,0.7761966364812419,0.3234152652005175
50,서울특별시,노원구,하계1동,하계1동제4투,2633,2024,786,960,219,36,3,2004,20,609,39.221556886227546,47.90419161676647,10.928143712574851,1.7964071856287425,0.14970059880239522
51,서울특별시,노원구,하계1동,하계1동제5투,3168,2249,792,1025,376,32,1,2226,23,919,35.57951482479784,46.04672057502246,16.89128481581312,1.4375561545372868,0.04492362982929021
52,서울특별시,노원구,하계1동,하계1동제6투,2763,2148,874,1016,208,35,1,2134,14,615,40.955951265229615,47.61012183692596,9.746954076850985,1.640112464854733,0.046860356138706656
53,서울특별시,노원구,하계2동,관내사전투표,4905,4905,3327,1102,378,55,2,4864,41,0,68.40049342105263,22.65625,7.771381578947369,1.1307565789473684,0.041118421052631575
54,서울특별시,노원구,하계2동,하계2동제1투,2192,1562,614,761,152,17,3,1547,15,630,39.68972204266322,49.19198448610213,9.825468648998061,1.098901098901099,0.19392372333548805
55,서울특별시,노원구,하계2동,하계2동제2투,1409,746,272,422,35,6,3,738,8,663,36.856368563685635,57.18157181571816,4.742547425474255,0.8130081300813009,0.40650406504065045
56,서울특별시,노원구,하계2동,하계2동제3투,2935,2376,1031,1055,248,25,1,2360,16,559,43.686440677966104,44.70338983050847,10.508474576271185,1.059322033898305,0.0423728813559322
57,서울특별시,노원구,하계2동,하계2동제4투,2567,2005,877,876,200,32,1,1986,19,562,44.15911379657603,44.10876132930513,10.070493454179255,1.6112789526686808,0.050352467270896276
58,서울특별시,노원구,하계2동,하계2동제5투,2765,2166,945,944,225,35,4,2153,13,599,43.89224338132838,43.84579656293544,10.450534138411518,1.625638643752903,0.18578727357176034
59,서울특별시,노원구,중계본동,관내사전투표,4008,4008,2851,747,331,42,2,3973,35,0,71.75937578655927,18.80191291215706,8.331235841933047,1.0571356657437703,0.05033979360684621
60,서울특별시,노원구,중계본동,중계본동제1투,2104,1519,584,732,162,27,0,1505,14,585,38.80398671096346,48.63787375415282,10.764119601328904,1.7940199335548173,0.0
61,서울특별시,노원구,중계본동,중계본동제2투,2306,1655,650,819,151,24,1,1645,10,651,39.51367781155015,49.787234042553195,9.179331306990882,1.458966565349544,0.060790273556231005
62,서울특별시,노원구,중계본동,중계본동제3투,1935,1477,639,634,163,30,2,1468,9,458,43.52861035422343,43.18801089918256,11.103542234332425,2.043596730245232,0.13623978201634876
63,서울특별시,노원구,중계본동,중계본동제4투,2538,1753,769,801,148,25,0,1743,10,785,44.11933448078027,45.955249569707405,8.49110728628801,1.4343086632243258,0.0
64,서울특별시,노원구,중계본동,중계본동제5투,2490,1890,737,903,211,27,3,1881,9,600,39.1812865497076,48.006379585326954,11.217437533227006,1.4354066985645932,0.1594896331738437
65,서울특별시,노원구,중계1동,관내사전투표,5500,5500,3784,1163,479,53,4,5483,17,0,69.01331387926317,21.21101586722597,8.736093379536749,0.9666241108882,0.07295276308590187
66,서울특별시,노원구,중계1동,중계1동제1투,2404,1691,701,787,163,23,3,1677,14,713,41.800834824090636,46.92903995229577,9.719737626714371,1.3714967203339297,0.17889087656529518
67,서울특별시,노원구,중계1동,중계1동제2투,2441,1710,739,769,158,26,1,1693,17,731,43.65032486709982,45.422327229769635,9.332545776727702,1.5357353809805079,0.05906674542232723
68,서울특별시,노원구,중계1동,중계1동제3투,2298,1748,718,815,178,24,1,1736,12,550,41.3594470046083,46.94700460829493,10.253456221198157,1.3824884792626728,0.0576036866359447
69,서울특별시,노원구,중계1동,중계1동제4투,2731,2119,900,948,228,26,1,2103,16,612,42.796005706134096,45.07845934379458,10.841654778887303,1.2363290537327627,0.0475511174512601
70,서울특별시,노원구,중계1동,중계1동제5투,2511,1883,733,868,242,22,2,1867,16,628,39.260846277450455,46.49169791108731,12.961971076593464,1.1783610069630424,0.10712372790573112
71,서울특별시,노원구,중계2·3동,관내사전투표,6698,6698,4523,1535,527,61,1,6647,51,0,68.04573491800812,23.093124717917856,7.928388746803069,0.9177072363472243,0.015044380923724988
72,서울특별시,노원구,중계2·3동,중계2·3동제1투,2252,1626,663,746,176,29,1,1615,11,626,41.05263157894737,46.191950464396285,10.897832817337463,1.7956656346749225,0.061919504643962855
73,서울특별시,노원구,중계2·3동,중계2·3동제2투,2441,1934,829,891,170,33,4,1927,7,507,43.02023871302543,46.23767514270887,8.822003113648158,1.7125064867669952,0.2075765438505449
74,서울특별시,노원구,중계2·3동,중계2·3동제3투,1891,1403,613,627,130,18,2,1390,13,488,44.100719424460436,45.10791366906475,9.352517985611511,1.2949640287769784,0.14388489208633093
75,서울특별시,노원구,중계2·3동,중계2·3동제4투,1947,1375,632,578,140,17,0,1367,8,572,46.23262618873446,42.282370153621066,10.241404535479152,1.2435991221653255,0.0
76,서울특별시,노원구,중계2·3동,중계2·3동제5투,1933,1274,479,642,124,18,0,1263,11,659,37.92557403008709,50.83135391923991,9.817893903404592,1.4251781472684086,0.0
77,서울특별시,노원구,중계2·3동,중계2·3동제6투,1927,1404,573,666,137,20,1,1397,7,523,41.01646385110952,47.67358625626342,9.806728704366499,1.4316392269148175,0.07158196134574087
78,서울특별시,노원구,중계2·3동,중계2·3동제7투,1663,1251,575,561,87,10,4,1237,14,412,46.483427647534356,45.35165723524656,7.033144704931285,0.8084074373484237,0.32336297493936944
79,서울특별시,노원구,중계2·3동,중계2·3동제8투,1811,1125,502,530,72,11,0,1115,10,686,45.02242152466368,47.53363228699551,6.457399103139013,0.9865470852017937,0.0
80,서울특별시,노원구,중계2·3동,중계2·3동제9투,1280,847,364,429,39,5,2,839,8,433,43.3849821215733,51.13230035756854,4.648390941597139,0.5959475566150179,0.23837902264600713
81,서울특별시,노원구,중계2·3동,중계2·3동제10투,1896,1190,437,665,73,7,1,1183,7,706,36.93998309382925,56.213017751479285,6.170752324598478,0.591715976331361,0.08453085376162299
82,서울특별시,노원구,중계4동,관내사전투표,4210,4210,2834,989,319,52,1,4195,15,0,67.55661501787843,23.575685339690107,7.604290822407628,1.2395709177592373,0.023837902264600714
83,서울특별시,노원구,중계4동,중계4동제1투,2726,1879,759,948,145,17,3,1872,7,847,40.544871794871796,50.641025641025635,7.745726495726496,0.9081196581196582,0.16025641025641024
84,서울특별시,노원구,중계4동,중계4동제2투,1925,1257,463,668,97,14,4,1246,11,668,37.15890850722312,53.6115569823435,7.784911717495987,1.1235955056179776,0.32102728731942215
85,서울특별시,노원구,중계4동,중계4동제3투,3186,2396,985,1097,261,39,1,2383,13,790,41.334452370960975,46.03441040704993,10.952580780528745,1.6365925304238356,0.0419639110365086
86,서울특별시,노원구,중계4동,중계4동제4투,2777,1949,838,902,166,25,0,1931,18,828,43.397203521491456,46.71154842050751,8.59658208182289,1.294665976178146,0.0
87,서울특별시,노원구,상계1동,관내사전투표,7841,7841,5217,1877,610,90,4,7798,43,0,66.9017696845345,24.070274429340856,7.822518594511413,1.1541420877147985,0.05129520389843549
88,서울특별시,노원구,상계1동,상계1동제1투,2832,1625,603,819,166,21,3,1612,13,1207,37.406947890818856,50.806451612903224,10.297766749379653,1.3027295285359801,0.18610421836228289
89,서울특별시,노원구,상계1동,상계1동제2투,2258,1512,622,700,161,20,0,1503,9,746,41.38389886892881,46.57351962741184,10.711909514304724,1.330671989354624,0.0
90,서울특별시,노원구,상계1동,상계1동제3투,2759,2032,840,925,216,33,3,2017,15,727,41.646008924144766,45.860188398611804,10.708973723351512,1.636093207734259,0.1487357461576599
91,서울특별시,노원구,상계1동,상계1동제4투,2296,1527,407,985,118,10,2,1522,5,769,26.741130091984232,64.71747700394218,7.752956636005257,0.657030223390276,0.1314060446780552
92,서울특별시,노원구,상계1동,상계1동제5투,2583,1801,772,831,156,23,2,1784,17,782,43.27354260089686,46.58071748878923,8.74439461883408,1.289237668161435,0.11210762331838565
93,서울특별시,노원구,상계1동,상계1동제6투,2379,1741,687,876,140,26,2,1731,10,638,39.68804159445407,50.60658578856152,8.087810514153668,1.5020219526285385,0.11554015020219525
94,서울특별시,노원구,상계1동,상계1동제7투,2469,1770,663,929,135,21,1,1749,21,699,37.9073756432247,53.116066323613495,7.718696397941681,1.2006861063464835,0.05717552887364208
95,서울특별시,노원구,상계1동,상계1동제8투,2837,2055,796,1010,211,23,3,2043,12,782,38.9623103279491,49.43710230053842,10.327949094468918,1.1257953989231522,0.14684287812041116
96,서울특별시,노원구,상계2동,관내사전투표,5624,5624,3579,1423,535,50,8,5595,29,0,63.96782841823057,25.43342269883825,9.562109025915996,0.8936550491510277,0.14298480786416443
97,서울특별시,노원구,상계2동,상계2동제1투,2444,1475,499,792,157,14,1,1463,12,969,34.107997265892,54.13533834586466,10.731373889268626,0.9569377990430622,0.0683526999316473
98,서울특별시,노원구,상계2동,상계2동제2투,2766,1801,607,972,186,26,0,1791,10,965,33.89168062534897,54.2713567839196,10.385259631490786,1.4517029592406476,0.0
99,서울특별시,노원구,상계2동,상계2동제3투,2613,1805,698,902,172,17,0,1789,16,808,39.016210173281166,50.419228619340416,9.614309670206818,0.9502515371716043,0.0
100,서울특별시,노원구,상계2동,상계2동제4투,2703,1976,734,980,226,23,3,1966,10,727,37.33468972533062,49.84740590030518,11.495422177009155,1.1698880976602237,0.1525940996948118
101,서울특별시,노원구,상계3·4동,관내사전투표,3890,3890,2656,965,226,25,0,3872,18,0,68.59504132231406,24.922520661157023,5.836776859504132,0.6456611570247934,0.0
102,서울특별시,노원구,상계3·4동,상계3·4동제1투,2786,1773,726,849,169,18,1,1763,10,1013,41.17980714690867,48.15655133295519,9.585933068633013,1.0209869540555871,0.05672149744753262
103,서울특별시,노원구,상계3·4동,상계3·4동제2투,2029,1627,829,594,163,33,1,1620,7,402,51.17283950617284,36.666666666666664,10.061728395061728,2.037037037037037,0.06172839506172839
104,서울특별시,노원구,상계3·4동,상계3·4동제3투,2360,1830,779,874,141,19,4,1817,13,530,42.87286736378646,48.10126582278481,7.760044028618602,1.0456796917996698,0.2201430930104568
105,서울특별시,노원구,상계3·4동,상계3·4동제4투,2185,1601,688,762,120,18,1,1589,12,584,43.29767149150409,47.95468848332284,7.551919446192574,1.1327879169288861,0.06293266205160479
106,서울특별시,노원구,상계3·4동,상계3·4동제5투,1571,986,376,518,77,9,0,980,6,585,38.36734693877551,52.85714285714286,7.857142857142857,0.9183673469387756,0.0
107,서울특별시,노원구,상계3·4동,상계3·4동제6투,2133,1602,570,839,154,26,3,1592,10,531,35.80402010050251,52.701005025125625,9.673366834170855,1.6331658291457287,0.18844221105527637
108,서울특별시,노원구,상계3·4동,상계3·4동제7투,3189,1757,624,970,141,11,1,1747,10,1432,35.71837435603892,55.52375500858615,8.070978820835718,0.6296508299942759,0.05724098454493417
109,서울특별시,노원구,상계5동,관내사전투표,5126,5126,3415,1233,378,54,6,5086,40,0,67.14510420762878,24.243020055053087,7.432166732206055,1.061738104600865,0.11797090051120723
110,서울특별시,노원구,상계5동,상계5동제1투,2009,1124,358,650,96,8,0,1112,12,885,32.194244604316545,58.45323741007194,8.633093525179856,0.7194244604316548,0.0
111,서울특별시,노원구,상계5동,상계5동제2투,2552,1824,720,900,173,18,2,1813,11,728,39.71318257032543,49.64147821290679,9.542195256480971,0.9928295642581356,0.11031439602868175
112,서울특별시,노원구,상계5동,상계5동제3투,1914,1197,445,643,86,16,0,1190,7,717,37.39495798319328,54.03361344537815,7.226890756302522,1.3445378151260505,0.0
113,서울특별시,노원구,상계5동,상계5동제4투,2450,1704,670,835,167,21,2,1695,9,746,39.52802359882006,49.26253687315634,9.852507374631267,1.238938053097345,0.11799410029498525
114,서울특별시,노원구,상계5동,상계5동제5투,2077,1415,562,683,139,17,3,1404,11,662,40.028490028490026,48.64672364672364,9.9002849002849,1.2108262108262107,0.2136752136752137
115,서울특별시,노원구,상계5동,상계5동제6투,2410,1657,655,838,132,18,1,1644,13,753,39.84184914841849,50.97323600973236,8.02919708029197,1.094890510948905,0.06082725060827251
116,서울특별시,노원구,상계6·7동,관내사전투표,5980,5980,4042,1206,600,81,5,5934,46,0,68.11594202898551,20.323559150657232,10.111223458038422,1.365015166835187,0.08426019548365353
117,서울특별시,노원구,상계6·7동,상계6·7동제1투,2436,1707,580,900,184,29,4,1697,10,729,34.17796110783736,53.03476723629935,10.842663523865644,1.7088980553918678,0.2357100766057749
118,서울특별시,노원구,상계6·7동,상계6·7동제2투,2541,1846,752,891,168,17,4,1832,14,695,41.04803493449782,48.635371179039296,9.170305676855897,0.9279475982532752,0.21834061135371177
119,서울특별시,노원구,상계6·7동,상계6·7동제3투,2577,1937,831,890,179,20,2,1922,15,640,43.23621227887617,46.30593132154006,9.31321540062435,1.040582726326743,0.10405827263267431
120,서울특별시,노원구,상계6·7동,상계6·7동제4투,3059,2284,1006,1015,223,19,1,2264,20,775,44.434628975265014,44.832155477031804,9.849823321554771,0.8392226148409895,0.044169611307420496
121,서울특별시,노원구,상계6·7동,상계6·7동제5투,2751,2022,755,1029,185,29,6,2004,18,729,37.6746506986028,51.34730538922155,9.231536926147704,1.4471057884231537,0.29940119760479045
122,서울특별시,노원구,상계6·7동,상계6·7동제6투,2630,1771,717,864,146,22,1,1750,21,859,40.97142857142857,49.371428571428574,8.342857142857143,1.2571428571428571,0.05714285714285715
123,서울특별시,노원구,상계6·7동,상계6·7동제7투,2612,2027,824,953,213,26,2,2018,9,585,40.83250743310208,47.22497522299306,10.555004955401387,1.288404360753221,0.09910802775024777
124,서울특별시,노원구,상계8동,관내사전투표,4711,4711,3168,970,501,46,6,4691,20,0,67.5335749307184,20.67789383926668,10.680025580899596,0.9806011511404817,0.12790449797484546
125,서울특별시,노원구,상계8동,상계8동제1투,1971,1403,553,671,145,24,1,1394,9,568,39.6700143472023,48.13486370157819,10.401721664275467,1.721664275466284,0.07173601147776185
126,서울특별시,노원구,상계8동,상계8동제2투,2549,1912,828,854,193,24,1,1900,12,637,43.57894736842105,44.94736842105263,10.157894736842104,1.263157894736842,0.05263157894736842
127,서울특별시,노원구,상계8동,상계8동제3투,2310,1689,653,847,156,19,0,1675,14,621,38.985074626865675,50.56716417910447,9.313432835820896,1.1343283582089554,0.0
128,서울특별시,노원구,상계8동,상계8동제4투,1630,1224,457,474,257,21,1,1210,14,406,37.768595041322314,39.17355371900826,21.2396694214876,1.7355371900826446,0.08264462809917356
129,서울특별시,노원구,상계8동,상계8동제5투,2322,1741,726,812,173,15,0,1726,15,581,42.06257242178447,47.04519119351101,10.023174971031287,0.869061413673233,0.0
130,서울특별시,노원구,상계9동,관내사전투표,4677,4677,3099,1042,449,69,3,4662,15,0,66.47361647361647,22.35092235092235,9.631059631059632,1.4800514800514801,0.06435006435006435
131,서울특별시,노원구,상계9동,상계9동제1투,2331,1639,545,868,195,18,1,1627,12,692,33.49723417332513,53.34972341733252,11.985248924400738,1.1063306699446833,0.06146281499692685
132,서울특별시,노원구,상계9동,상계9동제2투,2654,1969,667,1031,226,30,2,1956,13,685,34.100204498977504,52.70961145194274,11.554192229038856,1.5337423312883436,0.10224948875255625
133,서울특별시,노원구,상계9동,상계9동제3투,2550,1896,721,950,183,32,0,1886,10,654,38.229056203605516,50.37115588547189,9.703075291622481,1.6967126193001063,0.0
134,서울특별시,노원구,상계9동,상계9동제4투,2962,2189,925,997,231,17,3,2173,16,773,42.56787850897376,45.881270133456056,10.630464795213989,0.7823285780027611,0.13805798435342845
135,서울특별시,노원구,상계10동,관내사전투표,4463,4462,2880,1088,434,44,3,4449,13,1,64.73364801078894,24.454933692964712,9.755001123848055,0.9889862890537199,0.06743088334457181
136,서울특별시,노원구,상계10동,상계10동제1투,2211,1555,439,937,139,24,1,1540,15,656,28.50649350649351,60.84415584415584,9.025974025974026,1.5584415584415585,0.06493506493506493
137,서울특별시,노원구,상계10동,상계10동제2투,2259,1608,589,797,178,21,2,1587,21,651,37.114051669817265,50.22054190296156,11.216131064902331,1.3232514177693762,0.1260239445494644
138,서울특별시,노원구,상계10동,상계10동제3투,2859,2143,804,1023,268,32,2,2129,14,716,37.76420854861438,48.05072804133396,12.588069516204792,1.5030530765617662,0.09394081728511039
139,서울특별시,노원구,상계10동,상계10동제4투,2291,1646,650,787,179,16,3,1635,11,645,39.75535168195719,48.13455657492355,10.948012232415902,0.9785932721712538,0.1834862385321101
140,서울특별시,노원구,잘못 투입·구분된 투표지,,0,0,0,0,0,0,0,0,0,0,0.0,0.0,0.0,0.0,0.0
0,서울특별시,은평구,거소·선상투표,,905,854,412,235,122,21,15,805,49,51,51.18012422360248,29.19254658385093,15.15527950310559,2.608695652173913,1.8633540372670807
1,서울특별시,은평구,관외사전투표,,46524,46519,29115,10260,5746,857,40,46018,501,5,63.2687209352862,22.295623451692816,12.486418358033813,1.8623147464035812,0.08692250858359772
2,서울특별시,은평구,재외투표,,3406,2715,1872,551,220,52,2,2697,18,691,69.41045606229143,20.43010752688172,8.157211716722285,1.92806822395254,0.07415647015202076
3,서울특별시,은평구,녹번동,관내사전투표,7743,7742,5183,1819,575,98,2,7677,65,1,67.51335156962355,23.694151361208807,7.489904910772436,1.2765403152273025,0.02605184316790413
4,서울특별시,은평구,녹번동,녹번동제1투,2594,1572,633,722,165,31,2,1553,19,1022,40.7598197037991,46.490663232453315,10.624597553122987,1.9961365099806825,0.128783000643915
5,서울특별시,은평구,녹번동,녹번동제2투,3013,2216,771,1176,220,30,3,2200,16,797,35.04545454545455,53.45454545454545,10.0,1.3636363636363635,0.13636363636363638
6,서울특별시,은평구,녹번동,녹번동제3투,2792,1661,696,780,134,28,1,1639,22,1131,42.46491763270287,47.58999389871873,8.175716900549116,1.7083587553386212,0.06101281269066504
7,서울특별시,은평구,녹번동,녹번동제4투,2544,1535,548,824,133,16,4,1525,10,1009,35.9344262295082,54.0327868852459,8.721311475409836,1.0491803278688525,0.26229508196721313
8,서울특별시,은평구,녹번동,녹번동제5투,3135,2321,843,1241,190,30,3,2307,14,814,36.54096228868661,53.792804508019074,8.2358040745557,1.3003901170351104,0.13003901170351106
9,서울특별시,은평구,녹번동,녹번동제6투,2686,1572,600,817,115,24,0,1556,16,1114,38.56041131105398,52.50642673521851,7.3907455012853465,1.5424164524421593,0.0
10,서울특별시,은평구,녹번동,녹번동제7투,2831,1879,770,909,159,27,2,1867,12,952,41.24263524370648,48.68773433315479,8.516336368505623,1.44617032672737,0.10712372790573112
11,서울특별시,은평구,응암제1동,관내사전투표,6551,6551,4473,1507,435,85,3,6503,48,0,68.78363832077503,23.17391972935568,6.689220359833922,1.307089035829617,0.046132554205751186
12,서울특별시,은평구,응암제1동,응암제1동제1투,2453,1502,586,743,138,17,1,1485,17,951,39.46127946127946,50.03367003367003,9.292929292929292,1.144781144781145,0.06734006734006734
13,서울특별시,은평구,응암제1동,응암제1동제2투,1960,1483,619,676,152,20,1,1468,15,477,42.166212534059945,46.049046321525886,10.354223433242508,1.3623978201634876,0.06811989100817438
14,서울특별시,은평구,응암제1동,응암제1동제3투,2827,1817,726,875,177,21,4,1803,14,1010,40.26622296173045,48.530227398779815,9.816971713810316,1.1647254575707155,0.22185246810870773
15,서울특별시,은평구,응암제1동,응암제1동제4투,3772,2516,1049,1183,209,46,4,2491,25,1256,42.111601766358895,47.49096748293858,8.390204737053391,1.846647932557206,0.16057808109193095
16,서울특별시,은평구,응암제1동,응암제1동제5투,3092,2053,874,932,170,50,3,2029,24,1039,43.075406604238545,45.933957614588465,8.378511582060128,2.464268112370626,0.14785608674223755
17,서울특별시,은평구,응암제1동,응암제1동제6투,3483,2692,1067,1282,287,29,0,2665,27,791,40.0375234521576,48.10506566604128,10.76923076923077,1.0881801125703565,0.0
18,서울특별시,은평구,응암제2동,관내사전투표,4565,4565,3163,981,327,67,1,4539,26,0,69.68495263273849,21.612690019828158,7.204230006609386,1.476096056400088,0.02203128442388191
19,서울특별시,은평구,응암제2동,응암제2동제1투,1888,1227,511,579,90,29,2,1211,16,661,42.19653179190752,47.811725846407924,7.431874483897605,2.3947151114781176,0.16515276630883566
20,서울특별시,은평구,응암제2동,응암제2동제2투,2617,1903,806,904,161,20,2,1893,10,714,42.577918647649234,47.754886423666136,8.505018489170629,1.0565240359218173,0.10565240359218173
21,서울특별시,은평구,응암제2동,응암제2동제3투,2347,1747,676,865,172,29,1,1743,4,600,38.78370625358577,49.62707974756167,9.868043602983361,1.663798049340218,0.05737234652897303
22,서울특별시,은평구,응암제2동,응암제2동제4투,2841,2117,920,968,184,31,5,2108,9,724,43.643263757115754,45.920303605313094,8.72865275142315,1.4705882352941175,0.23719165085388993
23,서울특별시,은평구,응암제2동,응암제2동제5투,2248,1232,462,646,95,22,0,1225,7,1016,37.714285714285715,52.73469387755102,7.755102040816326,1.7959183673469388,0.0
24,서울특별시,은평구,응암제2동,응암제2동제6투,1736,1286,482,655,125,19,0,1281,5,450,37.62685402029664,51.13192818110851,9.758001561280249,1.483216237314598,0.0
25,서울특별시,은평구,응암제3동,관내사전투표,7501,7501,5156,1754,445,97,8,7460,41,0,69.11528150134049,23.512064343163537,5.96514745308311,1.3002680965147453,0.10723860589812334
26,서울특별시,은평구,응암제3동,응암제3동제1투,2464,1515,611,732,141,20,2,1506,9,949,40.571049136786186,48.60557768924303,9.362549800796813,1.3280212483399734,0.13280212483399734
27,서울특별시,은평구,응암제3동,응암제3동제2투,2591,1563,620,789,122,16,2,1549,14,1028,40.02582311168496,50.936087798579734,7.876049063912201,1.0329244673983213,0.12911555842479017
28,서울특별시,은평구,응암제3동,응암제3동제3투,2603,1543,627,747,123,27,4,1528,15,1060,41.03403141361257,48.88743455497382,8.049738219895287,1.7670157068062828,0.2617801047120419
29,서울특별시,은평구,응암제3동,응암제3동제4투,1598,850,325,441,65,8,1,840,10,748,38.69047619047619,52.5,7.738095238095238,0.9523809523809524,0.11904761904761905
30,서울특별시,은평구,응암제3동,응암제3동제5투,1849,1154,474,557,99,12,1,1143,11,695,41.46981627296588,48.731408573928256,8.661417322834646,1.0498687664041995,0.08748906386701663
31,서울특별시,은평구,응암제3동,응암제3동제6투,2177,1358,590,644,94,17,0,1345,13,819,43.866171003717476,47.88104089219331,6.988847583643122,1.2639405204460967,0.0
32,서울특별시,은평구,역촌동,관내사전투표,10710,10710,7492,2255,737,153,3,10640,70,0,70.41353383458646,21.19360902255639,6.926691729323309,1.4379699248120301,0.028195488721804513
33,서울특별시,은평구,역촌동,역촌동제1투,2657,1531,608,763,128,19,2,1520,11,1126,40.0,50.19736842105264,8.421052631578947,1.25,0.13157894736842105
34,서울특별시,은평구,역촌동,역촌동제2투,2818,1837,787,846,155,34,2,1824,13,981,43.146929824561404,46.381578947368425,8.49780701754386,1.8640350877192982,0.10964912280701754
35,서울특별시,은평구,역촌동,역촌동제3투,3200,2146,931,977,178,38,2,2126,20,1054,43.79115710253998,45.95484477892756,8.372530573847602,1.7873941674506115,0.09407337723424271
36,서울특별시,은평구,역촌동,역촌동제4투,2993,1882,780,917,137,35,2,1871,11,1111,41.68893639764832,49.01122394441475,7.322287546766434,1.870657402458578,0.10689470871191875
37,서울특별시,은평구,역촌동,역촌동제5투,2226,1372,538,678,129,18,1,1364,8,854,39.44281524926686,49.70674486803519,9.457478005865102,1.3196480938416422,0.07331378299120235
38,서울특별시,은평구,역촌동,역촌동제6투,2220,1416,613,666,102,23,2,1406,10,804,43.598862019914655,47.368421052631575,7.254623044096728,1.6358463726884778,0.1422475106685633
39,서울특별시,은평구,역촌동,역촌동제7투,2523,1635,674,789,124,29,4,1620,15,888,41.604938271604944,48.7037037037037,7.654320987654321,1.7901234567901234,0.24691358024691357
40,서울특별시,은평구,역촌동,역촌동제8투,2953,1892,814,887,146,26,0,1873,19,1061,43.45969033635878,47.35718099305926,7.794981313400962,1.388147357180993,0.0
41,서울특별시,은평구,역촌동,역촌동제9투,3359,2193,952,1008,184,37,0,2181,12,1166,43.649701971572675,46.217331499312245,8.436497019715727,1.6964695093993583,0.0
42,서울특별시,은평구,신사제1동,관내사전투표,8451,8451,5793,1969,530,108,7,8407,44,0,68.9068633281789,23.42095872487213,6.304270250981325,1.2846437492565719,0.08326394671107411
43,서울특별시,은평구,신사제1동,신사제1동제1투,2924,1837,732,901,161,28,3,1825,12,1087,40.10958904109589,49.36986301369863,8.821917808219178,1.5342465753424657,0.16438356164383564
44,서울특별시,은평구,신사제1동,신사제1동제2투,2689,1760,653,904,158,24,2,1741,19,929,37.507179781734635,51.92418150488225,9.075244112578977,1.3785180930499714,0.11487650775416428
45,서울특별시,은평구,신사제1동,신사제1동제3투,2850,1815,718,893,144,34,4,1793,22,1035,40.04461795872839,49.8047964305633,8.031232571109872,1.8962632459564976,0.2230897936419409
46,서울특별시,은평구,신사제1동,신사제1동제4투,2277,1439,586,686,140,20,1,1433,6,838,40.893230983949756,47.87159804605722,9.769713886950454,1.3956734124214933,0.06978367062107467
47,서울특별시,은평구,신사제1동,신사제1동제5투,3020,2088,853,1024,159,28,5,2069,19,932,41.22764620589657,49.49250845819236,7.6848719188013535,1.3533107781536975,0.2416626389560174
48,서울특별시,은평구,신사제2동,관내사전투표,2998,2998,2036,764,152,34,2,2988,10,0,68.13922356091031,25.568942436412318,5.087014725568943,1.1378848728246318,0.06693440428380187
49,서울특별시,은평구,신사제2동,신사제2동제1투,2010,1285,507,612,126,24,3,1272,13,725,39.85849056603774,48.113207547169814,9.90566037735849,1.8867924528301887,0.2358490566037736
50,서울특별시,은평구,신사제2동,신사제2동제2투,2382,1631,665,799,125,29,1,1619,12,751,41.07473749227918,49.351451513279805,7.720815318097592,1.7912291537986413,0.06176652254478073
51,서울특별시,은평구,신사제2동,신사제2동제3투,2453,1469,676,635,105,32,5,1453,16,984,46.5244322092223,43.702684101858225,7.226428079834825,2.202339986235375,0.3441156228492774
52,서울특별시,은평구,신사제2동,신사제2동제4투,1720,1196,485,606,76,20,0,1187,9,524,40.85930918281382,51.0530749789385,6.402695871946082,1.6849199663016006,0.0
53,서울특별시,은평구,신사제2동,신사제2동제5투,1911,1271,435,678,135,14,1,1263,8,640,34.441805225653205,53.681710213776725,10.688836104513063,1.1084718923198733,0.0791765637371338
54,서울특별시,은평구,증산동,관내사전투표,3906,3906,2604,974,253,50,1,3882,24,0,67.07882534775888,25.090159711488923,6.517259144770737,1.287995878413189,0.025759917568263783
55,서울특별시,은평구,증산동,증산동제1투,1944,1253,453,671,97,18,1,1240,13,691,36.53225806451613,54.112903225806456,7.822580645161291,1.4516129032258065,0.08064516129032258
56,서울특별시,은평구,증산동,증산동제2투,1138,737,269,389,60,11,0,729,8,401,36.89986282578875,53.360768175583,8.23045267489712,1.5089163237311385,0.0
57,서울특별시,은평구,증산동,증산동제3투,2227,1502,539,796,142,20,1,1498,4,725,35.981308411214954,53.13751668891856,9.479305740987984,1.335113484646195,0.06675567423230974
58,서울특별시,은평구,증산동,증산동제4투,2913,2300,950,1020,272,41,0,2283,17,613,41.61191414805081,44.678055190538764,11.914148050810338,1.7958826106000876,0.0
59,서울특별시,은평구,수색동,관내사전투표,5099,5099,3352,1206,454,54,3,5069,30,0,66.12744130992306,23.7916748865654,8.956401657131584,1.0652988755178536,0.05918327086210298
60,서울특별시,은평구,수색동,수색동제1투,2126,1433,477,747,168,24,1,1417,16,693,33.662667607621735,52.71700776287932,11.856033874382499,1.6937191249117856,0.07057163020465773
61,서울특별시,은평구,수색동,수색동제2투,2352,1656,530,915,167,32,1,1645,11,696,32.21884498480243,55.62310030395137,10.151975683890578,1.9452887537993921,0.060790273556231005
62,서울특별시,은평구,수색동,수색동제3투,2106,1575,626,777,132,21,6,1562,13,531,40.07682458386684,49.74391805377721,8.450704225352112,1.3444302176696543,0.3841229193341869
63,서울특별시,은평구,수색동,수색동제4투,4323,3239,1223,1580,367,42,2,3214,25,1084,38.0522713130056,49.159925326695706,11.418792781580585,1.3067828251400124,0.06222775357809583
64,서울특별시,은평구,불광제1동,관내사전투표,8626,8626,5695,2039,687,136,3,8560,66,0,66.5303738317757,23.820093457943926,8.02570093457944,1.588785046728972,0.035046728971962614
65,서울특별시,은평구,불광제1동,불광제1동제1투,2500,1568,559,804,164,23,0,1550,18,932,36.064516129032256,51.87096774193548,10.580645161290322,1.4838709677419355,0.0
66,서울특별시,은평구,불광제1동,불광제1동제2투,3190,2359,830,1297,174,41,4,2346,13,831,35.37936913895993,55.285592497868706,7.41687979539642,1.7476555839727195,0.17050298380221654
67,서울특별시,은평구,불광제1동,불광제1동제3투,2207,1353,527,703,97,14,3,1344,9,854,39.211309523809526,52.30654761904761,7.217261904761904,1.0416666666666665,0.2232142857142857
68,서울특별시,은평구,불광제1동,불광제1동제4투,2204,1796,590,998,184,14,1,1787,9,408,33.016228315612764,55.84778959149412,10.29658645775042,0.783435926133184,0.05595970900951316
69,서울특별시,은평구,불광제1동,불광제1동제5투,3207,2358,968,1143,197,34,2,2344,14,849,41.29692832764505,48.762798634812285,8.404436860068259,1.4505119453924915,0.08532423208191127
70,서울특별시,은평구,불광제1동,불광제1동제6투,2330,1635,722,739,143,18,1,1623,12,695,44.485520640788664,45.53296364756624,8.810844115834874,1.1090573012939002,0.06161429451632779
71,서울특별시,은평구,불광제1동,불광제1동제7투,4085,2905,1122,1453,269,34,3,2881,24,1180,38.944810829573065,50.43387712599792,9.337035751475183,1.1801457827143353,0.10413051023950018
72,서울특별시,은평구,불광제1동,불광제1동제8투,2670,1762,769,815,132,28,4,1748,14,908,43.993135011441645,46.62471395881007,7.551487414187644,1.6018306636155606,0.2288329519450801
73,서울특별시,은평구,불광제2동,관내사전투표,5513,5513,3790,1347,287,57,4,5485,28,0,69.0975387420237,24.557885141294438,5.232452142206016,1.0391978122151322,0.07292616226071104
74,서울특별시,은평구,불광제2동,불광제2동제1투,2011,1213,415,660,112,15,1,1203,10,798,34.49709060681629,54.862842892768086,9.310058187863675,1.2468827930174564,0.0831255195344971
75,서울특별시,은평구,불광제2동,불광제2동제2투,2358,1482,601,723,127,17,3,1471,11,876,40.85656016315431,49.150237933378655,8.633582596872875,1.1556764106050306,0.20394289598912305
76,서울특별시,은평구,불광제2동,불광제2동제3투,2397,1391,556,687,109,17,2,1371,20,1006,40.55433989788476,50.10940919037199,7.950401167031364,1.2399708242159009,0.14587892049598833
77,서울특별시,은평구,불광제2동,불광제2동제4투,2062,1240,428,692,91,14,3,1228,12,822,34.85342019543974,56.35179153094463,7.41042345276873,1.1400651465798046,0.24429967426710095
78,서울특별시,은평구,불광제2동,불광제2동제5투,2432,1582,648,778,129,14,2,1571,11,850,41.247612985359645,49.52259707192871,8.211330362826226,0.8911521323997454,0.1273074474856779
79,서울특별시,은평구,불광제2동,불광제2동제6투,2211,1500,613,771,97,7,0,1488,12,711,41.196236559139784,51.81451612903226,6.518817204301075,0.47043010752688175,0.0
80,서울특별시,은평구,불광제2동,불광제2동제7투,2394,1626,678,802,111,25,1,1617,9,768,41.929499072356215,49.598021026592455,6.8645640074211505,1.5460729746444033,0.06184291898577613
81,서울특별시,은평구,갈현제1동,관내사전투표,3960,3960,2654,985,248,41,4,3932,28,0,67.49745676500508,25.050864699898273,6.3072227873855535,1.0427263479145472,0.10172939979654119
82,서울특별시,은평구,갈현제1동,갈현제1동제1투,2538,1533,578,797,126,20,0,1521,12,1005,38.00131492439185,52.39973701512163,8.284023668639055,1.314924391847469,0.0
83,서울특별시,은평구,갈현제1동,갈현제1동제2투,2236,1373,513,742,93,17,0,1365,8,863,37.582417582417584,54.35897435897436,6.813186813186813,1.2454212454212454,0.0
84,서울특별시,은평구,갈현제1동,갈현제1동제3투,2977,1869,669,989,168,22,4,1852,17,1108,36.1231101511879,53.40172786177105,9.071274298056156,1.187904967602592,0.21598272138228944
85,서울특별시,은평구,갈현제2동,관내사전투표,6584,6583,4436,1493,501,93,5,6528,55,1,67.95343137254902,22.870710784313726,7.674632352941177,1.4246323529411764,0.07659313725490197
86,서울특별시,은평구,갈현제2동,갈현제2동제1투,3118,1908,749,920,192,23,3,1887,21,1210,39.69263381028087,48.75463698993111,10.174880763116057,1.2188659247482776,0.1589825119236884
87,서울특별시,은평구,갈현제2동,갈현제2동제2투,3332,2168,905,1053,157,26,3,2144,24,1164,42.21082089552239,49.11380597014926,7.322761194029851,1.212686567164179,0.13992537313432835
88,서울특별시,은평구,갈현제2동,갈현제2동제3투,3116,1932,848,867,163,38,3,1919,13,1184,44.18968212610735,45.17978113600834,8.494007295466389,1.9801980198019802,0.1563314226159458
89,서울특별시,은평구,갈현제2동,갈현제2동제4투,3216,2025,875,951,152,25,3,2006,19,1191,43.619142572283145,47.40777666999003,7.577268195413758,1.2462612163509472,0.14955134596211367
90,서울특별시,은평구,갈현제2동,갈현제2동제5투,2528,1694,652,849,154,24,1,1680,14,834,38.80952380952381,50.535714285714285,9.166666666666666,1.4285714285714286,0.05952380952380953
91,서울특별시,은평구,구산동,관내사전투표,6864,6863,4768,1497,441,109,3,6818,45,1,69.93253153417425,21.956585508946905,6.46817248459959,1.5987092989146376,0.04400117336462305
92,서울특별시,은평구,구산동,구산동제1투,3019,1823,711,913,149,25,1,1799,24,1196,39.52195664257921,50.75041689827682,8.282379099499721,1.3896609227348526,0.055586436909394105
93,서울특별시,은평구,구산동,구산동제2투,3483,2351,1064,1049,178,37,3,2331,20,1132,45.645645645645644,45.002145002145,7.636207636207636,1.5873015873015872,0.1287001287001287
94,서울특별시,은평구,구산동,구산동제3투,2800,1591,694,721,123,27,2,1567,24,1209,44.288449266113595,46.01148691767709,7.849393746011486,1.723037651563497,0.12763241863433314
95,서울특별시,은평구,구산동,구산동제4투,1977,1223,541,535,112,24,3,1215,8,754,44.52674897119341,44.03292181069959,9.218106995884774,1.9753086419753085,0.24691358024691357
96,서울특별시,은평구,구산동,구산동제5투,2951,1924,774,952,156,22,4,1908,16,1027,40.56603773584906,49.895178197064986,8.176100628930817,1.1530398322851152,0.20964360587002098
97,서울특별시,은평구,구산동,구산동제6투,2905,1898,708,1034,114,23,1,1880,18,1007,37.659574468085104,55.00000000000001,6.0638297872340425,1.2234042553191489,0.05319148936170213
98,서울특별시,은평구,대조동,관내사전투표,6340,6340,4241,1478,460,105,4,6288,52,0,67.44592875318067,23.505089058524174,7.315521628498728,1.6698473282442747,0.06361323155216285
99,서울특별시,은평구,대조동,대조동제1투,3451,2168,794,1052,252,42,3,2143,25,1283,37.050863275781616,49.09006066262249,11.759216052263183,1.959869342043864,0.1399906672888474
100,서울특별시,은평구,대조동,대조동제2투,2943,1840,755,882,146,36,3,1822,18,1103,41.437980241492866,48.40834248079034,8.01317233809001,1.9758507135016465,0.1646542261251372
101,서울특별시,은평구,대조동,대조동제3투,1984,1309,511,661,105,19,0,1296,13,675,39.42901234567901,51.00308641975309,8.101851851851851,1.4660493827160492,0.0
102,서울특별시,은평구,대조동,대조동제4투,1671,1244,457,523,217,28,2,1227,17,427,37.245313773431135,42.62428687856561,17.685411572942137,2.28198859005705,0.16299918500407498
103,서울특별시,은평구,대조동,대조동제5투,2857,1844,766,857,176,25,0,1824,20,1013,41.99561403508772,46.984649122807014,9.649122807017543,1.3706140350877192,0.0
104,서울특별시,은평구,대조동,대조동제6투,2804,1788,752,844,135,36,4,1771,17,1016,42.46188594014681,47.656691134952005,7.6228119706380575,2.0327498588368154,0.2258610954263128
105,서울특별시,은평구,진관동,관내사전투표,11068,11068,7493,2480,830,193,6,11002,66,0,68.10579894564624,22.541356117069625,7.544082894019269,1.7542265042719507,0.05453553899291039
106,서울특별시,은평구,진관동,진관동제1투,2585,1978,772,1008,155,27,3,1965,13,607,39.287531806615775,51.29770992366412,7.888040712468193,1.3740458015267176,0.15267175572519084
107,서울특별시,은평구,진관동,진관동제2투,2872,2232,931,1057,190,39,2,2219,13,640,41.95583596214511,47.63406940063091,8.562415502478595,1.757548445245606,0.09013068949977468
108,서울특별시,은평구,진관동,진관동제3투,2298,1740,735,838,129,27,4,1733,7,558,42.41200230813618,48.355452971725335,7.443739180611655,1.5579919215233697,0.2308136180034622
109,서울특별시,은평구,진관동,진관동제4투,2364,1714,606,923,134,32,2,1697,17,650,35.7100766057749,54.39010017678255,7.896287566293458,1.8856806128461991,0.11785503830288745
110,서울특별시,은평구,진관동,진관동제5투,2087,1513,599,746,133,29,1,1508,5,574,39.721485411140584,49.46949602122016,8.819628647214854,1.9230769230769231,0.0663129973474801
111,서울특별시,은평구,진관동,진관동제6투,2589,1878,697,1001,137,26,4,1865,13,711,37.37265415549598,53.67292225201072,7.345844504021448,1.394101876675603,0.21447721179624668
112,서울특별시,은평구,진관동,진관동제7투,2187,1590,584,849,131,22,1,1587,3,597,36.7989918084436,53.497164461247635,8.254568367989918,1.3862633900441084,0.0630119722747322
113,서울특별시,은평구,진관동,진관동제8투,2449,1853,725,973,123,21,1,1843,10,596,39.33803581117743,52.79435702658709,6.673901247965273,1.1394465545306565,0.05425935973955508
114,서울특별시,은평구,진관동,진관동제9투,3140,2397,1084,1036,212,37,2,2371,26,743,45.71910586250527,43.69464361029102,8.941374947279629,1.5605229860818222,0.08435259384226065
115,서울특별시,은평구,진관동,진관동제10투,2850,2133,1027,836,214,34,1,2112,21,717,48.62689393939394,39.58333333333333,10.132575757575758,1.6098484848484849,0.04734848484848485
116,서울특별시,은평구,진관동,진관동제11투,2435,1561,626,670,213,27,1,1537,24,874,40.72869225764476,43.59141184124919,13.858165256994145,1.756668835393624,0.06506180871828238
117,서울특별시,은평구,잘못 투입·구분된 투표지,,0,4,1,1,1,0,0,3,1,-4,33.33333333333333,33.33333333333333,33.33333333333333,0.0,0.0
0,서울특별시,서대문구,거소·선상투표,,329,315,145,109,53,4,0,311,4,14,46.62379421221865,35.048231511254016,17.041800643086816,1.2861736334405145,0.0
1,서울특별시,서대문구,관외사전투표,,33737,33730,20238,7825,4585,700,23,33371,359,7,60.645470618201436,23.448503191393723,13.739474393934852,2.0976296784633366,0.06892211800665247
2,서울특별시,서대문구,재외투표,,3020,2403,1655,457,219,58,1,2390,13,617,69.24686192468619,19.121338912133893,9.163179916317992,2.426778242677824,0.04184100418410042
3,서울특별시,서대문구,충현동,관내사전투표,2529,2529,1711,593,180,27,3,2514,15,0,68.05887032617342,23.587907716786,7.159904534606206,1.0739856801909307,0.11933174224343676
4,서울특별시,서대문구,충현동,충현동제1투,2312,1410,495,777,118,12,0,1402,8,902,35.30670470756063,55.42082738944365,8.416547788873038,0.8559201141226819,0.0
5,서울특별시,서대문구,충현동,충현동제2투,1686,1119,344,642,107,15,1,1109,10,567,31.01893597835888,57.889990982867445,9.648331830477908,1.3525698827772767,0.09017132551848511
6,서울특별시,서대문구,충현동,충현동제3투,2492,1882,701,944,194,31,1,1871,11,610,37.46659540352753,50.45430251202565,10.36878674505612,1.6568679850347405,0.053447354355959376
7,서울특별시,서대문구,충현동,충현동제4투,2346,1636,623,796,171,24,3,1617,19,710,38.52813852813853,49.2269635126778,10.575139146567718,1.4842300556586272,0.1855287569573284
8,서울특별시,서대문구,충현동,충현동제5투,2387,1636,603,797,194,33,0,1627,9,751,37.0620774431469,48.985863552550704,11.92378610940381,2.028272894898586,0.0
9,서울특별시,서대문구,천연동,관내사전투표,3759,3759,2444,930,288,70,1,3733,26,0,65.4701312617198,24.912938655237074,7.714974551299224,1.8751674256630058,0.026788106080900084
10,서울특별시,서대문구,천연동,천연동제1투,1909,1285,396,738,115,19,1,1269,16,624,31.20567375886525,58.156028368794324,9.062253743104808,1.4972419227738378,0.07880220646178093
11,서울특별시,서대문구,천연동,천연동제2투,2273,1650,668,808,146,17,0,1639,11,623,40.75655887736425,49.298352654057354,8.907870652837095,1.0372178157413057,0.0
12,서울특별시,서대문구,천연동,천연동제3투,2105,1508,585,756,137,20,0,1498,10,597,39.0520694259012,50.467289719626166,9.145527369826436,1.335113484646195,0.0
13,서울특별시,서대문구,천연동,천연동제4투,443,335,144,153,22,13,0,332,3,108,43.373493975903614,46.08433734939759,6.626506024096386,3.91566265060241,0.0
14,서울특별시,서대문구,천연동,천연동제5투,2498,1912,694,990,169,41,4,1898,14,586,36.56480505795574,52.160168598524756,8.904109589041095,2.1601685985247627,0.21074815595363539
15,서울특별시,서대문구,북아현동,관내사전투표,4113,4113,2628,1043,356,64,0,4091,22,0,64.2385724761672,25.494989000244438,8.70202884380347,1.5644096797848936,0.0
16,서울특별시,서대문구,북아현동,북아현동제1투,3185,1996,712,1068,178,23,1,1982,14,1189,35.92330978809283,53.884964682139255,8.980827447023207,1.160443995963673,0.050454086781029264
17,서울특별시,서대문구,북아현동,북아현동제2투,2455,1804,625,920,214,26,2,1787,17,651,34.97481813094572,51.4829322887521,11.975377728035815,1.4549524342473419,0.11191941801902631
18,서울특별시,서대문구,북아현동,북아현동제3투,2770,2060,685,1073,247,41,1,2047,13,710,33.46360527601368,52.418172936003906,12.066438690766976,2.0029311187103076,0.048851978505129456
19,서울특별시,서대문구,신촌동,관내사전투표,3690,3689,2189,686,654,118,3,3650,39,1,59.97260273972602,18.794520547945208,17.917808219178085,3.232876712328767,0.08219178082191782
20,서울특별시,서대문구,신촌동,신촌동제1투,1764,1150,402,588,114,31,0,1135,15,614,35.41850220264317,51.80616740088105,10.044052863436123,2.7312775330396475,0.0
21,서울특별시,서대문구,신촌동,신촌동제2투,3138,2206,836,1023,271,53,0,2183,23,932,38.295923041685754,46.862116353641774,12.414109024278517,2.4278515803939533,0.0
22,서울특별시,서대문구,신촌동,신촌동제3투,2447,1375,424,686,222,23,0,1355,20,1072,31.29151291512915,50.627306273062736,16.383763837638377,1.6974169741697416,0.0
23,서울특별시,서대문구,신촌동,신촌동제4투,2762,1817,497,853,395,38,1,1784,33,945,27.858744394618835,47.813901345291484,22.141255605381165,2.130044843049327,0.05605381165919283
24,서울특별시,서대문구,신촌동,신촌동제5투,2403,1501,520,741,183,32,2,1478,23,902,35.182679296346414,50.13531799729364,12.381596752368065,2.165087956698241,0.13531799729364005
25,서울특별시,서대문구,연희동,관내사전투표,5032,5032,3186,1182,483,133,3,4987,45,0,63.88610387006216,23.70162422297975,9.68518147182675,2.6669340284740324,0.060156406657309
26,서울특별시,서대문구,연희동,연희동제1투,2531,1482,450,846,131,34,1,1462,20,1049,30.779753761969904,57.865937072503414,8.960328317373461,2.3255813953488373,0.06839945280437756
27,서울특별시,서대문구,연희동,연희동제2투,1671,1173,406,642,86,27,1,1162,11,498,34.93975903614458,55.24956970740104,7.401032702237521,2.323580034423408,0.08605851979345956
28,서울특별시,서대문구,연희동,연희동제3투,2184,1440,488,752,141,42,2,1425,15,744,34.24561403508772,52.771929824561404,9.894736842105264,2.9473684210526314,0.14035087719298245
29,서울특별시,서대문구,연희동,연희동제4투,1068,721,331,324,45,14,1,715,6,347,46.29370629370629,45.31468531468531,6.293706293706294,1.9580419580419581,0.13986013986013987
30,서울특별시,서대문구,연희동,연희동제5투,2187,1582,693,728,116,27,4,1568,14,605,44.19642857142857,46.42857142857143,7.3979591836734695,1.7219387755102038,0.25510204081632654
31,서울특별시,서대문구,연희동,연희동제6투,2124,1471,574,749,109,25,7,1464,7,653,39.20765027322404,51.161202185792355,7.44535519125683,1.707650273224044,0.47814207650273227
32,서울특별시,서대문구,연희동,연희동제7투,2457,1657,488,958,157,41,0,1644,13,800,29.683698296836987,58.27250608272506,9.549878345498783,2.493917274939173,0.0
33,서울특별시,서대문구,연희동,연희동제8투,3055,2025,601,969,364,54,1,1989,36,1030,30.21618903971845,48.717948717948715,18.30065359477124,2.7149321266968327,0.050276520864756154
34,서울특별시,서대문구,연희동,연희동제9투,2679,1805,626,834,290,32,1,1783,22,874,35.10936623667975,46.77509814918676,16.264722378014582,1.79472798653954,0.056085249579360626
35,서울특별시,서대문구,홍제제1동,관내사전투표,3115,3115,2072,755,218,52,1,3098,17,0,66.88185926404132,24.37056165267915,7.036797934151065,1.6785022595222725,0.03227888960619754
36,서울특별시,서대문구,홍제제1동,홍제제1동제1투,1933,1310,540,634,106,23,2,1305,5,623,41.37931034482759,48.582375478927204,8.122605363984674,1.7624521072796935,0.15325670498084293
37,서울특별시,서대문구,홍제제1동,홍제제1동제2투,2414,1803,715,881,161,33,3,1793,10,611,39.87730061349693,49.13552704963748,8.97936419408812,1.8404907975460123,0.16731734523145567
38,서울특별시,서대문구,홍제제1동,홍제제1동제3투,2246,1632,727,767,106,23,1,1624,8,614,44.76600985221675,47.22906403940887,6.527093596059114,1.416256157635468,0.06157635467980296
39,서울특별시,서대문구,홍제제1동,홍제제1동제4투,1769,1203,551,546,79,17,0,1193,10,566,46.18608549874266,45.76697401508801,6.621961441743504,1.4249790444258172,0.0
40,서울특별시,서대문구,홍제제1동,홍제제1동제5투,2253,1672,661,819,153,28,1,1662,10,581,39.7713598074609,49.277978339350184,9.2057761732852,1.684717208182912,0.060168471720818295
41,서울특별시,서대문구,홍제제1동,홍제제1동제6투,1886,1386,437,766,146,25,3,1377,9,500,31.735657225853302,55.62817719680465,10.602759622367465,1.815541031227306,0.2178649237472767
42,서울특별시,서대문구,홍제제1동,홍제제1동제7투,1978,1516,547,774,161,28,0,1510,6,462,36.22516556291391,51.25827814569537,10.662251655629138,1.8543046357615895,0.0
43,서울특별시,서대문구,홍제제2동,관내사전투표,4338,4338,2855,1045,346,55,1,4302,36,0,66.36448163644816,24.291027429102744,8.04277080427708,1.2784751278475126,0.023245002324500233
44,서울특별시,서대문구,홍제제2동,홍제제2동제1투,1610,1072,413,544,92,11,1,1061,11,538,38.92554194156456,51.272384542884076,8.671065032987748,1.0367577756833177,0.0942507068803016
45,서울특별시,서대문구,홍제제2동,홍제제2동제2투,2138,1613,569,859,146,29,2,1605,8,525,35.45171339563863,53.5202492211838,9.096573208722742,1.8068535825545171,0.12461059190031153
46,서울특별시,서대문구,홍제제2동,홍제제2동제3투,1716,1224,390,708,111,12,0,1221,3,492,31.941031941031937,57.98525798525799,9.090909090909092,0.9828009828009828,0.0
47,서울특별시,서대문구,홍제제2동,홍제제2동제4투,1217,901,306,504,70,16,1,897,4,316,34.11371237458194,56.187290969899664,7.803790412486064,1.7837235228539576,0.11148272017837235
48,서울특별시,서대문구,홍제제3동,관내사전투표,3412,3411,2347,805,200,37,4,3393,18,1,69.17182434423815,23.725316828765106,5.894488653109343,1.0904804008252285,0.11788977306218684
49,서울특별시,서대문구,홍제제3동,홍제제3동제1투,1594,984,384,512,70,13,1,980,4,610,39.183673469387756,52.244897959183675,7.142857142857142,1.3265306122448979,0.10204081632653061
50,서울특별시,서대문구,홍제제3동,홍제제3동제2투,1997,1362,534,686,111,18,0,1349,13,635,39.584877687175684,50.8524833209785,8.228317272053372,1.3343217197924389,0.0
51,서울특별시,서대문구,홍제제3동,홍제제3동제3투,1886,1280,485,627,132,20,3,1267,13,606,38.279400157853196,49.4869771112865,10.418310970797158,1.5785319652722969,0.23677979479084454
52,서울특별시,서대문구,홍제제3동,홍제제3동제4투,2180,1446,589,691,125,26,2,1433,13,734,41.10258199581298,48.22051639916259,8.722958827634333,1.8143754361479414,0.13956734124214934
53,서울특별시,서대문구,홍제제3동,홍제제3동제5투,2185,1755,728,777,205,28,3,1741,14,430,41.81504882251579,44.62952326249282,11.774842044801838,1.6082711085583,0.17231476163124643
54,서울특별시,서대문구,홍은제1동,관내사전투표,4958,4958,3485,1109,270,65,4,4933,25,0,70.646665315224,22.4812487330225,5.473342793431988,1.3176565984188122,0.08108655990269613
55,서울특별시,서대문구,홍은제1동,홍은제1동제1투,1074,625,221,351,41,8,0,621,4,449,35.5877616747182,56.52173913043478,6.602254428341385,1.288244766505636,0.0
56,서울특별시,서대문구,홍은제1동,홍은제1동제2투,2736,1956,800,942,172,25,3,1942,14,780,41.1946446961895,48.506694129763126,8.85684860968074,1.2873326467559219,0.15447991761071062
57,서울특별시,서대문구,홍은제1동,홍은제1동제3투,2307,1724,602,950,135,27,2,1716,8,583,35.08158508158508,55.361305361305355,7.8671328671328675,1.5734265734265735,0.11655011655011654
58,서울특별시,서대문구,홍은제1동,홍은제1동제4투,1688,1307,555,585,134,23,2,1299,8,381,42.725173210161664,45.03464203233256,10.31562740569669,1.770592763664357,0.15396458814472672
59,서울특별시,서대문구,홍은제1동,홍은제1동제5투,2066,1423,555,731,114,15,2,1417,6,643,39.16725476358504,51.5878616796048,8.045165843330981,1.058574453069866,0.14114326040931546
60,서울특별시,서대문구,홍은제1동,홍은제1동제6투,2306,1448,596,719,97,22,1,1435,13,858,41.53310104529616,50.10452961672473,6.7595818815331015,1.5331010452961673,0.06968641114982578
61,서울특별시,서대문구,홍은제2동,관내사전투표,5253,5253,3591,1232,329,70,1,5223,30,0,68.75358989086732,23.587976258855065,6.299061841853342,1.3402259237985832,0.019146084625694046
62,서울특별시,서대문구,홍은제2동,홍은제2동제1투,2278,1338,461,722,121,25,0,1329,9,940,34.68773513920241,54.32656132430399,9.104589917231001,1.8811136192626037,0.0
63,서울특별시,서대문구,홍은제2동,홍은제2동제2투,2504,1738,659,876,166,21,1,1723,15,766,38.24724318049913,50.84155542658154,9.63435867672664,1.2188044109112013,0.05803830528148578
64,서울특별시,서대문구,홍은제2동,홍은제2동제3투,2819,2025,834,999,134,41,0,2008,17,794,41.53386454183267,49.75099601593625,6.673306772908366,2.041832669322709,0.0
65,서울특별시,서대문구,홍은제2동,홍은제2동제4투,2347,1542,633,736,134,25,3,1531,11,805,41.34552580013063,48.073154800783804,8.752449379490528,1.6329196603527107,0.1959503592423253
66,서울특별시,서대문구,홍은제2동,홍은제2동제5투,2399,1409,534,719,114,23,0,1390,19,990,38.41726618705036,51.726618705035975,8.201438848920864,1.6546762589928057,0.0
67,서울특별시,서대문구,홍은제2동,홍은제2동제6투,3020,2099,839,1029,178,33,2,2081,18,921,40.3171552138395,49.44738106679481,8.553580009610764,1.5857760691975011,0.09610764055742432
68,서울특별시,서대문구,남가좌제1동,관내사전투표,5274,5274,3503,1230,423,86,1,5243,31,0,66.81289338165173,23.45985123021171,8.067900057219148,1.6402822811367537,0.019073049780659927
69,서울특별시,서대문구,남가좌제1동,남가좌제1동제1투,2045,1476,494,815,133,27,2,1471,5,569,33.5825968728756,55.40448674371176,9.041468388851122,1.8354860639021073,0.13596193065941536
70,서울특별시,서대문구,남가좌제1동,남가좌제1동제2투,1861,1439,568,709,132,22,1,1432,7,422,39.66480446927375,49.511173184357546,9.217877094972067,1.536312849162011,0.06983240223463687
71,서울특별시,서대문구,남가좌제1동,남가좌제1동제3투,2302,1717,707,824,148,26,2,1707,10,585,41.41769185705917,48.27182190978325,8.670181605155243,1.5231400117164615,0.11716461628588166
72,서울특별시,서대문구,남가좌제1동,남가좌제1동제4투,2208,1655,594,825,187,32,4,1642,13,553,36.17539585870889,50.2436053593179,11.38855054811206,1.9488428745432398,0.24360535931790497
73,서울특별시,서대문구,남가좌제2동,관내사전투표,5846,5846,3877,1254,535,118,6,5790,56,0,66.96027633851467,21.6580310880829,9.24006908462867,2.0379965457685665,0.10362694300518134
74,서울특별시,서대문구,남가좌제2동,남가좌제2동제1투,1906,1171,383,629,119,23,4,1158,13,735,33.074265975820374,54.317789291882555,10.276338514680482,1.9861830742659756,0.3454231433506045
75,서울특별시,서대문구,남가좌제2동,남가좌제2동제2투,1866,1232,498,616,95,13,1,1223,9,634,40.71954210956664,50.36794766966476,7.76778413736713,1.062959934587081,0.08176614881439084
76,서울특별시,서대문구,남가좌제2동,남가좌제2동제3투,2121,1562,502,876,148,21,3,1550,12,559,32.387096774193544,56.516129032258064,9.548387096774194,1.3548387096774193,0.1935483870967742
77,서울특별시,서대문구,남가좌제2동,남가좌제2동제4투,2911,2293,945,1066,233,30,4,2278,15,618,41.48375768217735,46.795434591747146,10.228270412642669,1.3169446883230904,0.17559262510974538
78,서울특별시,서대문구,남가좌제2동,남가좌제2동제5투,2673,2054,851,967,197,25,3,2043,11,619,41.65442976015663,47.33235438081253,9.642682329907,1.2236906510034264,0.14684287812041116
79,서울특별시,서대문구,남가좌제2동,남가좌제2동제6투,1917,1210,465,579,126,29,2,1201,9,707,38.71773522064946,48.2098251457119,10.491257285595337,2.4146544546211492,0.16652789342214822
80,서울특별시,서대문구,남가좌제2동,남가좌제2동제7투,2125,1536,602,728,175,21,0,1526,10,589,39.44954128440367,47.706422018348626,11.46788990825688,1.3761467889908259,0.0
81,서울특별시,서대문구,북가좌제1동,관내사전투표,4724,4724,3193,1120,329,61,1,4704,20,0,67.87840136054422,23.809523809523807,6.9940476190476195,1.2967687074829932,0.021258503401360544
82,서울특별시,서대문구,북가좌제1동,북가좌제1동제1투,1992,1420,474,797,122,21,1,1415,5,572,33.4982332155477,56.32508833922262,8.62190812720848,1.4840989399293287,0.0706713780918728
83,서울특별시,서대문구,북가좌제1동,북가좌제1동제2투,1391,913,323,489,85,10,1,908,5,478,35.5726872246696,53.85462555066079,9.361233480176212,1.1013215859030838,0.11013215859030838
84,서울특별시,서대문구,북가좌제1동,북가좌제1동제3투,1712,1122,418,579,106,14,0,1117,5,590,37.421665174574755,51.83527305282005,9.489704565801253,1.2533572068039391,0.0
85,서울특별시,서대문구,북가좌제1동,북가좌제1동제4투,2411,1825,651,934,201,25,2,1813,12,586,35.907335907335906,51.51682294539437,11.086596800882516,1.3789299503585217,0.11031439602868175
86,서울특별시,서대문구,북가좌제1동,북가좌제1동제5투,1462,1153,423,603,97,21,2,1146,7,309,36.910994764397905,52.617801047120416,8.464223385689355,1.832460732984293,0.17452006980802792
87,서울특별시,서대문구,북가좌제2동,관내사전투표,6256,6256,4291,1451,387,81,5,6215,41,0,69.04263877715205,23.3467417538214,6.226870474658085,1.3032984714400644,0.08045052292839903
88,서울특별시,서대문구,북가좌제2동,북가좌제2동제1투,2492,1544,593,753,149,22,1,1518,26,948,39.064558629776016,49.60474308300395,9.81554677206851,1.4492753623188406,0.06587615283267458
89,서울특별시,서대문구,북가좌제2동,북가좌제2동제2투,2563,1662,659,812,148,28,1,1648,14,901,39.987864077669904,49.271844660194176,8.980582524271846,1.6990291262135921,0.06067961165048543
90,서울특별시,서대문구,북가좌제2동,북가좌제2동제3투,1786,1161,476,591,73,11,2,1153,8,625,41.28360797918474,51.25758889852558,6.331309627059845,0.9540329575021683,0.17346053772766695
91,서울특별시,서대문구,북가좌제2동,북가좌제2동제4투,2414,1845,732,925,149,20,4,1830,15,569,40.0,50.54644808743169,8.14207650273224,1.092896174863388,0.2185792349726776
92,서울특별시,서대문구,북가좌제2동,북가좌제2동제5투,2178,1466,630,681,118,18,1,1448,18,712,43.508287292817684,47.030386740331494,8.149171270718233,1.2430939226519337,0.06906077348066297
93,서울특별시,서대문구,북가좌제2동,북가좌제2동제6투,2579,1613,673,741,156,28,3,1601,12,966,42.03622735790131,46.283572767020615,9.743910056214865,1.7489069331667706,0.18738288569643974
94,서울특별시,서대문구,북가좌제2동,북가좌제2동제7투,2933,2012,901,908,161,23,2,1995,17,921,45.16290726817043,45.51378446115288,8.070175438596491,1.1528822055137844,0.10025062656641603
95,서울특별시,서대문구,잘못 투입·구분된 투표지,,0,4,3,0,1,0,0,4,0,-4,75.0,0.0,25.0,0.0,0.0
0,서울특별시,마포구,거소·선상투표,,337,328,143,94,76,3,0,316,12,9,45.25316455696203,29.746835443037973,24.050632911392405,0.949367088607595,0.0
1,서울특별시,마포구,관외사전투표,,35942,35942,21131,8904,4712,759,32,35538,404,0,59.46029602116045,25.054870842478472,13.259046654285553,2.1357420226236705,0.09004445945185435
2,서울특별시,마포구,재외투표,,3996,3195,2015,755,322,83,0,3175,20,801,63.46456692913386,23.77952755905512,10.141732283464568,2.614173228346457,0.0
3,서울특별시,마포구,공덕동,관내사전투표,4076,4076,2747,990,274,42,3,4056,20,0,67.7268244575937,24.40828402366864,6.7554240631163704,1.0355029585798818,0.07396449704142012
4,서울특별시,마포구,공덕동,공덕동제1투,2391,1633,633,846,125,17,1,1622,11,758,39.025893958076445,52.15782983970407,7.706535141800247,1.0480887792848335,0.06165228113440197
5,서울특별시,마포구,공덕동,공덕동제2투,3140,2364,782,1292,250,27,1,2352,12,776,33.24829931972789,54.93197278911565,10.629251700680271,1.1479591836734695,0.04251700680272109
6,서울특별시,마포구,공덕동,공덕동제3투,1847,1167,430,573,132,20,3,1158,9,680,37.13298791018998,49.48186528497409,11.398963730569948,1.7271157167530224,0.2590673575129534
7,서울특별시,마포구,공덕동,공덕동제4투,1904,1209,534,541,103,19,2,1199,10,695,44.5371142618849,45.120934111759794,8.590492076730609,1.58465387823186,0.16680567139282734
8,서울특별시,마포구,공덕동,공덕동제5투,2316,1624,702,704,176,29,2,1613,11,692,43.521388716677,43.64538127712338,10.911345319280844,1.7978921264724117,0.12399256044637322
9,서울특별시,마포구,공덕동,공덕동제6투,1978,1353,451,706,154,24,3,1338,15,625,33.70702541106129,52.76532137518684,11.509715994020926,1.7937219730941705,0.2242152466367713
10,서울특별시,마포구,공덕동,공덕동제7투,2291,1579,607,770,151,29,0,1557,22,712,38.985228002569045,49.454078355812456,9.698137443802183,1.8625561978163132,0.0
11,서울특별시,마포구,공덕동,공덕동제8투,2639,2076,747,1069,212,33,4,2065,11,563,36.17433414043584,51.767554479418884,10.26634382566586,1.5980629539951572,0.1937046004842615
12,서울특별시,마포구,공덕동,공덕동제9투,2974,2156,721,1199,194,27,1,2142,14,818,33.66013071895425,55.975723622782446,9.056956115779645,1.2605042016806722,0.04668534080298786
13,서울특별시,마포구,아현동,관내사전투표,5607,5607,3385,1517,572,91,1,5566,41,0,60.81566654689185,27.254761049227454,10.276679841897234,1.6349263384836505,0.017966223499820338
14,서울특별시,마포구,아현동,아현동제1투,2710,1809,533,979,246,38,3,1799,10,901,29.62757087270706,54.41912173429683,13.674263479710952,2.112284602556976,0.16675931072818231
15,서울특별시,마포구,아현동,아현동제2투,1824,1320,394,746,148,23,0,1311,9,504,30.05339435545385,56.90312738367659,11.289092295957284,1.7543859649122806,0.0
16,서울특별시,마포구,아현동,아현동제3투,2310,1802,588,971,204,28,2,1793,9,508,32.79419966536531,54.15504740658115,11.377579475738985,1.5616285554935863,0.11154489682097045
17,서울특별시,마포구,아현동,아현동제4투,3273,2399,781,1264,289,45,1,2380,19,874,32.81512605042017,53.109243697478995,12.142857142857142,1.8907563025210083,0.04201680672268908
18,서울특별시,마포구,아현동,아현동제5투,2771,2213,767,1160,247,28,1,2203,10,558,34.8161597821153,52.65546981389016,11.2119836586473,1.2709940989559692,0.04539264639128461
19,서울특별시,마포구,아현동,아현동제6투,3259,2593,818,1488,245,21,2,2574,19,666,31.77933177933178,57.80885780885781,9.518259518259518,0.8158508158508158,0.0777000777000777
20,서울특별시,마포구,도화동,관내사전투표,5590,5589,3432,1466,551,90,3,5542,47,1,61.927102129195234,26.452544207867195,9.94225911223385,1.623962468422952,0.05413208228076506
21,서울특별시,마포구,도화동,도화동제1투,1764,1114,351,616,116,17,1,1101,13,650,31.88010899182561,55.949137148047235,10.535876475930973,1.544050862851953,0.09082652134423251
22,서울특별시,마포구,도화동,도화동제2투,1811,1357,363,827,136,17,1,1344,13,454,27.00892857142857,61.532738095238095,10.119047619047619,1.2648809523809523,0.0744047619047619
23,서울특별시,마포구,도화동,도화동제3투,1561,1259,290,802,138,17,1,1248,11,302,23.23717948717949,64.26282051282051,11.057692307692307,1.3621794871794872,0.08012820512820512
24,서울특별시,마포구,도화동,도화동제4투,1556,1247,450,643,129,19,1,1242,5,309,36.231884057971016,51.77133655394525,10.38647342995169,1.529790660225443,0.08051529790660225
25,서울특별시,마포구,도화동,도화동제5투,1282,866,295,476,73,9,1,854,12,416,34.54332552693209,55.73770491803278,8.548009367681498,1.053864168618267,0.117096018735363
26,서울특별시,마포구,도화동,도화동제6투,2071,1680,502,960,183,24,2,1671,9,391,30.041891083183724,57.450628366247756,10.951526032315979,1.436265709156194,0.11968880909634949
27,서울특별시,마포구,도화동,도화동제7투,1803,1331,499,650,160,13,0,1322,9,472,37.74583963691377,49.167927382753405,12.102874432677762,0.9833585476550681,0.0
28,서울특별시,마포구,용강동,관내사전투표,4481,4481,2842,1185,373,58,0,4458,23,0,63.750560789591745,26.5814266487214,8.366980708838044,1.3010318528488112,0.0
29,서울특별시,마포구,용강동,용강동제1투,2526,1857,572,1084,161,27,2,1846,11,669,30.985915492957744,58.72156013001083,8.721560130010834,1.4626218851570965,0.10834236186348861
30,서울특별시,마포구,용강동,용강동제2투,1921,1340,377,782,150,25,1,1335,5,581,28.239700374531836,58.57677902621723,11.235955056179774,1.8726591760299627,0.0749063670411985
31,서울특별시,마포구,용강동,용강동제3투,3031,2228,704,1237,241,30,2,2214,14,803,31.79765130984643,55.8717253839205,10.88527551942186,1.3550135501355014,0.09033423667570009
32,서울특별시,마포구,용강동,용강동제4투,1896,1529,541,804,151,24,1,1521,8,367,35.568704799474034,52.85996055226825,9.92767915844839,1.5779092702169626,0.06574621959237344
33,서울특별시,마포구,용강동,용강동제5투,1911,1437,523,736,142,25,0,1426,11,474,36.67601683029453,51.61290322580645,9.957924263674615,1.753155680224404,0.0
34,서울특별시,마포구,대흥동,관내사전투표,3632,3632,2131,906,475,85,3,3600,32,0,59.19444444444445,25.166666666666664,13.194444444444445,2.361111111111111,0.08333333333333334
35,서울특별시,마포구,대흥동,대흥동제1투,1872,1279,430,677,144,17,4,1272,7,593,33.80503144654088,53.22327044025157,11.320754716981133,1.3364779874213837,0.3144654088050315
36,서울특별시,마포구,대흥동,대흥동제2투,1864,1388,396,761,193,25,1,1376,12,476,28.77906976744186,55.30523255813954,14.026162790697674,1.8168604651162792,0.07267441860465117
37,서울특별시,마포구,대흥동,대흥동제3투,2130,1268,377,670,171,31,2,1251,17,862,30.135891286970423,53.557154276578736,13.66906474820144,2.478017585931255,0.15987210231814547
38,서울특별시,마포구,대흥동,대흥동제4투,2158,1352,421,662,234,22,2,1341,11,806,31.3944817300522,49.36614466815809,17.449664429530202,1.6405667412378822,0.14914243102162564
39,서울특별시,마포구,염리동,관내사전투표,4211,4210,2634,962,474,94,2,4166,44,1,63.226116178588576,23.091694671147383,11.377820451272203,2.256361017762842,0.04800768122899664
40,서울특별시,마포구,염리동,염리동제1투,1463,956,301,522,116,12,0,951,5,507,31.650893796004205,54.889589905362776,12.197686645636173,1.2618296529968454,0.0
41,서울특별시,마포구,염리동,염리동제2투,3519,2499,842,1302,294,42,2,2482,17,1020,33.92425463336019,52.45769540692989,11.84528605962933,1.6921837228041903,0.08058017727639001
42,서울특별시,마포구,염리동,염리동제3투,2336,1727,631,877,174,26,2,1710,17,609,36.90058479532164,51.28654970760233,10.175438596491228,1.5204678362573099,0.11695906432748539
43,서울특별시,마포구,염리동,염리동제4투,1410,1066,340,596,103,16,2,1057,9,344,32.16650898770104,56.38599810785241,9.744560075685904,1.5137180700094608,0.1892147587511826
44,서울특별시,마포구,신수동,관내사전투표,4023,4023,2559,986,362,80,1,3988,35,0,64.16750250752257,24.72417251755266,9.077231695085256,2.0060180541624875,0.025075225677031094
45,서울특별시,마포구,신수동,신수동제1투,2173,1432,496,763,135,25,4,1423,9,741,34.85593815881939,53.61911454673226,9.486999297259311,1.7568517217146873,0.28109627547434995
46,서울특별시,마포구,신수동,신수동제2투,1510,1118,366,633,94,15,1,1109,9,392,33.00270513976555,57.07844905320108,8.476104598737603,1.3525698827772767,0.09017132551848511
47,서울특별시,마포구,신수동,신수동제3투,3123,2244,726,1183,280,42,2,2233,11,879,32.51231527093596,52.97805642633229,12.539184952978054,1.8808777429467085,0.08956560680698611
48,서울특별시,마포구,신수동,신수동제4투,2736,2005,635,1126,198,20,2,1981,24,731,32.054517920242304,56.83997980817769,9.994952044422009,1.0095911155981827,0.10095911155981827
49,서울특별시,마포구,신수동,신수동제5투,2472,1866,628,1014,190,23,0,1855,11,606,33.854447439353095,54.663072776280316,10.242587601078167,1.2398921832884098,0.0
50,서울특별시,마포구,서강동,관내사전투표,5670,5668,3637,1344,540,95,4,5620,48,2,64.7153024911032,23.914590747330962,9.608540925266903,1.6903914590747333,0.0711743772241993
51,서울특별시,마포구,서강동,서강동제1투,1895,1300,462,645,157,23,1,1288,12,595,35.869565217391305,50.077639751552795,12.18944099378882,1.7857142857142856,0.07763975155279502
52,서울특별시,마포구,서강동,서강동제2투,2205,1670,616,870,135,34,1,1656,14,535,37.19806763285024,52.53623188405797,8.152173913043478,2.0531400966183577,0.06038647342995169
53,서울특별시,마포구,서강동,서강동제3투,2605,1834,669,903,204,43,4,1823,11,771,36.69775095995612,49.53373560065826,11.190345584201864,2.35874931431706,0.21941854086670326
54,서울특별시,마포구,서강동,서강동제4투,2322,1595,478,856,206,37,3,1580,15,727,30.253164556962027,54.177215189873415,13.037974683544304,2.3417721518987342,0.18987341772151897
55,서울특별시,마포구,서강동,서강동제5투,2169,1530,550,752,177,33,3,1515,15,639,36.303630363036305,49.636963696369634,11.683168316831685,2.178217821782178,0.19801980198019803
56,서울특별시,마포구,서강동,서강동제6투,2996,2246,610,1358,221,43,4,2236,10,750,27.280858676207515,60.73345259391771,9.883720930232558,1.9230769230769231,0.17889087656529518
57,서울특별시,마포구,서교동,관내사전투표,4551,4551,3031,896,449,135,5,4516,35,0,67.11691762621788,19.840566873339238,9.942426926483613,2.9893711248892827,0.11071744906997344
58,서울특별시,마포구,서교동,서교동제1투,2332,1440,467,709,198,38,2,1414,26,892,33.02687411598303,50.141442715700144,14.002828854314004,2.6874115983026874,0.14144271570014144
59,서울특별시,마포구,서교동,서교동제2투,2764,1788,509,1054,188,26,2,1779,9,976,28.611579539066888,59.24676784710512,10.567734682405847,1.4614952220348512,0.11242270938729623
60,서울특별시,마포구,서교동,서교동제3투,1956,1307,482,681,110,24,0,1297,10,649,37.162683114880494,52.50578257517348,8.481110254433307,1.8504240555127216,0.0
61,서울특별시,마포구,서교동,서교동제4투,2502,1601,593,772,165,39,2,1571,30,901,37.7466581795035,49.14067472947167,10.502864417568428,2.4824952259707196,0.1273074474856779
62,서울특별시,마포구,서교동,서교동제5투,1118,685,220,362,78,15,0,675,10,433,32.592592592592595,53.629629629629626,11.555555555555555,2.2222222222222223,0.0
63,서울특별시,마포구,서교동,서교동제6투,1431,936,301,478,117,26,1,923,13,495,32.61105092091008,51.787648970747554,12.676056338028168,2.8169014084507045,0.10834236186348861
64,서울특별시,마포구,서교동,서교동제7투,2173,1404,493,657,198,35,1,1384,20,769,35.62138728323699,47.471098265895954,14.30635838150289,2.5289017341040463,0.0722543352601156
65,서울특별시,마포구,합정동,관내사전투표,5411,5410,3554,1150,535,119,7,5365,45,1,66.24417520969244,21.435228331780056,9.972041006523765,2.218080149114632,0.130475302889096
66,서울특별시,마포구,합정동,합정동제1투,1664,1163,434,543,142,28,0,1147,16,501,37.83783783783784,47.34088927637315,12.380122057541412,2.4411508282476024,0.0
67,서울특별시,마포구,합정동,합정동제2투,1785,1201,458,592,111,22,3,1186,15,584,38.61720067453626,49.915682967959526,9.359190556492411,1.854974704890388,0.25295109612141653
68,서울특별시,마포구,합정동,합정동제3투,2364,1585,545,816,182,30,1,1574,11,779,34.62515883100381,51.84243964421855,11.56289707750953,1.9059720457433291,0.06353240152477764
69,서울특별시,마포구,합정동,합정동제4투,1652,1111,396,564,109,29,1,1099,12,541,36.03275705186533,51.31938125568699,9.918107370336669,2.6387625113739763,0.09099181073703368
70,서울특별시,마포구,합정동,합정동제5투,1770,1205,419,615,138,19,1,1192,13,565,35.151006711409394,51.59395973154363,11.577181208053691,1.5939597315436242,0.08389261744966443
71,서울특별시,마포구,망원1동,관내사전투표,5600,5600,3780,1205,413,151,7,5556,44,0,68.03455723542116,21.688264938804895,7.433405327573794,2.7177825773938085,0.12598992080633548
72,서울특별시,마포구,망원1동,망원1동제1투,1745,1049,350,545,123,25,1,1044,5,696,33.524904214559385,52.20306513409961,11.781609195402298,2.3946360153256707,0.09578544061302681
73,서울특별시,마포구,망원1동,망원1동제2투,2137,1395,521,687,138,35,1,1382,13,742,37.69898697539797,49.71056439942113,9.985528219971057,2.532561505065123,0.0723589001447178
74,서울특별시,마포구,망원1동,망원1동제3투,1962,1287,490,633,120,32,2,1277,10,675,38.37118245888802,49.569303054032886,9.397024275646046,2.505873140172279,0.15661707126076743
75,서울특별시,마포구,망원1동,망원1동제4투,2461,1681,672,794,152,41,2,1661,20,780,40.45755568934377,47.802528597230584,9.151113786875378,2.4683925346177005,0.12040939193257075
76,서울특별시,마포구,망원1동,망원1동제5투,1954,1399,541,692,128,30,1,1392,7,555,38.86494252873563,49.712643678160916,9.195402298850574,2.1551724137931036,0.07183908045977011
77,서울특별시,마포구,망원2동,관내사전투표,4502,4502,3197,874,307,94,0,4472,30,0,71.48926654740609,19.5438282647585,6.864937388193202,2.1019677996422184,0.0
78,서울특별시,마포구,망원2동,망원2동제1투,1868,1245,471,619,115,30,0,1235,10,623,38.13765182186235,50.12145748987854,9.31174089068826,2.42914979757085,0.0
79,서울특별시,마포구,망원2동,망원2동제2투,1699,1243,519,552,120,36,3,1230,13,456,42.19512195121951,44.87804878048781,9.75609756097561,2.9268292682926833,0.24390243902439024
80,서울특별시,마포구,망원2동,망원2동제3투,2175,1519,579,757,126,37,0,1499,20,656,38.62575050033355,50.500333555703804,8.405603735823883,2.468312208138759,0.0
81,서울특별시,마포구,망원2동,망원2동제4투,2092,1487,607,730,121,15,2,1475,12,605,41.152542372881356,49.49152542372882,8.203389830508474,1.0169491525423728,0.13559322033898305
82,서울특별시,마포구,망원2동,망원2동제5투,1734,1305,490,640,127,32,4,1293,12,429,37.896365042536736,49.49729311678268,9.822119102861562,2.474864655839134,0.30935808197989173
83,서울특별시,마포구,연남동,관내사전투표,4422,4422,2937,920,405,118,4,4384,38,0,66.99361313868614,20.985401459854014,9.238138686131386,2.691605839416058,0.09124087591240876
84,서울특별시,마포구,연남동,연남동제1투,1762,1099,383,548,129,28,1,1089,10,663,35.16988062442608,50.321395775941234,11.84573002754821,2.571166207529844,0.09182736455463728
85,서울특별시,마포구,연남동,연남동제2투,1374,898,287,478,89,24,0,878,20,476,32.687927107061505,54.441913439635535,10.136674259681094,2.733485193621868,0.0
86,서울특별시,마포구,연남동,연남동제3투,2387,1563,495,838,173,38,0,1544,19,824,32.059585492227974,54.274611398963735,11.204663212435232,2.461139896373057,0.0
87,서울특별시,마포구,연남동,연남동제4투,2620,1784,644,923,154,45,2,1768,16,836,36.425339366515836,52.20588235294118,8.710407239819004,2.5452488687782804,0.11312217194570137
88,서울특별시,마포구,성산1동,관내사전투표,4405,4405,3105,798,329,140,2,4374,31,0,70.98765432098766,18.244170096021946,7.5217192501143115,3.2007315957933242,0.04572473708276177
89,서울특별시,마포구,성산1동,성산1동제1투,1847,1129,399,574,103,41,0,1117,12,718,35.72068039391226,51.38764547896151,9.221128021486123,3.670546105640107,0.0
90,서울특별시,마포구,성산1동,성산1동제2투,2246,1536,677,673,124,44,1,1519,17,710,44.5687952600395,44.305464121132324,8.16326530612245,2.8966425279789334,0.06583278472679394
91,서울특별시,마포구,성산1동,성산1동제3투,1733,1099,396,562,106,28,0,1092,7,634,36.26373626373626,51.46520146520146,9.706959706959708,2.564102564102564,0.0
92,서울특별시,마포구,성산1동,성산1동제4투,2187,1434,505,761,124,28,1,1419,15,753,35.58844256518675,53.62931642001409,8.738548273431993,1.9732205778717407,0.07047216349541931
93,서울특별시,마포구,성산1동,성산1동제5투,2120,1381,552,646,117,51,1,1367,14,739,40.38039502560351,47.25676664228237,8.558888076079004,3.730797366495977,0.0731528895391368
94,서울특별시,마포구,성산2동,관내사전투표,5861,5861,3905,1346,472,94,1,5818,43,0,67.11928497765555,23.135097971811618,8.11275352354761,1.615675489859058,0.017188037126160193
95,서울특별시,마포구,성산2동,성산2동제1투,2256,1647,556,896,152,28,1,1633,14,609,34.04776484996938,54.8683404776485,9.30802204531537,1.7146356399265157,0.0612369871402327
96,서울특별시,마포구,성산2동,성산2동제2투,2780,1975,809,925,174,48,1,1957,18,805,41.338783852835974,47.266223811957076,8.891159938681655,2.452733776188043,0.0510986203372509
97,서울특별시,마포구,성산2동,성산2동제3투,2206,1329,513,655,118,23,1,1310,19,877,39.160305343511446,50.0,9.007633587786259,1.7557251908396947,0.07633587786259542
98,서울특별시,마포구,성산2동,성산2동제4투,2452,1804,714,860,185,31,2,1792,12,648,39.84375,47.99107142857143,10.323660714285714,1.7299107142857144,0.11160714285714285
99,서울특별시,마포구,성산2동,성산2동제5투,3272,2335,1026,915,291,66,0,2298,37,937,44.64751958224543,39.81723237597911,12.663185378590077,2.8720626631853787,0.0
100,서울특별시,마포구,성산2동,성산2동제6투,2121,1411,626,699,59,6,6,1396,15,710,44.84240687679083,50.071633237822354,4.226361031518625,0.42979942693409745,0.42979942693409745
101,서울특별시,마포구,성산2동,성산2동제7투,2266,1755,743,775,182,38,2,1740,15,511,42.701149425287355,44.54022988505747,10.459770114942529,2.1839080459770113,0.11494252873563218
102,서울특별시,마포구,성산2동,성산2동제8투,2470,1801,672,907,183,26,1,1789,12,669,37.56288429290106,50.698714365567355,10.229178311906093,1.4533258803801008,0.05589714924538849
103,서울특별시,마포구,성산2동,성산2동제9투,2268,1717,628,874,172,29,0,1703,14,551,36.87610099823841,51.32119788608338,10.099823840281855,1.7028772753963595,0.0
104,서울특별시,마포구,상암동,관내사전투표,5145,5145,3544,992,477,97,1,5111,34,0,69.34063783995305,19.409117589512814,9.332811582860497,1.8978673449422814,0.019565642731363724
105,서울특별시,마포구,상암동,상암동제1투,2274,1488,533,708,204,28,2,1475,13,786,36.13559322033898,48.0,13.830508474576272,1.8983050847457625,0.13559322033898305
106,서울특별시,마포구,상암동,상암동제2투,1930,1344,524,705,88,17,1,1335,9,586,39.250936329588015,52.80898876404494,6.591760299625468,1.2734082397003745,0.0749063670411985
107,서울특별시,마포구,상암동,상암동제3투,1893,1506,616,721,144,17,2,1500,6,387,41.06666666666667,48.06666666666667,9.6,1.1333333333333333,0.13333333333333333
108,서울특별시,마포구,상암동,상암동제4투,2808,2239,809,1170,217,27,2,2225,14,569,36.359550561797754,52.58426966292134,9.752808988764045,1.2134831460674158,0.0898876404494382
109,서울특별시,마포구,상암동,상암동제5투,2361,1817,806,839,131,23,3,1802,15,544,44.72807991120977,46.55937846836848,7.2697003329633745,1.2763596004439512,0.1664816870144284
110,서울특별시,마포구,상암동,상암동제6투,2397,1779,934,655,148,26,3,1766,13,618,52.88788221970555,37.08946772366931,8.380520951302378,1.4722536806342015,0.16987542468856173
111,서울특별시,마포구,상암동,상암동제7투,2754,2061,1006,832,175,37,1,2051,10,693,49.049244271087275,40.56557776694296,8.532423208191126,1.8039980497318382,0.04875670404680643
112,서울특별시,마포구,잘못 투입·구분된 투표지,,0,2,1,0,0,0,0,1,1,-2,100.0,0.0,0.0,0.0,0.0
0,서울특별시,양천구,거소·선상투표,,404,380,152,129,87,1,0,369,11,24,41.19241192411924,34.959349593495936,23.577235772357724,0.27100271002710025,0.0
1,서울특별시,양천구,관외사전투표,,40694,40689,24151,10266,5306,565,43,40331,358,5,59.88197664327688,25.454365128561157,13.156132999429717,1.4009074905159802,0.10661773821626044
2,서울특별시,양천구,재외투표,,3354,2717,1771,587,289,51,0,2698,19,637,65.6412157153447,21.756856931060046,10.711638250555968,1.8902891030392883,0.0
3,서울특별시,양천구,목1동,관내사전투표,4246,4246,2577,1198,405,39,5,4224,22,0,61.00852272727273,28.361742424242426,9.588068181818182,0.9232954545454546,0.11837121212121213
4,서울특별시,양천구,목1동,목1동제1투,2649,1947,563,1180,173,23,0,1939,8,702,29.035585353274882,60.85611139762764,8.92212480660134,1.186178442496132,0.0
5,서울특별시,양천구,목1동,목1동제2투,2713,2085,632,1205,219,21,3,2080,5,628,30.384615384615383,57.932692307692314,10.528846153846153,1.0096153846153846,0.14423076923076925
6,서울특별시,양천구,목1동,목1동제3투,2623,1948,759,980,183,16,2,1940,8,675,39.123711340206185,50.51546391752577,9.43298969072165,0.8247422680412372,0.10309278350515465
7,서울특별시,양천구,목1동,목1동제4투,2472,2002,687,1101,181,18,1,1988,14,470,34.55734406438632,55.38229376257545,9.104627766599597,0.9054325955734407,0.05030181086519115
8,서울특별시,양천구,목1동,목1동제5투,2877,2180,648,1272,226,27,2,2175,5,697,29.793103448275858,58.48275862068966,10.390804597701148,1.2413793103448276,0.09195402298850575
9,서울특별시,양천구,목1동,목1동제6투,2701,2028,523,1260,212,25,0,2020,8,673,25.89108910891089,62.37623762376238,10.495049504950495,1.2376237623762376,0.0
10,서울특별시,양천구,목2동,관내사전투표,6506,6506,4346,1466,550,81,10,6453,53,0,67.34852006818534,22.718115605144895,8.523167518983419,1.2552301255230125,0.1549666821633349
11,서울특별시,양천구,목2동,목2동제1투,2053,1331,458,685,150,22,0,1315,16,722,34.82889733840304,52.09125475285171,11.406844106463879,1.6730038022813687,0.0
12,서울특별시,양천구,목2동,목2동제2투,2248,1567,500,891,138,31,0,1560,7,681,32.05128205128205,57.11538461538461,8.846153846153847,1.987179487179487,0.0
13,서울특별시,양천구,목2동,목2동제3투,2200,1573,587,804,141,29,1,1562,11,627,37.580025608194624,51.47247119078106,9.026888604353394,1.856594110115237,0.06402048655569782
14,서울특별시,양천구,목2동,목2동제4투,2370,1785,673,905,179,19,1,1777,8,585,37.87281935846933,50.92853123241417,10.07315700619021,1.0692177827799663,0.056274620146314014
15,서울특별시,양천구,목2동,목2동제5투,1521,1071,415,511,114,15,1,1056,15,450,39.29924242424242,48.390151515151516,10.795454545454545,1.4204545454545454,0.0946969696969697
16,서울특별시,양천구,목2동,목2동제6투,1591,1149,433,556,128,17,2,1136,13,442,38.11619718309859,48.943661971830984,11.267605633802818,1.4964788732394365,0.17605633802816903
17,서울특별시,양천구,목2동,목2동제7투,1905,1303,469,682,126,19,1,1297,6,602,36.1603700848111,52.582883577486506,9.714726291441789,1.4649190439475714,0.07710100231303006
18,서울특별시,양천구,목2동,목2동제8투,1943,1392,538,672,155,20,0,1385,7,551,38.844765342960294,48.51985559566787,11.191335740072201,1.444043321299639,0.0
19,서울특별시,양천구,목3동,관내사전투표,4297,4297,2849,1084,279,47,6,4265,32,0,66.79953106682298,25.41617819460727,6.541617819460726,1.1019929660023446,0.1406799531066823
20,서울특별시,양천구,목3동,목3동제1투,2267,1734,465,1100,142,15,1,1723,11,533,26.98781195589089,63.84213580963436,8.24143934997098,0.8705745792222866,0.05803830528148578
21,서울특별시,양천구,목3동,목3동제2투,2543,1662,544,884,190,26,4,1648,14,881,33.00970873786408,53.640776699029125,11.529126213592233,1.5776699029126213,0.24271844660194172
22,서울특별시,양천구,목3동,목3동제3투,2307,1500,500,809,149,18,3,1479,21,807,33.80662609871535,54.69912102772143,10.074374577417174,1.2170385395537524,0.2028397565922921
23,서울특별시,양천구,목3동,목3동제4투,2373,1521,571,770,140,17,3,1501,20,852,38.04130579613591,51.299133910726184,9.327115256495668,1.1325782811459029,0.19986675549633579
24,서울특별시,양천구,목3동,목3동제5투,2087,1406,471,760,143,19,1,1394,12,681,33.787661406025826,54.51936872309899,10.258249641319942,1.362984218077475,0.07173601147776185
25,서울특별시,양천구,목4동,관내사전투표,5024,5024,3259,1248,426,59,0,4992,32,0,65.28445512820514,25.0,8.533653846153847,1.1818910256410255,0.0
26,서울특별시,양천구,목4동,목4동제1투,2184,1470,516,778,145,22,2,1463,7,714,35.26999316473001,53.1784005468216,9.911141490088857,1.5037593984962405,0.1367053998632946
27,서울특별시,양천구,목4동,목4동제2투,1948,1263,451,663,122,10,1,1247,16,685,36.16680032076985,53.167602245388935,9.783480352846832,0.8019246190858059,0.08019246190858059
28,서울특별시,양천구,목4동,목4동제3투,2461,1725,647,866,179,26,0,1718,7,736,37.66006984866123,50.40745052386496,10.419091967403958,1.5133876600698486,0.0
29,서울특별시,양천구,목4동,목4동제4투,2140,1503,606,716,138,27,3,1490,13,637,40.671140939597315,48.053691275167786,9.261744966442953,1.8120805369127517,0.20134228187919465
30,서울특별시,양천구,목4동,목4동제5투,2196,1575,608,774,158,20,1,1561,14,621,38.94939141575912,49.583600256245994,10.121716848174248,1.2812299807815504,0.06406149903907751
31,서울특별시,양천구,목4동,목4동제6투,2609,1934,828,883,186,24,3,1924,10,675,43.03534303534304,45.893970893970895,9.667359667359667,1.2474012474012475,0.15592515592515593
32,서울특별시,양천구,목5동,관내사전투표,6082,6082,3569,1825,568,80,6,6048,34,0,59.011243386243386,30.17526455026455,9.39153439153439,1.3227513227513228,0.0992063492063492
33,서울특별시,양천구,목5동,목5동제1투,3121,2156,518,1367,224,26,0,2135,21,965,24.262295081967213,64.02810304449649,10.491803278688524,1.2177985948477752,0.0
34,서울특별시,양천구,목5동,목5동제2투,2756,2184,667,1267,204,28,4,2170,14,572,30.737327188940096,58.387096774193544,9.400921658986174,1.2903225806451613,0.18433179723502305
35,서울특별시,양천구,목5동,목5동제3투,2694,2055,532,1288,202,24,2,2048,7,639,25.9765625,62.890625,9.86328125,1.171875,0.09765625
36,서울특별시,양천구,목5동,목5동제4투,2601,2025,541,1233,214,20,1,2009,16,576,26.92882030861125,61.37381781981085,10.652065704330512,0.9955201592832255,0.049776007964161276
37,서울특별시,양천구,목5동,목5동제5투,2643,2059,547,1252,206,41,1,2047,12,584,26.722032242305815,61.16267708842208,10.063507572056668,2.0029311187103076,0.048851978505129456
38,서울특별시,양천구,목5동,목5동제6투,3020,2407,628,1499,235,33,4,2399,8,613,26.177573989162152,62.48436848686952,9.795748228428511,1.3755731554814505,0.16673614005835766
39,서울특별시,양천구,목5동,목5동제7투,2124,1668,451,1020,160,23,3,1657,11,456,27.217863608931804,61.55703077851539,9.656004828002414,1.388050694025347,0.18105009052504525
40,서울특별시,양천구,목5동,목5동제8투,2574,2078,746,1055,231,36,0,2068,10,496,36.07350096711799,51.01547388781431,11.170212765957446,1.7408123791102514,0.0
41,서울특별시,양천구,신월1동,관내사전투표,3884,3884,2688,966,181,24,3,3862,22,0,69.60124287933714,25.01294665976178,4.686690833764889,0.6214396685655101,0.07767995857068877
42,서울특별시,양천구,신월1동,신월1동제1투,2396,1485,532,797,121,18,4,1472,13,911,36.141304347826086,54.14402173913043,8.220108695652174,1.2228260869565217,0.2717391304347826
43,서울특별시,양천구,신월1동,신월1동제2투,2334,1437,567,731,113,19,2,1432,5,897,39.59497206703911,51.047486033519554,7.8910614525139655,1.3268156424581006,0.13966480446927373
44,서울특별시,양천구,신월1동,신월1동제3투,1861,1197,504,591,83,11,2,1191,6,664,42.31738035264483,49.622166246851386,6.9689336691855575,0.9235936188077246,0.16792611251049538
45,서울특별시,양천구,신월1동,신월1동제4투,2211,1383,595,668,101,13,2,1379,4,828,43.14720812182741,48.44089920232052,7.324147933284989,0.9427121102248005,0.145032632342277
46,서울특별시,양천구,신월1동,신월1동제5투,2657,1792,829,816,121,11,0,1777,15,865,46.65166010129432,45.920090039392235,6.809229037703996,0.6190208216094542,0.0
47,서울특별시,양천구,신월2동,관내사전투표,3959,3959,2643,1039,222,27,4,3935,24,0,67.16645489199492,26.404066073697585,5.641677255400254,0.6861499364675985,0.10165184243964422
48,서울특별시,양천구,신월2동,신월2동제1투,2014,1352,539,688,104,6,2,1339,13,662,40.253920836445104,51.38162808065721,7.766990291262135,0.4480955937266617,0.14936519790888725
49,서울특별시,양천구,신월2동,신월2동제2투,1660,1185,497,576,90,14,0,1177,8,475,42.22599830076466,48.93797790994053,7.646559048428207,1.1894647408666101,0.0
50,서울특별시,양천구,신월2동,신월2동제3투,2734,2026,687,1143,154,31,3,2018,8,708,34.04360753221011,56.6402378592666,7.631318136769079,1.5361744301288405,0.14866204162537167
51,서울특별시,양천구,신월2동,신월2동제4투,2458,1696,692,841,140,14,2,1689,7,762,40.970988750740084,49.79277679100059,8.288928359976317,0.8288928359976317,0.11841326228537595
52,서울특별시,양천구,신월2동,신월2동제5투,2061,1291,466,711,94,9,1,1281,10,770,36.377829820452774,55.503512880562056,7.338017174082748,0.702576112412178,0.078064012490242
53,서울특별시,양천구,신월3동,관내사전투표,2742,2742,1897,680,134,16,3,2730,12,0,69.48717948717949,24.90842490842491,4.908424908424909,0.5860805860805861,0.10989010989010989
54,서울특별시,양천구,신월3동,신월3동제1투,1874,1068,416,551,82,10,3,1062,6,806,39.1713747645951,51.88323917137476,7.721280602636535,0.9416195856873822,0.2824858757062147
55,서울특별시,양천구,신월3동,신월3동제2투,2072,1257,515,623,88,17,3,1246,11,815,41.3322632423756,50.0,7.062600321027287,1.3643659711075442,0.2407704654895666
56,서울특별시,양천구,신월3동,신월3동제3투,1728,966,356,548,51,2,0,957,9,762,37.19958202716823,57.26227795193313,5.329153605015674,0.20898641588296762,0.0
57,서울특별시,양천구,신월3동,신월3동제4투,2284,1403,560,705,123,7,0,1395,8,881,40.14336917562724,50.53763440860215,8.817204301075268,0.5017921146953405,0.0
58,서울특별시,양천구,신월4동,관내사전투표,4056,4056,2855,913,239,29,4,4040,16,0,70.66831683168317,22.5990099009901,5.915841584158415,0.7178217821782179,0.09900990099009901
59,서울특별시,양천구,신월4동,신월4동제1투,2655,1826,694,945,156,14,4,1813,13,829,38.27909542195256,52.123552123552116,8.604522890237176,0.7722007722007722,0.2206287920573635
60,서울특별시,양천구,신월4동,신월4동제2투,2205,1570,647,771,117,15,4,1554,16,635,41.63449163449163,49.61389961389961,7.5289575289575295,0.9652509652509652,0.2574002574002574
61,서울특별시,양천구,신월4동,신월4동제3투,2539,1774,764,838,133,15,5,1755,19,765,43.53276353276353,47.74928774928775,7.578347578347579,0.8547008547008548,0.2849002849002849
62,서울특별시,양천구,신월4동,신월4동제4투,1835,1281,513,624,116,13,5,1271,10,554,40.36191974822974,49.09520062942565,9.12667191188041,1.0228166797797011,0.3933910306845004
63,서울특별시,양천구,신월5동,관내사전투표,3862,3861,2612,926,264,32,3,3837,24,1,68.07401615845713,24.133437581443836,6.88037529319781,0.8339848840239771,0.07818608287724785
64,서울특별시,양천구,신월5동,신월5동제1투,2488,1670,611,891,124,25,5,1656,14,818,36.89613526570048,53.80434782608695,7.487922705314009,1.5096618357487923,0.30193236714975846
65,서울특별시,양천구,신월5동,신월5동제2투,2314,1413,514,761,116,14,1,1406,7,901,36.55761024182077,54.12517780938833,8.250355618776672,0.995732574679943,0.07112375533428165
66,서울특별시,양천구,신월5동,신월5동제3투,2454,1409,522,729,128,20,0,1399,10,1045,37.31236597569693,52.108649035025024,9.1493924231594,1.4295925661186561,0.0
67,서울특별시,양천구,신월6동,관내사전투표,5396,5396,3664,1215,431,62,1,5373,23,0,68.1928159315094,22.613065326633166,8.021589428624605,1.1539177368323097,0.018611576400521124
68,서울특별시,양천구,신월6동,신월6동제1투,2729,2005,688,1107,180,21,1,1997,8,724,34.45167751627441,55.43314972458688,9.01352028042063,1.0515773660490735,0.050075112669003496
69,서울특별시,양천구,신월6동,신월6동제2투,3382,2607,931,1357,266,37,1,2592,15,775,35.91820987654321,52.35339506172839,10.262345679012345,1.4274691358024691,0.038580246913580245
70,서울특별시,양천구,신월6동,신월6동제3투,1098,785,344,383,45,6,2,780,5,313,44.1025641025641,49.1025641025641,5.769230769230769,0.7692307692307693,0.2564102564102564
71,서울특별시,양천구,신월7동,관내사전투표,4148,4148,2912,980,208,26,4,4130,18,0,70.50847457627118,23.728813559322035,5.036319612590799,0.6295399515738499,0.09685230024213075
72,서울특별시,양천구,신월7동,신월7동제1투,1725,1046,404,547,65,14,0,1030,16,679,39.22330097087379,53.10679611650485,6.310679611650485,1.3592233009708738,0.0
73,서울특별시,양천구,신월7동,신월7동제2투,1839,1219,464,627,102,10,0,1203,16,620,38.57024106400665,52.119700748129674,8.478802992518704,0.8312551953449709,0.0
74,서울특별시,양천구,신월7동,신월7동제3투,1573,978,356,542,66,5,2,971,7,595,36.66323377960865,55.81874356333677,6.797116374871266,0.5149330587023687,0.20597322348094746
75,서울특별시,양천구,신월7동,신월7동제4투,1525,958,372,510,62,10,1,955,3,567,38.952879581151834,53.403141361256544,6.492146596858639,1.0471204188481675,0.10471204188481677
76,서울특별시,양천구,신월7동,신월7동제5투,2173,1608,680,776,130,15,0,1601,7,565,42.473454091193005,48.469706433479075,8.119925046845722,0.9369144284821986,0.0
77,서울특별시,양천구,신월7동,신월7동제6투,2088,1549,665,723,133,17,1,1539,10,539,43.20987654320987,46.978557504873294,8.641975308641975,1.1046133853151396,0.0649772579597141
78,서울특별시,양천구,신정1동,관내사전투표,5078,5078,3284,1281,423,59,3,5050,28,0,65.02970297029704,25.366336633663366,8.376237623762377,1.1683168316831682,0.0594059405940594
79,서울특별시,양천구,신정1동,신정1동제1투,2217,1554,557,805,160,22,2,1546,8,663,36.02846054333765,52.06985769728332,10.34928848641656,1.423027166882277,0.129366106080207
80,서울특별시,양천구,신정1동,신정1동제2투,2426,1833,585,1031,178,27,1,1822,11,593,32.107574094401755,56.586169045005484,9.769484083424809,1.481888035126235,0.054884742041712405
81,서울특별시,양천구,신정1동,신정1동제3투,2047,1651,390,1077,154,19,1,1641,10,396,23.76599634369287,65.63071297989032,9.384521633150518,1.157830591102986,0.06093845216331505
82,서울특별시,양천구,신정1동,신정1동제4투,1870,1511,449,879,157,19,0,1504,7,359,29.853723404255316,58.444148936170215,10.438829787234043,1.2632978723404253,0.0
83,서울특별시,양천구,신정1동,신정1동제5투,1615,1182,290,752,114,15,1,1172,10,433,24.744027303754265,64.16382252559727,9.726962457337883,1.2798634812286689,0.08532423208191127
84,서울특별시,양천구,신정2동,관내사전투표,5842,5842,3773,1514,469,49,7,5812,30,0,64.91741225051616,26.049552649690295,8.069511355815553,0.8430832759807294,0.12044046799724707
85,서울특별시,양천구,신정2동,신정2동제1투,3394,2379,818,1323,189,27,6,2363,16,1015,34.617012272534915,55.98815065594584,7.99830723656369,1.1426153195090987,0.25391451544646637
86,서울특별시,양천구,신정2동,신정2동제2투,3079,2320,885,1160,216,37,4,2302,18,759,38.44483058210252,50.39096437880104,9.383145091225021,1.6072980017376195,0.1737619461337967
87,서울특별시,양천구,신정2동,신정2동제3투,2469,1771,639,925,163,28,2,1757,14,698,36.36881047239613,52.64655663062038,9.277177006260672,1.593625498007968,0.11383039271485487
88,서울특별시,양천구,신정3동,관내사전투표,4646,4646,3148,1153,284,37,2,4624,22,0,68.07958477508652,24.935121107266436,6.141868512110726,0.8001730103806228,0.043252595155709346
89,서울특별시,양천구,신정3동,신정3동제1투,2416,1508,547,797,130,27,1,1502,6,908,36.41810918774967,53.06258322237017,8.655126498002662,1.7976031957390146,0.06657789613848203
90,서울특별시,양천구,신정3동,신정3동제2투,2287,1518,599,769,119,16,2,1505,13,769,39.800664451827245,51.09634551495017,7.906976744186046,1.06312292358804,0.132890365448505
91,서울특별시,양천구,신정3동,신정3동제3투,2632,2043,779,986,230,32,3,2030,13,589,38.3743842364532,48.57142857142857,11.330049261083744,1.5763546798029555,0.1477832512315271
92,서울특별시,양천구,신정3동,신정3동제4투,2716,1801,713,920,133,18,0,1784,17,915,39.96636771300449,51.569506726457405,7.455156950672645,1.0089686098654709,0.0
93,서울특별시,양천구,신정3동,신정3동제5투,2696,2091,778,1067,197,28,5,2075,16,605,37.493975903614455,51.42168674698795,9.493975903614457,1.3493975903614457,0.24096385542168677
94,서울특별시,양천구,신정3동,신정3동제6투,2338,1828,771,888,140,19,3,1821,7,510,42.33937397034596,48.76441515650741,7.688083470620538,1.043382756727073,0.16474464579901155
95,서울특별시,양천구,신정3동,신정3동제7투,2199,1663,670,826,129,27,1,1653,10,536,40.53236539624924,49.9697519661222,7.80399274047187,1.6333938294010888,0.06049606775559589
96,서울특별시,양천구,신정3동,신정3동제8투,2492,1899,783,960,127,17,4,1891,8,593,41.40666314119513,50.76679005817029,6.71602326811211,0.8989952406134322,0.21152829190904282
97,서울특별시,양천구,신정3동,신정3동제9투,2594,2028,960,893,130,29,0,2012,16,566,47.713717693836976,44.38369781312127,6.461232604373758,1.4413518886679921,0.0
98,서울특별시,양천구,신정3동,신정3동제10투,2421,1937,914,824,152,28,0,1918,19,484,47.653806047966626,42.96141814389989,7.924921793534932,1.4598540145985401,0.0
99,서울특별시,양천구,신정3동,신정3동제11투,1759,1435,766,542,104,14,1,1427,8,324,53.67904695164681,37.98177995795375,7.288016818500351,0.9810791871058164,0.0700770847932726
100,서울특별시,양천구,신정3동,신정3동제12투,1639,1329,660,551,89,14,3,1317,12,310,50.11389521640092,41.83750949126803,6.757782839787396,1.0630220197418374,0.22779043280182232
101,서울특별시,양천구,신정4동,관내사전투표,6025,6025,4190,1264,472,63,1,5990,35,0,69.94991652754591,21.101836393989984,7.879799666110183,1.0517529215358932,0.01669449081803005
102,서울특별시,양천구,신정4동,신정4동제1투,2668,1863,792,880,146,27,3,1848,15,805,42.857142857142854,47.61904761904761,7.900432900432901,1.461038961038961,0.16233766233766234
103,서울특별시,양천구,신정4동,신정4동제2투,1893,1179,422,624,109,12,0,1167,12,714,36.16109682947729,53.470437017994854,9.34018851756641,1.0282776349614395,0.0
104,서울특별시,양천구,신정4동,신정4동제3투,2092,1264,462,666,105,15,1,1249,15,828,36.98959167333867,53.322658126501196,8.406725380304243,1.200960768614892,0.08006405124099279
105,서울특별시,양천구,신정4동,신정4동제4투,2364,1708,668,852,151,27,2,1700,8,656,39.294117647058826,50.117647058823536,8.882352941176471,1.588235294117647,0.1176470588235294
106,서울특별시,양천구,신정4동,신정4동제5투,2518,1803,711,922,138,13,2,1786,17,715,39.80963045912654,51.62374020156775,7.726763717805152,0.7278835386338186,0.11198208286674133
107,서울특별시,양천구,신정4동,신정4동제6투,2397,1645,739,710,163,20,1,1633,12,752,45.254133496631965,43.47826086956522,9.98162890385793,1.224739742804654,0.0612369871402327
108,서울특별시,양천구,신정4동,신정4동제7투,2220,1463,604,687,134,21,1,1447,16,757,41.74153420870767,47.477539737387694,9.260539046302695,1.4512785072563925,0.0691085003455425
109,서울특별시,양천구,신정4동,신정4동제8투,2779,1948,775,959,175,21,3,1933,15,831,40.09311950336265,49.612002069322294,9.053285049146405,1.0863942058975684,0.1551991722710812
110,서울특별시,양천구,신정6동,관내사전투표,4599,4599,2754,1284,475,54,5,4572,27,0,60.23622047244095,28.083989501312335,10.389326334208224,1.1811023622047243,0.10936132983377078
111,서울특별시,양천구,신정6동,신정6동제1투,2144,1614,393,1051,138,18,2,1602,12,530,24.531835205992508,65.60549313358302,8.614232209737828,1.1235955056179776,0.12484394506866417
112,서울특별시,양천구,신정6동,신정6동제2투,1735,1330,359,825,123,16,0,1323,7,405,27.13529856386999,62.358276643990926,9.297052154195011,1.2093726379440666,0.0
113,서울특별시,양천구,신정6동,신정6동제3투,2782,2288,691,1347,208,23,3,2272,16,494,30.4137323943662,59.28697183098591,9.15492957746479,1.012323943661972,0.13204225352112675
114,서울특별시,양천구,신정6동,신정6동제4투,2585,2053,720,1085,200,31,2,2038,15,532,35.328753680078506,53.23846908734053,9.813542688910697,1.521099116781158,0.09813542688910697
115,서울특별시,양천구,신정6동,신정6동제5투,2290,1884,678,985,176,31,1,1871,13,406,36.23730625334046,52.645644040619985,9.406734366648852,1.6568679850347405,0.053447354355959376
116,서울특별시,양천구,신정6동,신정6동제6투,1829,1418,434,829,139,12,1,1415,3,411,30.671378091872793,58.58657243816254,9.823321554770319,0.8480565371024734,0.0706713780918728
117,서울특별시,양천구,신정7동,관내사전투표,3654,3654,2346,936,294,48,4,3628,26,0,64.66372657111357,25.799338478500548,8.103638368246969,1.3230429988974641,0.11025358324145534
118,서울특별시,양천구,신정7동,신정7동제1투,1992,1430,427,832,145,19,0,1423,7,562,30.00702740688686,58.46802529866479,10.189739985945186,1.3352073085031624,0.0
119,서울특별시,양천구,신정7동,신정7동제2투,2291,1836,752,872,179,24,1,1828,8,455,41.13785557986871,47.70240700218819,9.792122538293217,1.312910284463895,0.05470459518599562
120,서울특별시,양천구,신정7동,신정7동제3투,2596,1890,747,979,136,14,1,1877,13,706,39.79754928076718,52.15769845498135,7.245604688332445,0.7458710708577517,0.05327650506126798
121,서울특별시,양천구,신정7동,신정7동제4투,2269,1785,591,1005,152,29,1,1778,7,484,33.23959505061867,56.524184476940384,8.548931383577054,1.6310461192350956,0.05624296962879641
122,서울특별시,양천구,신정7동,신정7동제5투,1750,1245,491,672,61,11,1,1236,9,505,39.724919093851135,54.36893203883495,4.935275080906148,0.889967637540453,0.08090614886731393
123,서울특별시,양천구,신정7동,신정7동제6투,1795,1300,549,673,61,8,2,1293,7,495,42.459396751740144,52.04949729311679,4.7177107501933495,0.6187161639597835,0.15467904098994587
124,서울특별시,양천구,신정7동,신정7동제7투,2185,1794,587,1007,166,18,2,1780,14,391,32.97752808988764,56.57303370786517,9.325842696629213,1.0112359550561798,0.11235955056179776
125,서울특별시,양천구,신정7동,신정7동제8투,1571,1262,454,668,115,14,0,1251,11,309,36.290967226219024,53.397282174260596,9.192645883293366,1.1191047162270185,0.0
126,서울특별시,양천구,잘못 투입·구분된 투표지,,0,1,1,0,0,0,0,1,0,-1,100.0,0.0,0.0,0.0,0.0
0,서울특별시,강서구,거소·선상투표,,669,624,312,193,101,1,2,609,15,45,51.231527093596064,31.69129720853859,16.58456486042693,0.16420361247947454,0.3284072249589491
1,서울특별시,강서구,관외사전투표,,49963,49957,29776,11924,6909,748,50,49407,550,6,60.26676381889205,24.13423199141822,13.983848442528387,1.5139555123767887,0.10120023478454471
2,서울특별시,강서구,재외투표,,3848,3146,2187,615,281,38,2,3123,23,702,70.02881844380403,19.6926032660903,8.99775856548191,1.2167787383925712,0.06404098623118795
3,서울특별시,강서구,염창동,관내사전투표,7394,7394,5054,1587,591,111,8,7351,43,0,68.75255067337778,21.58889946945994,8.0397224867365,1.5099986396408651,0.10882873078492722
4,서울특별시,강서구,염창동,염창동제1투,2995,2225,809,1093,269,34,1,2206,19,770,36.67271078875793,49.546690843155034,12.194016319129647,1.5412511332728922,0.04533091568449683
5,서울특별시,강서구,염창동,염창동제2투,3091,2344,863,1181,247,41,1,2333,11,747,36.99099871410201,50.6215173596228,10.587226746678096,1.7573939134162022,0.04286326618088298
6,서울특별시,강서구,염창동,염창동제3투,2814,2144,855,998,251,28,1,2133,11,670,40.08438818565401,46.78856071261134,11.767463666197843,1.3127051101734646,0.04688232536333802
7,서울특별시,강서구,염창동,염창동제4투,2247,1709,640,843,192,21,3,1699,10,538,37.66921718658034,49.61742201294879,11.300765155974101,1.2360211889346673,0.17657445556209533
8,서울특별시,강서구,염창동,염창동제5투,2036,1419,516,716,152,27,0,1411,8,617,36.569808646350104,50.744153082919915,10.772501771793054,1.9135364989369241,0.0
9,서울특별시,강서구,염창동,염창동제6투,3144,2407,945,1159,263,25,2,2394,13,737,39.473684210526315,48.41269841269841,10.98579782790309,1.0442773600668338,0.0835421888053467
10,서울특별시,강서구,염창동,염창동제7투,2235,1814,735,835,210,23,0,1803,11,421,40.765391014975044,46.31170271769273,11.647254575707153,1.2756516916250693,0.0
11,서울특별시,강서구,염창동,염창동제8투,3127,2459,962,1205,243,29,0,2439,20,668,39.442394423944236,49.405494054940554,9.96309963099631,1.1890118901189013,0.0
12,서울특별시,강서구,등촌제1동,관내사전투표,6094,6094,3882,1361,705,75,3,6026,68,0,64.4208430136077,22.58546299369399,11.699303020245603,1.244606704281447,0.04978426817125788
13,서울특별시,강서구,등촌제1동,등촌제1동제1투,3411,2558,1014,1165,312,32,1,2524,34,853,40.1743264659271,46.156893819334385,12.361331220285262,1.2678288431061806,0.039619651347068144
14,서울특별시,강서구,등촌제1동,등촌제1동제2투,3179,2108,631,1208,222,25,2,2088,20,1071,30.220306513409962,57.8544061302682,10.632183908045976,1.1973180076628354,0.09578544061302681
15,서울특별시,강서구,등촌제1동,등촌제1동제3투,4399,2971,1060,1388,436,53,5,2942,29,1428,36.02991162474507,47.17878993881713,14.819850441876275,1.8014955812372537,0.1699524133242692
16,서울특별시,강서구,등촌제1동,등촌제1동제4투,3017,2042,731,985,263,33,3,2015,27,975,36.27791563275434,48.883374689826304,13.05210918114144,1.6377171215880892,0.1488833746898263
17,서울특별시,강서구,등촌제2동,관내사전투표,4606,4606,2918,1204,375,72,6,4575,31,0,63.78142076502732,26.316939890710383,8.19672131147541,1.5737704918032787,0.13114754098360656
18,서울특별시,강서구,등촌제2동,등촌제2동제1투,2220,1436,520,733,146,25,2,1426,10,784,36.4656381486676,51.40252454417953,10.238429172510518,1.753155680224404,0.1402524544179523
19,서울특별시,강서구,등촌제2동,등촌제2동제2투,3059,2053,734,1045,235,23,2,2039,14,1006,35.9980382540461,51.25061304561059,11.52525747915645,1.1280039234919077,0.0980872976949485
20,서울특별시,강서구,등촌제2동,등촌제2동제3투,2549,1663,587,898,145,18,1,1649,14,886,35.59733171619163,54.45724681625227,8.793208004851426,1.0915706488781078,0.06064281382656155
21,서울특별시,강서구,등촌제2동,등촌제2동제4투,2861,2251,633,1420,166,22,1,2242,9,610,28.23371989295272,63.336306868867084,7.404103479036575,0.9812667261373774,0.04460303300624443
22,서울특별시,강서구,등촌제3동,관내사전투표,7004,7004,4643,1627,607,77,3,6957,47,0,66.73853672560011,23.386517176944086,8.725025154520626,1.1067989075751044,0.043122035360069
23,서울특별시,강서구,등촌제3동,등촌제3동제1투,2072,1415,566,731,97,12,3,1409,6,657,40.17033356990773,51.88076650106459,6.88431511710433,0.8516678495386799,0.21291696238466998
24,서울특별시,강서구,등촌제3동,등촌제3동제2투,2723,2122,781,1086,199,36,3,2105,17,601,37.1021377672209,51.59144893111639,9.453681710213777,1.7102137767220902,0.14251781472684086
25,서울특별시,강서구,등촌제3동,등촌제3동제3투,2760,2113,764,1090,218,26,0,2098,15,647,36.41563393708294,51.95424213536701,10.390848427073403,1.2392755004766445,0.0
26,서울특별시,강서구,등촌제3동,등촌제3동제4투,1528,977,357,549,47,7,1,961,16,551,37.14880332986473,57.12799167533819,4.890738813735692,0.72840790842872,0.10405827263267431
27,서울특별시,강서구,등촌제3동,등촌제3동제5투,1446,961,380,499,60,13,1,953,8,485,39.874081846799584,52.36096537250787,6.295907660020986,1.3641133263378804,0.1049317943336831
28,서울특별시,강서구,등촌제3동,등촌제3동제6투,2182,1380,468,741,134,22,0,1365,15,802,34.285714285714285,54.285714285714285,9.816849816849818,1.611721611721612,0.0
29,서울특별시,강서구,등촌제3동,등촌제3동제7투,2142,1634,612,822,172,12,5,1623,11,508,37.707948243992604,50.64695009242144,10.59765865680838,0.7393715341959335,0.3080714725816389
30,서울특별시,강서구,등촌제3동,등촌제3동제8투,1576,1070,391,599,59,9,0,1058,12,506,36.95652173913043,56.61625708884688,5.576559546313799,0.8506616257088847,0.0
31,서울특별시,강서구,등촌제3동,등촌제3동제9투,1551,1224,442,587,169,17,1,1216,8,327,36.348684210526315,48.27302631578947,13.898026315789474,1.3980263157894737,0.08223684210526315
32,서울특별시,강서구,화곡본동,관내사전투표,6106,6106,4194,1340,436,74,7,6051,55,0,69.3108577094695,22.145099983473806,7.205420591637745,1.2229383572963148,0.11568335812262437
33,서울특별시,강서구,화곡본동,화곡본동제1투,2865,1712,687,828,153,26,3,1697,15,1153,40.483205657041836,48.7919858573954,9.015910430170889,1.5321154979375369,0.1767825574543312
34,서울특별시,강서구,화곡본동,화곡본동제2투,3654,2074,816,921,294,21,1,2053,21,1580,39.74671212859231,44.86117876278617,14.320506575742813,1.0228933268387725,0.04870920603994155
35,서울특별시,강서구,화곡본동,화곡본동제3투,3041,1852,778,869,159,25,3,1834,18,1189,42.420937840785164,47.38276990185387,8.66957470010905,1.3631406761177753,0.16357688113413305
36,서울특별시,강서구,화곡본동,화곡본동제4투,2778,1737,672,834,182,26,3,1717,20,1041,39.13803145020384,48.57309260337799,10.59988351776354,1.5142690739662201,0.17472335468841002
37,서울특별시,강서구,화곡본동,화곡본동제5투,2963,1867,825,822,181,18,4,1850,17,1096,44.5945945945946,44.432432432432435,9.783783783783784,0.9729729729729729,0.21621621621621623
38,서울특별시,강서구,화곡본동,화곡본동제6투,2976,1867,866,807,150,23,1,1847,20,1109,46.88684353004873,43.692474282620466,8.12127774769897,1.245262587980509,0.05414185165132648
39,서울특별시,강서구,화곡제1동,관내사전투표,8394,8394,5535,2030,697,66,9,8337,57,0,66.39078805325657,24.349286314021832,8.360321458558234,0.791651673263764,0.10795250089960418
40,서울특별시,강서구,화곡제1동,화곡제1동제1투,3507,1921,727,937,215,20,3,1902,19,1586,38.22292323869611,49.26393270241851,11.303890641430074,1.0515247108307046,0.15772870662460567
41,서울특별시,강서구,화곡제1동,화곡제1동제2투,3296,1970,737,961,218,26,5,1947,23,1326,37.85310734463277,49.357986646122235,11.196712891628145,1.335387776065742,0.25680534155110424
42,서울특별시,강서구,화곡제1동,화곡제1동제3투,3797,2099,801,1029,225,24,0,2079,20,1698,38.52813852813853,49.494949494949495,10.822510822510822,1.1544011544011543,0.0
43,서울특별시,강서구,화곡제1동,화곡제1동제4투,3341,1970,690,993,241,28,4,1956,14,1371,35.2760736196319,50.76687116564417,12.321063394683026,1.4314928425357873,0.2044989775051125
44,서울특별시,강서구,화곡제1동,화곡제1동제5투,2255,1531,648,713,126,28,2,1517,14,724,42.71588661832564,47.00065919578115,8.30586684245221,1.845748187211602,0.13183915622940012
45,서울특별시,강서구,화곡제1동,화곡제1동제6투,2399,1382,562,642,140,20,0,1364,18,1017,41.20234604105572,47.06744868035191,10.263929618768328,1.466275659824047,0.0
46,서울특별시,강서구,화곡제1동,화곡제1동제7투,2611,1692,775,746,138,15,1,1675,17,919,46.26865671641791,44.53731343283582,8.238805970149254,0.8955223880597015,0.05970149253731343
47,서울특별시,강서구,화곡제1동,화곡제1동제8투,2655,1735,761,777,155,11,3,1707,28,920,44.58113649677797,45.518453427065026,9.080257762155828,0.6444053895723492,0.17574692442882248
48,서울특별시,강서구,화곡제1동,화곡제1동제9투,2775,1796,769,840,152,20,2,1783,13,979,43.12955692652832,47.11160964666293,8.524957936062815,1.1217049915872126,0.11217049915872125
49,서울특별시,강서구,화곡제1동,화곡제1동제10투,3028,1984,842,897,199,32,2,1972,12,1044,42.697768762677484,45.4868154158215,10.09127789046653,1.6227180527383367,0.10141987829614604
50,서울특별시,강서구,화곡제2동,관내사전투표,3790,3790,2607,879,234,37,3,3760,30,0,69.33510638297872,23.377659574468083,6.223404255319149,0.9840425531914894,0.07978723404255318
51,서울특별시,강서구,화곡제2동,화곡제2동제1투,1625,1006,411,503,76,9,2,1001,5,619,41.05894105894106,50.24975024975025,7.592407592407592,0.8991008991008992,0.1998001998001998
52,서울특별시,강서구,화곡제2동,화곡제2동제2투,2204,1368,568,630,132,18,2,1350,18,836,42.074074074074076,46.666666666666664,9.777777777777779,1.3333333333333335,0.14814814814814814
53,서울특별시,강서구,화곡제2동,화곡제2동제3투,2716,1712,720,792,168,19,2,1701,11,1004,42.32804232804233,46.56084656084656,9.876543209876543,1.1169900058788949,0.11757789535567313
54,서울특별시,강서구,화곡제2동,화곡제2동제4투,2776,1618,645,814,124,18,2,1603,15,1158,40.237055520898316,50.77978789769183,7.735495945102933,1.122894572676232,0.12476606363069245
55,서울특별시,강서구,화곡제3동,관내사전투표,7165,7165,4733,1616,649,94,10,7102,63,0,66.6431990988454,22.754153759504366,9.138270909602928,1.3235708251196845,0.14080540692762603
56,서울특별시,강서구,화곡제3동,화곡제3동제1투,2118,1327,487,686,127,18,2,1320,7,791,36.8939393939394,51.96969696969697,9.621212121212121,1.3636363636363635,0.15151515151515152
57,서울특별시,강서구,화곡제3동,화곡제3동제2투,2439,1490,527,753,165,23,2,1470,20,949,35.85034013605442,51.22448979591837,11.224489795918368,1.5646258503401362,0.13605442176870747
58,서울특별시,강서구,화곡제3동,화곡제3동제3투,2698,2005,787,995,178,30,0,1990,15,693,39.54773869346734,50.0,8.944723618090453,1.507537688442211,0.0
59,서울특별시,강서구,화곡제3동,화곡제3동제4투,2606,2122,601,1338,147,22,2,2110,12,484,28.48341232227488,63.41232227488152,6.966824644549763,1.042654028436019,0.09478672985781991
60,서울특별시,강서구,화곡제3동,화곡제3동제5투,2504,1914,693,1059,140,15,1,1908,6,590,36.32075471698113,55.503144654088054,7.337526205450734,0.7861635220125787,0.052410901467505246
61,서울특별시,강서구,화곡제4동,관내사전투표,4890,4890,3378,1154,272,45,6,4855,35,0,69.57775489186406,23.76930998970134,5.602471678681771,0.9268795056642637,0.12358393408856848
62,서울특별시,강서구,화곡제4동,화곡제4동제1투,2189,1346,502,708,102,19,4,1335,11,843,37.60299625468165,53.033707865168545,7.640449438202247,1.4232209737827715,0.299625468164794
63,서울특별시,강서구,화곡제4동,화곡제4동제2투,2134,1265,451,670,114,13,0,1248,17,869,36.13782051282051,53.68589743589743,9.134615384615383,1.0416666666666665,0.0
64,서울특별시,강서구,화곡제4동,화곡제4동제3투,2348,1349,508,690,117,16,5,1336,13,999,38.02395209580838,51.646706586826355,8.757485029940119,1.1976047904191618,0.37425149700598803
65,서울특별시,강서구,화곡제4동,화곡제4동제4투,1839,1108,414,584,90,8,1,1097,11,731,37.73928896991796,53.23609845031905,8.20419325432999,0.7292616226071102,0.09115770282588878
66,서울특별시,강서구,화곡제4동,화곡제4동제5투,2360,1634,741,713,138,23,2,1617,17,726,45.82560296846011,44.09400123685838,8.534322820037106,1.4223871366728509,0.12368583797155226
67,서울특별시,강서구,화곡제6동,관내사전투표,6606,6606,4399,1462,600,75,6,6542,64,0,67.24243350657292,22.347905839192908,9.171507184347295,1.1464383980434119,0.09171507184347294
68,서울특별시,강서구,화곡제6동,화곡제6동제1투,4099,2554,947,1203,342,39,3,2534,20,1545,37.37174427782163,47.47434885556432,13.496448303078138,1.5390686661404893,0.11838989739542227
69,서울특별시,강서구,화곡제6동,화곡제6동제2투,2152,1359,499,697,122,13,1,1332,27,793,37.46246246246246,52.327327327327325,9.15915915915916,0.975975975975976,0.07507507507507508
70,서울특별시,강서구,화곡제6동,화곡제6동제3투,2072,1354,487,716,127,13,1,1344,10,718,36.235119047619044,53.273809523809526,9.449404761904761,0.9672619047619048,0.0744047619047619
71,서울특별시,강서구,화곡제6동,화곡제6동제4투,4066,2690,945,1399,293,30,2,2669,21,1376,35.406519295616334,52.416635443986515,10.977894342450355,1.1240164855751216,0.07493443237167478
72,서울특별시,강서구,화곡제6동,화곡제6동제5투,2279,1872,569,1150,130,15,0,1864,8,407,30.52575107296137,61.69527896995708,6.974248927038626,0.8047210300429184,0.0
73,서울특별시,강서구,화곡제8동,관내사전투표,6854,6854,4760,1494,478,63,5,6800,54,0,70.0,21.970588235294116,7.029411764705882,0.926470588235294,0.07352941176470588
74,서울특별시,강서구,화곡제8동,화곡제8동제1투,2727,1638,660,764,165,31,2,1622,16,1089,40.6905055487053,47.1023427866831,10.172626387176326,1.911220715166461,0.12330456226880394
75,서울특별시,강서구,화곡제8동,화곡제8동제2투,2475,1599,688,735,144,13,0,1580,19,876,43.54430379746835,46.51898734177215,9.113924050632912,0.8227848101265823,0.0
76,서울특별시,강서구,화곡제8동,화곡제8동제3투,2670,1624,596,851,147,17,2,1613,11,1046,36.949783013019214,52.758834469931806,9.11345319280843,1.0539367637941723,0.12399256044637322
77,서울특별시,강서구,화곡제8동,화곡제8동제4투,2312,1516,674,670,141,18,1,1504,12,796,44.81382978723404,44.547872340425535,9.375,1.196808510638298,0.06648936170212766
78,서울특별시,강서구,화곡제8동,화곡제8동제5투,2589,1699,702,805,155,20,4,1686,13,890,41.637010676156585,47.74614472123369,9.193357058125741,1.1862396204033214,0.2372479240806643
79,서울특별시,강서구,우장산동,관내사전투표,6047,6047,3935,1544,476,49,5,6009,38,0,65.4851056748211,25.69479114661341,7.921451156598436,0.8154435014145448,0.08320852055250458
80,서울특별시,강서구,우장산동,우장산동제1투,2747,1846,657,980,175,22,1,1835,11,901,35.80381471389646,53.40599455040872,9.536784741144414,1.1989100817438691,0.05449591280653951
81,서울특별시,강서구,우장산동,우장산동제2투,2059,1281,496,627,131,14,1,1269,12,778,39.08589440504334,49.40898345153664,10.323089046493301,1.103230890464933,0.07880220646178093
82,서울특별시,강서구,우장산동,우장산동제3투,3077,2226,802,1151,225,22,1,2201,25,851,36.4379827351204,52.294411631076784,10.222626079054976,0.9995456610631531,0.045433893684688774
83,서울특별시,강서구,우장산동,우장산동제4투,2519,1980,738,1048,168,16,0,1970,10,539,37.46192893401015,53.1979695431472,8.527918781725887,0.8121827411167513,0.0
84,서울특별시,강서구,우장산동,우장산동제5투,3240,2384,988,1124,225,29,3,2369,15,856,41.70536091177712,47.44617982271001,9.497678345293373,1.2241452089489235,0.1266357112705783
85,서울특별시,강서구,우장산동,우장산동제6투,3392,2626,1002,1358,221,35,1,2617,9,766,38.28811616354604,51.891478792510505,8.444784103935804,1.3374092472296522,0.03821169277799007
86,서울특별시,강서구,우장산동,우장산동제7투,3050,2258,871,1145,204,27,4,2251,7,792,38.693913816081746,50.86628165259884,9.062638827187916,1.1994669035984007,0.1776988005330964
87,서울특별시,강서구,우장산동,우장산동제8투,3144,2474,829,1381,218,29,5,2462,12,670,33.67181153533713,56.09260763606824,8.85458976441917,1.1779041429731927,0.20308692120227456
88,서울특별시,강서구,가양제1동,관내사전투표,4693,4693,2949,1111,535,50,6,4651,42,0,63.40571920017201,23.88733605676199,11.502902601591055,1.075037626316921,0.12900451515803052
89,서울특별시,강서구,가양제1동,가양제1동제1투,2519,1878,712,922,190,29,1,1854,24,641,38.403451995685,49.730312837108954,10.248112189859762,1.564185544768069,0.05393743257820927
90,서울특별시,강서구,가양제1동,가양제1동제2투,1410,1015,367,531,98,10,0,1006,9,395,36.48111332007952,52.78330019880716,9.74155069582505,0.9940357852882704,0.0
91,서울특별시,강서구,가양제1동,가양제1동제3투,2116,1501,407,940,131,13,1,1492,9,615,27.278820375335123,63.00268096514745,8.780160857908847,0.871313672922252,0.06702412868632708
92,서울특별시,강서구,가양제1동,가양제1동제4투,1535,1077,381,558,107,16,5,1067,10,458,35.70759137769447,52.29615745079662,10.028116213683223,1.499531396438613,0.4686035613870665
93,서울특별시,강서구,가양제1동,가양제1동제5투,1503,1124,322,687,100,10,0,1119,5,379,28.775692582663094,61.3941018766756,8.936550491510276,0.8936550491510277,0.0
94,서울특별시,강서구,가양제1동,가양제1동제6투,1830,1469,549,742,149,15,2,1457,12,361,37.68016472203157,50.92656142759095,10.226492793411118,1.029512697323267,0.13726835964310227
95,서울특별시,강서구,가양제1동,가양제1동제7투,3510,2523,997,1057,395,35,9,2493,30,987,39.99197753710389,42.39871640593662,15.844364219815482,1.4039310068190936,0.36101083032490977
96,서울특별시,강서구,가양제1동,가양제1동제8투,2907,1846,698,805,285,32,2,1822,24,1061,38.30954994511526,44.182217343578486,15.642151481888037,1.756311745334797,0.10976948408342481
97,서울특별시,강서구,가양제1동,가양제1동제9투,2719,1782,629,793,319,25,1,1767,15,937,35.5970571590266,44.87832484436899,18.053197509903793,1.414827391058291,0.056593095642331635
98,서울특별시,강서구,가양제2동,관내사전투표,3871,3871,2507,1008,284,42,3,3844,27,0,65.21852237252862,26.222684703433924,7.388137356919875,1.09261186264308,0.07804370447450572
99,서울특별시,강서구,가양제2동,가양제2동제1투,1564,1096,250,763,68,8,0,1089,7,468,22.95684113865932,70.06427915518825,6.244260789715335,0.7346189164370982,0.0
100,서울특별시,강서구,가양제2동,가양제2동제2투,1644,1245,472,603,134,26,1,1236,9,399,38.18770226537217,48.786407766990294,10.841423948220065,2.103559870550162,0.08090614886731393
101,서울특별시,강서구,가양제2동,가양제2동제3투,1809,1112,413,598,76,11,4,1102,10,697,37.47731397459165,54.264972776769504,6.896551724137931,0.9981851179673321,0.3629764065335753
102,서울특별시,강서구,가양제2동,가양제2동제4투,1336,872,315,495,49,4,1,864,8,464,36.45833333333333,57.291666666666664,5.671296296296297,0.4629629629629629,0.11574074074074073
103,서울특별시,강서구,가양제2동,가양제2동제5투,2129,1553,582,805,136,15,3,1541,12,576,37.76768332251785,52.23880597014925,8.82543802725503,0.9733939000648929,0.1946787800129786
104,서울특별시,강서구,가양제3동,관내사전투표,3922,3922,2578,929,340,38,3,3888,34,0,66.30658436213992,23.894032921810698,8.74485596707819,0.977366255144033,0.07716049382716049
105,서울특별시,강서구,가양제3동,가양제3동제1투,1907,1378,504,734,111,14,1,1364,14,529,36.950146627565985,53.81231671554252,8.13782991202346,1.0263929618768328,0.07331378299120235
106,서울특별시,강서구,가양제3동,가양제3동제2투,1844,1231,397,708,104,11,1,1221,10,613,32.514332514332516,57.98525798525799,8.517608517608517,0.9009009009009009,0.08190008190008191
107,서울특별시,강서구,가양제3동,가양제3동제3투,1759,1257,499,622,111,15,0,1247,10,502,40.01603849238172,49.87971130713713,8.901363271852446,1.202886928628709,0.0
108,서울특별시,강서구,가양제3동,가양제3동제4투,1189,736,278,416,26,5,3,728,8,453,38.18681318681318,57.14285714285714,3.571428571428571,0.6868131868131868,0.4120879120879121
109,서울특별시,강서구,가양제3동,가양제3동제5투,1760,1379,458,718,172,20,2,1370,9,381,33.43065693430657,52.40875912408759,12.554744525547445,1.4598540145985401,0.145985401459854
110,서울특별시,강서구,발산제1동,관내사전투표,8638,8638,6030,1711,723,98,5,8567,71,0,70.38636628924945,19.971985525855025,8.43936033617369,1.1439243609198086,0.05836348780203105
111,서울특별시,강서구,발산제1동,발산제1동제1투,2199,1506,624,703,133,30,8,1498,8,693,41.655540720961284,46.92923898531375,8.878504672897195,2.0026702269692924,0.5340453938584779
112,서울특별시,강서구,발산제1동,발산제1동제2투,1833,1158,437,576,121,18,0,1152,6,675,37.93402777777778,50.0,10.503472222222223,1.5625,0.0
113,서울특별시,강서구,발산제1동,발산제1동제3투,2597,1848,750,886,161,30,2,1829,19,749,41.00601421541826,48.441771459814106,8.802624384909787,1.6402405686167305,0.10934937124111535
114,서울특별시,강서구,발산제1동,발산제1동제4투,2719,2094,891,990,162,32,2,2077,17,625,42.89841116995667,47.66490129995186,7.799711121810303,1.5406836783822822,0.09629272989889263
115,서울특별시,강서구,발산제1동,발산제1동제5투,2933,2153,874,1062,186,20,1,2143,10,780,40.783947736817545,49.556696220251986,8.67942137190854,0.9332711152589827,0.04666355576294914
116,서울특별시,강서구,발산제1동,발산제1동제6투,3035,2330,1115,923,241,34,3,2316,14,705,48.1433506044905,39.85319516407599,10.40587219343696,1.468048359240069,0.1295336787564767
117,서울특별시,강서구,발산제1동,발산제1동제7투,2222,1806,989,651,134,16,5,1795,11,416,55.097493036211695,36.267409470752085,7.465181058495822,0.8913649025069639,0.2785515320334262
118,서울특별시,강서구,발산제1동,발산제1동제8투,1968,1626,809,675,116,15,2,1617,9,342,50.03092145949288,41.74397031539889,7.173778602350031,0.927643784786642,0.12368583797155226
119,서울특별시,강서구,공항동,관내사전투표,5210,5210,3412,1247,486,35,2,5182,28,0,65.84330374372828,24.064067927441144,9.378618294094943,0.6754148977228869,0.0385951370127364
120,서울특별시,강서구,공항동,공항동제1투,1560,1025,352,553,90,16,4,1015,10,535,34.679802955665025,54.48275862068965,8.866995073891626,1.5763546798029555,0.3940886699507389
121,서울특별시,강서구,공항동,공항동제2투,2640,1565,523,828,173,20,4,1548,17,1075,33.78552971576227,53.48837209302325,11.175710594315245,1.2919896640826873,0.2583979328165375
122,서울특별시,강서구,공항동,공항동제3투,1916,1097,386,604,88,14,2,1094,3,819,35.283363802559414,55.21023765996343,8.043875685557587,1.2797074954296161,0.18281535648994515
123,서울특별시,강서구,공항동,공항동제4투,2079,1194,456,559,148,15,2,1180,14,885,38.64406779661017,47.37288135593221,12.54237288135593,1.2711864406779663,0.1694915254237288
124,서울특별시,강서구,공항동,공항동제5투,1936,1237,471,652,93,12,2,1230,7,699,38.29268292682927,53.008130081300806,7.560975609756097,0.975609756097561,0.16260162601626016
125,서울특별시,강서구,공항동,공항동제6투,3888,3093,1511,1269,269,25,1,3075,18,795,49.13821138211382,41.26829268292683,8.747967479674797,0.8130081300813009,0.03252032520325203
126,서울특별시,강서구,공항동,공항동제7투,2499,2012,990,810,167,26,2,1995,17,487,49.62406015037594,40.6015037593985,8.37092731829574,1.3032581453634084,0.10025062656641603
127,서울특별시,강서구,방화제1동,관내사전투표,9759,9759,6545,2225,830,87,4,9691,68,0,67.53688989784335,22.959446909503665,8.564647611185636,0.8977401712929522,0.041275410174388606
128,서울특별시,강서구,방화제1동,방화제1동제1투,1956,1363,510,691,139,13,0,1353,10,593,37.6940133037694,51.071692535107175,10.273466371027347,0.9608277900960829,0.0
129,서울특별시,강서구,방화제1동,방화제1동제2투,2185,1540,512,862,142,15,2,1533,7,645,33.39856490541422,56.22961513372472,9.262883235485974,0.9784735812133072,0.1304631441617743
130,서울특별시,강서구,방화제1동,방화제1동제3투,2100,1379,507,733,106,16,2,1364,15,721,37.17008797653959,53.739002932551315,7.771260997067449,1.1730205278592376,0.1466275659824047
131,서울특별시,강서구,방화제1동,방화제1동제4투,491,243,65,152,21,3,0,241,2,248,26.970954356846473,63.07053941908713,8.71369294605809,1.2448132780082988,0.0
132,서울특별시,강서구,방화제1동,방화제1동제5투,2165,1477,516,785,157,12,0,1470,7,688,35.10204081632653,53.40136054421769,10.680272108843537,0.8163265306122449,0.0
133,서울특별시,강서구,방화제1동,방화제1동제6투,2541,1834,619,985,198,20,4,1826,8,707,33.89923329682366,53.943044906900326,10.843373493975903,1.095290251916758,0.21905805038335158
134,서울특별시,강서구,방화제1동,방화제1동제7투,1962,1324,450,734,112,13,2,1311,13,638,34.32494279176201,55.98779557589626,8.543096872616324,0.9916094584286803,0.15255530129672007
135,서울특별시,강서구,방화제1동,방화제1동제8투,2448,1818,699,932,164,15,0,1810,8,630,38.61878453038674,51.49171270718232,9.060773480662982,0.8287292817679558,0.0
136,서울특별시,강서구,방화제1동,방화제1동제9투,2422,1931,983,784,130,20,1,1918,13,491,51.25130344108446,40.87591240875913,6.777893639207508,1.0427528675703857,0.05213764337851929
137,서울특별시,강서구,방화제1동,방화제1동제10투,3420,2666,1052,1275,277,45,3,2652,14,754,39.66817496229261,48.07692307692308,10.444947209653092,1.6968325791855203,0.11312217194570137
138,서울특별시,강서구,방화제2동,관내사전투표,5190,5190,3399,1293,428,30,5,5155,35,0,65.93598448108634,25.082444228903977,8.302618816682832,0.5819592628516004,0.09699321047526674
139,서울특별시,강서구,방화제2동,방화제2동제1투,2801,1757,626,878,200,27,3,1734,23,1044,36.10149942329873,50.63437139561707,11.534025374855824,1.5570934256055362,0.17301038062283738
140,서울특별시,강서구,방화제2동,방화제2동제2투,1958,1256,428,706,105,10,1,1250,6,702,34.239999999999995,56.48,8.4,0.8,0.08
141,서울특별시,강서구,방화제2동,방화제2동제3투,2433,1631,644,836,125,10,1,1616,15,802,39.851485148514854,51.73267326732673,7.735148514851485,0.6188118811881188,0.06188118811881188
142,서울특별시,강서구,방화제2동,방화제2동제4투,2188,1539,541,802,165,24,1,1533,6,649,35.290280495759944,52.31572080887149,10.76320939334638,1.5655577299412915,0.06523157208088715
143,서울특별시,강서구,방화제2동,방화제2동제5투,1719,1095,369,583,119,13,1,1085,10,624,34.00921658986175,53.73271889400921,10.967741935483872,1.19815668202765,0.09216589861751152
144,서울특별시,강서구,방화제2동,방화제2동제6투,1040,722,209,453,47,6,1,716,6,318,29.18994413407821,63.268156424581,6.564245810055866,0.8379888268156425,0.13966480446927373
145,서울특별시,강서구,방화제2동,방화제2동제7투,1538,1028,374,574,59,8,4,1019,9,510,36.702649656526006,56.329735034347394,5.789990186457311,0.7850834151128557,0.39254170755642787
146,서울특별시,강서구,방화제3동,관내사전투표,5908,5908,3793,1566,445,58,7,5869,39,0,64.62770489010052,26.68256943261203,7.582211620378258,0.988243312318964,0.1192707445902198
147,서울특별시,강서구,방화제3동,방화제3동제1투,2302,1540,549,823,139,22,2,1535,5,762,35.76547231270359,53.615635179153095,9.055374592833875,1.4332247557003257,0.13029315960912052
148,서울특별시,강서구,방화제3동,방화제3동제2투,1385,1040,438,478,103,12,2,1033,7,345,42.400774443368825,46.2729912875121,9.970958373668925,1.1616650532429817,0.1936108422071636
149,서울특별시,강서구,방화제3동,방화제3동제3투,1516,986,436,495,34,5,5,975,11,530,44.717948717948715,50.76923076923077,3.4871794871794872,0.5128205128205128,0.5128205128205128
150,서울특별시,강서구,방화제3동,방화제3동제4투,2333,1591,501,954,109,18,1,1583,8,742,31.648768161718255,60.265319014529375,6.885660138976626,1.137081490840177,0.06317119393556538
151,서울특별시,강서구,방화제3동,방화제3동제5투,1646,1245,368,757,93,18,1,1237,8,401,29.74939369442199,61.19644300727567,7.5181891673403385,1.4551333872271623,0.08084074373484236
152,서울특별시,강서구,방화제3동,방화제3동제6투,1390,916,304,535,58,11,1,909,7,474,33.44334433443345,58.855885588558856,6.380638063806381,1.21012101210121,0.11001100110011
153,서울특별시,강서구,방화제3동,방화제3동제7투,1906,1339,465,741,103,18,1,1328,11,567,35.015060240963855,55.798192771084345,7.756024096385543,1.355421686746988,0.07530120481927711
154,서울특별시,강서구,잘못 투입·구분된 투표지,,0,1,0,0,0,0,0,0,1,-1,0.0,0.0,0.0,0.0,0.0
0,서울특별시,구로구,거소·선상투표,,418,386,183,115,69,7,1,375,11,32,48.8,30.666666666666664,18.4,1.866666666666667,0.26666666666666666
1,서울특별시,구로구,관외사전투표,,38001,37996,22953,8890,5137,569,53,37602,394,5,61.04196585288017,23.64235944896548,13.661507366629436,1.513217382054146,0.14094994947077283
2,서울특별시,구로구,재외투표,,2405,1953,1354,374,184,22,2,1936,17,452,69.93801652892562,19.318181818181817,9.50413223140496,1.1363636363636365,0.10330578512396695
3,서울특별시,구로구,신도림동,관내사전투표,7134,7134,4638,1765,608,87,2,7100,34,0,65.32394366197182,24.859154929577464,8.56338028169014,1.2253521126760565,0.028169014084507043
4,서울특별시,구로구,신도림동,신도림동제1투,2926,2034,696,1086,208,29,2,2021,13,892,34.43839683325087,53.7357743691242,10.29193468579911,1.4349332013854528,0.09896091044037605
5,서울특별시,구로구,신도림동,신도림동제2투,2267,1863,700,923,197,32,0,1852,11,404,37.79697624190065,49.83801295896328,10.637149028077754,1.7278617710583155,0.0
6,서울특별시,구로구,신도림동,신도림동제3투,2000,1621,576,807,186,33,2,1604,17,379,35.910224438902745,50.31172069825436,11.596009975062344,2.057356608478803,0.12468827930174563
7,서울특별시,구로구,신도림동,신도림동제4투,2079,1409,463,800,123,16,0,1402,7,670,33.02425106990014,57.06134094151213,8.773181169757489,1.1412268188302426,0.0
8,서울특별시,구로구,신도림동,신도림동제5투,2421,1934,770,957,176,22,1,1926,8,487,39.979231568016615,49.68847352024922,9.138110072689512,1.142263759086189,0.05192107995846314
9,서울특별시,구로구,신도림동,신도림동제6투,2528,2044,766,1024,210,31,1,2032,12,484,37.696850393700785,50.39370078740157,10.334645669291339,1.5255905511811023,0.049212598425196846
10,서울특별시,구로구,신도림동,신도림동제7투,2906,2213,714,1188,268,26,3,2199,14,693,32.46930422919509,54.02455661664393,12.187357889949977,1.182355616189177,0.1364256480218281
11,서울특별시,구로구,신도림동,신도림동제8투,2734,2181,710,1255,186,17,1,2169,12,553,32.733978792070076,57.860765329645005,8.575380359612724,0.7837713231904103,0.04610419548178884
12,서울특별시,구로구,구로제1동,관내사전투표,4985,4985,3343,1131,431,52,3,4960,25,0,67.39919354838709,22.80241935483871,8.689516129032258,1.0483870967741937,0.06048387096774194
13,서울특별시,구로구,구로제1동,구로제1동제1투,2020,1515,554,805,137,12,0,1508,7,505,36.737400530503976,53.38196286472149,9.084880636604776,0.7957559681697612,0.0
14,서울특별시,구로구,구로제1동,구로제1동제2투,1826,1377,468,718,150,22,1,1359,18,449,34.437086092715234,52.83296541574687,11.037527593818984,1.6188373804267846,0.07358351729212656
15,서울특별시,구로구,구로제1동,구로제1동제3투,1852,1364,419,779,130,21,3,1352,12,488,30.99112426035503,57.61834319526628,9.615384615384617,1.5532544378698225,0.22189349112426035
16,서울특별시,구로구,구로제1동,구로제1동제4투,2008,1426,575,658,160,21,2,1416,10,582,40.60734463276836,46.46892655367232,11.299435028248588,1.4830508474576272,0.14124293785310735
17,서울특별시,구로구,구로제1동,구로제1동제5투,2575,1865,774,833,213,30,0,1850,15,710,41.83783783783784,45.027027027027025,11.513513513513514,1.6216216216216217,0.0
18,서울특별시,구로구,구로제2동,관내사전투표,4340,4340,3077,979,230,35,2,4323,17,0,71.17742308582004,22.646310432569976,5.320379366180893,0.8096229470275271,0.046264168401572985
19,서울특별시,구로구,구로제2동,구로제2동제1투,1445,773,317,394,45,12,1,769,4,672,41.222366710013006,51.23537061118335,5.851755526657997,1.5604681404421328,0.13003901170351106
20,서울특별시,구로구,구로제2동,구로제2동제2투,2355,1349,501,717,101,8,2,1329,20,1006,37.69751693002257,53.95033860045147,7.599699021820918,0.601956358164033,0.15048908954100826
21,서울특별시,구로구,구로제2동,구로제2동제3투,650,404,152,206,40,4,0,402,2,246,37.81094527363184,51.243781094527364,9.950248756218906,0.9950248756218906,0.0
22,서울특별시,구로구,구로제2동,구로제2동제4투,1742,1045,437,503,91,6,1,1038,7,697,42.10019267822736,48.458574181117534,8.766859344894026,0.5780346820809248,0.09633911368015415
23,서울특별시,구로구,구로제2동,구로제2동제5투,3024,1991,832,974,145,19,4,1974,17,1033,42.14792299898683,49.34143870314083,7.34549138804458,0.9625126646403243,0.2026342451874367
24,서울특별시,구로구,구로제2동,구로제2동제6투,2839,2065,831,985,208,22,2,2048,17,774,40.576171875,48.095703125,10.15625,1.07421875,0.09765625
25,서울특별시,구로구,구로제2동,구로제2동제7투,1217,696,271,359,55,3,2,690,6,521,39.27536231884058,52.028985507246375,7.971014492753622,0.43478260869565216,0.2898550724637681
26,서울특별시,구로구,구로제3동,관내사전투표,5273,5273,3652,1018,505,47,9,5231,42,0,69.81456700439686,19.46090613649398,9.653985853565283,0.8984897725100364,0.17205123303383674
27,서울특별시,구로구,구로제3동,구로제3동제1투,1385,859,381,378,84,5,3,851,8,526,44.770857814336075,44.41833137485312,9.870740305522913,0.5875440658049353,0.35252643948296125
28,서울특별시,구로구,구로제3동,구로제3동제2투,1439,849,376,395,54,8,2,835,14,590,45.02994011976048,47.30538922155689,6.467065868263473,0.9580838323353293,0.23952095808383234
29,서울특별시,구로구,구로제3동,구로제3동제3투,2016,1479,674,645,124,25,1,1469,10,537,45.88155207624234,43.907420013614704,8.441116405718176,1.7018379850238259,0.06807351940095302
30,서울특별시,구로구,구로제3동,구로제3동제4투,2168,1532,684,639,174,18,2,1517,15,636,45.08899143045485,42.122610415293344,11.47000659195781,1.186552406064601,0.13183915622940012
31,서울특별시,구로구,구로제3동,구로제3동제5투,1921,1293,536,476,253,16,1,1282,11,628,41.80967238689547,37.129485179407176,19.734789391575664,1.24804992199688,0.078003120124805
32,서울특별시,구로구,구로제3동,구로제3동제6투,1757,1392,597,646,118,23,1,1385,7,365,43.104693140794225,46.64259927797834,8.51985559566787,1.660649819494585,0.07220216606498195
33,서울특별시,구로구,구로제3동,구로제3동제7투,3002,1748,650,743,311,23,5,1732,16,1254,37.52886836027714,42.89838337182448,17.956120092378754,1.327944572748268,0.28868360277136257
34,서울특별시,구로구,구로제4동,관내사전투표,3475,3475,2405,864,164,17,2,3452,23,0,69.66975666280418,25.02896871378911,4.750869061413673,0.49246813441483195,0.057937427578215524
35,서울특별시,구로구,구로제4동,구로제4동제1투,1914,1205,590,531,70,4,0,1195,10,709,49.37238493723849,44.43514644351465,5.857740585774058,0.33472803347280333,0.0
36,서울특별시,구로구,구로제4동,구로제4동제2투,1527,977,421,495,49,5,0,970,7,550,43.402061855670105,51.03092783505154,5.051546391752577,0.5154639175257731,0.0
37,서울특별시,구로구,구로제4동,구로제4동제3투,2151,1566,694,708,131,21,2,1556,10,585,44.601542416452446,45.501285347043705,8.419023136246787,1.3496143958868894,0.12853470437017994
38,서울특별시,구로구,구로제4동,구로제4동제4투,1208,687,263,367,46,5,2,683,4,521,38.50658857979502,53.733528550512446,6.734992679355783,0.7320644216691069,0.29282576866764276
39,서울특별시,구로구,구로제4동,구로제4동제5투,2608,1743,674,839,182,20,4,1719,24,865,39.208842350203604,48.80744618964514,10.587550901687028,1.1634671320535195,0.2326934264107039
40,서울특별시,구로구,구로제4동,구로제4동제6투,1303,838,318,438,69,9,2,836,2,465,38.038277511961724,52.39234449760766,8.253588516746412,1.076555023923445,0.23923444976076555
41,서울특별시,구로구,구로제5동,관내사전투표,6421,6421,4329,1398,554,79,10,6370,51,0,67.9591836734694,21.946624803767662,8.69701726844584,1.2401883830455258,0.15698587127158556
42,서울특별시,구로구,구로제5동,구로제5동제1투,2224,1587,663,760,134,17,2,1576,11,637,42.068527918781726,48.223350253807105,8.50253807106599,1.0786802030456852,0.12690355329949238
43,서울특별시,구로구,구로제5동,구로제5동제2투,2946,2375,943,1150,234,34,0,2361,14,571,39.94070309191021,48.70817450232952,9.91105463786531,1.4400677678949596,0.0
44,서울특별시,구로구,구로제5동,구로제5동제3투,2753,1760,652,865,203,20,3,1743,17,993,37.40676993689041,49.62707974756167,11.646586345381527,1.1474469305794608,0.17211703958691912
45,서울특별시,구로구,구로제5동,구로제5동제4투,2953,1865,702,883,238,22,0,1845,20,1088,38.048780487804876,47.859078590785906,12.899728997289973,1.1924119241192412,0.0
46,서울특별시,구로구,구로제5동,구로제5동제5투,3931,2793,1159,1220,357,24,1,2761,32,1138,41.97754436798262,44.18688880840275,12.930097790655559,0.8692502716407098,0.036218761318362915
47,서울특별시,구로구,구로제5동,구로제5동제6투,2756,2214,773,1209,178,36,1,2197,17,542,35.184342284934,55.02958579881657,8.10195721438325,1.6385980883022302,0.04551661356395084
48,서울특별시,구로구,가리봉동,관내사전투표,1924,1924,1306,403,183,11,3,1906,18,0,68.52046169989507,21.143756558237143,9.601259181532004,0.577124868835257,0.15739769150052466
49,서울특별시,구로구,가리봉동,가리봉동제1투,1366,718,265,377,60,8,0,710,8,648,37.32394366197183,53.09859154929577,8.450704225352112,1.1267605633802817,0.0
50,서울특별시,구로구,가리봉동,가리봉동제2투,2364,1336,485,626,197,14,0,1322,14,1028,36.68683812405446,47.352496217851744,14.901664145234495,1.059001512859304,0.0
51,서울특별시,구로구,가리봉동,가리봉동제3투,1657,990,414,453,101,14,3,985,5,667,42.03045685279188,45.98984771573604,10.253807106598984,1.4213197969543148,0.3045685279187817
52,서울특별시,구로구,고척제1동,관내사전투표,6392,6392,4134,1587,576,51,4,6352,40,0,65.08186397984886,24.984256926952142,9.06801007556675,0.802896725440806,0.06297229219143577
53,서울특별시,구로구,고척제1동,고척제1동제1투,2283,1610,595,836,145,18,2,1596,14,673,37.280701754385966,52.38095238095239,9.085213032581454,1.1278195488721803,0.12531328320802004
54,서울특별시,구로구,고척제1동,고척제1동제2투,2487,1750,595,967,157,19,1,1739,11,737,34.21506612995975,55.60667050028753,9.028177113283496,1.0925819436457735,0.05750431282346176
55,서울특별시,구로구,고척제1동,고척제1동제3투,3126,2232,797,1149,240,26,1,2213,19,894,36.014460009037506,51.92046995029372,10.845006778129235,1.174875734297334,0.045187528242205156
56,서울특별시,구로구,고척제1동,고척제1동제4투,1849,1207,436,643,108,11,1,1199,8,642,36.36363636363637,53.628023352793996,9.007506255212677,0.9174311926605505,0.08340283569641367
57,서울특별시,구로구,고척제1동,고척제1동제5투,2563,1897,767,955,145,17,0,1884,13,666,40.711252653927815,50.69002123142251,7.6963906581740975,0.9023354564755839,0.0
58,서울특별시,구로구,고척제1동,고척제1동제6투,2610,2102,873,844,337,26,1,2081,21,508,41.950985103315716,40.55742431523306,16.194137433926,1.2493993272465163,0.04805382027871216
59,서울특별시,구로구,고척제2동,관내사전투표,4592,4592,3106,1118,299,46,2,4571,21,0,67.95012032378035,24.458542988405163,6.541238241085101,1.0063443447823233,0.04375410194705754
60,서울특별시,구로구,고척제2동,고척제2동제1투,2249,1506,581,783,109,19,1,1493,13,743,38.91493636972538,52.44474212993971,7.300736771600803,1.2726054922973877,0.06697923643670461
61,서울특별시,구로구,고척제2동,고척제2동제2투,2229,1636,615,857,123,27,2,1624,12,593,37.86945812807882,52.77093596059114,7.573891625615764,1.66256157635468,0.12315270935960591
62,서울특별시,구로구,고척제2동,고척제2동제3투,2278,1555,641,747,132,26,0,1546,9,723,41.46183699870634,48.31824062095731,8.538163001293661,1.6817593790426906,0.0
63,서울특별시,구로구,고척제2동,고척제2동제4투,1876,1143,473,586,62,13,1,1135,8,733,41.67400881057269,51.629955947136565,5.462555066079295,1.145374449339207,0.0881057268722467
64,서울특별시,구로구,고척제2동,고척제2동제5투,1861,1186,422,655,86,10,1,1174,12,675,35.945485519591145,55.792163543441234,7.325383304940375,0.8517887563884157,0.08517887563884156
65,서울특별시,구로구,고척제2동,고척제2동제6투,2586,2002,825,998,146,22,1,1992,10,584,41.41566265060241,50.100401606425706,7.329317269076305,1.104417670682731,0.0502008032128514
66,서울특별시,구로구,고척제2동,고척제2동제7투,1606,1157,387,644,110,8,1,1150,7,449,33.65217391304348,56.00000000000001,9.565217391304348,0.6956521739130435,0.08695652173913043
67,서울특별시,구로구,개봉제1동,관내사전투표,5851,5851,3949,1455,339,64,5,5812,39,0,67.94562973158982,25.034411562284927,5.832759807295251,1.1011699931176875,0.08602890571231935
68,서울특별시,구로구,개봉제1동,개봉제1동제1투,2222,1535,596,800,106,22,1,1525,10,687,39.08196721311475,52.459016393442624,6.950819672131148,1.4426229508196722,0.06557377049180328
69,서울특별시,구로구,개봉제1동,개봉제1동제2투,1943,1416,542,774,83,4,2,1405,11,527,38.57651245551602,55.088967971530245,5.907473309608541,0.2846975088967972,0.1423487544483986
70,서울특별시,구로구,개봉제1동,개봉제1동제3투,1837,1116,394,606,100,12,2,1114,2,721,35.36804308797127,54.39856373429084,8.976660682226212,1.0771992818671454,0.17953321364452424
71,서울특별시,구로구,개봉제1동,개봉제1동제4투,2217,1535,626,744,138,12,1,1521,14,682,41.157133464825776,48.91518737672584,9.072978303747535,0.7889546351084813,0.06574621959237344
72,서울특별시,구로구,개봉제1동,개봉제1동제5투,2580,1723,629,920,135,24,3,1711,12,857,36.76212741087084,53.7697253068381,7.8901227352425485,1.402688486265342,0.17533606078316774
73,서울특별시,구로구,개봉제1동,개봉제1동제6투,2075,1290,464,696,103,14,3,1280,10,785,36.25,54.37499999999999,8.046875,1.09375,0.234375
74,서울특별시,구로구,개봉제1동,개봉제1동제7투,3701,2775,1174,1282,268,36,0,2760,15,926,42.536231884057976,46.44927536231884,9.710144927536232,1.3043478260869565,0.0
75,서울특별시,구로구,개봉제1동,개봉제1동제8투,3376,2636,1114,1246,234,20,2,2616,20,740,42.584097859327215,47.62996941896024,8.944954128440367,0.764525993883792,0.0764525993883792
76,서울특별시,구로구,개봉제2동,관내사전투표,6536,6536,4372,1590,475,60,3,6500,36,0,67.26153846153846,24.461538461538463,7.307692307692308,0.9230769230769231,0.04615384615384615
77,서울특별시,구로구,개봉제2동,개봉제2동제1투,2214,1416,540,730,119,11,2,1402,14,798,38.516405135520685,52.06847360912982,8.487874465049929,0.7845934379457917,0.14265335235378032
78,서울특별시,구로구,개봉제2동,개봉제2동제2투,2100,1436,586,702,124,11,2,1425,11,664,41.12280701754386,49.26315789473684,8.701754385964913,0.7719298245614036,0.14035087719298245
79,서울특별시,구로구,개봉제2동,개봉제2동제3투,2114,1676,525,1004,117,18,1,1665,11,438,31.53153153153153,60.3003003003003,7.027027027027027,1.0810810810810811,0.06006006006006006
80,서울특별시,구로구,개봉제2동,개봉제2동제4투,2439,1942,750,1006,155,20,2,1933,9,497,38.7997930677703,52.0434557682359,8.01862390067253,1.0346611484738748,0.10346611484738748
81,서울특별시,구로구,개봉제2동,개봉제2동제5투,2303,1878,619,1075,157,15,3,1869,9,425,33.119315141787055,57.51738897806313,8.400214018191546,0.8025682182985553,0.16051364365971107
82,서울특별시,구로구,개봉제2동,개봉제2동제6투,2166,1726,689,840,150,33,4,1716,10,440,40.15151515151515,48.95104895104895,8.741258741258742,1.9230769230769231,0.2331002331002331
83,서울특별시,구로구,개봉제2동,개봉제2동제7투,2334,1685,748,767,135,23,0,1673,12,649,44.7101016138673,45.84578601315003,8.069336521219366,1.3747758517632995,0.0
84,서울특별시,구로구,개봉제2동,개봉제2동제8투,1544,1141,430,595,90,17,0,1132,9,403,37.985865724381625,52.561837455830386,7.950530035335689,1.5017667844522968,0.0
85,서울특별시,구로구,개봉제3동,관내사전투표,4100,4100,2746,1070,231,32,6,4085,15,0,67.22154222766218,26.193390452876375,5.65483476132191,0.7833537331701347,0.14687882496940025
86,서울특별시,구로구,개봉제3동,개봉제3동제1투,2544,1649,690,825,110,12,1,1638,11,895,42.124542124542124,50.366300366300365,6.715506715506716,0.7326007326007326,0.06105006105006105
87,서울특별시,구로구,개봉제3동,개봉제3동제2투,2231,1420,563,736,97,11,1,1408,12,811,39.98579545454545,52.27272727272727,6.889204545454546,0.78125,0.07102272727272728
88,서울특별시,구로구,개봉제3동,개봉제3동제3투,2272,1421,500,790,108,10,4,1412,9,851,35.41076487252124,55.949008498583574,7.64872521246459,0.708215297450425,0.28328611898017
89,서울특별시,구로구,개봉제3동,개봉제3동제4투,2161,1684,623,875,151,25,1,1675,9,477,37.19402985074627,52.23880597014925,9.014925373134329,1.4925373134328357,0.05970149253731343
90,서울특별시,구로구,개봉제3동,개봉제3동제5투,1555,1073,430,505,106,18,1,1060,13,482,40.56603773584906,47.64150943396226,10.0,1.6981132075471699,0.09433962264150944
91,서울특별시,구로구,오류제1동,관내사전투표,6077,6077,3953,1454,529,79,3,6018,59,0,65.68627450980392,24.160850780990362,8.79029577932868,1.3127284812229978,0.049850448654037885
92,서울특별시,구로구,오류제1동,오류제1동제1투,3175,1892,704,870,256,39,5,1874,18,1283,37.5667022411953,46.4247598719317,13.660618996798293,2.08110992529349,0.26680896478121663
93,서울특별시,구로구,오류제1동,오류제1동제2투,2773,1839,677,981,135,26,1,1820,19,934,37.1978021978022,53.9010989010989,7.417582417582418,1.4285714285714286,0.054945054945054944
94,서울특별시,구로구,오류제1동,오류제1동제3투,2702,1741,504,1070,124,22,3,1723,18,961,29.251305861868833,62.100986651189785,7.196749854904237,1.2768427161926872,0.17411491584445735
95,서울특별시,구로구,오류제1동,오류제1동제4투,2295,1807,689,972,122,13,0,1796,11,488,38.3630289532294,54.12026726057907,6.7928730512249444,0.7238307349665924,0.0
96,서울특별시,구로구,오류제1동,오류제1동제5투,2630,1874,700,923,203,22,1,1849,25,756,37.85830178474851,49.91887506760411,10.978907517577069,1.1898323418063819,0.05408328826392645
97,서울특별시,구로구,오류제2동,관내사전투표,5549,5549,3896,1198,349,62,5,5510,39,0,70.70780399274047,21.742286751361164,6.333938294010889,1.1252268602540834,0.09074410163339383
98,서울특별시,구로구,오류제2동,오류제2동제1투,2655,1808,615,1043,114,17,0,1789,19,847,34.37674678591392,58.30072666294019,6.372275013974288,0.9502515371716043,0.0
99,서울특별시,구로구,오류제2동,오류제2동제2투,2583,1756,598,989,127,22,4,1740,16,827,34.367816091954026,56.839080459770116,7.2988505747126435,1.264367816091954,0.22988505747126436
100,서울특별시,구로구,오류제2동,오류제2동제3투,2930,2248,814,1221,179,21,2,2237,11,682,36.38801966919982,54.58202950379973,8.001788109074653,0.9387572641931158,0.08940545373267769
101,서울특별시,구로구,오류제2동,오류제2동제4투,2091,1563,593,828,110,20,2,1553,10,528,38.1841596909208,53.31616226658081,7.083065035415325,1.28783000643915,0.128783000643915
102,서울특별시,구로구,오류제2동,오류제2동제5투,2116,1490,626,734,93,20,2,1475,15,626,42.440677966101696,49.762711864406775,6.305084745762713,1.3559322033898304,0.13559322033898305
103,서울특별시,구로구,오류제2동,오류제2동제6투,2682,1943,783,991,135,23,1,1933,10,739,40.506983962752194,51.2674599068805,6.983962752198655,1.189860320744956,0.05173305742369374
104,서울특별시,구로구,오류제2동,오류제2동제7투,3121,2376,1091,1062,165,40,2,2360,16,745,46.228813559322035,45.0,6.991525423728813,1.694915254237288,0.0847457627118644
105,서울특별시,구로구,오류제2동,오류제2동제8투,2245,1703,701,840,135,22,0,1698,5,542,41.283863368669024,49.46996466431096,7.950530035335689,1.2956419316843346,0.0
106,서울특별시,구로구,수궁동,관내사전투표,4027,4027,2693,1026,225,58,6,4008,19,0,67.19061876247505,25.59880239520958,5.61377245508982,1.4471057884231537,0.14970059880239522
107,서울특별시,구로구,수궁동,수궁동제1투,2663,1988,448,1397,104,14,3,1966,22,675,22.787385554425228,71.05798575788403,5.289928789420142,0.7121057985757884,0.1525940996948118
108,서울특별시,구로구,수궁동,수궁동제2투,2141,1546,496,931,92,10,3,1532,14,595,32.375979112271544,60.77023498694517,6.005221932114883,0.6527415143603132,0.19582245430809397
109,서울특별시,구로구,수궁동,수궁동제3투,2769,1930,572,1202,126,17,0,1917,13,839,29.83828899321857,62.70213875847679,6.572769953051644,0.8868022952529996,0.0
110,서울특별시,구로구,수궁동,수궁동제4투,2227,1779,690,927,131,22,4,1774,5,448,38.89515219842165,52.254791431792555,7.384441939120631,1.2401352874859075,0.2254791431792559
111,서울특별시,구로구,수궁동,수궁동제5투,2473,1750,687,898,130,20,3,1738,12,723,39.52819332566168,51.66858457997699,7.479861910241657,1.1507479861910241,0.17261219792865362
112,서울특별시,구로구,수궁동,수궁동제6투,1061,758,300,392,45,8,2,747,11,303,40.16064257028113,52.47657295850067,6.024096385542169,1.07095046854083,0.2677376171352075
113,서울특별시,구로구,항동,관내사전투표,3792,3792,2723,744,254,50,2,3773,19,0,72.17068645640074,19.71905645375033,6.732043466737345,1.3252054068380599,0.05300821627352239
114,서울특별시,구로구,항동,항동제1투,2905,2163,869,1071,163,43,3,2149,14,742,40.43741275011633,49.8371335504886,7.584923220102373,2.0009306654257797,0.13959981386691486
115,서울특별시,구로구,항동,항동제2투,2235,1703,732,761,167,27,2,1689,14,532,43.3392539964476,45.05624629958555,9.887507400828893,1.5985790408525755,0.11841326228537595
116,서울특별시,구로구,항동,항동제3투,2162,1605,654,761,153,19,0,1587,18,557,41.209829867674856,47.9521109010712,9.640831758034027,1.1972274732199117,0.0
117,서울특별시,구로구,잘못 투입·구분된 투표지,,0,0,0,0,0,0,0,0,0,0,0.0,0.0,0.0,0.0,0.0
0,서울특별시,금천구,거소·선상투표,,303,285,122,98,47,0,2,269,16,18,45.353159851301115,36.43122676579926,17.472118959107807,0.0,0.7434944237918215
1,서울특별시,금천구,관외사전투표,,22852,22849,14054,5077,3122,311,21,22585,264,3,62.22714190834625,22.479521806508746,13.823334071286252,1.3770201461146778,0.09298206774407793
2,서울특별시,금천구,재외투표,,1110,880,628,141,91,12,0,872,8,230,72.01834862385321,16.1697247706422,10.435779816513762,1.3761467889908259,0.0
3,서울특별시,금천구,가산동,관내사전투표,5759,5759,3673,1057,870,89,6,5695,64,0,64.49517120280949,18.560140474100088,15.276558384547851,1.562774363476734,0.10535557506584722
4,서울특별시,금천구,가산동,가산동제1투,3403,2127,741,932,380,35,2,2090,37,1276,35.45454545454545,44.593301435406694,18.181818181818183,1.674641148325359,0.09569377990430622
5,서울특별시,금천구,가산동,가산동제2투,3470,1985,757,856,318,27,2,1960,25,1485,38.62244897959184,43.673469387755105,16.224489795918366,1.3775510204081634,0.10204081632653061
6,서울특별시,금천구,가산동,가산동제3투,2680,1979,776,955,200,27,2,1960,19,701,39.59183673469388,48.724489795918366,10.204081632653061,1.3775510204081634,0.10204081632653061
7,서울특별시,금천구,가산동,가산동제4투,3234,2013,767,848,341,28,5,1989,24,1221,38.56209150326798,42.63448969331322,17.14429361488185,1.4077425842131726,0.2513826043237808
8,서울특별시,금천구,가산동,가산동제5투,810,519,227,229,58,1,0,515,4,291,44.07766990291262,44.46601941747573,11.262135922330096,0.1941747572815534,0.0
9,서울특별시,금천구,가산동,가산동제6투,2017,1303,497,525,243,24,1,1290,13,714,38.52713178294573,40.69767441860465,18.83720930232558,1.8604651162790697,0.07751937984496124
10,서울특별시,금천구,독산제1동,관내사전투표,6560,6560,4345,1312,747,84,8,6496,64,0,66.88731527093597,20.19704433497537,11.499384236453201,1.293103448275862,0.12315270935960591
11,서울특별시,금천구,독산제1동,독산제1동제1투,4021,2503,918,1149,369,31,4,2471,32,1518,37.15095103197086,46.49939295831647,14.933225414811819,1.2545528126264671,0.16187778227438285
12,서울특별시,금천구,독산제1동,독산제1동제2투,2585,1589,649,628,270,23,2,1572,17,996,41.28498727735369,39.94910941475827,17.17557251908397,1.4631043256997456,0.1272264631043257
13,서울특별시,금천구,독산제1동,독산제1동제3투,3935,2580,1019,1073,427,35,1,2555,25,1355,39.88258317025441,41.99608610567515,16.71232876712329,1.36986301369863,0.03913894324853229
14,서울특별시,금천구,독산제1동,독산제1동제4투,3026,2335,1044,1023,225,28,2,2322,13,691,44.96124031007752,44.05684754521964,9.689922480620156,1.2058570198105083,0.08613264427217916
15,서울특별시,금천구,독산제1동,독산제1동제5투,2262,1608,726,740,108,13,3,1590,18,654,45.660377358490564,46.540880503144656,6.7924528301886795,0.8176100628930818,0.18867924528301888
16,서울특별시,금천구,독산제1동,독산제1동제6투,2976,2246,841,1177,178,29,3,2228,18,730,37.74685816876122,52.82764811490126,7.989228007181329,1.3016157989228008,0.13464991023339318
17,서울특별시,금천구,독산제1동,독산제1동제7투,3520,2878,1209,1325,288,40,3,2865,13,642,42.19895287958116,46.247818499127405,10.052356020942408,1.3961605584642234,0.10471204188481677
18,서울특별시,금천구,독산제1동,독산제1동제8투,2682,2101,920,887,251,24,1,2083,18,581,44.16706673067691,42.58281325012002,12.049927988478156,1.1521843494959194,0.04800768122899664
19,서울특별시,금천구,독산제1동,독산제1동제9투,4094,2842,1212,1134,428,28,4,2806,36,1252,43.19315751960085,40.413399857448326,15.25302922309337,0.9978617248752674,0.14255167498218105
20,서울특별시,금천구,독산제2동,관내사전투표,4258,4258,2935,995,267,28,5,4230,28,0,69.3853427895981,23.52245862884161,6.312056737588652,0.6619385342789598,0.1182033096926714
21,서울특별시,금천구,독산제2동,독산제2동제1투,1728,1101,471,490,105,17,3,1086,15,627,43.370165745856355,45.11970534069982,9.668508287292818,1.5653775322283612,0.2762430939226519
22,서울특별시,금천구,독산제2동,독산제2동제2투,1846,1090,385,578,110,9,2,1084,6,756,35.51660516605166,53.321033210332104,10.14760147601476,0.8302583025830259,0.18450184501845018
23,서울특별시,금천구,독산제2동,독산제2동제3투,1504,909,358,441,89,11,0,899,10,595,39.822024471635146,49.05450500556173,9.899888765294772,1.2235817575083427,0.0
24,서울특별시,금천구,독산제2동,독산제2동제4투,1619,959,390,460,91,6,1,948,11,660,41.139240506329116,48.52320675105485,9.599156118143458,0.6329113924050633,0.10548523206751054
25,서울특별시,금천구,독산제2동,독산제2동제5투,1688,972,413,454,84,9,1,961,11,716,42.97606659729448,47.242455775234134,8.74089490114464,0.9365244536940687,0.10405827263267431
26,서울특별시,금천구,독산제2동,독산제2동제6투,1851,1088,497,497,79,5,1,1079,9,763,46.06116774791474,46.06116774791474,7.32159406858202,0.46339202965708987,0.09267840593141798
27,서울특별시,금천구,독산제3동,관내사전투표,5140,5140,3595,1124,324,48,4,5095,45,0,70.55937193326791,22.060843964671246,6.359175662414132,0.9421000981354269,0.07850834151128558
28,서울특별시,금천구,독산제3동,독산제3동제1투,2461,1575,657,758,131,15,2,1563,12,886,42.034548944337814,48.49648112603967,8.38131797824696,0.9596928982725527,0.12795905310300704
29,서울특별시,금천구,독산제3동,독산제3동제2투,2456,1683,735,786,128,20,1,1670,13,773,44.01197604790419,47.06586826347306,7.664670658682635,1.1976047904191618,0.059880239520958084
30,서울특별시,금천구,독산제3동,독산제3동제3투,2292,1430,553,718,127,17,1,1416,14,862,39.05367231638418,50.706214689265536,8.968926553672317,1.2005649717514124,0.07062146892655367
31,서울특별시,금천구,독산제3동,독산제3동제4투,2053,1141,466,532,119,10,1,1128,13,912,41.312056737588655,47.16312056737589,10.549645390070921,0.8865248226950355,0.08865248226950355
32,서울특별시,금천구,독산제3동,독산제3동제5투,2045,1312,544,633,114,10,0,1301,11,733,41.81398923904689,48.65488086087625,8.762490392006148,0.7686395080707148,0.0
33,서울특별시,금천구,독산제3동,독산제3동제6투,2357,1570,682,699,154,24,2,1561,9,787,43.689942344650866,44.77898782831518,9.865470852017937,1.5374759769378605,0.12812299807815503
34,서울특별시,금천구,독산제4동,관내사전투표,4128,4128,2844,1012,225,31,3,4115,13,0,69.11300121506683,24.59295261239368,5.467800729040097,0.7533414337788579,0.07290400972053464
35,서울특별시,금천구,독산제4동,독산제4동제1투,2101,1286,477,689,97,12,1,1276,10,815,37.38244514106583,53.99686520376176,7.601880877742946,0.9404388714733543,0.07836990595611285
36,서울특별시,금천구,독산제4동,독산제4동제2투,2204,1311,514,657,106,22,1,1300,11,893,39.53846153846154,50.53846153846154,8.153846153846153,1.6923076923076923,0.07692307692307693
37,서울특별시,금천구,독산제4동,독산제4동제3투,1584,947,408,439,81,9,0,937,10,637,43.54322305229456,46.85165421558165,8.64461045891142,0.96051227321238,0.0
38,서울특별시,금천구,독산제4동,독산제4동제4투,2200,1387,647,593,123,13,2,1378,9,813,46.95210449927431,43.033381712627,8.925979680696662,0.9433962264150944,0.14513788098693758
39,서울특별시,금천구,시흥제1동,관내사전투표,6902,6902,4543,1790,454,63,4,6854,48,0,66.28246279544791,26.116136562591187,6.623869273416982,0.9191712868398016,0.05836008170411438
40,서울특별시,금천구,시흥제1동,시흥제1동제1투,2253,1581,614,757,169,27,4,1571,10,672,39.08338637810312,48.18586887332909,10.757479312539783,1.718650541056652,0.2546148949713558
41,서울특별시,금천구,시흥제1동,시흥제1동제2투,3298,2272,912,1040,270,23,5,2250,22,1026,40.53333333333333,46.22222222222222,12.0,1.0222222222222224,0.2222222222222222
42,서울특별시,금천구,시흥제1동,시흥제1동제3투,2251,1703,678,869,124,20,3,1694,9,548,40.023612750885476,51.298701298701296,7.319952774498228,1.1806375442739079,0.1770956316410862
43,서울특별시,금천구,시흥제1동,시흥제1동제4투,1660,854,357,403,74,9,0,843,11,806,42.34875444839858,47.805456702253856,8.778173190984578,1.0676156583629894,0.0
44,서울특별시,금천구,시흥제1동,시흥제1동제5투,1925,1105,456,542,83,9,1,1091,14,820,41.79651695692026,49.679193400549956,7.6076993583868004,0.8249312557286892,0.09165902841429881
45,서울특별시,금천구,시흥제1동,시흥제1동제6투,1740,1112,440,566,87,9,2,1104,8,628,39.85507246376812,51.26811594202898,7.880434782608696,0.8152173913043478,0.18115942028985507
46,서울특별시,금천구,시흥제1동,시흥제1동제7투,1593,985,376,526,64,12,0,978,7,608,38.445807770961146,53.78323108384458,6.5439672801636,1.2269938650306749,0.0
47,서울특별시,금천구,시흥제1동,시흥제1동제8투,2121,1125,431,561,110,14,1,1117,8,996,38.58549686660698,50.22381378692927,9.847806624888094,1.2533572068039391,0.08952551477170993
48,서울특별시,금천구,시흥제1동,시흥제1동제9투,1702,1358,545,675,112,13,0,1345,13,344,40.520446096654275,50.18587360594795,8.327137546468402,0.966542750929368,0.0
49,서울특별시,금천구,시흥제2동,관내사전투표,4080,4080,2760,990,283,29,1,4063,17,0,67.93010091065716,24.36623184838789,6.965296578882599,0.7137583066699483,0.02461235540241201
50,서울특별시,금천구,시흥제2동,시흥제2동제1투,1542,1018,362,530,106,7,1,1006,12,524,35.984095427435385,52.683896620278325,10.536779324055665,0.6958250497017893,0.09940357852882703
51,서울특별시,금천구,시흥제2동,시흥제2동제2투,1803,1313,540,670,80,11,0,1301,12,490,41.506533435818596,51.49884704073789,6.149116064565718,0.8455034588777863,0.0
52,서울특별시,금천구,시흥제2동,시흥제2동제3투,2159,1659,565,942,129,14,3,1653,6,500,34.180278281911676,56.98729582577132,7.80399274047187,0.8469449485783425,0.18148820326678766
53,서울특별시,금천구,시흥제2동,시흥제2동제4투,2345,1904,751,985,131,19,1,1887,17,441,39.79862215156333,52.19925808161102,6.942236354001059,1.00688924218336,0.052994170641229466
54,서울특별시,금천구,시흥제2동,시흥제2동제5투,2071,1610,792,625,157,21,0,1595,15,461,49.6551724137931,39.18495297805642,9.843260188087774,1.316614420062696,0.0
55,서울특별시,금천구,시흥제2동,시흥제2동제6투,1239,838,325,451,45,6,0,827,11,401,39.29866989117291,54.53446191051995,5.441354292623942,0.7255139056831923,0.0
56,서울특별시,금천구,시흥제3동,관내사전투표,2941,2941,2014,716,177,20,2,2929,12,0,68.7606691703653,24.445203141003756,6.04301809491294,0.6828269033799932,0.06828269033799932
57,서울특별시,금천구,시흥제3동,시흥제3동제1투,1907,1286,455,697,108,13,3,1276,10,621,35.658307210031346,54.62382445141066,8.463949843260188,1.018808777429467,0.23510971786833856
58,서울특별시,금천구,시흥제3동,시흥제3동제2투,1323,922,355,466,77,17,0,915,7,401,38.79781420765027,50.92896174863388,8.415300546448087,1.8579234972677594,0.0
59,서울특별시,금천구,시흥제3동,시흥제3동제3투,1477,1034,381,567,73,6,4,1031,3,443,36.954413191076625,54.99515033947624,7.080504364694471,0.5819592628516004,0.38797284190106696
60,서울특별시,금천구,시흥제3동,시흥제3동제4투,975,740,301,358,66,8,0,733,7,235,41.06412005457026,48.84038199181446,9.004092769440655,1.0914051841746248,0.0
61,서울특별시,금천구,시흥제4동,관내사전투표,3941,3941,2681,1000,200,25,5,3911,30,0,68.55024290462796,25.568908207619533,5.113781641523907,0.6392227051904884,0.12784454103809767
62,서울특별시,금천구,시흥제4동,시흥제4동제1투,2055,1340,566,659,92,9,6,1332,8,715,42.492492492492495,49.47447447447447,6.906906906906906,0.6756756756756757,0.45045045045045046
63,서울특별시,금천구,시흥제4동,시흥제4동제2투,1615,928,340,508,59,14,2,923,5,687,36.83640303358614,55.03791982665223,6.392199349945829,1.5167930660888407,0.21668472372697722
64,서울특별시,금천구,시흥제4동,시흥제4동제3투,1562,1039,395,549,83,6,1,1034,5,523,38.20116054158607,53.094777562862674,8.027079303675048,0.5802707930367506,0.09671179883945842
65,서울특별시,금천구,시흥제4동,시흥제4동제4투,1903,1420,594,704,106,5,2,1411,9,483,42.09780297661233,49.89369241672573,7.5124025513819985,0.3543586109142452,0.14174344436569808
66,서울특별시,금천구,시흥제4동,시흥제4동제5투,1903,1205,475,629,82,11,1,1198,7,698,39.64941569282137,52.504173622704506,6.844741235392321,0.9181969949916527,0.08347245409015025
67,서울특별시,금천구,시흥제4동,시흥제4동제6투,1915,1257,539,601,87,15,3,1245,12,658,43.29317269076306,48.27309236947791,6.987951807228916,1.2048192771084338,0.24096385542168677
68,서울특별시,금천구,시흥제5동,관내사전투표,5348,5348,3551,1433,276,46,9,5315,33,0,66.81091251175917,26.961429915333962,5.1928504233301975,0.8654750705550329,0.16933207902163688
69,서울특별시,금천구,시흥제5동,시흥제5동제1투,1664,1035,379,562,80,12,0,1033,2,629,36.689254598257506,54.404646660212975,7.744433688286543,1.1616650532429817,0.0
70,서울특별시,금천구,시흥제5동,시흥제5동제2투,2239,1348,557,649,111,19,2,1338,10,891,41.62929745889387,48.50523168908819,8.295964125560538,1.4200298953662183,0.14947683109118087
71,서울특별시,금천구,시흥제5동,시흥제5동제3투,2276,1476,549,792,112,15,2,1470,6,800,37.3469387755102,53.87755102040816,7.6190476190476195,1.0204081632653061,0.13605442176870747
72,서울특별시,금천구,시흥제5동,시흥제5동제4투,1862,1139,425,590,105,8,2,1130,9,723,37.610619469026545,52.21238938053098,9.29203539823009,0.7079646017699115,0.17699115044247787
73,서울특별시,금천구,시흥제5동,시흥제5동제5투,1717,1086,402,563,92,15,2,1074,12,631,37.43016759776536,52.42085661080075,8.56610800744879,1.3966480446927374,0.186219739292365
74,서울특별시,금천구,잘못 투입·구분된 투표지,,0,0,0,0,0,0,0,0,0,0,0.0,0.0,0.0,0.0,0.0
0,서울특별시,영등포구,거소·선상투표,,409,385,149,141,77,3,2,372,13,24,40.053763440860216,37.903225806451616,20.698924731182796,0.8064516129032258,0.5376344086021506
1,서울특별시,영등포구,관외사전투표,,37119,37104,20757,9649,5660,592,35,36693,411,15,56.56937290491374,26.29656882784182,15.42528547679394,1.6133867495162564,0.09538604093423814
2,서울특별시,영등포구,재외투표,,3195,2546,1595,613,263,48,3,2522,24,649,63.243457573354476,24.30610626486915,10.428231562252181,1.9032513877874702,0.11895321173671689
3,서울특별시,영등포구,영등포본동,관내사전투표,4786,4786,3105,1172,401,64,7,4749,37,0,65.38218572331017,24.678879764160875,8.443882922720574,1.3476521372920613,0.14739945251631922
4,서울특별시,영등포구,영등포본동,영등포본동제1투,2091,1485,564,761,137,10,0,1472,13,606,38.315217391304344,51.6983695652174,9.307065217391305,0.6793478260869565,0.0
5,서울특별시,영등포구,영등포본동,영등포본동제2투,2793,1766,680,907,137,22,0,1746,20,1027,38.94616265750287,51.94730813287515,7.846506300114547,1.2600229095074456,0.0
6,서울특별시,영등포구,영등포본동,영등포본동제3투,2554,1531,529,816,148,19,3,1515,16,1023,34.917491749174914,53.86138613861387,9.768976897689768,1.2541254125412542,0.19801980198019803
7,서울특별시,영등포구,영등포본동,영등포본동제4투,2081,1621,630,794,157,20,1,1602,19,460,39.325842696629216,49.56304619225968,9.800249687890137,1.2484394506866416,0.062421972534332085
8,서울특별시,영등포구,영등포본동,영등포본동제5투,2588,2124,831,1029,221,31,1,2113,11,464,39.327969711310935,48.69853289162329,10.459062943681968,1.4671083767155704,0.047326076668244205
9,서울특별시,영등포구,영등포동,관내사전투표,5432,5432,3174,1345,763,90,2,5374,58,0,59.062151097878676,25.027912169705992,14.197990323781168,1.6747301823595087,0.037216226274655755
10,서울특별시,영등포구,영등포동,영등포동제1투,4442,2788,847,1283,585,37,2,2754,34,1654,30.75526506899056,46.58678286129266,21.241830065359476,1.3435003631082063,0.07262164124909223
11,서울특별시,영등포구,영등포동,영등포동제2투,3453,1902,646,934,270,26,1,1877,25,1551,34.416622269579115,49.7602557272243,14.384656366542355,1.3851891315929674,0.05327650506126798
12,서울특별시,영등포구,영등포동,영등포동제3투,2617,1805,623,940,192,28,3,1786,19,812,34.882418812989926,52.63157894736842,10.750279955207166,1.5677491601343785,0.16797312430011196
13,서울특별시,영등포구,영등포동,영등포동제4투,3026,1956,633,895,363,39,0,1930,26,1070,32.7979274611399,46.373056994818654,18.808290155440417,2.0207253886010363,0.0
14,서울특별시,영등포구,영등포동,영등포동제5투,2936,2010,624,1064,258,38,4,1988,22,926,31.388329979879277,53.52112676056338,12.977867203219315,1.9114688128772637,0.2012072434607646
15,서울특별시,영등포구,영등포동,영등포동제6투,2384,1866,572,1040,219,16,0,1847,19,518,30.969139144558746,56.307525717379534,11.857065511640497,0.8662696264212236,0.0
16,서울특별시,영등포구,여의동,관내사전투표,5462,5462,2795,1912,650,74,3,5434,28,0,51.43540669856459,35.185866764814136,11.961722488038278,1.3617960986382038,0.055207949944792056
17,서울특별시,영등포구,여의동,여의동제1투,2553,1935,430,1323,144,29,0,1926,9,618,22.326064382139148,68.69158878504673,7.476635514018691,1.505711318795431,0.0
18,서울특별시,영등포구,여의동,여의동제2투,2757,1877,302,1406,127,24,1,1860,17,880,16.236559139784944,75.59139784946237,6.827956989247312,1.2903225806451613,0.053763440860215055
19,서울특별시,영등포구,여의동,여의동제3투,2444,1856,414,1259,155,16,0,1844,12,588,22.45119305856833,68.27548806941431,8.405639913232104,0.8676789587852495,0.0
20,서울특별시,영등포구,여의동,여의동제4투,3083,2193,402,1600,172,14,1,2189,4,890,18.36455002284148,73.09273640931933,7.857469164001827,0.6395614435815441,0.04568296025582458
21,서울특별시,영등포구,여의동,여의동제5투,2889,2195,489,1473,200,23,0,2185,10,694,22.379862700228834,67.4141876430206,9.153318077803203,1.0526315789473684,0.0
22,서울특별시,영등포구,여의동,여의동제6투,2787,2061,428,1439,175,16,0,2058,3,726,20.796890184645285,69.92225461613216,8.503401360544217,0.7774538386783284,0.0
23,서울특별시,영등포구,여의동,여의동제7투,3138,2372,391,1789,163,13,0,2356,16,766,16.59592529711375,75.93378607809848,6.918505942275043,0.5517826825127334,0.0
24,서울특별시,영등포구,여의동,여의동제8투,2014,1455,426,848,146,22,1,1443,12,559,29.521829521829524,58.76645876645876,10.117810117810118,1.5246015246015245,0.0693000693000693
25,서울특별시,영등포구,당산제1동,관내사전투표,5900,5900,3642,1432,658,108,4,5844,56,0,62.32032854209446,24.503764544832308,11.259411362080767,1.8480492813141685,0.06844626967830253
26,서울특별시,영등포구,당산제1동,당산제1동제1투,1533,1102,406,534,128,15,5,1088,14,431,37.31617647058824,49.080882352941174,11.76470588235294,1.3786764705882353,0.4595588235294118
27,서울특별시,영등포구,당산제1동,당산제1동제2투,2546,1781,644,893,205,25,1,1768,13,765,36.425339366515836,50.509049773755656,11.595022624434389,1.414027149321267,0.056561085972850686
28,서울특별시,영등포구,당산제1동,당산제1동제3투,3077,2362,885,1121,301,29,5,2341,21,715,37.80435711234515,47.885519008970526,12.857753096967109,1.2387868432293891,0.21358393848782573
29,서울특별시,영등포구,당산제1동,당산제1동제4투,3056,2019,569,1144,248,34,2,1997,22,1037,28.492739108662995,57.285928893340014,12.418627941912868,1.7025538307461192,0.10015022533800699
30,서울특별시,영등포구,당산제1동,당산제1동제5투,2324,1735,602,870,215,23,1,1711,24,589,35.184102863822325,50.847457627118644,12.56575102279369,1.3442431326709527,0.058445353594389245
31,서울특별시,영등포구,당산제2동,관내사전투표,5549,5549,3302,1513,597,84,5,5501,48,0,60.02544991819669,27.504090165424465,10.852572259589166,1.5269950918014907,0.09089256498818396
32,서울특별시,영등포구,당산제2동,당산제2동제1투,3636,2563,868,1228,393,48,1,2538,25,1073,34.20015760441292,48.38455476753349,15.484633569739954,1.8912529550827424,0.039401103230890466
33,서울특별시,영등포구,당산제2동,당산제2동제2투,2409,1711,504,990,174,24,1,1693,18,698,29.769639692852923,58.47607796810396,10.277613703484938,1.4176018901358536,0.05906674542232723
34,서울특별시,영등포구,당산제2동,당산제2동제3투,3483,2620,899,1350,314,35,4,2602,18,863,34.55034588777863,51.88316679477325,12.067640276710224,1.345119139123751,0.15372790161414296
35,서울특별시,영등포구,당산제2동,당산제2동제4투,2055,1700,600,924,132,28,0,1684,16,355,35.62945368171022,54.86935866983374,7.8384798099762465,1.66270783847981,0.0
36,서울특별시,영등포구,당산제2동,당산제2동제5투,2906,2336,625,1457,224,21,0,2327,9,570,26.858616244091106,62.61280618822518,9.626128061882252,0.9024495058014611,0.0
37,서울특별시,영등포구,당산제2동,당산제2동제6투,3226,2510,887,1258,298,35,1,2479,31,716,35.78055667607906,50.74626865671642,12.020976200080678,1.4118596208148446,0.04033884630899556
38,서울특별시,영등포구,당산제2동,당산제2동제7투,1943,1431,560,579,237,35,0,1411,20,512,39.68816442239547,41.034727143869596,16.796598157335225,2.4805102763997167,0.0
39,서울특별시,영등포구,당산제2동,당산제2동제8투,1745,1297,421,682,166,16,0,1285,12,448,32.762645914396884,53.0739299610895,12.918287937743193,1.245136186770428,0.0
40,서울특별시,영등포구,도림동,관내사전투표,4381,4381,2933,963,404,53,4,4357,24,0,67.31696121184301,22.102364011934817,9.272435161808584,1.2164333256828093,0.09180628873077806
41,서울특별시,영등포구,도림동,도림동제1투,2492,1588,596,858,114,9,3,1580,8,904,37.721518987341774,54.30379746835443,7.215189873417721,0.569620253164557,0.18987341772151897
42,서울특별시,영등포구,도림동,도림동제2투,2232,1400,515,692,157,18,2,1384,16,832,37.21098265895954,50.0,11.34393063583815,1.300578034682081,0.1445086705202312
43,서울특별시,영등포구,도림동,도림동제3투,2748,1877,714,873,232,22,3,1844,33,871,38.72017353579176,47.34273318872017,12.58134490238612,1.193058568329718,0.16268980477223427
44,서울특별시,영등포구,도림동,도림동제4투,2769,1995,738,1032,184,24,3,1981,14,774,37.25391216557294,52.09490156486623,9.288238263503281,1.2115093387178193,0.1514386673397274
45,서울특별시,영등포구,문래동,관내사전투표,5832,5832,3821,1355,550,69,6,5801,31,0,65.86795380106878,23.358041716945355,9.48112394414756,1.1894500948112394,0.10343044302706429
46,서울특별시,영등포구,문래동,문래동제1투,1364,757,250,417,75,9,1,752,5,607,33.244680851063826,55.452127659574465,9.97340425531915,1.196808510638298,0.13297872340425532
47,서울특별시,영등포구,문래동,문래동제2투,2535,2016,715,1070,195,29,0,2009,7,519,35.58984569437531,53.26032852165257,9.706321553011449,1.443504230960677,0.0
48,서울특별시,영등포구,문래동,문래동제3투,2685,2090,760,1027,244,42,0,2073,17,595,36.661842739990355,49.54172696575012,11.770381090207428,2.0260492040520983,0.0
49,서울특별시,영등포구,문래동,문래동제4투,2311,1837,499,1164,148,12,4,1827,10,474,27.312534209085932,63.71100164203612,8.10071154898741,0.6568144499178982,0.21893814997263275
50,서울특별시,영등포구,문래동,문래동제5투,2888,2185,845,1108,182,36,0,2171,14,703,38.92215568862276,51.03638876093966,8.383233532934131,1.6582220175034548,0.0
51,서울특별시,영등포구,문래동,문래동제6투,3152,2545,1170,1029,283,38,3,2523,22,607,46.37336504161712,40.78478002378122,11.216805390408243,1.506143479984146,0.11890606420927466
52,서울특별시,영등포구,문래동,문래동제7투,3128,2507,1087,1104,276,26,0,2493,14,621,43.60208584035299,44.28399518652226,11.070998796630565,1.0429201764941836,0.0
53,서울특별시,영등포구,양평제1동,관내사전투표,4562,4564,2935,1003,514,72,2,4526,38,-2,64.84754750331419,22.160848431285903,11.356606274856386,1.5908086610693768,0.04418912947414936
54,서울특별시,영등포구,양평제1동,양평제1동제1투,2128,1442,512,713,182,18,1,1426,16,686,35.90462833099579,50.0,12.76297335203366,1.262272089761571,0.07012622720897616
55,서울특별시,영등포구,양평제1동,양평제1동제2투,2868,2189,869,1019,251,32,2,2173,16,679,39.99079613437644,46.89369535204786,11.55085135757018,1.4726184997699034,0.09203865623561897
56,서울특별시,영등포구,양평제1동,양평제1동제3투,2888,1938,672,972,240,30,0,1914,24,950,35.10971786833856,50.78369905956113,12.539184952978054,1.5673981191222568,0.0
57,서울특별시,영등포구,양평제1동,양평제1동제4투,2277,1662,606,782,216,36,3,1643,19,615,36.88374923919659,47.59586122945831,13.146682897139378,2.1911138161898966,0.18259281801582472
58,서울특별시,영등포구,양평제2동,관내사전투표,4569,4569,2906,1040,529,59,3,4537,32,0,64.05113511130703,22.922636103151863,11.659687017853207,1.3004187789288075,0.06612298875909191
59,서울특별시,영등포구,양평제2동,양평제2동제1투,2400,1873,753,879,204,24,0,1860,13,527,40.483870967741936,47.25806451612903,10.967741935483872,1.2903225806451613,0.0
60,서울특별시,영등포구,양평제2동,양평제2동제2투,2164,1568,522,837,162,23,4,1548,20,596,33.72093023255814,54.06976744186046,10.465116279069768,1.4857881136950903,0.2583979328165375
61,서울특별시,영등포구,양평제2동,양평제2동제3투,2253,1564,557,740,222,25,0,1544,20,689,36.075129533678755,47.92746113989637,14.378238341968913,1.6191709844559583,0.0
62,서울특별시,영등포구,양평제2동,양평제2동제4투,2580,2059,806,952,250,28,1,2037,22,521,39.567992145311734,46.735395189003434,12.272950417280313,1.3745704467353952,0.049091801669121256
63,서울특별시,영등포구,양평제2동,양평제2동제5투,3346,2435,877,1127,350,48,2,2404,31,911,36.480865224625624,46.8801996672213,14.559068219633945,1.9966722129783694,0.08319467554076539
64,서울특별시,영등포구,신길제1동,관내사전투표,3646,3646,2307,884,366,47,2,3606,40,0,63.97670549084859,24.5146977260122,10.149750415973378,1.3033832501386577,0.055463117027176934
65,서울특별시,영등포구,신길제1동,신길제1동제1투,2565,1657,622,783,211,20,2,1638,19,908,37.97313797313797,47.8021978021978,12.88156288156288,1.221001221001221,0.1221001221001221
66,서울특별시,영등포구,신길제1동,신길제1동제2투,2223,1350,471,709,138,16,1,1335,15,873,35.28089887640449,53.10861423220974,10.337078651685392,1.198501872659176,0.0749063670411985
67,서울특별시,영등포구,신길제1동,신길제1동제3투,2157,1316,455,683,144,17,0,1299,17,841,35.026943802925324,52.578906851424165,11.085450346420323,1.308698999230177,0.0
68,서울특별시,영등포구,신길제1동,신길제1동제4투,2207,1429,526,737,133,19,2,1417,12,778,37.120677487649964,52.011291460832744,9.386026817219479,1.340860973888497,0.14114326040931546
69,서울특별시,영등포구,신길제1동,신길제1동제5투,2250,1687,649,840,164,20,4,1677,10,563,38.70005963029219,50.089445438282645,9.779367918902802,1.1926058437686344,0.2385211687537269
70,서울특별시,영등포구,신길제3동,관내사전투표,3284,3284,2071,865,261,44,7,3248,36,0,63.762315270935964,26.63177339901478,8.035714285714286,1.354679802955665,0.21551724137931033
71,서울특별시,영등포구,신길제3동,신길제3동제1투,1632,997,355,541,85,7,1,989,8,635,35.8948432760364,54.70171890798786,8.59453993933266,0.7077856420626896,0.10111223458038424
72,서울특별시,영등포구,신길제3동,신길제3동제2투,1791,1137,403,618,92,12,2,1127,10,654,35.7586512866016,54.83584738243123,8.16326530612245,1.064773735581189,0.1774622892635315
73,서울특별시,영등포구,신길제3동,신길제3동제3투,1915,1533,552,812,137,21,1,1523,10,382,36.244254760341434,53.31582403151675,8.995403808273144,1.3788575180564675,0.06565988181221273
74,서울특별시,영등포구,신길제3동,신길제3동제4투,1977,1429,499,781,120,15,6,1421,8,548,35.11611541168192,54.96129486277269,8.444757213230119,1.0555946516537649,0.422237860661506
75,서울특별시,영등포구,신길제3동,신길제3동제5투,2020,1434,530,738,147,11,0,1426,8,586,37.166900420757365,51.7531556802244,10.308555399719495,0.7713884992987377,0.0
76,서울특별시,영등포구,신길제4동,관내사전투표,2283,2283,1524,556,160,20,1,2261,22,0,67.40380362671384,24.590888987173816,7.076514816452898,0.8845643520566122,0.044228217602830605
77,서울특별시,영등포구,신길제4동,신길제4동제1투,1494,889,333,461,74,11,1,880,9,605,37.84090909090909,52.38636363636363,8.409090909090908,1.25,0.11363636363636363
78,서울특별시,영등포구,신길제4동,신길제4동제2투,1415,871,308,466,78,11,0,863,8,544,35.68945538818076,53.99768250289687,9.038238702201621,1.2746234067207416,0.0
79,서울특별시,영등포구,신길제4동,신길제4동제3투,1731,1320,448,761,94,12,2,1317,3,411,34.0167046317388,57.7828397873956,7.137433561123766,0.9111617312072893,0.15186028853454822
80,서울특별시,영등포구,신길제4동,신길제4동제4투,2270,1852,779,858,181,20,2,1840,12,418,42.33695652173913,46.630434782608695,9.83695652173913,1.0869565217391304,0.10869565217391304
81,서울특별시,영등포구,신길제5동,관내사전투표,2570,2570,1757,630,142,22,3,2554,16,0,68.7940485512921,24.667188723570867,5.559906029757244,0.8613938919342208,0.11746280344557558
82,서울특별시,영등포구,신길제5동,신길제5동제1투,962,593,211,329,37,10,1,588,5,369,35.8843537414966,55.952380952380956,6.292517006802721,1.7006802721088436,0.17006802721088435
83,서울특별시,영등포구,신길제5동,신길제5동제2투,1972,1611,591,799,175,31,1,1597,14,361,37.00688791484033,50.03130870381967,10.958046336881653,1.9411396368190357,0.06261740763932373
84,서울특별시,영등포구,신길제5동,신길제5동제3투,1459,945,335,521,74,5,2,937,8,514,35.75240128068303,55.60298826040555,7.897545357524013,0.5336179295624333,0.21344717182497333
85,서울특별시,영등포구,신길제5동,신길제5동제4투,979,643,242,352,40,5,1,640,3,336,37.8125,55.00000000000001,6.25,0.78125,0.15625
86,서울특별시,영등포구,신길제6동,관내사전투표,4864,4864,3101,1204,462,58,6,4831,33,0,64.1896087766508,24.922376319602566,9.563237424963775,1.2005795901469674,0.12419788863589319
87,서울특별시,영등포구,신길제6동,신길제6동제1투,1618,1153,398,560,161,22,2,1143,10,465,34.820647419072614,48.99387576552931,14.085739282589676,1.9247594050743655,0.17497812773403326
88,서울특별시,영등포구,신길제6동,신길제6동제2투,1935,1481,463,848,140,14,3,1468,13,454,31.539509536784742,57.765667574931875,9.536784741144414,0.9536784741144414,0.20435967302452315
89,서울특별시,영등포구,신길제6동,신길제6동제3투,2212,1645,554,904,153,26,1,1638,7,567,33.82173382173382,55.18925518925519,9.340659340659341,1.5873015873015872,0.06105006105006105
90,서울특별시,영등포구,신길제6동,신길제6동제4투,2431,1620,562,839,186,13,1,1601,19,811,35.10306058713304,52.404747033104314,11.617738913179263,0.8119925046845722,0.06246096189881324
91,서울특별시,영등포구,신길제6동,신길제6동제5투,1850,1251,441,637,133,17,2,1230,21,599,35.853658536585364,51.78861788617887,10.8130081300813,1.3821138211382114,0.16260162601626016
92,서울특별시,영등포구,신길제7동,관내사전투표,3177,3177,1936,895,304,21,0,3156,21,0,61.34347275031685,28.35868187579214,9.632446134347274,0.6653992395437262,0.0
93,서울특별시,영등포구,신길제7동,신길제7동제1투,2664,2120,728,1135,212,33,3,2111,9,544,34.4860255802937,53.76598768356229,10.04263382283278,1.5632401705352912,0.14211274277593558
94,서울특별시,영등포구,신길제7동,신길제7동제2투,3190,2441,903,1227,266,33,1,2430,11,749,37.160493827160494,50.49382716049383,10.94650205761317,1.3580246913580247,0.0411522633744856
95,서울특별시,영등포구,신길제7동,신길제7동제3투,2298,1534,426,901,170,17,3,1517,17,764,28.081740276862227,59.39353988134476,11.206328279499012,1.1206328279499012,0.1977587343441002
96,서울특별시,영등포구,신길제7동,신길제7동제4투,2220,1737,496,1065,148,17,0,1726,11,483,28.7369640787949,61.70336037079953,8.574739281575898,0.9849362688296639,0.0
97,서울특별시,영등포구,대림제1동,관내사전투표,3250,3250,2169,811,224,22,0,3226,24,0,67.23496590204587,25.13949163050217,6.9435833849969,0.6819590824550528,0.0
98,서울특별시,영등포구,대림제1동,대림제1동제1투,1479,888,316,489,67,5,0,877,11,591,36.03192702394527,55.75826681870011,7.639680729760548,0.5701254275940707,0.0
99,서울특별시,영등포구,대림제1동,대림제1동제2투,1588,1049,344,594,97,6,0,1041,8,539,33.04514889529299,57.06051873198847,9.317963496637848,0.5763688760806917,0.0
100,서울특별시,영등포구,대림제1동,대림제1동제3투,1785,1340,523,650,139,16,0,1328,12,445,39.38253012048193,48.94578313253012,10.466867469879517,1.2048192771084338,0.0
101,서울특별시,영등포구,대림제1동,대림제1동제4투,1714,1157,448,576,111,10,2,1147,10,557,39.05841325196164,50.21795989537925,9.67741935483871,0.8718395815170008,0.17436791630340018
102,서울특별시,영등포구,대림제1동,대림제1동제5투,1093,642,230,342,58,5,0,635,7,451,36.22047244094488,53.85826771653544,9.133858267716535,0.7874015748031495,0.0
103,서울특별시,영등포구,대림제2동,관내사전투표,2738,2738,1923,607,160,26,5,2721,17,0,70.67254685777287,22.3079750091878,5.880191106210952,0.9555310547592797,0.18375597206909225
104,서울특별시,영등포구,대림제2동,대림제2동제1투,726,400,164,196,30,3,1,394,6,326,41.62436548223351,49.746192893401016,7.614213197969544,0.7614213197969544,0.25380710659898476
105,서울특별시,영등포구,대림제2동,대림제2동제2투,783,497,179,280,28,3,0,490,7,286,36.53061224489796,57.14285714285714,5.714285714285714,0.6122448979591837,0.0
106,서울특별시,영등포구,대림제2동,대림제2동제3투,2177,1460,582,693,151,21,3,1450,10,717,40.13793103448276,47.793103448275865,10.413793103448276,1.4482758620689655,0.20689655172413793
107,서울특별시,영등포구,대림제2동,대림제2동제4투,2432,1724,705,806,179,13,2,1705,19,708,41.348973607038126,47.27272727272727,10.498533724340176,0.7624633431085044,0.11730205278592376
108,서울특별시,영등포구,대림제2동,대림제2동제5투,1110,661,250,352,47,6,0,655,6,449,38.16793893129771,53.74045801526718,7.175572519083969,0.9160305343511451,0.0
109,서울특별시,영등포구,대림제3동,관내사전투표,3364,3364,2277,781,237,46,0,3341,23,0,68.15324753067944,23.37623466028135,7.09368452559114,1.3768332834480694,0.0
110,서울특별시,영등포구,대림제3동,대림제3동제1투,2027,1425,544,722,133,11,2,1412,13,602,38.52691218130311,51.13314447592068,9.41926345609065,0.7790368271954674,0.141643059490085
111,서울특별시,영등포구,대림제3동,대림제3동제2투,1784,1233,517,607,81,19,0,1224,9,551,42.23856209150327,49.591503267973856,6.61764705882353,1.5522875816993464,0.0
112,서울특별시,영등포구,대림제3동,대림제3동제3투,1642,1150,461,582,86,4,2,1135,15,492,40.61674008810573,51.27753303964758,7.577092511013215,0.3524229074889868,0.1762114537444934
113,서울특별시,영등포구,대림제3동,대림제3동제4투,1275,838,345,412,64,10,1,832,6,437,41.46634615384615,49.519230769230774,7.6923076923076925,1.201923076923077,0.1201923076923077
114,서울특별시,영등포구,대림제3동,대림제3동제5투,1867,1238,470,618,122,16,0,1226,12,629,38.33605220228385,50.40783034257748,9.9510603588907,1.3050570962479608,0.0
115,서울특별시,영등포구,대림제3동,대림제3동제6투,1668,1165,444,601,91,15,2,1153,12,503,38.50823937554206,52.12489158716392,7.8924544666088465,1.3009540329575022,0.17346053772766695
116,서울특별시,영등포구,대림제3동,대림제3동제7투,2400,1876,618,1040,181,27,0,1866,10,524,33.11897106109325,55.73419078242229,9.69989281886388,1.4469453376205788,0.0
117,서울특별시,영등포구,잘못 투입·구분된 투표지,,0,0,0,0,0,0,0,0,0,0,0.0,0.0,0.0,0.0,0.0
0,서울특별시,동작구,거소·선상투표,,378,350,138,124,74,2,2,340,10,28,40.588235294117645,36.470588235294116,21.764705882352942,0.5882352941176471,0.5882352941176471
1,서울특별시,동작구,관외사전투표,,42299,42294,24462,10656,6047,639,37,41841,453,5,58.46418584641858,25.467842546784254,14.452331445233144,1.5272101527210151,0.08843000884300088
2,서울특별시,동작구,재외투표,,3455,2795,1746,701,278,48,4,2777,18,660,62.8736046092906,25.243068059056533,10.010803024846956,1.7284839755131436,0.14404033129276198
3,서울특별시,동작구,노량진제1동,관내사전투표,4643,4643,2831,1032,651,74,4,4592,51,0,61.650696864111495,22.473867595818817,14.176829268292682,1.6114982578397212,0.08710801393728224
4,서울특별시,동작구,노량진제1동,노량진제1동제1투,2779,2213,813,1145,212,22,0,2192,21,566,37.08941605839416,52.23540145985402,9.67153284671533,1.0036496350364963,0.0
5,서울특별시,동작구,노량진제1동,노량진제1동제2투,3424,2253,706,1182,322,22,0,2232,21,1171,31.630824372759857,52.956989247311824,14.42652329749104,0.985663082437276,0.0
6,서울특별시,동작구,노량진제1동,노량진제1동제3투,2145,1695,556,930,169,24,2,1681,14,450,33.0755502676978,55.32421177870316,10.053539559785841,1.4277215942891135,0.1189767995240928
7,서울특별시,동작구,노량진제1동,노량진제1동제4투,3416,1994,584,1050,308,29,2,1973,21,1422,29.59959452610238,53.21844906234161,15.610745058286874,1.4698428788646731,0.10136847440446022
8,서울특별시,동작구,노량진제1동,노량진제1동제5투,1611,1160,354,704,86,7,1,1152,8,451,30.729166666666668,61.111111111111114,7.465277777777778,0.607638888888889,0.08680555555555555
9,서울특별시,동작구,노량진제1동,노량진제1동제6투,2421,1694,652,855,146,25,1,1679,15,727,38.832638475282906,50.92316855270994,8.695652173913043,1.4889815366289458,0.05955926146515784
10,서울특별시,동작구,노량진제1동,노량진제1동제7투,1474,1164,361,676,105,13,0,1155,9,310,31.255411255411254,58.52813852813853,9.090909090909092,1.1255411255411256,0.0
11,서울특별시,동작구,노량진제1동,노량진제1동제8투,2696,2072,685,1154,197,21,4,2061,11,624,33.23629306162057,55.992236778262985,9.558466763706939,1.0189228529839884,0.19408054342552158
12,서울특별시,동작구,노량진제2동,관내사전투표,1871,1871,1215,466,158,17,2,1858,13,0,65.39289558665232,25.080731969860064,8.503767491926803,0.914962325080732,0.1076426264800861
13,서울특별시,동작구,노량진제2동,노량진제2동제1투,784,499,148,287,57,4,0,496,3,285,29.838709677419356,57.86290322580645,11.491935483870968,0.8064516129032258,0.0
14,서울특별시,동작구,노량진제2동,노량진제2동제2투,1788,1004,330,586,77,9,1,1003,1,784,32.901296111665005,58.424725822532395,7.676969092721834,0.897308075772682,0.09970089730807577
15,서울특별시,동작구,노량진제2동,노량진제2동제3투,2321,1502,498,745,211,28,3,1485,17,819,33.535353535353536,50.16835016835017,14.20875420875421,1.8855218855218854,0.20202020202020202
16,서울특별시,동작구,상도제1동,관내사전투표,8881,8880,5329,2229,1153,108,5,8824,56,1,60.3921124206709,25.26065276518586,13.06663644605621,1.2239347234814144,0.05666364460562103
17,서울특별시,동작구,상도제1동,상도제1동제1투,3950,2841,1030,1361,389,36,3,2819,22,1109,36.53777935438099,48.27953174884711,13.799219581411847,1.2770485987938986,0.1064207165661582
18,서울특별시,동작구,상도제1동,상도제1동제2투,3727,2642,814,1330,417,42,5,2608,34,1085,31.21165644171779,50.99693251533742,15.98926380368098,1.6104294478527608,0.19171779141104295
19,서울특별시,동작구,상도제1동,상도제1동제3투,2842,2030,748,1024,217,29,1,2019,11,812,37.048043585933634,50.71817731550272,10.747894997523527,1.4363546310054482,0.04952947003467063
20,서울특별시,동작구,상도제1동,상도제1동제4투,2744,1957,647,1088,184,25,1,1945,12,787,33.26478149100257,55.93830334190232,9.460154241645244,1.2853470437017995,0.051413881748071974
21,서울특별시,동작구,상도제1동,상도제1동제5투,2834,1958,470,1236,206,24,0,1936,22,876,24.276859504132233,63.84297520661158,10.640495867768596,1.2396694214876034,0.0
22,서울특별시,동작구,상도제1동,상도제1동제6투,2889,2085,595,1167,270,24,2,2058,27,804,28.91156462585034,56.70553935860059,13.119533527696792,1.1661807580174928,0.09718172983479105
23,서울특별시,동작구,상도제1동,상도제1동제7투,2725,1887,606,936,287,29,2,1860,27,838,32.58064516129032,50.32258064516129,15.43010752688172,1.5591397849462365,0.10752688172043011
24,서울특별시,동작구,상도제1동,상도제1동제8투,3539,2842,1002,1480,306,37,2,2827,15,697,35.44393349840821,52.35231694375663,10.824195259992925,1.3088079235939158,0.07074637424831977
25,서울특별시,동작구,상도제2동,관내사전투표,7366,7366,4712,1900,638,80,4,7334,32,0,64.24870466321244,25.906735751295333,8.699209162803381,1.09080992637033,0.0545404963185165
26,서울특별시,동작구,상도제2동,상도제2동제1투,3468,2434,806,1323,243,29,4,2405,29,1034,33.513513513513516,55.01039501039501,10.103950103950105,1.2058212058212059,0.16632016632016633
27,서울특별시,동작구,상도제2동,상도제2동제2투,3554,2467,679,1490,255,27,1,2452,15,1087,27.69168026101142,60.76672104404568,10.399673735725939,1.101141924959217,0.040783034257748776
28,서울특별시,동작구,상도제2동,상도제2동제3투,3557,2499,892,1288,260,32,1,2473,26,1058,36.06955115244642,52.08249090173878,10.513546300040437,1.293974929235746,0.040436716538617065
29,서울특별시,동작구,상도제2동,상도제2동제4투,3875,2955,992,1618,291,35,1,2937,18,920,33.77596186584951,55.090228123935994,9.908069458631257,1.191692202928158,0.034048348655090224
30,서울특별시,동작구,상도제3동,관내사전투표,8930,8930,5770,2242,736,113,4,8865,65,0,65.08742244782853,25.29046813310773,8.302312464749013,1.2746756909193457,0.04512126339537507
31,서울특별시,동작구,상도제3동,상도제3동제1투,3301,2281,842,1184,199,26,2,2253,28,1020,37.37239236573458,52.55215268530847,8.832667554371948,1.154016866400355,0.08877052818464269
32,서울특별시,동작구,상도제3동,상도제3동제2투,2526,1624,546,834,185,24,5,1594,30,902,34.253450439146796,52.32120451693852,11.606022584692598,1.5056461731493098,0.3136762860727729
33,서울특별시,동작구,상도제3동,상도제3동제3투,2093,1346,530,676,125,9,1,1341,5,747,39.5227442207308,50.410141685309476,9.321401938851604,0.6711409395973155,0.07457121551081282
34,서울특별시,동작구,상도제3동,상도제3동제4투,1866,1199,479,582,112,16,0,1189,10,667,40.28595458368377,48.94869638351556,9.419680403700589,1.3456686291000841,0.0
35,서울특별시,동작구,상도제3동,상도제3동제5투,3308,2312,955,1118,190,20,2,2285,27,996,41.79431072210066,48.927789934354486,8.315098468271334,0.87527352297593,0.087527352297593
36,서울특별시,동작구,상도제4동,관내사전투표,5854,5854,3885,1439,436,48,5,5813,41,0,66.8329606055393,24.75485979700671,7.500430070531568,0.82573542060898,0.0860141063134354
37,서울특별시,동작구,상도제4동,상도제4동제1투,1914,1138,469,551,93,13,0,1126,12,776,41.651865008880996,48.93428063943161,8.259325044404973,1.1545293072824157,0.0
38,서울특별시,동작구,상도제4동,상도제4동제2투,2541,1609,609,775,183,26,1,1594,15,932,38.20577164366374,48.6198243412798,11.480552070263487,1.631116687578419,0.06273525721455457
39,서울특별시,동작구,상도제4동,상도제4동제3투,2024,1222,451,604,137,15,2,1209,13,802,37.30355665839537,49.9586435070306,11.331679073614557,1.240694789081886,0.1654259718775848
40,서울특별시,동작구,상도제4동,상도제4동제4투,3233,2159,838,1056,219,25,4,2142,17,1074,39.12231559290383,49.299719887955185,10.224089635854341,1.1671335200746966,0.18674136321195145
41,서울특별시,동작구,상도제4동,상도제4동제5투,3058,2092,733,1136,180,27,3,2079,13,966,35.25733525733526,54.64165464165465,8.658008658008658,1.2987012987012987,0.1443001443001443
42,서울특별시,동작구,상도제4동,상도제4동제6투,2684,1714,668,829,171,28,2,1698,16,970,39.34040047114252,48.82214369846879,10.070671378091872,1.6489988221436984,0.11778563015312131
43,서울특별시,동작구,흑석동,관내사전투표,5878,5878,3472,1684,632,47,3,5838,40,0,59.47242206235012,28.845495032545394,10.825625214114423,0.8050702295306612,0.051387461459403906
44,서울특별시,동작구,흑석동,흑석동제1투,2635,1927,376,1340,178,18,1,1913,14,708,19.6549921589127,70.04704652378463,9.304756926293779,0.9409304756926294,0.052273915316257184
45,서울특별시,동작구,흑석동,흑석동제2투,2452,1743,415,1119,175,22,3,1734,9,709,23.933102652825834,64.53287197231833,10.092272202998846,1.2687427912341407,0.17301038062283738
46,서울특별시,동작구,흑석동,흑석동제3투,1911,1426,420,846,136,8,2,1412,14,485,29.745042492917843,59.915014164305944,9.631728045325778,0.56657223796034,0.141643059490085
47,서울특별시,동작구,흑석동,흑석동제4투,2801,1980,568,1108,266,16,0,1958,22,821,29.009193054136873,56.58835546475996,13.585291113381,0.8171603677221655,0.0
48,서울특별시,동작구,흑석동,흑석동제5투,3363,2402,776,1318,264,27,2,2387,15,961,32.50942605781316,55.21575198994554,11.059907834101383,1.1311269375785507,0.0837871805613741
49,서울특별시,동작구,흑석동,흑석동제6투,4009,3028,1042,1640,290,38,1,3011,17,981,34.60644304217868,54.466954500166054,9.631351710395219,1.262039189637994,0.033211557622052475
50,서울특별시,동작구,사당제1동,관내사전투표,4617,4617,3012,1022,471,59,6,4570,47,0,65.90809628008752,22.36323851203501,10.306345733041576,1.2910284463894968,0.13129102844638948
51,서울특별시,동작구,사당제1동,사당제1동제1투,3536,2462,973,1166,253,40,5,2437,25,1074,39.92613869511695,47.84571194091096,10.381616741895773,1.6413623307345095,0.2051702913418137
52,서울특별시,동작구,사당제1동,사당제1동제2투,2565,1771,633,897,195,27,3,1755,16,794,36.06837606837607,51.11111111111111,11.11111111111111,1.5384615384615385,0.17094017094017094
53,서울특별시,동작구,사당제1동,사당제1동제3투,2448,1660,536,859,218,24,0,1637,23,788,32.74282223579719,52.474037874160054,13.317043372021992,1.4660965180207697,0.0
54,서울특별시,동작구,사당제1동,사당제1동제4투,1984,1341,495,660,157,12,2,1326,15,643,37.33031674208145,49.7737556561086,11.840120663650074,0.904977375565611,0.1508295625942685
55,서울특별시,동작구,사당제1동,사당제1동제5투,2665,1717,533,918,217,27,0,1695,22,948,31.445427728613566,54.15929203539823,12.8023598820059,1.592920353982301,0.0
56,서울특별시,동작구,사당제2동,관내사전투표,7325,7324,4446,2107,633,83,3,7272,52,1,61.13861386138614,28.974147414741473,8.704620462046204,1.1413641364136413,0.041254125412541254
57,서울특별시,동작구,사당제2동,사당제2동제1투,2818,2154,598,1368,171,6,2,2145,9,664,27.878787878787882,63.77622377622377,7.972027972027972,0.27972027972027974,0.09324009324009325
58,서울특별시,동작구,사당제2동,사당제2동제2투,2442,1602,505,942,129,16,1,1593,9,840,31.70119271814187,59.133709981167605,8.097928436911488,1.0043942247332078,0.06277463904582549
59,서울특별시,동작구,사당제2동,사당제2동제3투,2146,1486,563,750,138,18,2,1471,15,660,38.27328348062542,50.985723997280765,9.381373215499659,1.2236573759347382,0.13596193065941536
60,서울특별시,동작구,사당제2동,사당제2동제4투,2247,1519,378,972,142,18,0,1510,9,728,25.03311258278146,64.37086092715232,9.403973509933774,1.1920529801324504,0.0
61,서울특별시,동작구,사당제2동,사당제2동제5투,1699,1159,338,656,137,14,2,1147,12,540,29.46817785527463,57.192676547515255,11.944202266782913,1.2205754141238012,0.17436791630340018
62,서울특별시,동작구,사당제2동,사당제2동제6투,2010,1543,399,926,176,28,1,1530,13,467,26.078431372549023,60.52287581699346,11.50326797385621,1.8300653594771243,0.065359477124183
63,서울특별시,동작구,사당제2동,사당제2동제7투,1967,1514,386,982,114,27,1,1510,4,453,25.562913907284766,65.03311258278146,7.549668874172186,1.7880794701986755,0.06622516556291391
64,서울특별시,동작구,사당제3동,관내사전투표,3651,3650,2300,1008,269,45,5,3627,23,1,63.41328921974083,27.791563275434246,7.416597739178385,1.240694789081886,0.13785497656465398
65,서울특별시,동작구,사당제3동,사당제3동제1투,2453,1732,583,945,170,20,1,1719,13,721,33.91506689936009,54.973821989528794,9.889470622454915,1.1634671320535195,0.058173356602675974
66,서울특별시,동작구,사당제3동,사당제3동제2투,983,694,210,387,79,13,0,689,5,289,30.478955007256893,56.16835994194484,11.46589259796807,1.8867924528301887,0.0
67,서울특별시,동작구,사당제3동,사당제3동제3투,1937,1338,348,854,117,11,2,1332,6,599,26.126126126126124,64.11411411411412,8.783783783783784,0.8258258258258258,0.15015015015015015
68,서울특별시,동작구,사당제3동,사당제3동제4투,3277,2318,777,1221,262,35,0,2295,23,959,33.8562091503268,53.20261437908497,11.416122004357298,1.5250544662309369,0.0
69,서울특별시,동작구,사당제3동,사당제3동제5투,2151,1631,569,906,127,15,2,1619,12,520,35.14515132798024,55.96046942557133,7.8443483631871525,0.9264978381717109,0.12353304508956146
70,서울특별시,동작구,사당제3동,사당제3동제6투,2236,1757,593,987,137,22,4,1743,14,479,34.02180149168101,56.62650602409639,7.860011474469306,1.262191623637407,0.22948938611589212
71,서울특별시,동작구,사당제4동,관내사전투표,3804,3804,2605,855,278,38,1,3777,27,0,68.97008207572148,22.637013502779986,7.360338893301561,1.0060894890124437,0.026476039184537992
72,서울특별시,동작구,사당제4동,사당제4동제1투,1875,1281,479,669,109,10,1,1268,13,594,37.77602523659306,52.760252365930604,8.59621451104101,0.7886435331230284,0.07886435331230283
73,서울특별시,동작구,사당제4동,사당제4동제2투,1821,1278,423,715,118,14,0,1270,8,543,33.30708661417322,56.2992125984252,9.291338582677165,1.1023622047244095,0.0
74,서울특별시,동작구,사당제4동,사당제4동제3투,2147,1521,545,805,134,18,2,1504,17,626,36.236702127659576,53.52393617021277,8.909574468085106,1.196808510638298,0.13297872340425532
75,서울특별시,동작구,사당제4동,사당제4동제4투,1715,1157,407,601,124,10,3,1145,12,558,35.54585152838428,52.48908296943231,10.829694323144105,0.8733624454148471,0.26200873362445415
76,서울특별시,동작구,사당제5동,관내사전투표,3460,3460,2286,831,273,37,3,3430,30,0,66.64723032069972,24.22740524781341,7.959183673469387,1.0787172011661808,0.08746355685131195
77,서울특별시,동작구,사당제5동,사당제5동제1투,2115,1586,538,844,167,23,0,1572,14,529,34.223918575063614,53.68956743002544,10.623409669211197,1.4631043256997456,0.0
78,서울특별시,동작구,사당제5동,사당제5동제2투,2008,1477,514,817,111,20,1,1463,14,531,35.13328776486671,55.84415584415584,7.587149692412851,1.367053998632946,0.0683526999316473
79,서울특별시,동작구,사당제5동,사당제5동제3투,1955,1265,401,705,131,15,2,1254,11,690,31.97767145135566,56.2200956937799,10.446570972886763,1.1961722488038278,0.1594896331738437
80,서울특별시,동작구,사당제5동,사당제5동제4투,1733,1260,497,611,128,12,0,1248,12,473,39.82371794871795,48.95833333333333,10.256410256410255,0.9615384615384616,0.0
81,서울특별시,동작구,대방동,관내사전투표,5233,5233,3416,1276,436,70,7,5205,28,0,65.62920268972142,24.51488952929875,8.376560999039386,1.344860710854947,0.1344860710854947
82,서울특별시,동작구,대방동,대방동제1투,2886,2095,736,1123,189,28,3,2079,16,791,35.4016354016354,54.016354016354015,9.090909090909092,1.3468013468013467,0.1443001443001443
83,서울특별시,동작구,대방동,대방동제2투,3152,2367,892,1156,270,33,0,2351,16,785,37.941301573798384,49.17056571671629,11.484474691620587,1.4036580178647384,0.0
84,서울특별시,동작구,대방동,대방동제3투,2069,1469,562,776,101,15,1,1455,14,600,38.62542955326461,53.333333333333336,6.941580756013746,1.0309278350515463,0.06872852233676977
85,서울특별시,동작구,대방동,대방동제4투,2536,1921,583,1137,168,22,0,1910,11,615,30.523560209424083,59.52879581151832,8.795811518324607,1.1518324607329842,0.0
86,서울특별시,동작구,대방동,대방동제5투,2161,1528,581,726,186,18,3,1514,14,633,38.37516512549538,47.95244385733157,12.285336856010568,1.1889035667107,0.19815059445178335
87,서울특별시,동작구,대방동,대방동제6투,2938,2050,793,930,261,26,3,2013,37,888,39.39393939393939,46.19970193740686,12.965722801788376,1.291604570293095,0.14903129657228018
88,서울특별시,동작구,대방동,대방동제7투,2754,1864,742,887,192,21,2,1844,20,890,40.23861171366595,48.10195227765727,10.412147505422993,1.13882863340564,0.10845986984815618
89,서울특별시,동작구,신대방제1동,관내사전투표,3820,3819,2451,997,298,42,2,3790,29,1,64.67018469656992,26.306068601583117,7.862796833773087,1.108179419525066,0.05277044854881266
90,서울특별시,동작구,신대방제1동,신대방제1동제1투,1487,1002,348,548,83,15,0,994,8,485,35.01006036217304,55.13078470824949,8.350100603621732,1.5090543259557343,0.0
91,서울특별시,동작구,신대방제1동,신대방제1동제2투,1883,1229,383,696,113,18,4,1214,15,654,31.548599670510708,57.33113673805601,9.308072487644152,1.4827018121911038,0.3294892915980231
92,서울특별시,동작구,신대방제1동,신대방제1동제3투,3101,2485,1057,1174,198,36,0,2465,20,616,42.88032454361055,47.62677484787019,8.032454361054766,1.460446247464503,0.0
93,서울특별시,동작구,신대방제1동,신대방제1동제4투,3768,2637,900,1379,278,33,7,2597,40,1131,34.6553715825953,53.09973045822103,10.704659222179439,1.2706969580284944,0.2695417789757413
94,서울특별시,동작구,신대방제1동,신대방제1동제5투,3026,2399,764,1413,177,28,3,2385,14,627,32.0335429769392,59.24528301886792,7.421383647798742,1.1740041928721174,0.12578616352201258
95,서울특별시,동작구,신대방제2동,관내사전투표,5502,5502,3595,1225,546,86,3,5455,47,0,65.90284142988084,22.45646196150321,10.00916590284143,1.5765352887259394,0.054995417048579284
96,서울특별시,동작구,신대방제2동,신대방제2동제1투,2581,1894,754,898,200,19,2,1873,21,687,40.2562733582488,47.94447410571276,10.678056593699948,1.014415376401495,0.10678056593699946
97,서울특별시,동작구,신대방제2동,신대방제2동제2투,3405,2484,915,1200,307,29,4,2455,29,921,37.270875763747455,48.87983706720978,12.5050916496945,1.1812627291242364,0.1629327902240326
98,서울특별시,동작구,신대방제2동,신대방제2동제3투,3142,2167,808,1037,255,39,4,2143,24,975,37.7041530564629,48.39010732617825,11.89920671955203,1.8198786747550162,0.18665422305179655
99,서울특별시,동작구,신대방제2동,신대방제2동제4투,2914,2157,631,1324,168,28,0,2151,6,757,29.335192933519295,61.552766155276615,7.810320781032078,1.3017201301720132,0.0
100,서울특별시,동작구,잘못 투입·구분된 투표지,,0,5,2,3,0,0,0,5,0,-5,40.0,60.0,0.0,0.0,0.0
0,서울특별시,관악구,거소·선상투표,,491,462,219,142,87,4,1,453,9,29,48.34437086092716,31.346578366445915,19.205298013245034,0.8830022075055187,0.22075055187637968
1,서울특별시,관악구,관외사전투표,,51408,51403,29503,11651,8549,874,70,50647,756,5,58.252216320808735,23.00432404683397,16.87957825734989,1.7256698323691433,0.1382115426382609
2,서울특별시,관악구,재외투표,,3295,2619,1761,513,272,49,1,2596,23,676,67.8351309707242,19.76117103235747,10.477657935285054,1.8875192604006163,0.038520801232665644
3,서울특별시,관악구,보라매동,관내사전투표,4535,4535,3022,927,497,48,9,4503,32,0,67.11081501221408,20.586275816122583,11.03708638685321,1.0659560293137909,0.19986675549633579
4,서울특별시,관악구,보라매동,보라매동제1투,2701,2010,690,1096,178,25,1,1990,20,691,34.67336683417086,55.07537688442211,8.944723618090453,1.256281407035176,0.05025125628140704
5,서울특별시,관악구,보라매동,보라매동제2투,2466,1752,741,805,161,25,5,1737,15,714,42.659758203799655,46.34427173287277,9.268854346574553,1.4392630972941853,0.28785261945883706
6,서울특별시,관악구,보라매동,보라매동제3투,3361,2243,832,1089,266,28,3,2218,25,1118,37.51127141568981,49.09828674481515,11.99278629395852,1.2623985572587917,0.1352569882777277
7,서울특별시,관악구,보라매동,보라매동제4투,2803,1736,619,866,217,21,0,1723,13,1067,35.9257109692397,50.261172373766684,12.594312246082415,1.2188044109112013,0.0
8,서울특별시,관악구,보라매동,보라매동제5투,2843,1835,777,840,178,17,6,1818,17,1008,42.73927392739274,46.2046204620462,9.79097909790979,0.935093509350935,0.33003300330033003
9,서울특별시,관악구,은천동,관내사전투표,6610,6610,4550,1411,544,48,6,6559,51,0,69.37033084311632,21.512425674645524,8.293947248056107,0.73181887482848,0.09147735935356
10,서울특별시,관악구,은천동,은천동제1투,2718,1813,631,928,214,21,1,1795,18,905,35.15320334261838,51.6991643454039,11.92200557103064,1.16991643454039,0.05571030640668524
11,서울특별시,관악구,은천동,은천동제2투,2857,1943,692,955,248,30,2,1927,16,914,35.91074208614427,49.558899844317594,12.869745718733782,1.5568240788790866,0.10378827192527244
12,서울특별시,관악구,은천동,은천동제3투,2221,1513,551,768,152,23,3,1497,16,708,36.80694722778891,51.302605210420836,10.153640614562457,1.5364061456245823,0.2004008016032064
13,서울특별시,관악구,은천동,은천동제4투,2554,2060,911,891,212,29,2,2045,15,494,44.54767726161369,43.56968215158924,10.366748166259168,1.4180929095354522,0.09779951100244498
14,서울특별시,관악구,은천동,은천동제5투,2475,1912,879,888,117,13,1,1898,14,563,46.31190727081138,46.78609062170706,6.164383561643835,0.684931506849315,0.052687038988408846
15,서울특별시,관악구,은천동,은천동제6투,2594,1664,737,755,141,16,5,1654,10,930,44.55864570737606,45.646916565900845,8.52478839177751,0.9673518742442563,0.3022974607013301
16,서울특별시,관악구,은천동,은천동제7투,2737,1717,679,832,174,13,4,1702,15,1020,39.89424206815511,48.88366627497062,10.223266745005875,0.763807285546416,0.23501762632197415
17,서울특별시,관악구,성현동,관내사전투표,4830,4830,3424,988,332,60,1,4805,25,0,71.25910509885536,20.561914672216442,6.9094693028095735,1.2486992715920915,0.02081165452653486
18,서울특별시,관악구,성현동,성현동제1투,2347,1724,750,818,114,24,4,1710,14,623,43.859649122807014,47.83625730994152,6.666666666666667,1.4035087719298245,0.23391812865497078
19,서울특별시,관악구,성현동,성현동제2투,3133,2254,983,1006,201,44,2,2236,18,879,43.96243291592129,44.991055456171736,8.989266547406082,1.9677996422182469,0.08944543828264759
20,서울특별시,관악구,성현동,성현동제3투,2265,1880,773,891,168,27,3,1862,18,385,41.514500537056925,47.85177228786252,9.022556390977442,1.4500537056928033,0.1611170784103115
21,서울특별시,관악구,성현동,성현동제4투,2578,2046,788,1020,200,24,0,2032,14,532,38.77952755905512,50.196850393700785,9.84251968503937,1.1811023622047243,0.0
22,서울특별시,관악구,성현동,성현동제5투,2462,1816,695,889,192,27,0,1803,13,646,38.54686633388796,49.30671103716029,10.64891846921797,1.497504159733777,0.0
23,서울특별시,관악구,성현동,성현동제6투,1956,1368,520,686,122,24,3,1355,13,588,38.37638376383764,50.627306273062736,9.00369003690037,1.7712177121771218,0.22140221402214022
24,서울특별시,관악구,성현동,성현동제7투,2220,1577,663,805,74,14,3,1559,18,643,42.52726106478512,51.63566388710712,4.746632456703015,0.8980115458627326,0.19243104554201412
25,서울특별시,관악구,중앙동,관내사전투표,4307,4307,2714,845,612,79,7,4257,50,0,63.753817242189335,19.849659384543106,14.376321353065538,1.855766972046042,0.1644350481559784
26,서울특별시,관악구,중앙동,중앙동제1투,2758,1745,606,800,276,28,5,1715,30,1013,35.33527696793003,46.647230320699705,16.0932944606414,1.6326530612244898,0.2915451895043732
27,서울특별시,관악구,중앙동,중앙동제2투,2624,1763,695,820,208,25,1,1749,14,861,39.73699256718125,46.883933676386505,11.892510005717554,1.429388221841052,0.05717552887364208
28,서울특별시,관악구,중앙동,중앙동제3투,3369,2171,752,1008,345,36,9,2150,21,1198,34.97674418604651,46.883720930232556,16.046511627906977,1.6744186046511629,0.4186046511627907
29,서울특별시,관악구,청림동,관내사전투표,3164,3164,2157,714,223,38,5,3137,27,0,68.75996174689195,22.76059929869302,7.108702582084795,1.2113484220592923,0.1593879502709595
30,서울특별시,관악구,청림동,청림동제1투,2414,1859,572,1071,177,21,1,1842,17,555,31.053203040173727,58.14332247557004,9.609120521172638,1.1400651465798046,0.05428881650380022
31,서울특별시,관악구,청림동,청림동제2투,2509,1611,637,811,126,26,0,1600,11,898,39.8125,50.6875,7.875,1.625,0.0
32,서울특별시,관악구,청림동,청림동제3투,3291,2699,1199,1176,266,37,1,2679,20,592,44.755505785740944,43.89697648376259,9.929078014184398,1.3811123553564764,0.03732736095558044
33,서울특별시,관악구,행운동,관내사전투표,6996,6996,4377,1436,986,122,4,6925,71,0,63.2057761732852,20.736462093862816,14.238267148014442,1.7617328519855595,0.05776173285198556
34,서울특별시,관악구,행운동,행운동제1투,2741,1963,725,895,286,27,3,1936,27,778,37.44834710743802,46.2293388429752,14.772727272727273,1.3946280991735538,0.15495867768595042
35,서울특별시,관악구,행운동,행운동제2투,3324,2363,815,1095,366,41,5,2322,41,961,35.09905254091301,47.15762273901809,15.762273901808785,1.7657192075796728,0.2153316106804479
36,서울특별시,관악구,행운동,행운동제3투,3238,2260,842,1011,326,45,4,2228,32,978,37.791741472172355,45.3770197486535,14.631956912028727,2.0197486535008977,0.17953321364452424
37,서울특별시,관악구,행운동,행운동제4투,2807,1803,609,879,255,27,3,1773,30,1004,34.34856175972927,49.57698815566836,14.382402707275805,1.5228426395939088,0.1692047377326565
38,서울특별시,관악구,행운동,행운동제5투,2165,1495,545,716,195,17,3,1476,19,670,36.92411924119241,48.509485094850945,13.211382113821138,1.151761517615176,0.20325203252032523
39,서울특별시,관악구,행운동,행운동제6투,2853,2158,892,1064,163,25,1,2145,13,695,41.58508158508158,49.603729603729604,7.599067599067599,1.1655011655011656,0.046620046620046623
40,서울특별시,관악구,청룡동,관내사전투표,6923,6923,4516,1419,837,89,8,6869,54,0,65.74464987625565,20.6580288251565,12.18517979327413,1.2956762265249673,0.1164652787887611
41,서울특별시,관악구,청룡동,청룡동제1투,3605,2262,797,1054,336,47,2,2236,26,1343,35.64400715563506,47.13774597495527,15.026833631484795,2.1019677996422184,0.08944543828264759
42,서울특별시,관악구,청룡동,청룡동제2투,3760,2543,909,1182,373,43,6,2513,30,1217,36.17190608834063,47.03541583764425,14.842817349781138,1.7111022682053323,0.23875845602865103
43,서울특별시,관악구,청룡동,청룡동제3투,3827,2779,933,1190,552,63,2,2740,39,1048,34.051094890510946,43.43065693430657,20.145985401459853,2.2992700729927007,0.072992700729927
44,서울특별시,관악구,청룡동,청룡동제4투,3209,2192,875,995,254,37,1,2162,30,1017,40.47178538390379,46.02220166512488,11.748381128584644,1.7113783533765032,0.04625346901017577
45,서울특별시,관악구,청룡동,청룡동제5투,4327,3118,1047,1429,542,60,1,3079,39,1209,34.0045469308217,46.41117245859045,17.603117895420592,1.948684637869438,0.03247807729782397
46,서울특별시,관악구,청룡동,청룡동제6투,3085,2175,752,1115,248,36,4,2155,20,910,34.895591647331784,51.74013921113689,11.508120649651971,1.6705336426914155,0.18561484918793503
47,서울특별시,관악구,낙성대동,관내사전투표,3983,3983,2305,880,637,111,2,3935,48,0,58.57687420584497,22.36340533672173,16.18805590851334,2.820838627700127,0.05082592121982211
48,서울특별시,관악구,낙성대동,낙성대동제1투,3881,2685,909,1221,472,53,1,2656,29,1196,34.22439759036144,45.971385542168676,17.771084337349397,1.995481927710843,0.03765060240963856
49,서울특별시,관악구,낙성대동,낙성대동제2투,2970,1871,594,930,283,38,3,1848,23,1099,32.142857142857146,50.324675324675326,15.313852813852813,2.0562770562770565,0.16233766233766234
50,서울특별시,관악구,낙성대동,낙성대동제3투,3232,2311,686,1113,422,63,2,2286,25,921,30.0087489063867,48.68766404199475,18.460192475940506,2.7559055118110236,0.08748906386701663
51,서울특별시,관악구,인헌동,관내사전투표,8155,8155,5156,1836,953,126,7,8078,77,0,63.8276801188413,22.728398118346124,11.797474622431295,1.559792027729636,0.08665511265164644
52,서울특별시,관악구,인헌동,인헌동제1투,2449,1571,523,802,208,18,1,1552,19,878,33.698453608247426,51.675257731958766,13.402061855670103,1.1597938144329898,0.06443298969072164
53,서울특별시,관악구,인헌동,인헌동제2투,3182,2110,693,1008,330,43,3,2077,33,1072,33.3654309099663,48.53153586904189,15.888300433317285,2.0702936928261915,0.14443909484833894
54,서울특별시,관악구,인헌동,인헌동제3투,2803,1958,663,976,270,31,0,1940,18,845,34.175257731958766,50.30927835051546,13.917525773195877,1.5979381443298968,0.0
55,서울특별시,관악구,인헌동,인헌동제4투,2654,1751,604,894,202,31,2,1733,18,903,34.85285631852279,51.5868436237738,11.656087709174841,1.788805539526832,0.1154068090017311
56,서울특별시,관악구,인헌동,인헌동제5투,2735,2121,852,1028,176,41,8,2105,16,614,40.4750593824228,48.836104513064136,8.36104513064133,1.9477434679334917,0.38004750593824227
57,서울특별시,관악구,남현동,관내사전투표,4266,4266,2720,1009,444,47,1,4221,45,0,64.439706230751,23.90428808339256,10.518834399431414,1.11348021795783,0.02369106846718787
58,서울특별시,관악구,남현동,남현동제1투,2513,1781,665,907,168,23,2,1765,16,732,37.6770538243626,51.388101983002834,9.518413597733712,1.3031161473087818,0.11331444759206798
59,서울특별시,관악구,남현동,남현동제2투,2290,1576,520,851,168,23,3,1565,11,714,33.22683706070288,54.37699680511182,10.73482428115016,1.4696485623003195,0.19169329073482427
60,서울특별시,관악구,남현동,남현동제3투,2589,1689,535,868,232,28,2,1665,24,900,32.13213213213213,52.132132132132135,13.933933933933934,1.6816816816816818,0.12012012012012012
61,서울특별시,관악구,남현동,남현동제4투,2341,1584,481,876,185,19,4,1565,19,757,30.734824281150157,55.97444089456869,11.821086261980831,1.2140575079872205,0.25559105431309903
62,서울특별시,관악구,신림동,관내사전투표,5224,5224,3226,1054,791,89,6,5166,58,0,62.44676732481611,20.40263259775455,15.311653116531165,1.7228029423151374,0.11614401858304298
63,서울특별시,관악구,신림동,신림동제1투,4723,2749,919,1221,521,37,7,2705,44,1974,33.97412199630314,45.138632162661736,19.260628465804068,1.3678373382624769,0.2587800369685767
64,서울특별시,관악구,신림동,신림동제2투,4622,2419,760,1073,498,40,3,2374,45,2203,32.01347935973041,45.19797809604044,20.977253580454928,1.6849199663016006,0.12636899747262004
65,서울특별시,관악구,신림동,신림동제3투,3066,1728,566,791,307,35,1,1700,28,1338,33.294117647058826,46.52941176470588,18.058823529411764,2.0588235294117645,0.0588235294117647
66,서울특별시,관악구,신림동,신림동제4투,2721,1729,606,833,243,31,2,1715,14,992,35.33527696793003,48.57142857142857,14.169096209912539,1.8075801749271136,0.11661807580174927
67,서울특별시,관악구,신사동,관내사전투표,5491,5491,3565,1187,605,64,10,5431,60,0,65.64168661388327,21.856011784201804,11.139753268274719,1.17842018044559,0.18412815319462347
68,서울특별시,관악구,신사동,신사동제1투,2424,1623,623,770,192,17,5,1607,16,801,38.76789047915371,47.91537025513379,11.947728686994399,1.057871810827629,0.3111387678904792
69,서울특별시,관악구,신사동,신사동제2투,2852,1760,638,835,227,30,4,1734,26,1092,36.793540945790085,48.15455594002307,13.09111880046136,1.7301038062283738,0.2306805074971165
70,서울특별시,관악구,신사동,신사동제3투,2654,1618,556,784,225,34,4,1603,15,1036,34.6849656893325,48.90829694323144,14.0361821584529,2.1210230817217717,0.2495321272613849
71,서울특별시,관악구,신사동,신사동제4투,2459,1404,495,676,198,12,2,1383,21,1055,35.791757049891544,48.879248011569054,14.316702819956618,0.8676789587852495,0.14461315979754158
72,서울특별시,관악구,신사동,신사동제5투,2853,1769,648,844,224,28,1,1745,24,1084,37.13467048710602,48.36676217765043,12.836676217765042,1.6045845272206303,0.05730659025787965
73,서울특별시,관악구,조원동,관내사전투표,4501,4501,2956,982,459,57,4,4458,43,0,66.30776132794975,22.02781516375056,10.296096904441454,1.278600269179004,0.08972633467922835
74,서울특별시,관악구,조원동,조원동제1투,3052,1893,668,910,254,24,4,1860,33,1159,35.913978494623656,48.924731182795696,13.655913978494624,1.2903225806451613,0.21505376344086022
75,서울특별시,관악구,조원동,조원동제2투,2842,1792,640,894,214,18,4,1770,22,1050,36.15819209039548,50.50847457627119,12.09039548022599,1.0169491525423728,0.22598870056497175
76,서울특별시,관악구,조원동,조원동제3투,2804,1789,636,842,261,32,1,1772,17,1015,35.89164785553047,47.51693002257336,14.729119638826186,1.805869074492099,0.0564334085778781
77,서울특별시,관악구,조원동,조원동제4투,3052,2235,787,1093,299,30,1,2210,25,817,35.61085972850679,49.457013574660635,13.529411764705882,1.3574660633484164,0.04524886877828054
78,서울특별시,관악구,미성동,관내사전투표,6373,6372,4247,1602,427,53,5,6334,38,1,67.0508367540259,25.29207451847174,6.7413956425639405,0.8367540258920114,0.07893905904641617
79,서울특별시,관악구,미성동,미성동제1투,2970,1825,697,852,219,34,4,1806,19,1145,38.59357696566999,47.176079734219265,12.12624584717608,1.8826135105204873,0.22148394241417496
80,서울특별시,관악구,미성동,미성동제2투,2454,1717,681,860,138,26,2,1707,10,737,39.894551845342704,50.380785002929116,8.084358523725834,1.5231400117164615,0.11716461628588166
81,서울특별시,관악구,미성동,미성동제3투,2758,2208,816,1188,171,15,1,2191,17,550,37.24326791419443,54.22181652213601,7.804655408489275,0.6846188954815152,0.045641259698767686
82,서울특별시,관악구,미성동,미성동제4투,2296,1481,595,732,124,15,1,1467,14,815,40.55896387184731,49.897750511247445,8.452624403544649,1.0224948875255624,0.0681663258350375
83,서울특별시,관악구,미성동,미성동제5투,2203,1441,521,758,133,18,0,1430,11,762,36.43356643356643,53.00699300699301,9.300699300699302,1.2587412587412588,0.0
84,서울특별시,관악구,미성동,미성동제6투,2091,1277,476,683,96,14,1,1270,7,814,37.480314960629926,53.77952755905512,7.559055118110236,1.1023622047244095,0.07874015748031496
85,서울특별시,관악구,미성동,미성동제7투,2176,1519,623,731,135,19,4,1512,7,657,41.2037037037037,48.34656084656085,8.928571428571429,1.2566137566137565,0.26455026455026454
86,서울특별시,관악구,난곡동,관내사전투표,4703,4703,3271,1064,285,47,4,4671,32,0,70.0278312995076,22.778848212374225,6.101477199743096,1.0062085206593878,0.08563476771569258
87,서울특별시,관악구,난곡동,난곡동제1투,2428,1401,573,666,120,21,5,1385,16,1027,41.371841155234655,48.08664259927798,8.664259927797833,1.516245487364621,0.36101083032490977
88,서울특별시,관악구,난곡동,난곡동제2투,2919,1894,805,874,176,18,4,1877,17,1025,42.88758657432072,46.563665423548215,9.376664890783164,0.9589770911028237,0.21310602024507191
89,서울특별시,관악구,난곡동,난곡동제3투,2757,1940,897,836,163,24,6,1926,14,817,46.573208722741434,43.40602284527518,8.463136033229492,1.2461059190031152,0.3115264797507788
90,서울특별시,관악구,난곡동,난곡동제4투,2181,1326,511,670,121,12,4,1318,8,855,38.770864946889226,50.834597875569045,9.180576631259484,0.9104704097116844,0.30349013657056145
91,서울특별시,관악구,난곡동,난곡동제5투,2166,1455,561,763,107,16,1,1448,7,711,38.74309392265193,52.693370165745854,7.38950276243094,1.1049723756906076,0.06906077348066297
92,서울특별시,관악구,난곡동,난곡동제6투,2284,1372,554,687,107,10,3,1361,11,912,40.70536370315944,50.47759000734754,7.861866274797942,0.7347538574577517,0.2204261572373255
93,서울특별시,관악구,난향동,관내사전투표,3335,3335,2352,734,200,27,2,3315,20,0,70.9502262443439,22.141779788838612,6.033182503770739,0.8144796380090499,0.06033182503770739
94,서울특별시,관악구,난향동,난향동제1투,2267,1529,603,801,106,14,2,1526,3,738,39.515072083879424,52.49017038007864,6.946264744429882,0.9174311926605505,0.1310615989515072
95,서울특별시,관악구,난향동,난향동제2투,3044,2243,921,1102,181,27,0,2231,12,801,41.28193635141192,49.394890183774095,8.11295383236217,1.2102196324518153,0.0
96,서울특별시,관악구,난향동,난향동제3투,2490,1539,628,772,104,20,1,1525,14,951,41.18032786885246,50.62295081967213,6.8196721311475414,1.3114754098360655,0.06557377049180328
97,서울특별시,관악구,서원동,관내사전투표,4455,4455,2795,967,566,63,7,4398,57,0,63.55161437016827,21.987266939517962,12.86948613005912,1.4324693042291952,0.1591632560254661
98,서울특별시,관악구,서원동,서원동제1투,3213,2093,753,997,280,32,2,2064,29,1120,36.48255813953488,48.304263565891475,13.565891472868216,1.550387596899225,0.09689922480620156
99,서울특별시,관악구,서원동,서원동제2투,2892,1751,547,889,278,22,1,1737,14,1141,31.491076568796778,51.18019573978123,16.00460564191134,1.266551525618883,0.05757052389176742
100,서울특별시,관악구,서원동,서원동제3투,3294,1832,609,875,285,35,1,1805,27,1462,33.739612188365655,48.476454293628805,15.789473684210526,1.9390581717451523,0.0554016620498615
101,서울특별시,관악구,서원동,서원동제4투,2274,1396,517,653,185,23,2,1380,16,878,37.46376811594203,47.31884057971015,13.405797101449277,1.6666666666666667,0.14492753623188406
102,서울특별시,관악구,서원동,서원동제5투,2638,1670,650,797,177,26,5,1655,15,968,39.274924471299094,48.1570996978852,10.694864048338369,1.570996978851964,0.3021148036253776
103,서울특별시,관악구,신원동,관내사전투표,5162,5162,3274,1202,583,54,4,5117,45,0,63.982802423294906,23.49032636310338,11.393394567129176,1.0553058432675395,0.07817080320500293
104,서울특별시,관악구,신원동,신원동제1투,3149,1874,596,920,288,36,3,1843,31,1275,32.33857840477483,49.918610960390666,15.62669560499186,1.9533369506239826,0.16277807921866522
105,서울특별시,관악구,신원동,신원동제2투,2335,1442,459,769,177,17,3,1425,17,893,32.21052631578947,53.964912280701746,12.421052631578949,1.1929824561403508,0.21052631578947367
106,서울특별시,관악구,신원동,신원동제3투,2325,1416,520,662,191,26,0,1399,17,909,37.16940671908506,47.31951393852752,13.652609006433167,1.858470335954253,0.0
107,서울특별시,관악구,신원동,신원동제4투,2471,1476,536,739,163,22,3,1463,13,995,36.63704716336295,50.512645249487356,11.14149008885851,1.5037593984962405,0.2050580997949419
108,서울특별시,관악구,서림동,관내사전투표,3011,3011,2025,677,245,39,1,2987,24,0,67.79377301640443,22.66488115165718,8.20220957482424,1.3056578506863072,0.03347840642785404
109,서울특별시,관악구,서림동,서림동제1투,2826,1702,609,857,202,22,0,1690,12,1124,36.035502958579876,50.710059171597635,11.95266272189349,1.301775147928994,0.0
110,서울특별시,관악구,서림동,서림동제2투,2145,1623,493,959,129,27,2,1610,13,522,30.62111801242236,59.56521739130435,8.012422360248447,1.6770186335403725,0.12422360248447205
111,서울특별시,관악구,서림동,서림동제3투,2956,1727,523,855,281,33,5,1697,30,1229,30.819092516205064,50.38302887448438,16.55863288155569,1.9446081319976427,0.29463759575721865
112,서울특별시,관악구,서림동,서림동제4투,3730,2186,752,970,395,44,2,2163,23,1544,34.76652797041147,44.84512251502542,18.261673601479426,2.034211742949607,0.09246417013407304
113,서울특별시,관악구,서림동,서림동제5투,2576,1701,695,796,179,17,1,1688,13,875,41.172985781990526,47.1563981042654,10.604265402843602,1.0071090047393365,0.05924170616113744
114,서울특별시,관악구,삼성동,관내사전투표,5000,5000,3345,1163,403,58,6,4975,25,0,67.23618090452261,23.376884422110553,8.100502512562814,1.1658291457286432,0.1206030150753769
115,서울특별시,관악구,삼성동,삼성동제1투,1762,991,359,550,58,14,1,982,9,771,36.55804480651731,56.0081466395112,5.906313645621181,1.4256619144602851,0.10183299389002036
116,서울특별시,관악구,삼성동,삼성동제2투,2223,1505,621,739,105,20,2,1487,18,718,41.761936785474106,49.697377269670476,7.061197041022192,1.3449899125756557,0.13449899125756556
117,서울특별시,관악구,삼성동,삼성동제3투,2791,1857,681,1013,128,22,1,1845,12,934,36.91056910569105,54.90514905149051,6.937669376693767,1.1924119241192412,0.05420054200542006
118,서울특별시,관악구,삼성동,삼성동제4투,1998,1448,740,621,66,15,1,1443,5,550,51.28205128205128,43.03534303534304,4.5738045738045745,1.0395010395010396,0.0693000693000693
119,서울특별시,관악구,삼성동,삼성동제5투,2520,1945,780,1001,132,25,0,1938,7,575,40.24767801857585,51.651186790505676,6.811145510835913,1.2899896800825592,0.0
120,서울특별시,관악구,대학동,관내사전투표,7544,7544,4603,1437,1231,186,8,7465,79,0,61.661085063630274,19.24983255190891,16.49028801071668,2.491627595445412,0.10716677829872738
121,서울특별시,관악구,대학동,대학동제1투,4369,2433,687,1191,472,51,2,2403,30,1936,28.58926342072409,49.56304619225968,19.642114024136497,2.1223470661672907,0.08322929671244278
122,서울특별시,관악구,대학동,대학동제2투,2841,1993,627,1011,297,38,3,1976,17,848,31.73076923076923,51.163967611336034,15.030364372469634,1.9230769230769231,0.15182186234817813
123,서울특별시,관악구,대학동,대학동제3투,3490,1974,773,946,213,31,2,1965,9,1516,39.338422391857506,48.14249363867684,10.839694656488549,1.5776081424936386,0.10178117048346055
124,서울특별시,관악구,대학동,대학동제4투,3899,2247,697,1146,333,33,3,2212,35,1652,31.50994575045208,51.80831826401446,15.054249547920435,1.4918625678119348,0.13562386980108498
125,서울특별시,관악구,잘못 투입·구분된 투표지,,0,1,0,1,0,0,0,1,0,-1,0.0,100.0,0.0,0.0,0.0
0,서울특별시,서초구,거소·선상투표,,322,299,98,136,60,1,0,295,4,23,33.220338983050844,46.101694915254235,20.33898305084746,0.3389830508474576,0.0
1,서울특별시,서초구,관외사전투표,,34545,34541,16878,12031,4834,479,24,34246,295,4,49.28458798107808,35.131110202651406,14.115517140687963,1.39870349821877,0.07008117736377971
2,서울특별시,서초구,재외투표,,5489,4380,2240,1466,564,84,2,4356,24,1109,51.42332415059688,33.65472910927456,12.947658402203857,1.9283746556473829,0.04591368227731864
3,서울특별시,서초구,서초1동,관내사전투표,4121,4121,2219,1393,431,48,4,4095,26,0,54.18803418803419,34.01709401709402,10.525030525030525,1.1721611721611722,0.09768009768009768
4,서울특별시,서초구,서초1동,서초1동제1투,3768,2654,617,1763,235,33,1,2649,5,1114,23.291808229520576,66.55341638354096,8.871272178180444,1.245753114382786,0.03775009437523594
5,서울특별시,서초구,서초1동,서초1동제2투,2838,2047,463,1339,211,16,2,2031,16,791,22.796651895617924,65.92811422944362,10.388970950270803,0.7877892663712458,0.09847365829640572
6,서울특별시,서초구,서초1동,서초1동제3투,2917,2034,361,1442,204,13,2,2022,12,883,17.85361028684471,71.31552917903066,10.089020771513352,0.6429277942631058,0.09891196834817012
7,서울특별시,서초구,서초1동,서초1동제4투,2535,1783,417,1121,199,29,2,1768,15,752,23.585972850678733,63.40497737556561,11.255656108597286,1.6402714932126699,0.11312217194570137
8,서울특별시,서초구,서초2동,관내사전투표,3951,3950,1983,1391,501,53,1,3929,21,1,50.47085772461186,35.40341053703233,12.751336217867143,1.3489437515907354,0.025451768897938407
9,서울특별시,서초구,서초2동,서초2동제1투,2251,1737,285,1287,138,13,3,1726,11,514,16.512166859791424,74.56546929316339,7.995365005793744,0.7531865585168018,0.17381228273464658
10,서울특별시,서초구,서초2동,서초2동제2투,3682,2434,642,1398,348,23,4,2415,19,1248,26.583850931677016,57.88819875776397,14.409937888198757,0.9523809523809524,0.16563146997929606
11,서울특별시,서초구,서초2동,서초2동제3투,3417,2577,665,1589,277,27,0,2558,19,840,25.99687255668491,62.11884284597342,10.828772478498827,1.055512118842846,0.0
12,서울특별시,서초구,서초2동,서초2동제4투,2959,2117,358,1564,171,17,2,2112,5,842,16.950757575757574,74.0530303030303,8.096590909090908,0.8049242424242424,0.0946969696969697
13,서울특별시,서초구,서초2동,서초2동제5투,2653,2131,434,1473,198,13,0,2118,13,522,20.49102927289896,69.54674220963173,9.34844192634561,0.6137865911237016,0.0
14,서울특별시,서초구,서초3동,관내사전투표,4773,4773,2682,1476,511,69,2,4740,33,0,56.58227848101266,31.139240506329113,10.780590717299578,1.4556962025316456,0.04219409282700422
15,서울특별시,서초구,서초3동,서초3동제1투,3584,2379,396,1753,189,23,3,2364,15,1205,16.751269035532996,74.15397631133672,7.994923857868021,0.972927241962775,0.12690355329949238
16,서울특별시,서초구,서초3동,서초3동제2투,2346,1687,474,1035,149,16,1,1675,12,659,28.29850746268657,61.791044776119406,8.895522388059701,0.9552238805970149,0.05970149253731343
17,서울특별시,서초구,서초3동,서초3동제3투,2716,2052,444,1409,165,21,1,2040,12,664,21.764705882352942,69.06862745098039,8.088235294117647,1.0294117647058822,0.049019607843137254
18,서울특별시,서초구,서초3동,서초3동제4투,2565,1894,536,1129,189,25,0,1879,15,671,28.525811601915912,60.085151676423635,10.058541777541246,1.3304949441192122,0.0
19,서울특별시,서초구,서초3동,서초3동제5투,2686,1895,517,1157,186,21,2,1883,12,791,27.45618693574084,61.444503451938395,9.877854487519915,1.1152416356877324,0.10621348911311736
20,서울특별시,서초구,서초3동,서초3동제6투,3712,2535,618,1607,261,33,0,2519,16,1177,24.533545057562524,63.795156808257246,10.361254466057959,1.3100436681222707,0.0
21,서울특별시,서초구,서초3동,서초3동제7투,2339,1789,371,1241,138,28,0,1778,11,550,20.866141732283463,69.79752530933632,7.761529808773904,1.574803149606299,0.0
22,서울특별시,서초구,서초4동,관내사전투표,3561,3561,1664,1359,466,46,0,3535,26,0,47.07213578500708,38.44413012729844,13.182461103253182,1.3012729844413014,0.0
23,서울특별시,서초구,서초4동,서초4동제1투,3232,2117,369,1488,226,23,0,2106,11,1115,17.52136752136752,70.65527065527066,10.731244064577398,1.0921177587844255,0.0
24,서울특별시,서초구,서초4동,서초4동제2투,3275,2551,430,1854,229,26,2,2541,10,724,16.922471467926016,72.96340023612751,9.012199921290831,1.023219205037387,0.07870916961826052
25,서울특별시,서초구,서초4동,서초4동제3투,3050,2368,307,1855,178,16,0,2356,12,682,13.03056027164686,78.73514431239389,7.555178268251274,0.6791171477079796,0.0
26,서울특별시,서초구,서초4동,서초4동제4투,2674,2129,301,1631,163,27,1,2123,6,545,14.178049929345265,76.82524729156853,7.677814413565709,1.2717852096090438,0.047103155911446065
27,서울특별시,서초구,서초4동,서초4동제5투,3371,2521,446,1826,224,16,1,2513,8,850,17.747711898129726,72.66215678471946,8.913649025069638,0.6366892160764027,0.03979307600477517
28,서울특별시,서초구,서초4동,서초4동제6투,2715,2204,456,1479,239,19,0,2193,11,511,20.79343365253078,67.44186046511628,10.898312813497492,0.8663930688554491,0.0
29,서울특별시,서초구,잠원동,관내사전투표,3698,3698,1854,1424,356,44,1,3679,19,0,50.39412883935852,38.7061701549334,9.67654253873335,1.1959771677086164,0.02718129926610492
30,서울특별시,서초구,잠원동,잠원동제1투,3024,2070,364,1491,181,24,0,2060,10,954,17.66990291262136,72.37864077669903,8.78640776699029,1.1650485436893203,0.0
31,서울특별시,서초구,잠원동,잠원동제2투,2819,2064,330,1525,179,15,0,2049,15,755,16.105417276720353,74.4265495363592,8.735968765251343,0.7320644216691069,0.0
32,서울특별시,서초구,잠원동,잠원동제3투,2430,1855,404,1236,179,24,0,1843,12,575,21.920781334780248,67.06456863809007,9.712425393380359,1.3022246337493217,0.0
33,서울특별시,서초구,잠원동,잠원동제4투,2855,2190,391,1567,190,30,0,2178,12,665,17.95224977043159,71.9467401285583,8.723599632690542,1.3774104683195594,0.0
34,서울특별시,서초구,잠원동,잠원동제5투,2212,1516,380,980,125,17,1,1503,13,696,25.28276779773786,65.20292747837658,8.316699933466401,1.1310711909514306,0.0665335994677312
35,서울특별시,서초구,잠원동,잠원동제6투,2620,2085,404,1452,198,21,1,2076,9,535,19.460500963391137,69.94219653179191,9.53757225433526,1.0115606936416186,0.04816955684007707
36,서울특별시,서초구,반포본동,관내사전투표,165,165,80,69,15,1,0,165,0,0,48.484848484848484,41.81818181818181,9.090909090909092,0.6060606060606061,0.0
37,서울특별시,서초구,반포본동,반포본동투표소,135,55,11,39,4,0,0,54,1,80,20.37037037037037,72.22222222222221,7.4074074074074066,0.0,0.0
38,서울특별시,서초구,반포1동,관내사전투표,4556,4556,2220,1823,451,48,0,4542,14,0,48.87714663143989,40.13650374284456,9.929546455306031,1.0568031704095113,0.0
39,서울특별시,서초구,반포1동,반포1동제1투,3621,2858,498,2060,264,21,1,2844,14,763,17.51054852320675,72.43319268635724,9.282700421940929,0.7383966244725738,0.035161744022503515
40,서울특별시,서초구,반포1동,반포1동제2투,3240,2522,537,1706,235,27,2,2507,15,718,21.420023932987633,68.04946150777822,9.373753490227363,1.0769844435580374,0.07977662544874352
41,서울특별시,서초구,반포1동,반포1동제3투,2635,1622,499,931,162,17,0,1609,13,1013,31.0130515848353,57.862026103169676,10.068365444375388,1.0565568676196395,0.0
42,서울특별시,서초구,반포1동,반포1동제4투,2226,1314,433,718,137,14,1,1303,11,912,33.23100537221796,55.103607060629315,10.514198004604758,1.0744435917114352,0.07674597083653108
43,서울특별시,서초구,반포1동,반포1동제5투,1994,965,285,553,102,14,1,955,10,1029,29.84293193717277,57.90575916230366,10.68062827225131,1.4659685863874345,0.10471204188481677
44,서울특별시,서초구,반포1동,반포1동제6투,3296,2272,307,1716,220,20,3,2266,6,1024,13.54810238305384,75.72815533980582,9.70873786407767,0.8826125330979699,0.1323918799646955
45,서울특별시,서초구,반포1동,반포1동제7투,2856,2293,414,1660,182,28,1,2285,8,563,18.11816192560175,72.64770240700219,7.964989059080962,1.225382932166302,0.0437636761487965
46,서울특별시,서초구,반포2동,관내사전투표,4140,4140,1798,1813,436,58,1,4106,34,0,43.78957622990745,44.15489527520701,10.618606916707257,1.412566975158305,0.024354603019970774
47,서울특별시,서초구,반포2동,반포2동제1투,4354,3439,471,2659,277,20,2,3429,10,915,13.73578302712161,77.54447360746573,8.078156897054535,0.5832604257801108,0.058326042578011085
48,서울특별시,서초구,반포2동,반포2동제2투,2795,2238,411,1563,230,24,1,2229,9,557,18.438761776581426,70.12113055181696,10.31852848811126,1.0767160161507403,0.04486316733961417
49,서울특별시,서초구,반포2동,반포2동제3투,2665,2117,260,1630,202,13,2,2107,10,548,12.33981964878975,77.36117702895112,9.587090650213574,0.6169909824394874,0.09492168960607499
50,서울특별시,서초구,반포2동,반포2동제4투,2764,2069,284,1601,153,19,1,2058,11,695,13.79980563654033,77.79397473275024,7.434402332361516,0.923226433430515,0.048590864917395525
51,서울특별시,서초구,반포2동,반포2동제5투,2496,2020,321,1492,175,20,1,2009,11,476,15.978098556495768,74.26580388252863,8.710801393728223,0.9955201592832255,0.049776007964161276
52,서울특별시,서초구,반포3동,관내사전투표,3523,3523,1583,1545,354,29,0,3511,12,0,45.08686983765309,44.00455710623754,10.082597550555397,0.8259755055539733,0.0
53,서울특별시,서초구,반포3동,반포3동제1투,2727,1984,302,1494,161,17,2,1976,8,743,15.2834008097166,75.60728744939271,8.147773279352228,0.8603238866396761,0.10121457489878542
54,서울특별시,서초구,반포3동,반포3동제2투,1891,1388,199,1063,99,16,2,1379,9,503,14.430746918056563,77.08484408992024,7.179115300942712,1.160261058738216,0.145032632342277
55,서울특별시,서초구,반포3동,반포3동제3투,3671,2938,512,2114,273,28,0,2927,11,733,17.492312948411342,72.22412025965153,9.326955927570891,0.9566108643662453,0.0
56,서울특별시,서초구,반포3동,반포3동제4투,2351,1742,303,1273,135,18,0,1729,13,609,17.524580682475417,73.62637362637363,7.807981492192019,1.0410641989589358,0.0
57,서울특별시,서초구,반포3동,반포3동제5투,3180,2483,493,1706,250,16,4,2469,14,697,19.967598217901987,69.09680032401782,10.125556905629809,0.6480356419603078,0.16200891049007696
58,서울특별시,서초구,반포4동,관내사전투표,2472,2472,1297,900,227,33,0,2457,15,0,52.78795278795278,36.63003663003663,9.238909238909239,1.3431013431013432,0.0
59,서울특별시,서초구,반포4동,반포4동제1투,2243,1498,312,1057,101,18,2,1490,8,745,20.93959731543624,70.93959731543625,6.778523489932886,1.2080536912751678,0.1342281879194631
60,서울특별시,서초구,반포4동,반포4동제2투,2629,1691,317,1210,135,18,2,1682,9,938,18.846611177170036,71.93816884661118,8.02615933412604,1.070154577883472,0.11890606420927466
61,서울특별시,서초구,반포4동,반포4동제3투,2513,2105,458,1438,177,20,2,2095,10,408,21.861575178997615,68.63961813842482,8.448687350835323,0.9546539379474941,0.0954653937947494
62,서울특별시,서초구,반포4동,반포4동제4투,1676,1273,288,841,124,11,1,1265,8,403,22.766798418972332,66.48221343873519,9.802371541501977,0.8695652173913043,0.07905138339920949
63,서울특별시,서초구,반포4동,반포4동제5투,1878,1375,241,994,110,20,0,1365,10,503,17.655677655677657,72.82051282051282,8.058608058608058,1.465201465201465,0.0
64,서울특별시,서초구,방배본동,관내사전투표,3345,3344,1856,1166,273,33,2,3330,14,1,55.73573573573574,35.01501501501502,8.198198198198197,0.990990990990991,0.06006006006006006
65,서울특별시,서초구,방배본동,방배본동제1투,2585,1922,376,1366,153,14,1,1910,12,663,19.68586387434555,71.51832460732984,8.010471204188482,0.7329842931937173,0.052356020942408384
66,서울특별시,서초구,방배본동,방배본동제2투,2994,2212,352,1689,151,13,1,2206,6,782,15.956482320942882,76.56391659111515,6.844968268359021,0.5893019038984587,0.04533091568449683
67,서울특별시,서초구,방배본동,방배본동제3투,3532,2631,659,1694,225,36,0,2614,17,901,25.21040550879878,64.80489671002296,8.607498087222647,1.3771996939556235,0.0
68,서울특별시,서초구,방배본동,방배본동제4투,2718,2067,648,1225,159,19,2,2053,14,651,31.563565513882125,59.6687773989284,7.744763760350707,0.9254749147588894,0.0974184120798831
69,서울특별시,서초구,방배1동,관내사전투표,3364,3364,1929,1048,309,48,2,3336,28,0,57.82374100719424,31.414868105515588,9.262589928057553,1.4388489208633095,0.05995203836930455
70,서울특별시,서초구,방배1동,방배1동제1투,2254,1572,400,992,156,14,1,1563,9,682,25.591810620601407,63.46769033909149,9.980806142034549,0.8957133717210494,0.06397952655150352
71,서울특별시,서초구,방배1동,방배1동제2투,2904,2084,613,1217,197,36,2,2065,19,820,29.685230024213077,58.93462469733656,9.53995157384988,1.7433414043583535,0.09685230024213075
72,서울특별시,서초구,방배1동,방배1동제3투,2067,1475,351,967,123,21,1,1463,12,592,23.991797676008204,66.09706083390294,8.407382091592618,1.4354066985645932,0.0683526999316473
73,서울특별시,서초구,방배1동,방배1동제4투,2249,1691,257,1277,128,17,1,1680,11,558,15.29761904761905,76.01190476190476,7.6190476190476195,1.0119047619047619,0.05952380952380953
74,서울특별시,서초구,방배2동,관내사전투표,3297,3296,2032,912,287,34,2,3267,29,1,62.19773492500765,27.915518824609737,8.784817875726967,1.0407101316192224,0.061218243036424855
75,서울특별시,서초구,방배2동,방배2동제1투,1898,1296,353,819,101,10,0,1283,13,602,27.513639906469212,63.83476227591582,7.872174590802807,0.779423226812159,0.0
76,서울특별시,서초구,방배2동,방배2동제2투,1088,753,202,495,47,3,0,747,6,335,27.041499330655956,66.26506024096386,6.291834002677376,0.4016064257028112,0.0
77,서울특별시,서초구,방배2동,방배2동제3투,527,371,97,218,52,2,1,370,1,156,26.216216216216214,58.91891891891892,14.054054054054054,0.5405405405405406,0.2702702702702703
78,서울특별시,서초구,방배2동,방배2동제4투,2376,1922,554,1145,187,17,1,1904,18,454,29.096638655462186,60.13655462184874,9.821428571428571,0.8928571428571428,0.052521008403361345
79,서울특별시,서초구,방배2동,방배2동제5투,1747,1260,373,732,132,14,1,1252,8,487,29.792332268370608,58.46645367412141,10.543130990415335,1.1182108626198082,0.07987220447284345
80,서울특별시,서초구,방배2동,방배2동제6투,1728,1403,376,852,150,19,1,1398,5,325,26.895565092989987,60.94420600858369,10.72961373390558,1.3590844062947067,0.07153075822603719
81,서울특별시,서초구,방배2동,방배2동제7투,1008,783,249,462,57,7,2,777,6,225,32.04633204633205,59.45945945945946,7.335907335907336,0.9009009009009009,0.2574002574002574
82,서울특별시,서초구,방배3동,관내사전투표,2587,2587,1311,995,240,35,1,2582,5,0,50.77459333849729,38.536018590240126,9.295120061967467,1.3555383423702556,0.03872966692486445
83,서울특별시,서초구,방배3동,방배3동제1투,3636,2764,523,2000,202,28,0,2753,11,872,18.99745731928805,72.6480203414457,7.337450054486015,1.0170722847802398,0.0
84,서울특별시,서초구,방배3동,방배3동제2투,3243,2355,397,1724,205,20,1,2347,8,888,16.915210907541542,73.45547507456327,8.734554750745632,0.8521516829995739,0.04260758414997869
85,서울특별시,서초구,방배3동,방배3동제3투,2311,1787,530,1060,155,31,1,1777,10,524,29.825548677546426,59.65109735509285,8.722566122678673,1.7445132245357344,0.056274620146314014
86,서울특별시,서초구,방배4동,관내사전투표,3991,3991,2245,1322,337,62,3,3969,22,0,56.563366087175616,33.30813807004283,8.490803728898968,1.562106324011086,0.07558578987150416
87,서울특별시,서초구,방배4동,방배4동제1투,2692,1908,328,1411,143,11,1,1894,14,784,17.31784582893347,74.49841605068637,7.550158394931363,0.5807814149947201,0.05279831045406547
88,서울특별시,서초구,방배4동,방배4동제2투,2244,1594,361,1080,118,23,0,1582,12,650,22.81921618204804,68.26801517067004,7.458912768647282,1.4538558786346398,0.0
89,서울특별시,서초구,방배4동,방배4동제3투,1891,1259,380,750,106,11,1,1248,11,632,30.448717948717945,60.09615384615385,8.493589743589745,0.8814102564102564,0.08012820512820512
90,서울특별시,서초구,방배4동,방배4동제4투,2604,1943,647,1052,195,24,1,1919,24,661,33.71547681083898,54.82021886399166,10.161542470036478,1.2506513809275663,0.05211047420531526
91,서울특별시,서초구,방배4동,방배4동제5투,1134,809,252,476,56,15,1,800,9,325,31.5,59.5,7.000000000000001,1.875,0.125
92,서울특별시,서초구,방배4동,방배4동제6투,2641,2141,581,1322,191,31,1,2126,15,500,27.328316086547506,62.18250235183444,8.98400752587018,1.458137347130762,0.047036688617121354
93,서울특별시,서초구,양재1동,관내사전투표,4647,4647,2898,1338,346,40,2,4624,23,0,62.67301038062284,28.935986159169552,7.482698961937715,0.8650519031141869,0.043252595155709346
94,서울특별시,서초구,양재1동,양재1동제1투,2025,1449,448,800,172,19,1,1440,9,576,31.11111111111111,55.55555555555556,11.944444444444445,1.3194444444444444,0.06944444444444445
95,서울특별시,서초구,양재1동,양재1동제2투,2446,1787,615,969,169,16,1,1770,17,659,34.74576271186441,54.74576271186441,9.548022598870057,0.903954802259887,0.05649717514124294
96,서울특별시,서초구,양재1동,양재1동제3투,2114,1504,409,927,146,13,0,1495,9,610,27.357859531772576,62.0066889632107,9.765886287625419,0.8695652173913043,0.0
97,서울특별시,서초구,양재1동,양재1동제4투,2423,1886,543,1170,134,24,2,1873,13,537,28.990923651895358,62.46663107314468,7.154297917778964,1.2813667912439934,0.10678056593699946
98,서울특별시,서초구,양재1동,양재1동제5투,2969,2196,769,1234,147,25,1,2176,20,773,35.34007352941176,56.70955882352941,6.755514705882352,1.1488970588235294,0.04595588235294117
99,서울특별시,서초구,양재1동,양재1동제6투,2147,1415,351,943,98,9,2,1403,12,732,25.01781895937277,67.21311475409836,6.98503207412687,0.6414825374198148,0.14255167498218105
100,서울특별시,서초구,양재1동,양재1동제7투,2192,1578,285,1132,120,21,1,1559,19,614,18.280949326491342,72.61064785118666,7.6972418216805645,1.3470173187940988,0.06414368184733803
101,서울특별시,서초구,양재1동,양재1동제8투,2599,2031,787,1058,152,18,1,2016,15,568,39.03769841269841,52.480158730158735,7.5396825396825395,0.8928571428571428,0.0496031746031746
102,서울특별시,서초구,양재1동,양재1동제9투,3261,2520,815,1397,262,32,3,2509,11,741,32.483060980470306,55.67955360701474,10.442407333599043,1.2754085292945396,0.11956954962136308
103,서울특별시,서초구,양재1동,양재1동제10투,2489,2008,845,946,174,22,2,1989,19,481,42.48366013071895,47.56158873805932,8.74811463046757,1.1060834590246356,0.10055304172951231
104,서울특별시,서초구,양재2동,관내사전투표,5246,5246,3353,1250,516,80,4,5203,43,0,64.44359023640207,24.024601191620217,9.917355371900827,1.537574476263694,0.0768787238131847
105,서울특별시,서초구,양재2동,양재2동제1투,2174,1455,450,852,125,15,1,1443,12,719,31.185031185031185,59.04365904365905,8.662508662508662,1.0395010395010396,0.0693000693000693
106,서울특별시,서초구,양재2동,양재2동제2투,2085,1492,482,823,152,22,3,1482,10,593,32.523616734143054,55.533063427800265,10.256410256410255,1.484480431848853,0.20242914979757085
107,서울특별시,서초구,양재2동,양재2동제3투,2661,1894,598,1065,196,22,1,1882,12,767,31.77470775770457,56.58873538788522,10.414452709883102,1.1689691817215728,0.053134962805526036
108,서울특별시,서초구,양재2동,양재2동제4투,2548,1790,611,964,182,19,3,1779,11,758,34.345137717819,54.18774592467679,10.230466554243957,1.0680157391793141,0.16863406408094433
109,서울특별시,서초구,양재2동,양재2동제5투,2386,1628,515,868,195,29,3,1610,18,758,31.987577639751553,53.91304347826087,12.111801242236025,1.8012422360248446,0.18633540372670807
110,서울특별시,서초구,내곡동,관내사전투표,3242,3242,1993,959,232,36,1,3221,21,0,61.875194039118284,29.773362309841666,7.20273207078547,1.11766532132878,0.03104625892579944
111,서울특별시,서초구,내곡동,내곡동제1투,1135,755,164,540,42,5,1,752,3,380,21.808510638297875,71.80851063829788,5.585106382978723,0.6648936170212766,0.13297872340425532
112,서울특별시,서초구,내곡동,내곡동제2투,2337,1808,475,1170,135,12,2,1794,14,529,26.477146042363437,65.21739130434783,7.5250836120401345,0.6688963210702341,0.11148272017837235
113,서울특별시,서초구,내곡동,내곡동제3투,3026,2230,656,1405,137,21,1,2220,10,796,29.549549549549546,63.288288288288285,6.171171171171172,0.945945945945946,0.04504504504504504
114,서울특별시,서초구,내곡동,내곡동제4투,2651,1910,496,1221,150,26,3,1896,14,741,26.160337552742618,64.39873417721519,7.9113924050632916,1.3713080168776373,0.15822784810126583
115,서울특별시,서초구,잘못 투입·구분된 투표지,,0,3,0,2,0,0,0,2,1,-3,0.0,100.0,0.0,0.0,0.0
0,서울특별시,강남구,거소·선상투표,,591,552,213,225,99,6,3,546,6,39,39.010989010989015,41.208791208791204,18.13186813186813,1.098901098901099,0.5494505494505495
1,서울특별시,강남구,관외사전투표,,42972,42971,19865,15991,6181,531,36,42604,367,1,46.62707726973993,37.534034362970615,14.508027415266172,1.2463618439583137,0.08449910806497042
2,서울특별시,강남구,재외투표,,6809,5379,2668,1921,646,101,2,5338,41,1430,49.981266391907084,35.98726114649681,12.101910828025478,1.8920944173847882,0.03746721618583739
3,서울특별시,강남구,신사동,관내사전투표,2576,2576,1196,1094,254,24,2,2570,6,0,46.536964980544745,42.568093385214006,9.883268482490273,0.933852140077821,0.07782101167315175
4,서울특별시,강남구,신사동,신사동제1투,1907,1235,210,904,95,18,1,1228,7,672,17.100977198697066,73.61563517915309,7.736156351791531,1.4657980456026058,0.08143322475570033
5,서울특별시,강남구,신사동,신사동제2투,1354,851,208,574,60,4,1,847,4,503,24.557260920897285,67.76859504132231,7.083825265643448,0.47225501770956313,0.11806375442739078
6,서울특별시,강남구,신사동,신사동제3투,1339,915,261,581,59,11,0,912,3,424,28.618421052631575,63.70614035087719,6.469298245614036,1.2061403508771928,0.0
7,서울특별시,강남구,신사동,신사동제4투,2842,2070,172,1760,119,6,0,2057,13,772,8.361691784151677,85.56149732620321,5.785123966942149,0.2916869227029655,0.0
8,서울특별시,강남구,신사동,신사동제5투,2484,1905,204,1553,130,9,1,1897,8,579,10.753821823932524,81.86610437532946,6.852925672113865,0.4744333157617291,0.05271481286241434
9,서울특별시,강남구,논현1동,관내사전투표,3390,3390,2063,973,307,29,2,3374,16,0,61.14404267931239,28.838174273858918,9.09899229401304,0.8595139300533492,0.05927682276229994
10,서울특별시,강남구,논현1동,논현1동제1투,2826,1381,343,862,148,12,2,1367,14,1445,25.091441111923924,63.05779078273592,10.826627651792247,0.8778346744696415,0.1463057790782736
11,서울특별시,강남구,논현1동,논현1동제2투,2584,1394,361,917,103,5,1,1387,7,1190,26.027397260273972,66.11391492429705,7.426099495313626,0.3604902667627974,0.07209805335255948
12,서울특별시,강남구,논현1동,논현1동제3투,3181,2049,460,1398,155,17,1,2031,18,1132,22.648941408173314,68.83308714918759,7.631708517971443,0.8370260955194485,0.04923682914820286
13,서울특별시,강남구,논현1동,논현1동제4투,2978,1611,470,945,163,10,2,1590,21,1367,29.559748427672954,59.43396226415094,10.251572327044025,0.628930817610063,0.12578616352201258
14,서울특별시,강남구,논현1동,논현1동제5투,2579,1452,429,832,163,18,0,1442,10,1127,29.750346740638,57.69764216366158,11.303744798890431,1.248266296809986,0.0
15,서울특별시,강남구,논현2동,관내사전투표,3354,3354,1731,1178,372,46,2,3329,25,0,51.997596875938726,35.386001802343046,11.174526884950435,1.3817963352358065,0.06007810153199159
16,서울특별시,강남구,논현2동,논현2동제1투,3133,1774,318,1302,125,13,2,1760,14,1359,18.06818181818182,73.97727272727272,7.1022727272727275,0.7386363636363636,0.11363636363636363
17,서울특별시,강남구,논현2동,논현2동제2투,2075,1376,245,1001,106,15,2,1369,7,699,17.896274653031412,73.1190650109569,7.742878013148284,1.095690284879474,0.1460920379839299
18,서울특별시,강남구,논현2동,논현2동제3투,1479,950,252,618,63,11,1,945,5,529,26.666666666666668,65.39682539682539,6.666666666666667,1.164021164021164,0.10582010582010583
19,서울특별시,강남구,논현2동,논현2동제4투,3533,2333,531,1534,231,20,1,2317,16,1200,22.91756581786793,66.20630125161847,9.969788519637463,0.8631851532153647,0.04315925766076824
20,서울특별시,강남구,논현2동,논현2동제5투,3083,1767,424,1136,169,23,2,1754,13,1316,24.173318129988598,64.76624857468643,9.635119726339795,1.3112884834663627,0.11402508551881414
21,서울특별시,강남구,압구정동,관내사전투표,2567,2567,850,1445,232,21,0,2548,19,0,33.35949764521193,56.71114599686028,9.105180533751962,0.8241758241758242,0.0
22,서울특별시,강남구,압구정동,압구정동제1투,3077,2082,138,1805,117,14,2,2076,6,995,6.6473988439306355,86.9460500963391,5.635838150289017,0.674373795761079,0.09633911368015415
23,서울특별시,강남구,압구정동,압구정동제2투,2137,1600,165,1327,91,14,0,1597,3,537,10.331872260488415,83.0932999373826,5.698184095178459,0.8766437069505322,0.0
24,서울특별시,강남구,압구정동,압구정동제3투,2508,1899,134,1645,96,9,1,1885,14,609,7.108753315649867,87.26790450928382,5.092838196286472,0.47745358090185674,0.05305039787798408
25,서울특별시,강남구,압구정동,압구정동제4투,1956,1365,235,1027,80,13,1,1356,9,591,17.330383480825958,75.73746312684366,5.899705014749262,0.9587020648967551,0.07374631268436578
26,서울특별시,강남구,압구정동,압구정동제5투,3157,2424,274,1956,166,14,1,2411,13,733,11.364579012857735,81.1281625881377,6.885109912899212,0.5806719203649938,0.04147656574035669
27,서울특별시,강남구,압구정동,압구정동제6투,2927,2137,232,1730,150,17,0,2129,8,790,10.897134805072804,81.25880695162047,7.045561296383279,0.7984969469234382,0.0
28,서울특별시,강남구,압구정동,압구정동제7투,1174,781,127,580,61,8,3,779,2,393,16.30295250320924,74.45442875481386,7.830551989730424,1.0269576379974326,0.38510911424903727
29,서울특별시,강남구,청담동,관내사전투표,2921,2921,1379,1212,277,32,2,2902,19,0,47.51895244658856,41.76430048242592,9.54514128187457,1.1026878015161956,0.06891798759476223
30,서울특별시,강남구,청담동,청담동제1투,2577,1655,229,1281,113,20,1,1644,11,922,13.929440389294404,77.91970802919708,6.873479318734793,1.2165450121654502,0.06082725060827251
31,서울특별시,강남구,청담동,청담동제2투,2401,1607,183,1314,98,7,1,1603,4,794,11.41609482220836,81.97130380536494,6.11353711790393,0.43668122270742354,0.06238303181534623
32,서울특별시,강남구,청담동,청담동제3투,2085,1520,233,1159,116,7,0,1515,5,565,15.37953795379538,76.5016501650165,7.656765676567656,0.46204620462046203,0.0
33,서울특별시,강남구,청담동,청담동제4투,1821,1197,171,940,75,6,1,1193,4,624,14.333612740989102,78.7929589270746,6.286672254819782,0.5029337803855826,0.08382229673093043
34,서울특별시,강남구,청담동,청담동제5투,2734,1991,425,1365,164,23,0,1977,14,743,21.497218007081436,69.04400606980273,8.295397066262012,1.163378856853819,0.0
35,서울특별시,강남구,청담동,청담동제6투,2676,1869,458,1209,168,20,1,1856,13,807,24.676724137931032,65.14008620689656,9.051724137931034,1.0775862068965518,0.05387931034482758
36,서울특별시,강남구,청담동,청담동제7투,1389,863,151,638,65,2,0,856,7,526,17.640186915887853,74.53271028037383,7.593457943925233,0.23364485981308408,0.0
37,서울특별시,강남구,삼성1동,관내사전투표,2407,2407,1193,935,236,24,1,2389,18,0,49.937212222687315,39.13771452490582,9.878610297195479,1.0046044370029301,0.041858518208455424
38,서울특별시,강남구,삼성1동,삼성1동제1투,2680,1776,340,1247,170,8,1,1766,10,904,19.25254813137033,70.61155152887882,9.626274065685164,0.4530011325028313,0.05662514156285391
39,서울특별시,강남구,삼성1동,삼성1동제2투,2685,2011,281,1565,140,13,2,2001,10,674,14.042978510744627,78.21089455272364,6.9965017491254375,0.6496751624187905,0.09995002498750624
40,서울특별시,강남구,삼성1동,삼성1동제3투,2751,1926,385,1385,129,17,0,1916,10,825,20.093945720250524,72.28601252609603,6.732776617954071,0.8872651356993737,0.0
41,서울특별시,강남구,삼성2동,관내사전투표,5794,5794,3157,1841,697,55,1,5751,43,0,54.894800904190575,32.01182403060338,12.119631368457659,0.9563554164493131,0.01738828029907842
42,서울특별시,강남구,삼성2동,삼성2동제1투,3133,1769,444,1124,171,21,0,1760,9,1364,25.227272727272727,63.86363636363637,9.71590909090909,1.1931818181818183,0.0
43,서울특별시,강남구,삼성2동,삼성2동제2투,3956,3074,608,2137,285,35,0,3065,9,882,19.836867862969005,69.7226753670473,9.29853181076672,1.1419249592169658,0.0
44,서울특별시,강남구,삼성2동,삼성2동제3투,4136,2864,602,2002,228,18,0,2850,14,1272,21.12280701754386,70.24561403508773,8.0,0.631578947368421,0.0
45,서울특별시,강남구,삼성2동,삼성2동제4투,3061,1989,545,1219,193,21,0,1978,11,1072,27.553083923154702,61.627906976744185,9.757330637007078,1.0616784630940344,0.0
46,서울특별시,강남구,삼성2동,삼성2동제5투,4251,3283,553,2384,302,25,1,3265,18,968,16.937212863705973,73.01684532924962,9.249617151607964,0.7656967840735069,0.030627871362940276
47,서울특별시,강남구,대치1동,관내사전투표,3503,3502,1399,1619,428,41,2,3489,13,1,40.09744912582402,46.40298079678991,12.26712525078819,1.1751218114072801,0.05732301519059903
48,서울특별시,강남구,대치1동,대치1동제1투,3470,2666,353,1946,339,14,2,2654,12,804,13.300678221552372,73.3232856066315,12.773172569706103,0.5275056518462697,0.07535795026375283
49,서울특별시,강남구,대치1동,대치1동제2투,2520,1967,356,1382,211,11,1,1961,6,553,18.154003059663438,70.4742478327384,10.759816420193777,0.5609382967873533,0.05099439061703213
50,서울특별시,강남구,대치1동,대치1동제3투,2036,1620,213,1242,147,8,2,1612,8,416,13.213399503722083,77.04714640198512,9.11910669975186,0.49627791563275436,0.12406947890818859
51,서울특별시,강남구,대치1동,대치1동제4투,2201,1751,166,1409,152,16,0,1743,8,450,9.523809523809524,80.837636259323,8.720596672403902,0.9179575444635685,0.0
52,서울특별시,강남구,대치1동,대치1동제5투,3326,2498,340,1846,287,17,0,2490,8,828,13.654618473895583,74.13654618473896,11.526104417670682,0.6827309236947792,0.0
53,서울특별시,강남구,대치2동,관내사전투표,3743,3743,1801,1502,391,32,1,3727,16,0,48.32304802790448,40.30050979339952,10.491011537429568,0.8585994097129058,0.026831231553528307
54,서울특별시,강남구,대치2동,대치2동제1투,3172,2453,510,1688,231,19,0,2448,5,719,20.833333333333336,68.95424836601308,9.436274509803921,0.7761437908496732,0.0
55,서울특별시,강남구,대치2동,대치2동제2투,2491,1994,439,1348,182,15,1,1985,9,497,22.115869017632242,67.90931989924434,9.168765743073049,0.7556675062972292,0.05037783375314861
56,서울특별시,강남구,대치2동,대치2동제3투,2605,2053,391,1495,147,14,1,2048,5,552,19.091796875,72.998046875,7.177734375,0.68359375,0.048828125
57,서울특별시,강남구,대치2동,대치2동제4투,2453,1950,235,1498,187,21,2,1943,7,503,12.094698919197118,77.0972722593927,9.624292331446217,1.0808028821410192,0.1029336078229542
58,서울특별시,강남구,대치2동,대치2동제5투,2515,2049,251,1612,162,12,1,2038,11,466,12.315996074582925,79.09715407262021,7.948969578017665,0.5888125613346418,0.04906771344455348
59,서울특별시,강남구,대치2동,대치2동제6투,2818,2238,301,1734,185,9,0,2229,9,580,13.503813369223867,77.79273216689099,8.299685957828624,0.4037685060565276,0.0
60,서울특별시,강남구,대치2동,대치2동제7투,3192,2238,402,1558,245,25,1,2231,7,954,18.01882563872703,69.83415508740475,10.981622590766472,1.1205737337516808,0.04482294935006724
61,서울특별시,강남구,대치2동,대치2동제8투,2957,2087,494,1329,224,29,1,2077,10,870,23.78430428502648,63.98651901781416,10.784785748675976,1.3962445835339432,0.04814636494944632
62,서울특별시,강남구,대치4동,관내사전투표,3989,3989,2297,1140,479,41,1,3958,31,0,58.034360788276906,28.802425467407783,12.102071753410813,1.0358767054067712,0.025265285497726126
63,서울특별시,강남구,대치4동,대치4동제1투,2432,1543,382,948,177,20,0,1527,16,889,25.01637197118533,62.082514734774065,11.591355599214145,1.309757694826457,0.0
64,서울특별시,강남구,대치4동,대치4동제2투,2863,1954,550,1192,167,26,0,1935,19,909,28.42377260981912,61.60206718346253,8.63049095607235,1.3436692506459949,0.0
65,서울특별시,강남구,대치4동,대치4동제3투,2770,1707,343,1170,169,15,1,1698,9,1063,20.200235571260304,68.90459363957598,9.952885747938751,0.88339222614841,0.058892815076560655
66,서울특별시,강남구,대치4동,대치4동제4투,2747,1588,438,976,138,19,1,1572,16,1159,27.86259541984733,62.086513994910945,8.778625954198473,1.2086513994910941,0.06361323155216285
67,서울특별시,강남구,역삼1동,관내사전투표,4939,4939,2786,1349,705,50,5,4895,44,0,56.91521961184882,27.55873340143003,14.402451481103167,1.0214504596527068,0.10214504596527069
68,서울특별시,강남구,역삼1동,역삼1동제1투,3103,1670,444,1012,182,13,2,1653,17,1433,26.860254083484573,61.22202056866304,11.01028433151845,0.7864488808227466,0.12099213551119178
69,서울특별시,강남구,역삼1동,역삼1동제2투,2326,1317,345,776,170,15,1,1307,10,1009,26.396327467482784,59.37260902830911,13.006885998469778,1.1476664116296864,0.07651109410864575
70,서울특별시,강남구,역삼1동,역삼1동제3투,3223,1759,497,1011,207,22,1,1738,21,1464,28.596087456846952,58.170310701956275,11.9102416570771,1.2658227848101267,0.05753739930955121
71,서울특별시,강남구,역삼1동,역삼1동제4투,3169,1761,457,1091,179,17,1,1745,16,1408,26.189111747851,62.521489971346696,10.257879656160458,0.9742120343839542,0.05730659025787965
72,서울특별시,강남구,역삼1동,역삼1동제5투,3940,2003,518,1161,279,29,0,1987,16,1937,26.0694514343231,58.42979365878208,14.041268243583291,1.4594866633115249,0.0
73,서울특별시,강남구,역삼1동,역삼1동제6투,2711,1637,461,971,171,14,5,1622,15,1074,28.42170160295931,59.864364981504316,10.542540073982737,0.8631319358816275,0.3082614056720099
74,서울특별시,강남구,역삼1동,역삼1동제7투,2581,1768,443,1079,210,18,1,1751,17,813,25.29982866933181,61.621930325528275,11.993146773272416,1.0279840091376355,0.05711022272986865
75,서울특별시,강남구,역삼1동,역삼1동제8투,1892,1094,282,644,136,15,2,1079,15,798,26.135310472659874,59.68489341983317,12.604263206672844,1.3901760889712698,0.18535681186283595
76,서울특별시,강남구,역삼2동,관내사전투표,6138,6138,3225,2156,655,60,0,6096,42,0,52.90354330708661,35.36745406824147,10.744750656167978,0.984251968503937,0.0
77,서울특별시,강남구,역삼2동,역삼2동제1투,3236,2157,394,1517,219,19,0,2149,8,1079,18.334108887854818,70.59097254536994,10.190786412284783,0.8841321544904607,0.0
78,서울특별시,강남구,역삼2동,역삼2동제2투,4319,3151,634,2180,289,35,0,3138,13,1168,20.203951561504145,69.47100063734864,9.209687699171447,1.1153601019757808,0.0
79,서울특별시,강남구,역삼2동,역삼2동제3투,3595,2124,610,1259,220,25,0,2114,10,1471,28.855250709555346,59.55534531693472,10.406811731315042,1.1825922421948913,0.0
80,서울특별시,강남구,역삼2동,역삼2동제4투,3134,1996,584,1152,219,21,4,1980,16,1138,29.494949494949495,58.18181818181818,11.06060606060606,1.0606060606060608,0.20202020202020202
81,서울특별시,강남구,역삼2동,역삼2동제5투,2919,2212,568,1397,213,25,1,2204,8,707,25.771324863883848,63.384754990925586,9.664246823956443,1.134301270417423,0.045372050816696916
82,서울특별시,강남구,역삼2동,역삼2동제6투,3506,2765,496,1987,237,31,0,2751,14,741,18.029807342784444,72.2282806252272,8.615049073064341,1.1268629589240278,0.0
83,서울특별시,강남구,도곡1동,관내사전투표,3640,3640,1890,1284,392,40,2,3608,32,0,52.38359201773836,35.58758314855876,10.864745011086473,1.1086474501108647,0.05543237250554324
84,서울특별시,강남구,도곡1동,도곡1동제1투,1137,872,160,633,70,8,0,871,1,265,18.369690011481058,72.67508610792193,8.036739380022963,0.9184845005740528,0.0
85,서울특별시,강남구,도곡1동,도곡1동제2투,3019,2247,476,1509,224,23,1,2233,14,772,21.316614420062695,67.57725033587103,10.031347962382444,1.0300044782803404,0.044782803403493054
86,서울특별시,강남구,도곡1동,도곡1동제3투,2856,2269,480,1527,216,29,1,2253,16,587,21.304926764314246,67.7762982689747,9.587217043941411,1.2871726586773191,0.044385264092321346
87,서울특별시,강남구,도곡1동,도곡1동제4투,2992,2179,552,1345,240,24,2,2163,16,813,25.52011095700416,62.18215441516413,11.095700416088766,1.1095700416088765,0.09246417013407304
88,서울특별시,강남구,도곡1동,도곡1동제5투,1852,1416,238,1040,116,14,0,1408,8,436,16.90340909090909,73.86363636363636,8.238636363636363,0.9943181818181818,0.0
89,서울특별시,강남구,도곡2동,관내사전투표,2773,2773,1235,1181,305,32,1,2754,19,0,44.84386347131445,42.88307915758896,11.074800290486566,1.1619462599854757,0.03631082062454612
90,서울특별시,강남구,도곡2동,도곡2동제1투,1830,1145,217,791,116,13,1,1138,7,685,19.068541300527244,69.5079086115993,10.193321616871705,1.1423550087873462,0.08787346221441124
91,서울특별시,강남구,도곡2동,도곡2동제2투,2547,1913,233,1515,139,17,3,1907,6,634,12.21814368117462,79.44415312008391,7.288935500786575,0.8914525432616675,0.15731515469323545
92,서울특별시,강남구,도곡2동,도곡2동제3투,2519,1937,178,1645,102,5,0,1930,7,582,9.22279792746114,85.23316062176166,5.284974093264249,0.2590673575129534,0.0
93,서울특별시,강남구,도곡2동,도곡2동제4투,3520,2702,230,2254,196,8,0,2688,14,818,8.556547619047619,83.85416666666666,7.291666666666667,0.2976190476190476,0.0
94,서울특별시,강남구,도곡2동,도곡2동제5투,3349,2546,391,1905,207,26,2,2531,15,803,15.448439352034768,75.26669300671671,8.178585539312525,1.0272619517977084,0.07902015013828526
95,서울특별시,강남구,도곡2동,도곡2동제6투,3403,2719,429,1988,283,12,0,2712,7,684,15.81858407079646,73.30383480825958,10.435103244837759,0.4424778761061947,0.0
96,서울특별시,강남구,도곡2동,도곡2동제7투,3327,2657,530,1802,284,27,1,2644,13,670,20.04538577912254,68.15431164901665,10.741301059001513,1.021180030257186,0.037821482602118005
97,서울특별시,강남구,개포1동,관내사전투표,4384,4383,2172,1678,469,38,3,4360,23,1,49.81651376146789,38.48623853211009,10.756880733944953,0.871559633027523,0.06880733944954129
98,서울특별시,강남구,개포1동,개포1동제1투,3488,2777,400,2129,209,23,1,2762,15,711,14.482259232440262,77.08182476466328,7.566980448950036,0.832729905865315,0.03620564808110065
99,서울특별시,강남구,개포1동,개포1동제2투,2692,2076,367,1470,207,15,1,2060,16,616,17.815533980582522,71.35922330097088,10.048543689320388,0.7281553398058253,0.04854368932038835
100,서울특별시,강남구,개포1동,개포1동제3투,540,380,178,188,11,2,0,379,1,160,46.965699208443276,49.6042216358839,2.9023746701846966,0.5277044854881267,0.0
101,서울특별시,강남구,개포1동,개포1동제4투,2724,2102,297,1592,198,9,1,2097,5,622,14.163090128755366,75.91797806390082,9.44206008583691,0.4291845493562232,0.04768717215069146
102,서울특별시,강남구,개포1동,개포1동제5투,2926,2316,473,1564,239,29,1,2306,10,610,20.511708586296617,67.82307025151778,10.364267129228102,1.2575888985255854,0.04336513443191674
103,서울특별시,강남구,개포1동,개포1동제6투,3000,2395,438,1704,212,31,0,2385,10,605,18.364779874213834,71.44654088050314,8.88888888888889,1.29979035639413,0.0
104,서울특별시,강남구,개포2동,관내사전투표,4037,4037,1909,1626,428,55,0,4018,19,0,47.51119960179194,40.467894474863115,10.652065704330512,1.368840219014435,0.0
105,서울특별시,강남구,개포2동,개포2동제1투,2751,2001,379,1418,176,17,1,1991,10,750,19.03566047212456,71.22049221496735,8.83977900552486,0.8538422903063787,0.05022601707684581
106,서울특별시,강남구,개포2동,개포2동제2투,2208,1756,359,1253,125,12,0,1749,7,452,20.526014865637507,71.64093767867354,7.14694110920526,0.6861063464837049,0.0
107,서울특별시,강남구,개포2동,개포2동제3투,2486,1984,445,1318,194,16,0,1973,11,502,22.554485554992397,66.80182463253928,9.83274201723264,0.8109477952356817,0.0
108,서울특별시,강남구,개포2동,개포2동제4투,3377,2717,464,1953,268,18,1,2704,13,660,17.159763313609467,72.22633136094674,9.911242603550296,0.6656804733727811,0.03698224852071006
109,서울특별시,강남구,개포2동,개포2동제5투,1905,1394,263,1006,109,10,0,1388,6,511,18.948126801152736,72.47838616714697,7.853025936599424,0.7204610951008645,0.0
110,서울특별시,강남구,개포2동,개포2동제6투,3332,2626,731,1492,361,33,0,2617,9,706,27.932747420710736,57.01184562476118,13.794421092854414,1.2609858616736722,0.0
111,서울특별시,강남구,개포2동,개포2동제7투,3728,3003,533,2126,286,43,1,2989,14,725,17.832050853128138,71.12746738039478,9.568417530946805,1.4386082301773169,0.03345600535296086
112,서울특별시,강남구,개포2동,개포2동제8투,3887,3056,873,1726,396,33,0,3028,28,831,28.83091149273448,57.001321003963014,13.0779392338177,1.0898282694848085,0.0
113,서울특별시,강남구,개포3동,관내사전투표,5046,5046,2890,1506,550,60,3,5009,37,0,57.69614693551607,30.06588141345578,10.980235575963267,1.1978438810141745,0.059892194050708725
114,서울특별시,강남구,개포3동,개포3동제1투,1374,821,247,525,34,3,0,809,12,553,30.53152039555006,64.89493201483313,4.202719406674907,0.3708281829419036,0.0
115,서울특별시,강남구,개포3동,개포3동제2투,2026,1486,349,945,167,16,0,1477,9,540,23.628977657413678,63.98104265402843,11.306702775897088,1.0832769126607988,0.0
116,서울특별시,강남구,개포3동,개포3동제3투,2079,1575,362,1024,164,15,1,1566,9,504,23.116219667943806,65.38952745849298,10.472541507024266,0.9578544061302682,0.06385696040868455
117,서울특별시,강남구,개포3동,개포3동제4투,1607,1271,235,903,111,19,0,1268,3,336,18.53312302839117,71.21451104100946,8.753943217665615,1.498422712933754,0.0
118,서울특별시,강남구,개포3동,개포3동제5투,2439,1968,435,1298,206,20,0,1959,9,471,22.2052067381317,66.25829504849413,10.515569167942827,1.0209290454313424,0.0
119,서울특별시,강남구,개포4동,관내사전투표,4204,4204,2566,1172,397,37,2,4174,30,0,61.4758025874461,28.07858169621466,9.511260182079539,0.8864398658361284,0.04791566842357451
120,서울특별시,강남구,개포4동,개포4동제1투,2778,1944,617,1118,166,26,3,1930,14,834,31.968911917098445,57.92746113989637,8.60103626943005,1.3471502590673576,0.15544041450777202
121,서울특별시,강남구,개포4동,개포4동제2투,3929,3005,509,2210,229,28,5,2981,24,924,17.07480711170748,74.13619590741362,7.6819859107682,0.9392821200939282,0.16772895001677288
122,서울특별시,강남구,개포4동,개포4동제3투,3477,2527,643,1624,228,14,2,2511,16,950,25.607327757865395,64.67542811628833,9.08004778972521,0.5575467941059339,0.07964954201513341
123,서울특별시,강남구,개포4동,개포4동제4투,3159,2044,669,1140,188,30,1,2028,16,1115,32.98816568047337,56.213017751479285,9.270216962524655,1.4792899408284024,0.04930966469428008
124,서울특별시,강남구,일원본동,관내사전투표,4562,4562,2504,1490,487,56,1,4538,24,0,55.17849272807405,32.83384750991626,10.731599823710885,1.23402379903041,0.022036139268400177
125,서울특별시,강남구,일원본동,일원본동제1투,3461,2390,532,1625,188,33,1,2379,11,1071,22.362337116435477,68.30601092896174,7.902480033627575,1.3871374527112232,0.04203446826397646
126,서울특별시,강남구,일원본동,일원본동제2투,2621,2078,512,1326,190,34,1,2063,15,543,24.81822588463403,64.27532719340766,9.20988851187591,1.6480853126514785,0.048473097430925836
127,서울특별시,강남구,일원본동,일원본동제3투,3367,2617,576,1731,255,37,1,2600,17,750,22.153846153846153,66.57692307692308,9.807692307692308,1.4230769230769231,0.038461538461538464
128,서울특별시,강남구,일원본동,일원본동제4투,2540,1892,496,1132,227,23,3,1881,11,648,26.36895268474216,60.18075491759702,12.068048910154173,1.2227538543328018,0.1594896331738437
129,서울특별시,강남구,일원1동,관내사전투표,2258,2258,1431,650,149,13,2,2245,13,0,63.741648106904236,28.953229398663698,6.636971046770601,0.579064587973274,0.08908685968819599
130,서울특별시,강남구,일원1동,일원1동제1투,1750,1087,297,683,94,5,2,1081,6,663,27.474560592044405,63.182238667900094,8.695652173913043,0.46253469010175763,0.18501387604070307
131,서울특별시,강남구,일원1동,일원1동제2투,1839,1380,406,815,127,19,0,1367,13,459,29.700073152889537,59.61960497439649,9.290416971470373,1.3899049012435991,0.0
132,서울특별시,강남구,일원1동,일원1동제3투,1708,1227,369,710,128,15,0,1222,5,481,30.196399345335518,58.10147299509002,10.474631751227497,1.227495908346972,0.0
133,서울특별시,강남구,일원1동,일원1동제4투,1830,1335,374,805,126,19,0,1324,11,495,28.247734138972806,60.800604229607245,9.516616314199396,1.4350453172205437,0.0
134,서울특별시,강남구,일원1동,일원1동제5투,1471,967,311,598,47,4,0,960,7,504,32.395833333333336,62.291666666666664,4.895833333333333,0.4166666666666667,0.0
135,서울특별시,강남구,수서동,관내사전투표,3485,3485,1965,1123,344,29,1,3462,23,0,56.759098786828424,32.43789716926632,9.936452917388792,0.8376660889659157,0.028885037550548814
136,서울특별시,강남구,수서동,수서동제1투,1804,1393,250,992,126,15,1,1384,9,411,18.063583815028903,71.67630057803468,9.104046242774565,1.083815028901734,0.0722543352601156
137,서울특별시,강남구,수서동,수서동제2투,1156,825,299,481,28,4,5,817,8,331,36.59730722154223,58.87392900856793,3.4271725826193387,0.4895960832313341,0.6119951040391677
138,서울특별시,강남구,수서동,수서동제3투,1446,871,292,537,30,1,2,862,9,575,33.874709976798144,62.2969837587007,3.480278422273782,0.11600928074245939,0.23201856148491878
139,서울특별시,강남구,수서동,수서동제4투,1329,901,346,505,32,6,4,893,8,428,38.745800671892496,56.55095184770437,3.5834266517357225,0.6718924972004479,0.4479283314669653
140,서울특별시,강남구,수서동,수서동제5투,2795,2131,485,1432,172,22,0,2111,20,664,22.974893415442917,67.83514921837993,8.147797252486972,1.0421601136901941,0.0
141,서울특별시,강남구,세곡동,관내사전투표,5935,5935,3852,1510,486,58,5,5911,24,0,65.16663847064794,25.545592962273727,8.221959059380815,0.9812214515310438,0.08458805616646929
142,서울특별시,강남구,세곡동,세곡동제1투,2321,1501,456,886,131,22,1,1496,5,820,30.481283422459892,59.224598930481285,8.75668449197861,1.4705882352941175,0.06684491978609625
143,서울특별시,강남구,세곡동,세곡동제2투,2228,1656,583,914,135,11,2,1645,11,572,35.440729483282674,55.56231003039513,8.206686930091186,0.668693009118541,0.12158054711246201
144,서울특별시,강남구,세곡동,세곡동제3투,2623,1960,694,1115,119,18,2,1948,12,663,35.62628336755647,57.23819301848049,6.108829568788502,0.9240246406570842,0.10266940451745381
145,서울특별시,강남구,세곡동,세곡동제4투,3139,2302,709,1327,223,27,1,2287,15,837,31.0013117621338,58.0236117184084,9.75076519457805,1.1805859204197637,0.043725404459991256
146,서울특별시,강남구,세곡동,세곡동제5투,2390,1882,691,1029,131,18,0,1869,13,508,36.97164258962012,55.0561797752809,7.009095773140716,0.9630818619582664,0.0
147,서울특별시,강남구,세곡동,세곡동제6투,2829,2083,814,1050,179,19,1,2063,20,746,39.45710130877363,50.89675230247212,8.676684440135725,0.9209888511875909,0.048473097430925836
148,서울특별시,강남구,세곡동,세곡동제7투,2756,2006,636,1138,201,17,1,1993,13,750,31.911690918213747,57.09984947315605,10.085298544907175,0.8529854490717512,0.050175614651279475
149,서울특별시,강남구,세곡동,세곡동제8투,2706,2002,787,1050,129,23,0,1989,13,704,39.5676219205631,52.79034690799397,6.485671191553545,1.1563599798893918,0.0
150,서울특별시,강남구,세곡동,세곡동제9투,3064,2368,685,1422,210,34,1,2352,16,696,29.124149659863946,60.45918367346938,8.928571428571429,1.445578231292517,0.04251700680272109
151,서울특별시,강남구,세곡동,세곡동제10투,2406,2019,806,825,345,20,1,1997,22,387,40.36054081121683,41.31196795192789,17.27591387080621,1.0015022533800702,0.050075112669003496
152,서울특별시,강남구,잘못 투입·구분된 투표지,,0,3,1,2,0,0,0,3,0,-3,33.33333333333333,66.66666666666666,0.0,0.0,0.0
0,서울특별시,송파구,거소·선상투표,,607,580,230,233,94,7,2,566,14,27,40.63604240282685,41.1660777385159,16.607773851590103,1.2367491166077738,0.35335689045936397
1,서울특별시,송파구,관외사전투표,,54423,54418,28928,16287,8001,635,63,53914,504,5,53.655822235411954,30.209222094446712,14.840301220462218,1.177801684163668,0.11685276551545053
2,서울특별시,송파구,재외투표,,6264,5015,2943,1407,541,83,3,4977,38,1249,59.13200723327306,28.270042194092827,10.870002009242516,1.6676712879244524,0.06027727546714888
3,서울특별시,송파구,풍납1동,관내사전투표,3270,3270,2039,956,222,26,2,3245,25,0,62.835130970724194,29.460708782742678,6.841294298921417,0.8012326656394453,0.061633281972265024
4,서울특별시,송파구,풍납1동,풍납1동제1투,2252,1406,464,832,92,11,1,1400,6,846,33.14285714285714,59.42857142857143,6.571428571428571,0.7857142857142858,0.07142857142857142
5,서울특별시,송파구,풍납1동,풍납1동제2투,1934,1213,374,729,94,7,2,1206,7,721,31.01160862354892,60.447761194029844,7.79436152570481,0.5804311774461027,0.16583747927031509
6,서울특별시,송파구,풍납1동,풍납1동제3투,1950,1448,484,827,109,10,4,1434,14,502,33.751743375174335,57.67085076708508,7.601115760111576,0.697350069735007,0.2789400278940028
7,서울특별시,송파구,풍납2동,관내사전투표,5150,5150,3186,1441,436,59,0,5122,28,0,62.20226474033581,28.133541585318234,8.512299882858258,1.1518937914877,0.0
8,서울특별시,송파구,풍납2동,풍납2동제1투,1983,1370,385,786,161,18,1,1351,19,613,28.497409326424872,58.179126572908956,11.917098445595855,1.3323464100666174,0.07401924500370095
9,서울특별시,송파구,풍납2동,풍납2동제2투,2698,1935,566,1173,162,23,1,1925,10,763,29.4025974025974,60.93506493506493,8.415584415584416,1.194805194805195,0.05194805194805195
10,서울특별시,송파구,풍납2동,풍납2동제3투,2003,1460,424,889,118,17,2,1450,10,543,29.24137931034483,61.310344827586206,8.137931034482758,1.1724137931034484,0.13793103448275862
11,서울특별시,송파구,풍납2동,풍납2동제4투,2124,1510,543,771,156,23,1,1494,16,614,36.34538152610442,51.606425702811244,10.441767068273093,1.5394912985274432,0.06693440428380187
12,서울특별시,송파구,풍납2동,풍납2동제5투,1522,1097,350,653,82,7,0,1092,5,425,32.05128205128205,59.798534798534796,7.509157509157509,0.641025641025641,0.0
13,서울특별시,송파구,풍납2동,풍납2동제6투,1908,1323,418,752,123,15,2,1310,13,585,31.90839694656489,57.404580152671755,9.389312977099237,1.1450381679389312,0.15267175572519084
14,서울특별시,송파구,거여1동,관내사전투표,2957,2957,2005,718,199,21,2,2945,12,0,68.08149405772495,24.38030560271647,6.757215619694397,0.7130730050933786,0.06791171477079797
15,서울특별시,송파구,거여1동,거여1동제1투,2378,1579,523,921,115,13,3,1575,4,799,33.20634920634921,58.47619047619048,7.301587301587302,0.8253968253968255,0.19047619047619047
16,서울특별시,송파구,거여1동,거여1동제2투,2143,1431,499,769,139,11,2,1420,11,712,35.140845070422536,54.154929577464785,9.788732394366196,0.7746478873239436,0.14084507042253522
17,서울특별시,송파구,거여1동,거여1동제3투,2315,1735,591,957,151,25,2,1726,9,580,34.24101969872538,55.44611819235226,8.748551564310544,1.4484356894553883,0.11587485515643105
18,서울특별시,송파구,거여2동,관내사전투표,5078,5078,3359,1220,428,39,7,5053,25,0,66.47536117158124,24.144072828022956,8.470215713437563,0.7718187215515535,0.1385315654066891
19,서울특별시,송파구,거여2동,거여2동제1투,2400,1712,487,1052,150,11,0,1700,12,688,28.647058823529413,61.882352941176464,8.823529411764707,0.6470588235294118,0.0
20,서울특별시,송파구,거여2동,거여2동제2투,2777,1786,604,955,143,23,8,1733,53,991,34.85285631852279,55.10675129832661,8.251586843623773,1.3271783035199076,0.4616272360069244
21,서울특별시,송파구,거여2동,거여2동제3투,2810,2144,777,1167,167,23,0,2134,10,666,36.41049671977507,54.686035613870665,7.825679475164011,1.0777881911902532,0.0
22,서울특별시,송파구,거여2동,거여2동제4투,2333,1724,656,884,146,21,1,1708,16,609,38.40749414519906,51.75644028103045,8.548009367681498,1.2295081967213115,0.0585480093676815
23,서울특별시,송파구,거여2동,거여2동제5투,3011,2388,858,1266,218,33,1,2376,12,623,36.11111111111111,53.28282828282829,9.175084175084175,1.3888888888888888,0.04208754208754208
24,서울특별시,송파구,마천1동,관내사전투표,3125,3125,2087,820,175,28,1,3111,14,0,67.0845387335262,26.358084217293477,5.625200900032144,0.900032144005143,0.03214400514304082
25,서울특별시,송파구,마천1동,마천1동제1투,1828,1167,395,678,69,13,2,1157,10,661,34.1400172860847,58.599827139152985,5.963699222126189,1.1235955056179776,0.17286084701815038
26,서울특별시,송파구,마천1동,마천1동제2투,1202,763,294,405,55,7,0,761,2,439,38.633377135348226,53.21944809461235,7.227332457293036,0.9198423127463863,0.0
27,서울특별시,송파구,마천1동,마천1동제3투,1639,1051,384,567,82,12,2,1047,4,588,36.67621776504298,54.15472779369628,7.831900668576887,1.146131805157593,0.19102196752626552
28,서울특별시,송파구,마천1동,마천1동제4투,1739,1057,379,588,70,13,1,1051,6,682,36.06089438629876,55.94671741198858,6.660323501427213,1.236917221693625,0.09514747859181732
29,서울특별시,송파구,마천1동,마천1동제5투,2809,2103,885,1020,160,25,1,2091,12,706,42.32424677187948,48.78048780487805,7.651841224294596,1.1956001912960306,0.04782400765184123
30,서울특별시,송파구,마천2동,관내사전투표,4654,4654,3141,1225,225,24,6,4621,33,0,67.97230036788574,26.50941354685133,4.869075957584938,0.5193681021423934,0.12984202553559834
31,서울특별시,송파구,마천2동,마천2동제1투,2355,1409,499,784,103,9,0,1395,14,946,35.770609318996414,56.20071684587814,7.383512544802867,0.6451612903225806,0.0
32,서울특별시,송파구,마천2동,마천2동제2투,2477,1568,562,881,110,11,0,1564,4,909,35.933503836317136,56.329923273657286,7.033248081841433,0.7033248081841432,0.0
33,서울특별시,송파구,마천2동,마천2동제3투,3182,2228,892,1156,147,17,3,2215,13,954,40.270880361173816,52.18961625282167,6.636568848758465,0.7674943566591422,0.13544018058690743
34,서울특별시,송파구,마천2동,마천2동제4투,2443,1623,626,871,93,13,2,1605,18,820,39.00311526479751,54.26791277258567,5.794392523364486,0.809968847352025,0.12461059190031153
35,서울특별시,송파구,방이1동,관내사전투표,4209,4209,2680,1077,382,44,2,4185,24,0,64.03823178016727,25.734767025089607,9.127837514934289,1.0513739545997611,0.04778972520908004
36,서울특별시,송파구,방이1동,방이1동제1투,2687,1944,530,1200,173,20,3,1926,18,743,27.51817237798546,62.30529595015576,8.982346832814123,1.0384215991692627,0.1557632398753894
37,서울특별시,송파구,방이1동,방이1동제2투,2982,2050,820,1020,175,15,5,2035,15,932,40.2948402948403,50.122850122850124,8.5995085995086,0.7371007371007371,0.2457002457002457
38,서울특별시,송파구,방이1동,방이1동제3투,2602,2023,540,1267,169,27,2,2005,18,579,26.932668329177055,63.19201995012469,8.428927680798006,1.346633416458853,0.0997506234413965
39,서울특별시,송파구,방이2동,관내사전투표,5003,5003,2986,1208,674,52,9,4929,74,0,60.58023939947251,24.508013795901807,13.674173260296207,1.054980726313654,0.18259281801582472
40,서울특별시,송파구,방이2동,방이2동제1투,3041,1944,553,1049,284,28,3,1917,27,1097,28.8471570161711,54.720918101199786,14.814814814814813,1.4606155451225873,0.1564945226917058
41,서울특별시,송파구,방이2동,방이2동제2투,2654,1778,588,891,261,20,1,1761,17,876,33.39011925042589,50.596252129471885,14.821124361158432,1.135718341851221,0.05678591709256105
42,서울특별시,송파구,방이2동,방이2동제3투,2478,1619,529,892,151,23,4,1599,20,859,33.08317698561601,55.784865540963104,9.443402126328955,1.4383989993746091,0.2501563477173233
43,서울특별시,송파구,방이2동,방이2동제4투,2997,2207,810,1160,184,23,4,2181,26,790,37.13892709766162,53.18661164603393,8.436497019715727,1.0545621274644659,0.18340210912425492
44,서울특별시,송파구,방이2동,방이2동제5투,2635,1849,679,953,181,20,1,1834,15,786,37.02290076335878,51.962922573609596,9.869138495092693,1.0905125408942202,0.05452562704471102
45,서울특별시,송파구,방이2동,방이2동제6투,2384,1630,561,865,168,14,2,1610,20,754,34.84472049689441,53.72670807453416,10.434782608695652,0.8695652173913043,0.12422360248447205
46,서울특별시,송파구,오륜동,관내사전투표,3412,3412,1752,1284,322,39,0,3397,15,0,51.574919046217246,37.798057109214014,9.478952016485135,1.1480718280836033,0.0
47,서울특별시,송파구,오륜동,오륜동제1투,2061,1528,262,1118,122,18,0,1520,8,533,17.236842105263158,73.55263157894737,8.026315789473685,1.1842105263157896,0.0
48,서울특별시,송파구,오륜동,오륜동제2투,2735,2148,407,1519,187,22,1,2136,12,587,19.05430711610487,71.11423220973782,8.754681647940075,1.0299625468164793,0.04681647940074907
49,서울특별시,송파구,오륜동,오륜동제3투,2454,1927,371,1344,189,14,2,1920,7,527,19.322916666666668,70.0,9.84375,0.7291666666666666,0.10416666666666667
50,서울특별시,송파구,오륜동,오륜동제4투,2547,1922,302,1425,171,18,1,1917,5,625,15.753781950965049,74.33489827856025,8.92018779342723,0.9389671361502347,0.05216484089723526
51,서울특별시,송파구,오금동,관내사전투표,6138,6138,3888,1679,478,59,2,6106,32,0,63.67507369800196,27.497543399934493,7.828365542089748,0.9662626924336719,0.03275466754012447
52,서울특별시,송파구,오금동,오금동제1투,2937,2099,346,1566,164,17,0,2093,6,838,16.53129479216436,74.82083134257047,7.835642618251313,0.8122312470138557,0.0
53,서울특별시,송파구,오금동,오금동제2투,2999,2248,653,1389,177,24,0,2243,5,751,29.11279536335265,61.92599197503343,7.891217119928667,1.069995541685243,0.0
54,서울특별시,송파구,오금동,오금동제3투,2565,1848,650,990,168,24,2,1834,14,717,35.44165757906216,53.98037077426391,9.16030534351145,1.3086150490730644,0.10905125408942204
55,서울특별시,송파구,오금동,오금동제4투,3329,2363,903,1234,188,22,2,2349,14,966,38.441890166028095,52.53299276287782,8.00340570455513,0.9365687526607066,0.08514261387824607
56,서울특별시,송파구,오금동,오금동제5투,3031,2167,793,1145,190,24,2,2154,13,864,36.81522748375116,53.156917363045494,8.82079851439183,1.1142061281337048,0.09285051067780872
57,서울특별시,송파구,오금동,오금동제6투,2363,1824,560,1081,155,19,0,1815,9,539,30.853994490358126,59.55922865013774,8.539944903581267,1.046831955922865,0.0
58,서울특별시,송파구,오금동,오금동제7투,3184,2267,827,1198,194,31,2,2252,15,917,36.72291296625222,53.197158081705155,8.6145648312611,1.3765541740674956,0.08880994671403197
59,서울특별시,송파구,오금동,오금동제8투,2494,1868,763,940,129,19,2,1853,15,626,41.17647058823529,50.728548300053966,6.961683756071235,1.0253642741500268,0.10793308148947653
60,서울특별시,송파구,송파1동,관내사전투표,6329,6328,3951,1517,712,75,8,6263,65,1,63.08478365000798,24.22161903241258,11.368353824045984,1.1975091809037202,0.12773431262973017
61,서울특별시,송파구,송파1동,송파1동제1투,2477,1667,560,843,223,16,1,1643,24,810,34.08399269628728,51.308581862446744,13.572732805842971,0.9738283627510651,0.06086427267194157
62,서울특별시,송파구,송파1동,송파1동제2투,2787,1867,575,1067,181,14,6,1843,24,920,31.199131850244164,57.89473684210527,9.820944112859468,0.759631036353771,0.32555615843733043
63,서울특별시,송파구,송파1동,송파1동제3투,2867,2006,596,1172,195,24,0,1987,19,861,29.994967287367892,58.983392048314045,9.813789632611977,1.2078510317060895,0.0
64,서울특별시,송파구,송파1동,송파1동제4투,2495,1668,571,855,198,17,4,1645,23,827,34.7112462006079,51.97568389057751,12.036474164133738,1.033434650455927,0.24316109422492402
65,서울특별시,송파구,송파1동,송파1동제5투,2585,1811,482,1114,174,27,1,1798,13,774,26.807563959955505,61.957730812013345,9.67741935483871,1.5016685205784204,0.05561735261401557
66,서울특별시,송파구,송파2동,관내사전투표,4073,4073,2468,1158,387,38,2,4053,20,0,60.893165556377994,28.57142857142857,9.548482605477423,0.9375771033802123,0.049346163335800636
67,서울특별시,송파구,송파2동,송파2동제1투,2252,1638,396,1085,138,11,0,1630,8,614,24.294478527607364,66.56441717791411,8.466257668711656,0.6748466257668712,0.0
68,서울특별시,송파구,송파2동,송파2동제2투,2495,1845,609,973,224,19,1,1826,19,650,33.351588170865284,53.285870755750274,12.26725082146769,1.04052573932092,0.054764512595837894
69,서울특별시,송파구,송파2동,송파2동제3투,2911,2328,633,1444,215,21,1,2314,14,583,27.355229040622298,62.4027657735523,9.291270527225583,0.9075194468452896,0.043215211754537596
70,서울특별시,송파구,송파2동,송파2동제4투,3180,2441,653,1513,238,23,0,2427,14,739,26.905644829007002,62.34033786567779,9.80634528224145,0.9476720230737536,0.0
71,서울특별시,송파구,석촌동,관내사전투표,6692,6692,4348,1604,621,69,4,6646,46,0,65.42281071321095,24.13481793560036,9.3439662955161,1.0382184772795666,0.06018657839301836
72,서울특별시,송파구,석촌동,석촌동제1투,2617,1719,540,967,174,15,2,1698,21,898,31.802120141342755,56.949352179034165,10.247349823321555,0.88339222614841,0.11778563015312131
73,서울특별시,송파구,석촌동,석촌동제2투,2270,1456,500,757,174,10,0,1441,15,814,34.69812630117974,52.532963219986115,12.074947952810549,0.6939625260235947,0.0
74,서울특별시,송파구,석촌동,석촌동제3투,2730,1712,600,902,168,22,2,1694,18,1018,35.41912632821724,53.246753246753244,9.917355371900827,1.2987012987012987,0.11806375442739078
75,서울특별시,송파구,석촌동,석촌동제4투,2549,1666,612,863,155,16,3,1649,17,883,37.11340206185567,52.334748332322626,9.399636143117041,0.9702850212249848,0.18192844147968465
76,서울특별시,송파구,석촌동,석촌동제5투,2456,1567,548,850,137,15,4,1554,13,889,35.26383526383526,54.69755469755469,8.815958815958815,0.9652509652509652,0.2574002574002574
77,서울특별시,송파구,석촌동,석촌동제6투,2421,1659,560,892,171,20,4,1647,12,762,34.001214329083176,54.15907710989678,10.382513661202186,1.214329083181542,0.24286581663630846
78,서울특별시,송파구,석촌동,석촌동제7투,2301,1620,462,915,197,22,2,1598,22,681,28.911138923654566,57.259073842302875,12.3279098873592,1.376720901126408,0.1251564455569462
79,서울특별시,송파구,삼전동,관내사전투표,6989,6989,4517,1669,683,62,4,6935,54,0,65.13338139870224,24.066330209084356,9.848594087959626,0.8940158615717375,0.05767844268204759
80,서울특별시,송파구,삼전동,삼전동제1투,2097,1359,465,716,145,18,3,1347,12,738,34.521158129175944,53.15515961395694,10.764662212323682,1.3363028953229399,0.22271714922048996
81,서울특별시,송파구,삼전동,삼전동제2투,2366,1413,454,785,150,17,1,1407,6,953,32.26723525230988,55.792466240227434,10.660980810234541,1.2082444918265813,0.07107320540156362
82,서울특별시,송파구,삼전동,삼전동제3투,2461,1708,594,901,174,16,3,1688,20,753,35.18957345971564,53.37677725118483,10.308056872037914,0.9478672985781991,0.17772511848341233
83,서울특별시,송파구,삼전동,삼전동제4투,2316,1536,537,811,147,17,5,1517,19,780,35.39881344759394,53.46077785102176,9.69017798286091,1.1206328279499012,0.3295978905735003
84,서울특별시,송파구,삼전동,삼전동제5투,2826,1953,740,968,201,19,3,1931,22,873,38.32211289487312,50.129466597617814,10.409114448472295,0.9839461418953911,0.15535991714137753
85,서울특별시,송파구,삼전동,삼전동제6투,2463,1597,550,831,180,21,0,1582,15,866,34.7661188369153,52.528445006321114,11.378002528445007,1.3274336283185841,0.0
86,서울특별시,송파구,삼전동,삼전동제7투,2303,1472,564,737,135,18,0,1454,18,831,38.78954607977992,50.68775790921596,9.284731774415405,1.2379642365887207,0.0
87,서울특별시,송파구,가락본동,관내사전투표,5517,5515,3395,1498,504,72,6,5475,40,2,62.009132420091326,27.360730593607308,9.205479452054794,1.315068493150685,0.1095890410958904
88,서울특별시,송파구,가락본동,가락본동제1투,2252,1274,368,742,139,11,0,1260,14,978,29.20634920634921,58.88888888888889,11.031746031746032,0.873015873015873,0.0
89,서울특별시,송파구,가락본동,가락본동제2투,2916,2134,698,1185,206,31,1,2121,13,782,32.90900518623291,55.86987270155587,9.712399811409712,1.4615747289014616,0.04714757190004715
90,서울특별시,송파구,가락본동,가락본동제3투,2671,1758,562,1010,155,12,1,1740,18,913,32.298850574712645,58.04597701149425,8.908045977011495,0.6896551724137931,0.05747126436781609
91,서울특별시,송파구,가락본동,가락본동제4투,1823,1404,368,841,173,13,0,1395,9,419,26.379928315412187,60.28673835125448,12.401433691756273,0.9318996415770611,0.0
92,서울특별시,송파구,가락본동,가락본동제5투,2216,1627,557,858,175,17,3,1610,17,589,34.59627329192546,53.29192546583851,10.869565217391305,1.0559006211180124,0.18633540372670807
93,서울특별시,송파구,가락본동,가락본동제6투,2197,1631,402,1054,156,12,1,1625,6,566,24.73846153846154,64.86153846153846,9.6,0.7384615384615384,0.06153846153846154
94,서울특별시,송파구,가락1동,관내사전투표,4874,4874,2673,1652,482,42,1,4850,24,0,55.113402061855666,34.06185567010309,9.938144329896907,0.865979381443299,0.020618556701030927
95,서울특별시,송파구,가락1동,가락1동제1투,3268,2377,539,1549,250,25,3,2366,11,891,22.781065088757398,65.46914623837701,10.566356720202874,1.0566356720202874,0.12679628064243448
96,서울특별시,송파구,가락1동,가락1동제2투,3188,2501,593,1595,271,23,1,2483,18,687,23.882400322190897,64.23681031010874,10.914216673378977,0.9262988320579945,0.04027386226339106
97,서울특별시,송파구,가락1동,가락1동제3투,2557,2067,488,1366,191,15,0,2060,7,490,23.689320388349515,66.31067961165049,9.271844660194175,0.7281553398058253,0.0
98,서울특별시,송파구,가락1동,가락1동제4투,2899,2311,524,1499,246,25,0,2294,17,588,22.842197035745425,65.34437663469922,10.72362685265911,1.0897994768962511,0.0
99,서울특별시,송파구,가락1동,가락1동제5투,2670,2129,536,1341,215,17,2,2111,18,541,25.39081004263382,63.5243960208432,10.184746565608718,0.8053055423969682,0.09474182851729039
100,서울특별시,송파구,가락2동,관내사전투표,4607,4607,2949,1184,401,43,7,4584,23,0,64.3324607329843,25.82897033158813,8.7478184991274,0.9380453752181501,0.15270506108202442
101,서울특별시,송파구,가락2동,가락2동제1투,2477,1698,545,946,168,20,4,1683,15,779,32.382650029708856,56.209150326797385,9.982174688057041,1.1883541295306002,0.23767082590612004
102,서울특별시,송파구,가락2동,가락2동제2투,2216,1524,463,859,164,24,0,1510,14,692,30.66225165562914,56.88741721854305,10.860927152317881,1.5894039735099337,0.0
103,서울특별시,송파구,가락2동,가락2동제3투,3032,2544,924,1310,262,34,0,2530,14,488,36.52173913043478,51.77865612648221,10.355731225296443,1.3438735177865613,0.0
104,서울특별시,송파구,가락2동,가락2동제4투,2290,1773,518,1052,167,24,0,1761,12,517,29.415105053946622,59.73878478137422,9.483248154457694,1.362862010221465,0.0
105,서울특별시,송파구,가락2동,가락2동제5투,2549,1910,546,1165,172,13,0,1896,14,639,28.79746835443038,61.4451476793249,9.071729957805907,0.6856540084388186,0.0
106,서울특별시,송파구,가락2동,가락2동제6투,2640,2014,699,1119,157,16,3,1994,20,626,35.05516549648947,56.118355065195594,7.873620862587763,0.802407221664995,0.15045135406218654
107,서울특별시,송파구,가락2동,가락2동제7투,2443,1920,685,1047,153,19,3,1907,13,523,35.92029365495543,54.902988987939175,8.023072889355008,0.9963293130571578,0.15731515469323545
108,서울특별시,송파구,문정1동,관내사전투표,5865,5865,3645,1401,699,67,3,5815,50,0,62.68271711092004,24.09286328460877,12.020636285468616,1.1521926053310405,0.05159071367153912
109,서울특별시,송파구,문정1동,문정1동제1투,2794,1781,611,938,198,14,3,1764,17,1013,34.637188208616784,53.17460317460318,11.224489795918368,0.7936507936507936,0.17006802721088435
110,서울특별시,송파구,문정1동,문정1동제2투,2423,1852,582,1066,174,16,1,1839,13,571,31.64763458401305,57.96628602501359,9.461663947797716,0.8700380641653072,0.0543773790103317
111,서울특별시,송파구,문정1동,문정1동제3투,3012,2109,703,1093,262,28,4,2090,19,903,33.63636363636363,52.29665071770335,12.535885167464114,1.3397129186602872,0.19138755980861244
112,서울특별시,송파구,문정1동,문정1동제4투,3201,2573,594,1744,208,15,0,2561,12,628,23.194064818430302,68.09839906286606,8.121827411167512,0.5857087075361187,0.0
113,서울특별시,송파구,문정2동,관내사전투표,3135,3135,1652,1144,296,24,0,3116,19,0,53.01668806161746,36.71373555840822,9.499358151476251,0.7702182284980745,0.0
114,서울특별시,송파구,문정2동,문정2동제1투,2393,1885,283,1434,140,21,1,1879,6,508,15.061202767429481,76.31718999467803,7.450771687067589,1.1176157530601383,0.05321979776476849
115,서울특별시,송파구,문정2동,문정2동제2투,3145,2476,454,1792,198,24,0,2468,8,669,18.395461912479742,72.6094003241491,8.022690437601296,0.9724473257698543,0.0
116,서울특별시,송파구,문정2동,문정2동제3투,2855,2148,340,1620,148,22,0,2130,18,707,15.96244131455399,76.05633802816901,6.948356807511737,1.0328638497652582,0.0
117,서울특별시,송파구,문정2동,문정2동제4투,3258,2321,820,1120,329,32,1,2302,19,937,35.62119895742833,48.65334491746307,14.29192006950478,1.3900955690703736,0.043440486533449174
118,서울특별시,송파구,문정2동,문정2동제5투,3343,2519,881,1130,449,28,0,2488,31,824,35.40996784565916,45.41800643086817,18.04662379421222,1.1254019292604502,0.0
119,서울특별시,송파구,문정2동,문정2동제6투,3435,2616,868,1347,348,27,2,2592,24,819,33.48765432098765,51.967592592592595,13.425925925925927,1.0416666666666665,0.07716049382716049
120,서울특별시,송파구,장지동,관내사전투표,6942,6942,4576,1701,570,57,1,6905,37,0,66.27081824764663,24.634322954380885,8.254887762490949,0.8254887762490948,0.014482259232440259
121,서울특별시,송파구,장지동,장지동제1투,2542,1765,579,950,195,24,0,1748,17,777,33.12356979405035,54.347826086956516,11.155606407322654,1.3729977116704806,0.0
122,서울특별시,송파구,장지동,장지동제2투,1993,1436,463,787,154,21,1,1426,10,557,32.46844319775596,55.18934081346424,10.799438990182328,1.4726507713884993,0.07012622720897616
123,서울특별시,송파구,장지동,장지동제3투,2673,1793,644,942,163,17,1,1767,26,880,36.44595359366157,53.3106960950764,9.224674589700056,0.9620826259196379,0.056593095642331635
124,서울특별시,송파구,장지동,장지동제4투,2017,1497,493,828,157,16,0,1494,3,520,32.998661311914326,55.42168674698795,10.508701472556895,1.07095046854083,0.0
125,서울특별시,송파구,장지동,장지동제5투,2886,2188,762,1174,203,26,2,2167,21,698,35.163820950622984,54.17628057221966,9.367789570835255,1.1998154130133827,0.09229349330872173
126,서울특별시,송파구,장지동,장지동제6투,2887,2252,868,1134,218,18,2,2240,12,635,38.75,50.625,9.732142857142858,0.8035714285714285,0.08928571428571429
127,서울특별시,송파구,장지동,장지동제7투,2484,1917,722,992,181,13,1,1909,8,567,37.820848611838656,51.964379256155055,9.481403876375065,0.6809848088004191,0.05238344683080147
128,서울특별시,송파구,잠실본동,관내사전투표,5865,5865,3722,1445,574,72,5,5818,47,0,63.973874183568235,24.83671364730148,9.86593331041595,1.2375386730835338,0.08594018563080096
129,서울특별시,송파구,잠실본동,잠실본동제1투,2798,1702,513,972,191,19,2,1697,5,1096,30.229817324690632,57.2775486152033,11.255156157925752,1.1196228638774306,0.11785503830288745
130,서울특별시,송파구,잠실본동,잠실본동제2투,3035,1872,576,1022,225,33,1,1857,15,1163,31.017770597738288,55.03500269251481,12.116316639741518,1.7770597738287561,0.053850296176628974
131,서울특별시,송파구,잠실본동,잠실본동제3투,2373,1554,496,867,144,25,3,1535,19,819,32.31270358306189,56.48208469055375,9.381107491856678,1.6286644951140066,0.19543973941368079
132,서울특별시,송파구,잠실본동,잠실본동제4투,2659,1865,547,1086,189,24,1,1847,18,794,29.61559285327558,58.798050893340545,10.232809962100704,1.2994044396318354,0.05414185165132648
133,서울특별시,송파구,잠실본동,잠실본동제5투,2528,1757,532,1012,173,17,2,1736,21,771,30.64516129032258,58.294930875576036,9.965437788018432,0.9792626728110598,0.1152073732718894
134,서울특별시,송파구,잠실본동,잠실본동제6투,2669,1740,537,968,190,22,3,1720,20,929,31.220930232558143,56.27906976744186,11.046511627906977,1.2790697674418605,0.1744186046511628
135,서울특별시,송파구,잠실2동,관내사전투표,7216,7216,3951,2349,803,74,5,7182,34,0,55.012531328320804,32.70676691729324,11.180729601782232,1.0303536619326092,0.06961849067112225
136,서울특별시,송파구,잠실2동,잠실2동제1투,2081,1598,386,1028,165,11,0,1590,8,483,24.27672955974843,64.65408805031446,10.377358490566039,0.6918238993710693,0.0
137,서울특별시,송파구,잠실2동,잠실2동제2투,2897,2254,530,1443,231,33,0,2237,17,643,23.69244523915959,64.50603486812696,10.326329906124274,1.475189986589182,0.0
138,서울특별시,송파구,잠실2동,잠실2동제3투,2662,1872,442,1220,190,11,1,1864,8,790,23.71244635193133,65.45064377682404,10.193133047210301,0.5901287553648069,0.0536480686695279
139,서울특별시,송파구,잠실2동,잠실2동제4투,2525,1902,390,1291,193,19,1,1894,8,623,20.591341077085534,68.16261879619853,10.190073917634637,1.0031678986272439,0.05279831045406547
140,서울특별시,송파구,잠실2동,잠실2동제5투,2833,2244,572,1381,246,35,1,2235,9,589,25.592841163310965,61.78970917225951,11.006711409395974,1.5659955257270695,0.0447427293064877
141,서울특별시,송파구,잠실2동,잠실2동제6투,2519,2002,512,1242,212,20,3,1989,13,517,25.74157868275515,62.44343891402715,10.658622423328305,1.0055304172951232,0.1508295625942685
142,서울특별시,송파구,잠실2동,잠실2동제7투,2918,2342,622,1437,243,20,4,2326,16,576,26.741186586414443,61.7798796216681,10.447119518486673,0.8598452278589854,0.17196904557179707
143,서울특별시,송파구,잠실3동,관내사전투표,3608,3608,1736,1537,295,23,3,3594,14,0,48.30272676683361,42.76572064552031,8.208124652198109,0.6399554813578185,0.08347245409015025
144,서울특별시,송파구,잠실3동,잠실3동제1투,1928,1470,230,1099,119,8,2,1458,12,458,15.775034293552812,75.37722908093278,8.161865569272976,0.5486968449931412,0.1371742112482853
145,서울특별시,송파구,잠실3동,잠실3동제2투,2552,1850,344,1349,131,14,2,1840,10,702,18.695652173913043,73.31521739130434,7.119565217391305,0.7608695652173914,0.10869565217391304
146,서울특별시,송파구,잠실3동,잠실3동제3투,1970,1539,270,1156,98,9,0,1533,6,431,17.61252446183953,75.40769732550554,6.392694063926941,0.5870841487279843,0.0
147,서울특별시,송파구,잠실3동,잠실3동제4투,1895,1485,229,1155,87,4,2,1477,8,410,15.504400812457684,78.19905213270142,5.890318212593094,0.2708192281651997,0.13540961408259986
148,서울특별시,송파구,잠실3동,잠실3동제5투,2873,2309,485,1588,196,23,2,2294,15,564,21.14210985178727,69.22406277244987,8.54402789886661,1.0026155187445511,0.08718395815170009
149,서울특별시,송파구,잠실3동,잠실3동제6투,2218,1815,420,1223,140,26,0,1809,6,403,23.217247097844112,67.60641238253179,7.739082365948037,1.4372581536760642,0.0
150,서울특별시,송파구,잠실3동,잠실3동제7투,3306,2560,518,1767,243,20,1,2549,11,746,20.321694782267556,69.32130247155747,9.533150255001962,0.7846214201647704,0.03923107100823853
151,서울특별시,송파구,잠실3동,잠실3동제8투,3288,2665,655,1701,251,36,1,2644,21,623,24.77307110438729,64.33434190620272,9.493192133131618,1.361573373676248,0.037821482602118005
152,서울특별시,송파구,잠실4동,관내사전투표,3572,3572,1925,1263,334,31,3,3556,16,0,54.13385826771654,35.51743532058493,9.392575928008998,0.8717660292463443,0.0843644544431946
153,서울특별시,송파구,잠실4동,잠실4동제1투,2362,1732,394,1136,175,18,0,1723,9,630,22.8670922809054,65.93151479976784,10.156703424260012,1.044689495066744,0.0
154,서울특별시,송파구,잠실4동,잠실4동제2투,2876,2248,489,1491,225,30,2,2237,11,628,21.859633437639697,66.65176575771122,10.058113544926242,1.3410818059901655,0.08940545373267769
155,서울특별시,송파구,잠실4동,잠실4동제3투,3001,2361,532,1560,233,24,0,2349,12,640,22.647935291613454,66.41123882503193,9.919114516815666,1.0217113665389528,0.0
156,서울특별시,송파구,잠실4동,잠실4동제4투,3069,2399,617,1491,236,35,3,2382,17,670,25.90260285474391,62.59445843828715,9.907640638119227,1.4693534844668346,0.12594458438287154
157,서울특별시,송파구,잠실6동,관내사전투표,4290,4290,2171,1601,450,44,2,4268,22,0,50.86691658856607,37.511715089034674,10.543580131208998,1.0309278350515463,0.046860356138706656
158,서울특별시,송파구,잠실6동,잠실6동제1투,3191,2263,428,1610,188,19,1,2246,17,928,19.056099732858414,71.68299198575245,8.370436331255565,0.8459483526268923,0.04452359750667854
159,서울특별시,송파구,잠실6동,잠실6동제2투,2927,2133,362,1571,164,18,2,2117,16,794,17.099669343410486,74.20878601794992,7.7468115257439765,0.8502598016060462,0.0944733112895607
160,서울특별시,송파구,잠실6동,잠실6동제3투,2858,2201,409,1605,166,12,1,2193,8,657,18.650250797993618,73.18741450068399,7.569539443684451,0.5471956224350205,0.045599635202918376
161,서울특별시,송파구,잠실7동,관내사전투표,2070,2070,940,872,216,30,4,2062,8,0,45.586808923375365,42.289039767216295,10.475266731328807,1.454898157129001,0.19398642095053348
162,서울특별시,송파구,잠실7동,잠실7동제1투,3096,2301,246,1851,180,12,2,2291,10,795,10.737669140113487,80.79441292012221,7.856831078131821,0.5237887385421214,0.08729812309035355
163,서울특별시,송파구,잠실7동,잠실7동제2투,2829,2275,425,1609,196,28,2,2260,15,554,18.805309734513273,71.19469026548673,8.672566371681416,1.238938053097345,0.08849557522123894
164,서울특별시,송파구,위례동,관내사전투표,5662,5662,3654,1456,474,48,5,5637,25,0,64.82171367748802,25.829341848500974,8.408728046833422,0.8515167642362959,0.08869966294128083
165,서울특별시,송파구,위례동,위례동제1투,2912,2099,554,1323,195,18,1,2091,8,813,26.49450023912004,63.271162123385935,9.32568149210904,0.860832137733142,0.04782400765184123
166,서울특별시,송파구,위례동,위례동제2투,3181,2510,967,1220,276,24,2,2489,21,671,38.85094415427883,49.01566894335075,11.088790678987545,0.9642426677380473,0.08035355564483729
167,서울특별시,송파구,위례동,위례동제3투,2428,1891,638,1018,196,24,4,1880,11,537,33.93617021276596,54.14893617021277,10.425531914893616,1.276595744680851,0.2127659574468085
168,서울특별시,송파구,위례동,위례동제4투,2123,1603,424,964,187,12,5,1592,11,520,26.633165829145728,60.55276381909548,11.746231155778894,0.7537688442211055,0.314070351758794
169,서울특별시,송파구,위례동,위례동제5투,2932,2290,1110,997,142,24,1,2274,16,642,48.812664907651715,43.84344766930519,6.244503078276165,1.0554089709762533,0.04397537379067722
170,서울특별시,송파구,위례동,위례동제6투,2627,2003,844,905,217,24,0,1990,13,624,42.41206030150754,45.47738693467337,10.904522613065327,1.2060301507537687,0.0
171,서울특별시,송파구,위례동,위례동제7투,2583,1977,770,950,208,32,0,1960,17,606,39.285714285714285,48.46938775510204,10.612244897959183,1.6326530612244898,0.0
172,서울특별시,송파구,위례동,위례동제8투,3292,2616,1317,1011,241,36,1,2606,10,676,50.537221795855714,38.79508825786646,9.247889485801995,1.3814274750575595,0.03837298541826554
173,서울특별시,송파구,잘못 투입·구분된 투표지,,0,0,0,0,0,0,0,0,0,0,0.0,0.0,0.0,0.0,0.0
0,서울특별시,강동구,거소·선상투표,,625,590,231,209,98,7,4,549,41,35,42.07650273224044,38.069216757741344,17.850637522768668,1.2750455373406193,0.7285974499089253
1,서울특별시,강동구,관외사전투표,,45265,45256,26005,12025,6193,534,33,44790,466,9,58.05983478455013,26.84751060504577,13.826747041750389,1.1922304085733422,0.07367716008037509
2,서울특별시,강동구,재외투표,,3514,2817,1806,632,321,34,3,2796,21,697,64.59227467811158,22.603719599427755,11.48068669527897,1.2160228898426324,0.1072961373390558
3,서울특별시,강동구,강일동,관내사전투표,6516,6516,4584,1439,403,62,3,6491,25,0,70.62085965182561,22.16915729471576,6.208596518256047,0.9551686951163149,0.046217840086273304
4,서울특별시,강동구,강일동,강일동제1투,2428,1671,605,907,126,19,2,1659,12,757,36.46775165762507,54.671488848704044,7.59493670886076,1.1452682338758287,0.12055455093429776
5,서울특별시,강동구,강일동,강일동제2투,2319,1745,704,873,129,20,3,1729,16,574,40.717177559282824,50.49161364950838,7.4609600925390405,1.156737998843262,0.1735106998264893
6,서울특별시,강동구,강일동,강일동제3투,2215,1635,603,883,124,15,0,1625,10,580,37.10769230769231,54.33846153846154,7.630769230769231,0.9230769230769231,0.0
7,서울특별시,강동구,강일동,강일동제4투,2432,1786,669,938,136,26,0,1769,17,646,37.81797625777275,53.02430751837196,7.687959299039004,1.4697569248162803,0.0
8,서울특별시,강동구,강일동,강일동제5투,2169,1725,769,779,148,16,0,1712,13,444,44.918224299065415,45.50233644859813,8.644859813084112,0.9345794392523363,0.0
9,서울특별시,강동구,강일동,강일동제6투,4051,3055,1315,1370,325,28,3,3041,14,996,43.242354488655046,45.05097007563302,10.687273923051627,0.9207497533706017,0.09865175928970733
10,서울특별시,강동구,강일동,강일동제7투,2750,2078,928,962,161,13,4,2068,10,672,44.87427466150871,46.518375241779495,7.785299806576402,0.6286266924564796,0.19342359767891684
11,서울특별시,강동구,상일제1동,관내사전투표,6885,6885,4419,1781,577,73,2,6852,33,0,64.49211908931699,25.99241097489784,8.420899007589025,1.0653823701109166,0.02918855808523059
12,서울특별시,강동구,상일제1동,상일제1동제1투,1687,1294,431,739,101,12,0,1283,11,393,33.59314107560405,57.59937646141855,7.872174590802807,0.9353078721745909,0.0
13,서울특별시,강동구,상일제1동,상일제1동제2투,1590,1108,384,616,87,10,6,1103,5,482,34.814143245693565,55.84768812330009,7.887579329102448,0.9066183136899365,0.543970988213962
14,서울특별시,강동구,상일제1동,상일제1동제3투,1981,1414,387,901,89,22,2,1401,13,567,27.62312633832976,64.3112062812277,6.35260528194147,1.5703069236259815,0.14275517487508924
15,서울특별시,강동구,상일제1동,상일제1동제4투,2592,1920,554,1144,188,25,1,1912,8,672,28.97489539748954,59.83263598326359,9.832635983263598,1.307531380753138,0.05230125523012552
16,서울특별시,강동구,상일제1동,상일제1동제5투,2857,2273,722,1303,210,26,1,2262,11,584,31.918656056587093,57.60389036251106,9.283819628647215,1.1494252873563218,0.044208664898320066
17,서울특별시,강동구,상일제1동,상일제1동제6투,3344,2727,976,1429,276,26,1,2708,19,617,36.04135893648449,52.76957163958641,10.19202363367799,0.9601181683899557,0.03692762186115214
18,서울특별시,강동구,상일제1동,상일제1동제7투,3236,2595,846,1456,252,31,3,2588,7,641,32.689335394126736,56.25965996908809,9.73724884080371,1.1978361669242659,0.11591962905718702
19,서울특별시,강동구,상일제1동,상일제1동제8투,2824,2281,831,1183,228,22,2,2266,15,543,36.67255075022065,52.20653133274492,10.061782877316858,0.9708737864077669,0.088261253309797
20,서울특별시,강동구,상일제2동,관내사전투표,2742,2742,1946,546,203,29,4,2728,14,0,71.33431085043989,20.014662756598238,7.441348973607038,1.063049853372434,0.1466275659824047
21,서울특별시,강동구,상일제2동,상일제2동제1투,1650,1195,471,600,96,17,2,1186,9,455,39.713322091062395,50.5902192242833,8.094435075885329,1.433389544688027,0.16863406408094433
22,서울특별시,강동구,상일제2동,상일제2동제2투,1998,1540,653,711,150,18,2,1534,6,458,42.56844850065189,46.34941329856584,9.778357235984354,1.1734028683181226,0.1303780964797914
23,서울특별시,강동구,상일제2동,상일제2동제3투,2977,2203,871,1051,228,34,0,2184,19,774,39.88095238095239,48.12271062271062,10.43956043956044,1.5567765567765568,0.0
24,서울특별시,강동구,명일제1동,관내사전투표,6760,6759,4084,1960,609,69,1,6723,36,1,60.74669046556597,29.153651643611482,9.058456046407853,1.0263275323516288,0.014874312063067083
25,서울특별시,강동구,명일제1동,명일제1동제1투,2252,1580,439,984,131,15,1,1570,10,672,27.961783439490446,62.67515923566879,8.343949044585987,0.9554140127388535,0.06369426751592357
26,서울특별시,강동구,명일제1동,명일제1동제2투,2964,2217,681,1330,171,23,3,2208,9,747,30.842391304347828,60.235507246376805,7.744565217391304,1.0416666666666665,0.1358695652173913
27,서울특별시,강동구,명일제1동,명일제1동제3투,2338,1842,459,1194,150,23,1,1827,15,496,25.12315270935961,65.35303776683087,8.210180623973727,1.258894362342638,0.05473453749315819
28,서울특별시,강동구,명일제1동,명일제1동제4투,2871,2219,611,1335,237,25,1,2209,10,652,27.659574468085108,60.434585785423266,10.72883657763694,1.131733816206428,0.04526935264825713
29,서울특별시,강동구,명일제1동,명일제1동제5투,3042,2071,686,1172,173,27,2,2060,11,971,33.300970873786405,56.89320388349515,8.398058252427184,1.3106796116504855,0.0970873786407767
30,서울특별시,강동구,명일제2동,관내사전투표,3403,3403,2188,914,251,31,5,3389,14,0,64.5618176453231,26.969607553850693,7.40631454706403,0.9147241074063145,0.14753614635585718
31,서울특별시,강동구,명일제2동,명일제2동제1투,2155,1756,484,1111,140,14,0,1749,7,399,27.67295597484277,63.52201257861635,8.00457404230989,0.8004574042309892,0.0
32,서울특별시,강동구,명일제2동,명일제2동제2투,2037,1482,437,898,119,16,2,1472,10,555,29.6875,61.00543478260869,8.084239130434783,1.0869565217391304,0.1358695652173913
33,서울특별시,강동구,명일제2동,명일제2동제3투,2855,2186,714,1237,190,29,3,2173,13,669,32.85780027611597,56.92590888173032,8.743672342383801,1.3345605154164748,0.13805798435342845
34,서울특별시,강동구,명일제2동,명일제2동제4투,2355,1848,459,1205,155,20,1,1840,8,507,24.945652173913043,65.48913043478261,8.423913043478262,1.0869565217391304,0.05434782608695652
35,서울특별시,강동구,고덕제1동,관내사전투표,4836,4836,3011,1311,441,50,2,4815,21,0,62.533748701973,27.227414330218068,9.158878504672897,1.0384215991692627,0.04153686396677051
36,서울특별시,강동구,고덕제1동,고덕제1동제1투,1452,1117,390,606,102,13,1,1112,5,335,35.07194244604317,54.49640287769785,9.172661870503598,1.169064748201439,0.08992805755395684
37,서울특별시,강동구,고덕제1동,고덕제1동제2투,2308,1799,556,1039,186,15,0,1796,3,509,30.957683741648108,57.85077951002228,10.356347438752785,0.8351893095768375,0.0
38,서울특별시,강동구,고덕제1동,고덕제1동제3투,2227,1450,414,896,113,12,1,1436,14,777,28.830083565459606,62.39554317548747,7.86908077994429,0.8356545961002786,0.06963788300835655
39,서울특별시,강동구,고덕제1동,고덕제1동제4투,2761,2224,728,1216,250,17,2,2213,11,537,32.89652056032535,54.94803434252147,11.296882060551287,0.7681879801174876,0.09037505648441031
40,서울특별시,강동구,고덕제1동,고덕제1동제5투,2696,2088,781,1096,183,19,3,2082,6,608,37.512007684918345,52.641690682036504,8.789625360230549,0.9125840537944284,0.1440922190201729
41,서울특별시,강동구,고덕제2동,관내사전투표,3956,3956,2412,1124,357,40,1,3934,22,0,61.31164209456025,28.57142857142857,9.07473309608541,1.0167768174885612,0.02541942043721403
42,서울특별시,강동구,고덕제2동,고덕제2동제1투,1777,1115,354,657,90,9,0,1110,5,662,31.891891891891895,59.189189189189186,8.108108108108109,0.8108108108108109,0.0
43,서울특별시,강동구,고덕제2동,고덕제2동제2투,2919,2006,659,1113,185,20,4,1981,25,913,33.26602725896012,56.18374558303887,9.33871781928319,1.0095911155981827,0.20191822311963653
44,서울특별시,강동구,고덕제2동,고덕제2동제3투,3233,2656,842,1526,257,22,1,2648,8,577,31.797583081570995,57.62839879154078,9.705438066465257,0.8308157099697886,0.0377643504531722
45,서울특별시,강동구,고덕제2동,고덕제2동제4투,2885,2304,776,1257,234,23,0,2290,14,581,33.88646288209607,54.89082969432314,10.218340611353712,1.0043668122270744,0.0
46,서울특별시,강동구,고덕제2동,고덕제2동제5투,2644,2175,647,1300,194,24,3,2168,7,469,29.843173431734314,59.96309963099631,8.948339483394834,1.107011070110701,0.13837638376383762
47,서울특별시,강동구,암사제1동,관내사전투표,5907,5907,3955,1517,338,52,8,5870,37,0,67.37649063032369,25.84327086882453,5.7580919931856895,0.8858603066439523,0.1362862010221465
48,서울특별시,강동구,암사제1동,암사제1동제1투,2671,1632,652,800,142,17,5,1616,16,1039,40.34653465346535,49.504950495049506,8.787128712871286,1.051980198019802,0.3094059405940594
49,서울특별시,강동구,암사제1동,암사제1동제2투,2477,1554,560,818,141,15,1,1535,19,923,36.48208469055375,53.2899022801303,9.185667752442997,0.9771986970684038,0.06514657980456026
50,서울특별시,강동구,암사제1동,암사제1동제3투,2392,1552,546,830,152,12,0,1540,12,840,35.45454545454545,53.896103896103895,9.87012987012987,0.7792207792207793,0.0
51,서울특별시,강동구,암사제1동,암사제1동제4투,2310,1546,579,810,129,14,1,1533,13,764,37.76908023483366,52.83757338551859,8.414872798434441,0.91324200913242,0.06523157208088715
52,서울특별시,강동구,암사제1동,암사제1동제5투,2038,1249,492,620,114,11,4,1241,8,789,39.64544721998388,49.959709911361806,9.186140209508462,0.8863819500402902,0.32232070910556004
53,서울특별시,강동구,암사제1동,암사제1동제6투,2192,1397,480,768,124,18,1,1391,6,795,34.507548526240114,55.21207764198418,8.914450035945363,1.2940330697340043,0.07189072609633358
54,서울특별시,강동구,암사제1동,암사제1동제7투,2224,1493,542,802,117,14,4,1479,14,731,36.64638269100744,54.22582826233941,7.910750507099391,0.9465855307640297,0.2704530087897228
55,서울특별시,강동구,암사제1동,암사제1동제8투,2581,2061,651,1199,170,24,2,2046,15,520,31.818181818181817,58.602150537634415,8.308895405669599,1.1730205278592376,0.09775171065493646
56,서울특별시,강동구,암사제2동,관내사전투표,6061,6061,3813,1533,589,74,2,6011,50,0,63.43370487439694,25.503244052570288,9.798702378971885,1.2310763600066543,0.0332723340542339
57,서울특별시,강동구,암사제2동,암사제2동제1투,1703,1205,308,774,105,7,2,1196,9,498,25.75250836120401,64.71571906354515,8.779264214046822,0.5852842809364548,0.16722408026755853
58,서울특별시,강동구,암사제2동,암사제2동제2투,3178,2214,786,1154,230,28,2,2200,14,964,35.72727272727273,52.45454545454545,10.454545454545453,1.2727272727272727,0.09090909090909091
59,서울특별시,강동구,암사제2동,암사제2동제3투,2494,1923,527,1166,188,24,2,1907,16,571,27.63502884111169,61.143156790770846,9.858416360776088,1.2585212375458836,0.1048767697954903
60,서울특별시,강동구,암사제3동,관내사전투표,3947,3947,2468,1120,297,43,2,3930,17,0,62.79898218829516,28.498727735368956,7.557251908396946,1.0941475826972011,0.05089058524173028
61,서울특별시,강동구,암사제3동,암사제3동제1투,2633,1976,546,1207,187,24,1,1965,11,657,27.78625954198473,61.42493638676845,9.516539440203562,1.2213740458015268,0.05089058524173028
62,서울특별시,강동구,암사제3동,암사제3동제2투,2440,1951,567,1189,170,17,0,1943,8,489,29.18167781780752,61.19402985074627,8.749356664951106,0.8749356664951106,0.0
63,서울특별시,강동구,암사제3동,암사제3동제3투,2062,1513,526,834,121,26,2,1509,4,549,34.85752153744202,55.26838966202783,8.018555334658714,1.7229953611663356,0.13253810470510272
64,서울특별시,강동구,암사제3동,암사제3동제4투,1919,1418,502,751,126,20,4,1403,15,501,35.78047042052744,53.528153955808975,8.980755523877406,1.4255167498218104,0.2851033499643621
65,서울특별시,강동구,천호제1동,관내사전투표,5682,5682,3710,1525,372,37,6,5650,32,0,65.66371681415929,26.991150442477874,6.5840707964601775,0.6548672566371682,0.10619469026548674
66,서울특별시,강동구,천호제1동,천호제1동제1투,2674,1589,561,869,128,12,1,1571,18,1085,35.70973901973266,55.315085932527055,8.147676639083386,0.7638446849140674,0.06365372374283895
67,서울특별시,강동구,천호제1동,천호제1동제2투,2639,1812,634,1006,137,22,1,1800,12,827,35.22222222222222,55.888888888888886,7.611111111111112,1.2222222222222223,0.05555555555555555
68,서울특별시,강동구,천호제1동,천호제1동제3투,2537,1596,609,804,144,28,1,1586,10,941,38.3984867591425,50.69356872635561,9.079445145018916,1.7654476670870116,0.06305170239596469
69,서울특별시,강동구,천호제1동,천호제1동제4투,2833,1952,683,1066,169,17,2,1937,15,881,35.2607124419205,55.033557046979865,8.724832214765101,0.8776458440887971,0.10325245224574084
70,서울특별시,강동구,천호제1동,천호제1동제5투,2336,1641,569,916,126,16,1,1628,13,695,34.95085995085995,56.26535626535627,7.73955773955774,0.9828009828009828,0.06142506142506143
71,서울특별시,강동구,천호제1동,천호제1동제6투,2074,1377,543,714,96,10,2,1365,12,697,39.78021978021978,52.307692307692314,7.032967032967033,0.7326007326007326,0.14652014652014653
72,서울특별시,강동구,천호제2동,관내사전투표,6760,6760,4409,1761,497,51,4,6722,38,0,65.59059803629872,26.197560249925615,7.393632847366854,0.7587027670336209,0.05950609937518596
73,서울특별시,강동구,천호제2동,천호제2동제1투,2129,1419,535,720,132,19,1,1407,12,710,38.024164889836534,51.1727078891258,9.381663113006397,1.3503909026297085,0.07107320540156362
74,서울특별시,강동구,천호제2동,천호제2동제2투,2501,1829,678,941,173,18,2,1812,17,672,37.41721854304636,51.93156732891833,9.547461368653423,0.9933774834437087,0.11037527593818984
75,서울특별시,강동구,천호제2동,천호제2동제3투,1865,1254,454,621,151,9,2,1237,17,611,36.70169765561843,50.2021018593371,12.206952303961197,0.7275666936135812,0.16168148746968472
76,서울특별시,강동구,천호제2동,천호제2동제4투,2718,1813,589,974,205,19,2,1789,24,905,32.92342090553382,54.443823365008384,11.458915595304639,1.0620458356623812,0.11179429849077697
77,서울특별시,강동구,천호제2동,천호제2동제5투,2883,1887,757,943,150,22,1,1873,14,996,40.4164442071543,50.34703683929524,8.00854244527496,1.174586225306994,0.05339028296849973
78,서울특별시,강동구,천호제2동,천호제2동제6투,2805,1849,654,996,156,24,3,1833,16,956,35.67921440261866,54.337152209492636,8.51063829787234,1.309328968903437,0.16366612111292964
79,서울특별시,강동구,천호제2동,천호제2동제7투,2744,1880,685,1007,159,17,1,1869,11,864,36.65061530230069,53.87907972177635,8.507223113964688,0.9095773140716961,0.05350454788657035
80,서울특별시,강동구,천호제2동,천호제2동제8투,3169,2108,705,1102,254,20,6,2087,21,1061,33.780546238620026,52.80306660277911,12.170579779587925,0.9583133684714902,0.287494010541447
81,서울특별시,강동구,천호제3동,관내사전투표,4840,4840,3023,1244,489,41,5,4802,38,0,62.95293627655144,25.90587255310287,10.18325697625989,0.8538109121199501,0.10412328196584757
82,서울특별시,강동구,천호제3동,천호제3동제1투,2797,1740,543,955,203,23,2,1726,14,1057,31.46002317497103,55.330243337195824,11.761297798377752,1.3325608342989572,0.11587485515643105
83,서울특별시,강동구,천호제3동,천호제3동제2투,2718,1930,563,1112,220,28,1,1924,6,788,29.26195426195426,57.7962577962578,11.434511434511435,1.4553014553014554,0.05197505197505198
84,서울특별시,강동구,천호제3동,천호제3동제3투,2827,1984,736,977,230,22,1,1966,18,843,37.43641912512716,49.69481180061038,11.698880976602238,1.119023397761953,0.050864699898270596
85,서울특별시,강동구,천호제3동,천호제3동제4투,2546,1539,529,825,152,13,1,1520,19,1007,34.80263157894737,54.276315789473685,10.0,0.855263157894737,0.06578947368421052
86,서울특별시,강동구,천호제3동,천호제3동제5투,2598,1613,664,768,141,18,2,1593,20,985,41.682360326428125,48.21092278719397,8.851224105461393,1.1299435028248588,0.12554927809165098
87,서울특별시,강동구,천호제3동,천호제3동제6투,2319,1623,617,817,157,21,2,1614,9,696,38.22800495662949,50.619578686493185,9.727385377942998,1.3011152416356877,0.12391573729863693
88,서울특별시,강동구,성내제1동,관내사전투표,4995,4995,3154,1279,471,55,5,4964,31,0,63.53746978243352,25.765511684125702,9.488315874294925,1.1079774375503626,0.1007252215954875
89,서울특별시,강동구,성내제1동,성내제1동제1투,2436,1682,556,917,182,19,1,1675,7,754,33.19402985074627,54.74626865671641,10.865671641791044,1.1343283582089554,0.05970149253731343
90,서울특별시,강동구,성내제1동,성내제1동제2투,2669,1896,639,1039,181,22,0,1881,15,773,33.97129186602871,55.236576289207875,9.62254120148857,1.1695906432748537,0.0
91,서울특별시,강동구,성내제1동,성내제1동제3투,2417,1680,632,859,147,22,3,1663,17,737,38.00360793746242,51.65363800360794,8.83944678292243,1.32291040288635,0.1803968731208659
92,서울특별시,강동구,성내제1동,성내제1동제4투,2720,2052,647,1173,206,12,2,2040,12,668,31.715686274509803,57.49999999999999,10.098039215686274,0.5882352941176471,0.09803921568627451
93,서울특별시,강동구,성내제2동,관내사전투표,5380,5379,3478,1421,394,50,2,5345,34,1,65.07015902712816,26.585594013096355,7.371375116931713,0.9354536950420954,0.037418147801683815
94,서울특별시,강동구,성내제2동,성내제2동제1투,2516,1611,524,889,166,13,2,1594,17,905,32.8732747804266,55.77164366373902,10.41405269761606,0.8155583437892095,0.12547051442910914
95,서울특별시,강동구,성내제2동,성내제2동제2투,2762,1851,605,1033,170,27,2,1837,14,911,32.93413173652694,56.23298856831791,9.254218835057157,1.4697876973326074,0.10887316276537834
96,서울특별시,강동구,성내제2동,성내제2동제3투,2806,1893,701,960,201,17,1,1880,13,913,37.287234042553195,51.06382978723404,10.691489361702128,0.9042553191489361,0.05319148936170213
97,서울특별시,강동구,성내제2동,성내제2동제4투,2258,1469,506,799,129,23,2,1459,10,789,34.681288553803974,54.76353666895134,8.841672378341329,1.5764222069910898,0.1370801919122687
98,서울특별시,강동구,성내제2동,성내제2동제5투,3588,2573,891,1246,371,29,2,2539,34,1015,35.09255612445845,49.074438755415514,14.612051988972036,1.1421819614021267,0.07877116975187082
99,서울특별시,강동구,성내제3동,관내사전투표,5647,5647,3620,1467,476,52,5,5620,27,0,64.41281138790036,26.103202846975087,8.469750889679716,0.9252669039145907,0.0889679715302491
100,서울특별시,강동구,성내제3동,성내제3동제1투,2437,1570,515,900,131,14,2,1562,8,867,32.97055057618438,57.618437900128036,8.386683738796414,0.8962868117797695,0.12804097311139565
101,서울특별시,강동구,성내제3동,성내제3동제2투,2773,1868,551,1100,176,27,3,1857,11,905,29.671513193322564,59.23532579429187,9.477652127086698,1.4539579967689822,0.16155088852988692
102,서울특별시,강동구,성내제3동,성내제3동제3투,3557,2510,875,1334,242,26,5,2482,28,1047,35.25382755842063,53.74697824335214,9.75020145044319,1.04754230459307,0.201450443190975
103,서울특별시,강동구,성내제3동,성내제3동제4투,3587,2482,884,1296,248,27,6,2461,21,1105,35.920357578220234,52.661519707436,10.077204388459975,1.0971149939049167,0.24380333197887039
104,서울특별시,강동구,길동,관내사전투표,8876,8876,5637,2475,635,76,8,8831,45,0,63.83195561091609,28.02627109047673,7.190578643415242,0.8606046880308006,0.0905899671611369
105,서울특별시,강동구,길동,길동제1투,2896,1697,577,962,126,20,0,1685,12,1199,34.2433234421365,57.0919881305638,7.4777448071216615,1.1869436201780417,0.0
106,서울특별시,강동구,길동,길동제2투,3726,2583,874,1453,213,22,5,2567,16,1143,34.04752629528633,56.60303856641995,8.297623685235683,0.8570315543435918,0.19477989871445267
107,서울특별시,강동구,길동,길동제3투,3944,2779,910,1610,216,19,4,2759,20,1165,32.98296484233418,58.35447625951432,7.828923523015585,0.6886553098948894,0.14498006524102935
108,서울특별시,강동구,길동,길동제4투,3590,2150,719,1110,270,28,5,2132,18,1440,33.724202626641656,52.06378986866792,12.664165103189493,1.3133208255159476,0.23452157598499063
109,서울특별시,강동구,길동,길동제5투,3057,2230,831,1104,248,23,2,2208,22,827,37.63586956521739,50.0,11.231884057971014,1.0416666666666665,0.09057971014492754
110,서울특별시,강동구,길동,길동제6투,4110,2918,1027,1581,255,26,2,2891,27,1192,35.52404012452438,54.686959529574544,8.820477343479764,0.8993427879626428,0.06918021445866482
111,서울특별시,강동구,길동,길동제7투,3653,2537,957,1342,196,26,1,2522,15,1116,37.94607454401269,53.21173671689136,7.7716098334655035,1.0309278350515463,0.03965107057890563
112,서울특별시,강동구,길동,길동제8투,3620,2670,929,1487,206,29,0,2651,19,950,35.043379856657864,56.09204073934364,7.770652583930593,1.0939268200678989,0.0
113,서울특별시,강동구,둔촌제1동,관내사전투표,5659,5659,3038,1847,673,65,3,5626,33,0,53.999289015286166,32.82971916103804,11.96231781016708,1.1553501599715605,0.053323853537148955
114,서울특별시,강동구,둔촌제1동,둔촌제1동제1투,2991,2415,639,1420,316,27,2,2404,11,576,26.58069883527454,59.06821963394343,13.14475873544093,1.123128119800333,0.08319467554076539
115,서울특별시,강동구,둔촌제1동,둔촌제1동제2투,3228,2608,587,1734,259,15,0,2595,13,620,22.62042389210019,66.82080924855491,9.980732177263969,0.5780346820809248,0.0
116,서울특별시,강동구,둔촌제1동,둔촌제1동제3투,2433,1947,507,1141,266,21,2,1937,10,486,26.174496644295303,58.905524006195144,13.732576148683531,1.0841507485802788,0.10325245224574084
117,서울특별시,강동구,둔촌제1동,둔촌제1동제4투,2947,2359,554,1485,284,25,0,2348,11,588,23.594548551959114,63.24531516183987,12.095400340715502,1.0647359454855196,0.0
118,서울특별시,강동구,둔촌제1동,둔촌제1동제5투,2609,2106,486,1374,222,18,0,2100,6,503,23.142857142857142,65.42857142857143,10.571428571428571,0.8571428571428572,0.0
119,서울특별시,강동구,둔촌제1동,둔촌제1동제6투,2196,1803,521,1061,193,16,1,1792,11,393,29.073660714285715,59.20758928571429,10.770089285714286,0.8928571428571428,0.055803571428571425
120,서울특별시,강동구,둔촌제2동,관내사전투표,4803,4803,3102,1258,367,37,2,4766,37,0,65.08602601762485,26.39530004196391,7.700377675199328,0.7763323541754091,0.0419639110365086
121,서울특별시,강동구,둔촌제2동,둔촌제2동제1투,2888,1862,642,1016,173,14,1,1846,16,1026,34.77789815817985,55.03791982665223,9.371614301191766,0.7583965330444203,0.054171180931744306
122,서울특별시,강동구,둔촌제2동,둔촌제2동제2투,2773,1956,649,1099,172,14,4,1938,18,817,33.48813209494324,56.7079463364293,8.875128998968009,0.7223942208462332,0.20639834881320948
123,서울특별시,강동구,둔촌제2동,둔촌제2동제3투,3110,2367,866,1200,255,28,4,2353,14,743,36.80407989800255,50.9987250318742,10.837229069273269,1.1899702507437315,0.16999575010624735
124,서울특별시,강동구,둔촌제2동,둔촌제2동제4투,2897,2142,672,1230,204,27,1,2134,8,755,31.490159325210872,57.63823805060918,9.559512652296158,1.2652296157450795,0.046860356138706656
125,서울특별시,강동구,둔촌제2동,둔촌제2동제5투,2792,2210,671,1314,176,29,2,2192,18,582,30.611313868613138,59.94525547445255,8.02919708029197,1.322992700729927,0.09124087591240876
126,서울특별시,강동구,잘못 투입·구분된 투표지,,0,1,0,1,0,0,0,1,0,-1,0.0,100.0,0.0,0.0,0.0
0,부산광역시,중구,거소·선상투표,,82,77,28,34,12,1,0,75,2,5,37.333333333333336,45.33333333333333,16.0,1.3333333333333335,0.0
1,부산광역시,중구,관외사전투표,,3420,3420,1750,1164,437,35,3,3389,31,0,51.63765122455002,34.34641487164355,12.894659191501917,1.0327530244910004,0.08852168781351431
2,부산광역시,중구,재외투표,,232,162,120,29,10,2,0,161,1,70,74.53416149068323,18.012422360248447,6.211180124223603,1.2422360248447204,0.0
3,부산광역시,중구,중앙동,관내사전투표,732,732,404,222,90,6,0,722,10,0,55.95567867036011,30.747922437673132,12.465373961218837,0.8310249307479225,0.0
4,부산광역시,중구,중앙동,중앙동제1투,898,532,140,313,64,4,3,524,8,366,26.717557251908396,59.732824427480914,12.213740458015266,0.7633587786259541,0.5725190839694656
5,부산광역시,중구,중앙동,중앙동제2투,988,590,157,334,89,3,2,585,5,398,26.837606837606838,57.09401709401709,15.213675213675213,0.5128205128205128,0.3418803418803419
6,부산광역시,중구,동광동,관내사전투표,768,768,404,295,55,3,0,757,11,0,53.36856010568032,38.969616908850725,7.26552179656539,0.3963011889035667,0.0
7,부산광역시,중구,동광동,동광동제1투,690,367,97,246,19,4,0,366,1,323,26.50273224043716,67.21311475409836,5.191256830601093,1.092896174863388,0.0
8,부산광역시,중구,동광동,동광동제2투,693,413,93,297,18,3,0,411,2,280,22.62773722627737,72.26277372262774,4.37956204379562,0.7299270072992701,0.0
9,부산광역시,중구,대청동,관내사전투표,1003,1003,554,372,60,9,1,996,7,0,55.62248995983936,37.34939759036144,6.024096385542169,0.9036144578313252,0.1004016064257028
10,부산광역시,중구,대청동,대청동제1투,1543,960,226,647,74,6,1,954,6,583,23.68972746331237,67.81970649895179,7.756813417190776,0.628930817610063,0.10482180293501049
11,부산광역시,중구,대청동,대청동제2투,1114,657,195,413,39,2,1,650,7,457,30.0,63.53846153846155,6.0,0.3076923076923077,0.15384615384615385
12,부산광역시,중구,대청동,대청동제3투,907,589,201,366,13,2,2,584,5,318,34.417808219178085,62.671232876712324,2.2260273972602738,0.3424657534246575,0.3424657534246575
13,부산광역시,중구,보수동,관내사전투표,1870,1870,956,776,114,11,1,1858,12,0,51.45317545748116,41.76533907427341,6.135629709364909,0.5920344456404736,0.05382131324004305
14,부산광역시,중구,보수동,보수동제1투,1369,877,217,613,39,2,0,871,6,492,24.913892078071182,70.37887485648679,4.477611940298507,0.2296211251435132,0.0
15,부산광역시,중구,보수동,보수동제2투,1371,869,226,588,44,7,0,865,4,502,26.1271676300578,67.97687861271676,5.086705202312139,0.8092485549132947,0.0
16,부산광역시,중구,보수동,보수동제3투,749,425,106,300,13,1,1,421,4,324,25.17814726840855,71.25890736342043,3.0878859857482186,0.23752969121140144,0.23752969121140144
17,부산광역시,중구,보수동,보수동제4투,2801,1800,463,1172,129,19,2,1785,15,1001,25.93837535014006,65.65826330532212,7.226890756302522,1.0644257703081232,0.11204481792717086
18,부산광역시,중구,부평동,관내사전투표,1246,1246,603,575,57,5,2,1242,4,0,48.55072463768116,46.2962962962963,4.5893719806763285,0.40257648953301123,0.1610305958132045
19,부산광역시,중구,부평동,부평동제1투,1071,685,122,536,24,0,0,682,3,386,17.888563049853374,78.59237536656892,3.519061583577713,0.0,0.0
20,부산광역시,중구,부평동,부평동제2투,1555,930,183,680,53,7,0,923,7,625,19.826652221018417,73.67280606717227,5.742145178764897,0.7583965330444203,0.0
21,부산광역시,중구,광복동,관내사전투표,383,383,190,157,29,4,1,381,2,0,49.86876640419948,41.20734908136483,7.611548556430446,1.0498687664041995,0.26246719160104987
22,부산광역시,중구,광복동,광복동투표소,544,349,57,269,20,0,0,346,3,195,16.473988439306357,77.74566473988439,5.780346820809249,0.0,0.0
23,부산광역시,중구,남포동,관내사전투표,266,266,130,119,13,1,0,263,3,0,49.42965779467681,45.247148288973385,4.942965779467681,0.38022813688212925,0.0
24,부산광역시,중구,남포동,남포동투표소,507,277,52,216,6,1,1,276,1,230,18.84057971014493,78.26086956521739,2.1739130434782608,0.36231884057971014,0.36231884057971014
25,부산광역시,중구,영주제1동,관내사전투표,790,790,418,293,66,7,0,784,6,0,53.316326530612244,37.37244897959184,8.418367346938775,0.8928571428571428,0.0
26,부산광역시,중구,영주제1동,영주제1동제1투,1888,1084,265,720,78,6,1,1070,14,804,24.766355140186917,67.28971962616822,7.289719626168225,0.5607476635514018,0.09345794392523366
27,부산광역시,중구,영주제1동,영주제1동제2투,758,424,121,274,24,1,1,421,3,334,28.741092636579573,65.08313539192399,5.7007125890736345,0.23752969121140144,0.23752969121140144
28,부산광역시,중구,영주제2동,관내사전투표,927,927,510,373,31,4,3,921,6,0,55.37459283387622,40.499457111834964,3.3659066232356136,0.43431053203040176,0.32573289902280134
29,부산광역시,중구,영주제2동,영주제2동제1투,902,515,132,346,31,4,0,513,2,387,25.730994152046783,67.44639376218323,6.042884990253411,0.7797270955165692,0.0
30,부산광역시,중구,영주제2동,영주제2동제2투,982,586,140,409,27,9,0,585,1,396,23.931623931623932,69.91452991452991,4.615384615384616,1.5384615384615385,0.0
31,부산광역시,중구,영주제2동,영주제2동제3투,1540,1132,356,684,74,11,0,1125,7,408,31.644444444444442,60.8,6.577777777777778,0.9777777777777777,0.0
32,부산광역시,중구,영주제2동,영주제2동제4투,695,518,168,335,9,4,0,516,2,177,32.55813953488372,64.92248062015504,1.744186046511628,0.7751937984496124,0.0
33,부산광역시,중구,잘못 투입·구분된 투표지,,0,0,0,0,0,0,0,0,0,0,0.0,0.0,0.0,0.0,0.0
0,부산광역시,서구,거소·선상투표,,268,251,97,92,46,1,0,236,15,17,41.10169491525424,38.983050847457626,19.491525423728813,0.423728813559322,0.0
1,부산광역시,서구,관외사전투표,,9255,9255,4660,3287,1143,80,18,9188,67,0,50.71832825424467,35.77492381367001,12.440139312146279,0.87070091423596,0.195907705703091
2,부산광역시,서구,재외투표,,608,447,264,129,41,7,0,441,6,161,59.863945578231295,29.25170068027211,9.297052154195011,1.5873015873015872,0.0
3,부산광역시,서구,동대신제1동,관내사전투표,1123,1123,561,476,68,12,0,1117,6,0,50.22381378692927,42.614145031333926,6.087735004476276,1.0743061772605194,0.0
4,부산광역시,서구,동대신제1동,동대신제1동제1투,1528,1063,206,788,55,9,0,1058,5,465,19.47069943289225,74.48015122873346,5.198487712665406,0.8506616257088847,0.0
5,부산광역시,서구,동대신제1동,동대신제1동제2투,1570,1100,329,687,70,5,3,1094,6,470,30.073126142595978,62.797074954296164,6.39853747714808,0.4570383912248629,0.2742230347349177
6,부산광역시,서구,동대신제2동,관내사전투표,1003,1003,550,402,39,4,1,996,7,0,55.22088353413655,40.36144578313253,3.91566265060241,0.4016064257028112,0.1004016064257028
7,부산광역시,서구,동대신제2동,동대신제2동제1투,1383,971,205,698,59,4,0,966,5,412,21.22153209109731,72.2567287784679,6.107660455486543,0.4140786749482402,0.0
8,부산광역시,서구,동대신제2동,동대신제2동제2투,1267,820,210,570,30,2,2,814,6,447,25.7985257985258,70.02457002457002,3.6855036855036856,0.2457002457002457,0.2457002457002457
9,부산광역시,서구,동대신제2동,동대신제2동제3투,1232,762,195,522,35,5,2,759,3,470,25.691699604743086,68.77470355731225,4.61133069828722,0.6587615283267457,0.2635046113306983
10,부산광역시,서구,동대신제3동,관내사전투표,1941,1941,1032,738,133,13,2,1918,23,0,53.80604796663191,38.47758081334723,6.934306569343065,0.6777893639207508,0.10427528675703858
11,부산광역시,서구,동대신제3동,동대신제3동제1투,2375,1637,472,994,135,20,2,1623,14,738,29.081947011706717,61.244608749229826,8.317929759704251,1.2322858903265557,0.12322858903265559
12,부산광역시,서구,동대신제3동,동대신제3동제2투,1767,1228,312,837,66,7,0,1222,6,539,25.53191489361702,68.49427168576105,5.400981996726677,0.5728314238952537,0.0
13,부산광역시,서구,서대신제1동,관내사전투표,2544,2544,1438,908,156,21,3,2526,18,0,56.927949326999205,35.94615993665875,6.175771971496437,0.831353919239905,0.11876484560570072
14,부산광역시,서구,서대신제1동,서대신제1동제1투,2650,1995,621,1161,184,16,2,1984,11,655,31.30040322580645,58.51814516129033,9.274193548387096,0.8064516129032258,0.10080645161290322
15,부산광역시,서구,서대신제1동,서대신제1동제2투,905,562,128,401,20,7,1,557,5,343,22.980251346499102,71.99281867145422,3.5906642728904847,1.2567324955116697,0.17953321364452424
16,부산광역시,서구,서대신제1동,서대신제1동제3투,2227,1425,369,950,88,10,1,1418,7,802,26.02256699576869,66.99576868829337,6.205923836389281,0.7052186177715092,0.07052186177715092
17,부산광역시,서구,서대신제1동,서대신제1동제4투,2610,1998,656,1146,163,17,3,1985,13,612,33.04785894206549,57.73299748110831,8.211586901763223,0.8564231738035265,0.15113350125944583
18,부산광역시,서구,서대신제3동,관내사전투표,1659,1659,925,609,109,7,0,1650,9,0,56.060606060606055,36.90909090909091,6.6060606060606055,0.4242424242424243,0.0
19,부산광역시,서구,서대신제3동,서대신제3동제1투,2353,1645,414,1104,97,16,1,1632,13,708,25.36764705882353,67.64705882352942,5.943627450980392,0.9803921568627451,0.061274509803921566
20,부산광역시,서구,서대신제3동,서대신제3동제2투,1461,982,268,630,64,8,2,972,10,479,27.572016460905353,64.81481481481481,6.584362139917696,0.823045267489712,0.205761316872428
21,부산광역시,서구,서대신제4동,관내사전투표,1534,1534,912,507,85,17,2,1523,11,0,59.88181221273802,33.28956007879186,5.581089954038083,1.1162179908076166,0.13131976362442546
22,부산광역시,서구,서대신제4동,서대신제4동제1투,1187,854,262,501,78,7,0,848,6,333,30.89622641509434,59.08018867924528,9.19811320754717,0.8254716981132075,0.0
23,부산광역시,서구,서대신제4동,서대신제4동제2투,2142,1550,437,989,104,14,2,1546,4,592,28.266494178525225,63.97153945666235,6.727037516170762,0.9055627425614489,0.129366106080207
24,부산광역시,서구,서대신제4동,서대신제4동제3투,465,319,91,207,13,3,1,315,4,146,28.888888888888886,65.71428571428571,4.1269841269841265,0.9523809523809524,0.31746031746031744
25,부산광역시,서구,부민동,관내사전투표,1931,1931,1045,635,206,25,3,1914,17,0,54.59770114942529,33.176593521421104,10.762800417972832,1.3061650992685474,0.1567398119122257
26,부산광역시,서구,부민동,부민동제1투,2305,1548,386,993,143,12,0,1534,14,757,25.16297262059974,64.73272490221643,9.322033898305085,0.7822685788787485,0.0
27,부산광역시,서구,부민동,부민동제2투,1933,1292,302,860,101,11,0,1274,18,641,23.704866562009418,67.50392464678178,7.927786499215071,0.8634222919937204,0.0
28,부산광역시,서구,아미동,관내사전투표,1019,1019,520,421,62,6,0,1009,10,0,51.536174430128845,41.72447968285431,6.144697720515362,0.5946481665014867,0.0
29,부산광역시,서구,아미동,아미동제1투,1768,983,228,675,59,7,2,971,12,785,23.480947476828014,69.51596292481977,6.07621009268795,0.7209062821833162,0.20597322348094746
30,부산광역시,서구,아미동,아미동제2투,1051,550,136,390,18,1,0,545,5,501,24.954128440366972,71.55963302752293,3.302752293577982,0.1834862385321101,0.0
31,부산광역시,서구,아미동,아미동제3투,1419,961,289,571,78,10,1,949,12,458,30.453108535300316,60.168598524762906,8.21917808219178,1.053740779768177,0.10537407797681769
32,부산광역시,서구,초장동,관내사전투표,699,699,303,364,21,7,0,695,4,0,43.597122302158276,52.37410071942447,3.0215827338129495,1.0071942446043165,0.0
33,부산광역시,서구,초장동,초장동제1투,1347,740,163,540,29,3,0,735,5,607,22.176870748299322,73.46938775510205,3.9455782312925165,0.40816326530612246,0.0
34,부산광역시,서구,초장동,초장동제2투,922,492,110,357,17,4,0,488,4,430,22.540983606557376,73.15573770491804,3.483606557377049,0.819672131147541,0.0
35,부산광역시,서구,충무동,관내사전투표,2354,2354,1151,1014,144,22,4,2335,19,0,49.29336188436831,43.42612419700214,6.167023554603855,0.9421841541755889,0.17130620985010706
36,부산광역시,서구,충무동,충무동제1투,3243,2015,450,1402,135,14,0,2001,14,1228,22.488755622188904,70.06496751624188,6.746626686656672,0.6996501749125438,0.0
37,부산광역시,서구,충무동,충무동제2투,2591,1594,344,1135,84,16,2,1581,13,997,21.758380771663504,71.7900063251107,5.313092979127135,1.0120177103099304,0.1265022137887413
38,부산광역시,서구,남부민제1동,관내사전투표,957,957,428,482,36,8,0,954,3,0,44.863731656184484,50.524109014675055,3.7735849056603774,0.8385744234800839,0.0
39,부산광역시,서구,남부민제1동,남부민제1동제1투,1950,1276,311,889,60,7,0,1267,9,674,24.546172059984215,70.1657458563536,4.73559589581689,0.5524861878453038,0.0
40,부산광역시,서구,남부민제1동,남부민제1동제2투,957,551,131,391,21,1,1,545,6,406,24.036697247706424,71.74311926605505,3.853211009174312,0.1834862385321101,0.1834862385321101
41,부산광역시,서구,남부민제2동,관내사전투표,1270,1270,672,524,51,4,1,1252,18,0,53.674121405750796,41.853035143769965,4.073482428115016,0.3194888178913738,0.07987220447284345
42,부산광역시,서구,남부민제2동,남부민제2동제1투,1796,1099,297,736,49,8,0,1090,9,697,27.247706422018346,67.52293577981652,4.495412844036697,0.7339449541284404,0.0
43,부산광역시,서구,남부민제2동,남부민제2동제2투,1021,593,155,414,19,1,0,589,4,428,26.31578947368421,70.28862478777589,3.225806451612903,0.1697792869269949,0.0
44,부산광역시,서구,남부민제2동,남부민제2동제3투,1083,740,174,535,19,7,1,736,4,343,23.641304347826086,72.69021739130434,2.5815217391304346,0.9510869565217392,0.1358695652173913
45,부산광역시,서구,남부민제2동,남부민제2동제4투,1126,735,212,490,25,2,1,730,5,391,29.041095890410958,67.12328767123287,3.4246575342465753,0.273972602739726,0.136986301369863
46,부산광역시,서구,암남동,관내사전투표,2626,2626,1471,933,183,17,1,2605,21,0,56.468330134357004,35.815738963531665,7.024952015355086,0.6525911708253359,0.038387715930902115
47,부산광역시,서구,암남동,암남동제1투,2962,1919,458,1286,137,25,3,1909,10,1043,23.99161864850707,67.36511262441068,7.1765322158198,1.3095861707700367,0.1571503404924044
48,부산광역시,서구,암남동,암남동제2투,1038,731,252,407,44,12,0,715,16,307,35.24475524475525,56.92307692307692,6.153846153846154,1.6783216783216783,0.0
49,부산광역시,서구,암남동,암남동제3투,1112,733,243,423,49,13,1,729,4,379,33.33333333333333,58.0246913580247,6.721536351165981,1.7832647462277091,0.1371742112482853
50,부산광역시,서구,암남동,암남동제4투,1952,1234,347,785,85,11,0,1228,6,718,28.257328990228014,63.92508143322475,6.921824104234528,0.8957654723127036,0.0
51,부산광역시,서구,암남동,암남동제5투,3397,2281,608,1511,125,17,3,2264,17,1116,26.855123674911663,66.74028268551237,5.521201413427561,0.7508833922261484,0.13250883392226148
52,부산광역시,서구,잘못 투입·구분된 투표지,,0,0,0,0,0,0,0,0,0,0,0.0,0.0,0.0,0.0,0.0
0,부산광역시,동구,거소·선상투표,,168,163,69,69,21,2,1,162,1,5,42.592592592592595,42.592592592592595,12.962962962962962,1.2345679012345678,0.6172839506172839
1,부산광역시,동구,관외사전투표,,7479,7478,3899,2584,813,75,6,7377,101,1,52.853463467534226,35.02778907414938,11.02074013826759,1.01667344448963,0.08133387555917039
2,부산광역시,동구,재외투표,,425,306,220,57,25,3,0,305,1,119,72.1311475409836,18.688524590163937,8.19672131147541,0.9836065573770493,0.0
3,부산광역시,동구,초량제1동,관내사전투표,1071,1071,601,388,74,5,0,1068,3,0,56.27340823970037,36.329588014981276,6.928838951310862,0.46816479400749067,0.0
4,부산광역시,동구,초량제1동,초량제1동제1투,1976,1116,314,682,97,9,2,1104,12,860,28.442028985507246,61.77536231884058,8.78623188405797,0.8152173913043478,0.18115942028985507
5,부산광역시,동구,초량제1동,초량제1동제2투,834,539,122,387,20,4,0,533,6,295,22.88930581613508,72.6078799249531,3.75234521575985,0.7504690431519699,0.0
6,부산광역시,동구,초량제2동,관내사전투표,1284,1284,629,554,81,9,1,1274,10,0,49.37205651491366,43.4850863422292,6.357927786499215,0.7064364207221351,0.07849293563579278
7,부산광역시,동구,초량제2동,초량제2동제1투,1841,1074,214,795,52,4,0,1065,9,767,20.093896713615024,74.64788732394366,4.882629107981221,0.3755868544600939,0.0
8,부산광역시,동구,초량제2동,초량제2동제2투,1265,773,182,548,28,6,1,765,8,492,23.79084967320261,71.63398692810458,3.6601307189542487,0.7843137254901961,0.130718954248366
9,부산광역시,동구,초량제3동,관내사전투표,2517,2517,1445,809,236,17,1,2508,9,0,57.61562998405104,32.25677830940989,9.409888357256778,0.6778309409888358,0.03987240829346093
10,부산광역시,동구,초량제3동,초량제3동제1투,2409,1632,499,970,132,16,5,1622,10,777,30.764488286066584,59.80271270036991,8.138101109741061,0.9864364981504316,0.3082614056720099
11,부산광역시,동구,초량제3동,초량제3동제2투,1785,1286,458,675,133,5,4,1275,11,499,35.92156862745098,52.94117647058824,10.431372549019608,0.39215686274509803,0.3137254901960784
12,부산광역시,동구,초량제3동,초량제3동제3투,2620,1629,456,1020,122,18,3,1619,10,991,28.16553428042001,63.001852995676344,7.535515750463249,1.1117974058060531,0.1852995676343422
13,부산광역시,동구,초량제6동,관내사전투표,1217,1217,579,581,44,3,3,1210,7,0,47.85123966942149,48.01652892561983,3.6363636363636362,0.24793388429752067,0.24793388429752067
14,부산광역시,동구,초량제6동,초량제6동제1투,1678,987,239,691,45,5,0,980,7,691,24.387755102040817,70.51020408163265,4.591836734693878,0.5102040816326531,0.0
15,부산광역시,동구,초량제6동,초량제6동제2투,1517,920,220,653,36,3,0,912,8,597,24.12280701754386,71.60087719298247,3.9473684210526314,0.3289473684210526,0.0
16,부산광역시,동구,수정제1동,관내사전투표,1270,1270,603,562,92,6,1,1264,6,0,47.70569620253164,44.462025316455694,7.2784810126582276,0.4746835443037975,0.07911392405063292
17,부산광역시,동구,수정제1동,수정제1동제1투,1013,593,149,381,47,6,1,584,9,420,25.51369863013699,65.23972602739725,8.047945205479452,1.0273972602739725,0.17123287671232876
18,부산광역시,동구,수정제1동,수정제1동제2투,1210,792,230,499,53,3,1,786,6,418,29.262086513994912,63.48600508905853,6.743002544529262,0.38167938931297707,0.1272264631043257
19,부산광역시,동구,수정제2동,관내사전투표,2500,2500,1342,976,148,17,2,2485,15,0,54.00402414486921,39.27565392354125,5.955734406438632,0.6841046277665996,0.08048289738430583
20,부산광역시,동구,수정제2동,수정제2동제1투,2501,1717,433,1132,129,11,3,1708,9,784,25.35128805620609,66.27634660421545,7.552693208430913,0.6440281030444965,0.1756440281030445
21,부산광역시,동구,수정제2동,수정제2동제2투,1333,803,207,542,36,8,2,795,8,530,26.037735849056602,68.17610062893081,4.528301886792453,1.0062893081761006,0.25157232704402516
22,부산광역시,동구,수정제2동,수정제2동제3투,1576,1059,284,716,47,4,2,1053,6,517,26.970560303893638,67.99620132953467,4.46343779677113,0.3798670465337132,0.1899335232668566
23,부산광역시,동구,수정제4동,관내사전투표,758,758,355,359,37,5,0,756,2,0,46.95767195767196,47.48677248677249,4.894179894179894,0.6613756613756614,0.0
24,부산광역시,동구,수정제4동,수정제4동제1투,919,536,121,382,22,6,1,532,4,383,22.74436090225564,71.80451127819549,4.135338345864661,1.1278195488721803,0.18796992481203006
25,부산광역시,동구,수정제4동,수정제4동제2투,1067,679,156,495,21,3,2,677,2,388,23.042836041358935,73.11669128508123,3.10192023633678,0.4431314623338257,0.29542097488921715
26,부산광역시,동구,수정제5동,관내사전투표,1163,1163,570,524,52,9,0,1155,8,0,49.35064935064935,45.36796536796537,4.5021645021645025,0.7792207792207793,0.0
27,부산광역시,동구,수정제5동,수정제5동제1투,1298,835,222,566,37,5,2,832,3,463,26.682692307692307,68.02884615384616,4.447115384615385,0.6009615384615385,0.2403846153846154
28,부산광역시,동구,수정제5동,수정제5동제2투,1418,858,189,616,41,7,1,854,4,560,22.131147540983605,72.1311475409836,4.8009367681498825,0.819672131147541,0.117096018735363
29,부산광역시,동구,좌천동,관내사전투표,2327,2327,1241,934,106,21,4,2306,21,0,53.81613183000867,40.503035559410236,4.5967042497831745,0.9106678230702514,0.17346053772766695
30,부산광역시,동구,좌천동,좌천동제1투,2622,1701,456,1096,124,11,2,1689,12,921,26.99822380106572,64.89046773238603,7.341622261693309,0.6512729425695678,0.11841326228537595
31,부산광역시,동구,좌천동,좌천동제2투,1948,1276,285,916,59,8,0,1268,8,672,22.476340694006307,72.2397476340694,4.652996845425868,0.6309148264984227,0.0
32,부산광역시,동구,좌천동,좌천동제3투,1992,1242,342,807,71,8,1,1229,13,750,27.827502034174124,65.66314076484947,5.777054515866558,0.6509357200976403,0.08136696501220504
33,부산광역시,동구,범일제1동,관내사전투표,1689,1689,783,810,68,15,2,1678,11,0,46.662693682955904,48.27175208581645,4.052443384982122,0.8939213349225268,0.11918951132300357
34,부산광역시,동구,범일제1동,범일제1동제1투,3195,2195,636,1405,126,11,3,2181,14,1000,29.160935350756535,64.41999082989454,5.777166437414031,0.504355800091701,0.1375515818431912
35,부산광역시,동구,범일제1동,범일제1동제2투,1600,1002,235,689,57,6,3,990,12,598,23.737373737373737,69.5959595959596,5.757575757575758,0.6060606060606061,0.30303030303030304
36,부산광역시,동구,범일제1동,범일제1동제3투,2014,1167,262,849,39,6,2,1158,9,847,22.625215889464595,73.31606217616581,3.3678756476683938,0.5181347150259068,0.17271157167530224
37,부산광역시,동구,범일제2동,관내사전투표,1926,1926,1084,696,122,10,1,1913,13,0,56.66492420282279,36.382645060115,6.3774176685833766,0.5227391531625719,0.052273915316257184
38,부산광역시,동구,범일제2동,범일제2동제1투,1115,619,117,468,26,1,1,613,6,496,19.086460032626427,76.3458401305057,4.241435562805873,0.1631321370309951,0.1631321370309951
39,부산광역시,동구,범일제2동,범일제2동제2투,1803,1147,302,723,101,12,0,1138,9,656,26.537785588752193,63.53251318101933,8.875219683655535,1.054481546572935,0.0
40,부산광역시,동구,범일제2동,범일제2동제3투,1492,1116,295,726,77,9,1,1108,8,376,26.624548736462096,65.52346570397111,6.949458483754513,0.8122743682310468,0.09025270758122744
41,부산광역시,동구,범일제5동,관내사전투표,957,957,559,333,56,7,0,955,2,0,58.53403141361257,34.86910994764398,5.863874345549738,0.7329842931937173,0.0
42,부산광역시,동구,범일제5동,범일제5동제1투,4043,2988,945,1734,263,27,0,2969,19,1055,31.828898619063654,58.40350286291681,8.858201414617717,0.9093971034018189,0.0
43,부산광역시,동구,범일제5동,범일제5동제2투,1058,725,195,476,45,3,1,720,5,333,27.083333333333332,66.11111111111111,6.25,0.4166666666666667,0.1388888888888889
44,부산광역시,동구,잘못 투입·구분된 투표지,,0,0,0,0,0,0,0,0,0,0,0.0,0.0,0.0,0.0,0.0
0,부산광역시,영도구,거소·선상투표,,294,284,122,101,37,3,6,269,15,10,45.353159851301115,37.54646840148699,13.754646840148698,1.1152416356877324,2.2304832713754648
1,부산광역시,영도구,관외사전투표,,7317,7317,3927,2408,834,65,9,7243,74,0,54.21786552533481,33.24589258594505,11.514565787657048,0.897418196879746,0.12425790418334944
2,부산광역시,영도구,재외투표,,531,411,301,76,31,3,0,411,0,120,73.2360097323601,18.491484184914842,7.542579075425791,0.7299270072992701,0.0
3,부산광역시,영도구,남항동,관내사전투표,2485,2485,1325,1027,106,13,2,2473,12,0,53.57864941366761,41.528507885159726,4.286291953093409,0.5256773150020219,0.08087343307723413
4,부산광역시,영도구,남항동,남항동제1투,1989,1243,384,796,46,8,0,1234,9,746,31.118314424635336,64.50567260940032,3.727714748784441,0.6482982171799028,0.0
5,부산광역시,영도구,남항동,남항동제2투,1607,1025,302,672,33,6,3,1016,9,582,29.7244094488189,66.14173228346458,3.2480314960629917,0.5905511811023622,0.2952755905511811
6,부산광역시,영도구,남항동,남항동제3투,2715,1567,434,1028,79,10,2,1553,14,1148,27.945911139729557,66.19446233097231,5.086928525434643,0.643915003219575,0.128783000643915
7,부산광역시,영도구,영선제1동,관내사전투표,951,951,571,329,40,5,1,946,5,0,60.35940803382663,34.77801268498943,4.2283298097251585,0.5285412262156448,0.10570824524312897
8,부산광역시,영도구,영선제1동,영선제1동투표소,1995,1207,326,802,59,13,0,1200,7,788,27.166666666666668,66.83333333333333,4.916666666666666,1.0833333333333335,0.0
9,부산광역시,영도구,영선제2동,관내사전투표,2997,2997,1652,1192,122,16,2,2984,13,0,55.36193029490617,39.946380697050934,4.088471849865952,0.5361930294906166,0.06702412868632708
10,부산광역시,영도구,영선제2동,영선제2동제1투,2050,1371,384,880,85,9,1,1359,12,679,28.2560706401766,64.75349521707138,6.254598969830758,0.6622516556291391,0.07358351729212656
11,부산광역시,영도구,영선제2동,영선제2동제2투,2169,1341,368,886,62,11,2,1329,12,828,27.689992475545523,66.66666666666666,4.6651617757712565,0.8276899924755455,0.15048908954100826
12,부산광역시,영도구,신선동,관내사전투표,1241,1241,686,502,40,6,0,1234,7,0,55.59157212317666,40.680713128038896,3.2414910858995136,0.48622366288492713,0.0
13,부산광역시,영도구,신선동,신선동제1투,1152,613,169,410,21,4,0,604,9,539,27.980132450331123,67.88079470198676,3.47682119205298,0.6622516556291391,0.0
14,부산광역시,영도구,신선동,신선동제2투,1306,732,185,504,35,5,0,729,3,574,25.377229080932786,69.1358024691358,4.801097393689986,0.6858710562414266,0.0
15,부산광역시,영도구,신선동,신선동제3투,933,556,193,328,25,4,1,551,5,377,35.027223230490016,59.528130671506354,4.537205081669692,0.7259528130671506,0.18148820326678766
16,부산광역시,영도구,신선동,신선동제4투,751,335,87,227,9,6,1,330,5,416,26.36363636363636,68.78787878787878,2.727272727272727,1.8181818181818181,0.30303030303030304
17,부산광역시,영도구,봉래제1동,관내사전투표,2054,2054,1104,844,77,11,0,2036,18,0,54.223968565815326,41.45383104125737,3.781925343811395,0.5402750491159135,0.0
18,부산광역시,영도구,봉래제1동,봉래제1동제1투,1863,1237,357,808,52,10,1,1228,9,626,29.07166123778502,65.79804560260585,4.234527687296417,0.8143322475570033,0.08143322475570033
19,부산광역시,영도구,봉래제1동,봉래제1동제2투,1672,979,275,610,77,12,0,974,5,693,28.234086242299796,62.62833675564682,7.905544147843943,1.2320328542094456,0.0
20,부산광역시,영도구,봉래제2동,관내사전투표,1465,1465,890,480,79,10,1,1460,5,0,60.95890410958904,32.87671232876712,5.410958904109589,0.684931506849315,0.0684931506849315
21,부산광역시,영도구,봉래제2동,봉래제2동제1투,2166,1491,555,814,107,7,1,1484,7,675,37.3989218328841,54.851752021563335,7.210242587601077,0.4716981132075472,0.06738544474393532
22,부산광역시,영도구,봉래제2동,봉래제2동제2투,2034,1206,402,729,60,8,0,1199,7,828,33.527939949958295,60.80066722268557,5.004170141784821,0.6672226855713094,0.0
23,부산광역시,영도구,청학제1동,관내사전투표,1070,1070,606,417,36,4,1,1064,6,0,56.954887218045116,39.19172932330827,3.3834586466165413,0.37593984962406013,0.09398496240601503
24,부산광역시,영도구,청학제1동,청학제1동제1투,1857,1172,400,704,56,8,0,1168,4,685,34.24657534246575,60.273972602739725,4.794520547945205,0.684931506849315,0.0
25,부산광역시,영도구,청학제1동,청학제1동제2투,1268,750,242,468,29,4,0,743,7,518,32.5706594885599,62.98788694481831,3.9030955585464335,0.5383580080753702,0.0
26,부산광역시,영도구,청학제2동,관내사전투표,2509,2509,1568,775,132,15,3,2493,16,0,62.89610910549539,31.087043722422784,5.294825511432009,0.601684717208183,0.12033694344163659
27,부산광역시,영도구,청학제2동,청학제2동제1투,1910,1290,446,776,59,6,0,1287,3,620,34.654234654234656,60.2952602952603,4.584304584304584,0.4662004662004662,0.0
28,부산광역시,영도구,청학제2동,청학제2동제2투,1915,1210,384,740,71,6,0,1201,9,705,31.973355537052456,61.61532056619484,5.911740216486262,0.4995836802664446,0.0
29,부산광역시,영도구,청학제2동,청학제2동제3투,1920,1141,366,703,56,8,1,1134,7,779,32.27513227513227,61.99294532627866,4.938271604938271,0.7054673721340388,0.08818342151675485
30,부산광역시,영도구,청학제2동,청학제2동제4투,2215,1423,480,856,72,9,0,1417,6,792,33.87438249823571,60.40931545518702,5.081157374735357,0.6351446718419196,0.0
31,부산광역시,영도구,청학제2동,청학제2동제5투,1937,1270,387,794,60,16,1,1258,12,667,30.763116057233702,63.11605723370429,4.769475357710652,1.2718600953895072,0.0794912559618442
32,부산광역시,영도구,동삼제1동,관내사전투표,5460,5460,3188,1956,254,27,7,5432,28,0,58.68924889543447,36.00883652430044,4.6759941089838,0.4970544918998527,0.12886597938144329
33,부산광역시,영도구,동삼제1동,동삼제1동제1투,1667,1044,355,620,55,6,2,1038,6,623,34.200385356454724,59.73025048169557,5.298651252408478,0.5780346820809248,0.1926782273603083
34,부산광역시,영도구,동삼제1동,동삼제1동제2투,1901,1074,319,656,84,7,0,1066,8,827,29.924953095684803,61.53846153846154,7.879924953095685,0.6566604127579738,0.0
35,부산광역시,영도구,동삼제1동,동삼제1동제3투,3032,2008,680,1166,130,15,2,1993,15,1024,34.119417962870045,58.50476668339187,6.522829904666332,0.7526342197691922,0.10035122930255895
36,부산광역시,영도구,동삼제1동,동삼제1동제4투,2761,1887,633,1091,132,14,3,1873,14,874,33.79604911906033,58.24879871863321,7.0475173518419645,0.7474639615589963,0.16017084890549918
37,부산광역시,영도구,동삼제1동,동삼제1동제5투,1781,1169,359,713,78,10,2,1162,7,612,30.89500860585198,61.35972461273666,6.712564543889846,0.8605851979345954,0.17211703958691912
38,부산광역시,영도구,동삼제1동,동삼제1동제6투,1771,1130,327,735,49,14,0,1125,5,641,29.06666666666667,65.33333333333333,4.355555555555555,1.2444444444444445,0.0
39,부산광역시,영도구,동삼제1동,동삼제1동제7투,1356,656,162,460,29,3,0,654,2,700,24.770642201834864,70.33639143730886,4.434250764525994,0.45871559633027525,0.0
40,부산광역시,영도구,동삼제1동,동삼제1동제8투,1617,1019,336,624,50,4,2,1016,3,598,33.07086614173229,61.417322834645674,4.921259842519685,0.39370078740157477,0.19685039370078738
41,부산광역시,영도구,동삼제2동,관내사전투표,1707,1707,1024,470,188,12,5,1699,8,0,60.27074749852854,27.66333137139494,11.065332548557976,0.7062978222483813,0.2942907592701589
42,부산광역시,영도구,동삼제2동,동삼제2동투표소,2716,1657,458,1034,141,13,1,1647,10,1059,27.808136004857314,62.78081360048573,8.561020036429873,0.7893139040680024,0.060716454159077116
43,부산광역시,영도구,동삼제3동,관내사전투표,2391,2391,1344,899,106,22,4,2375,16,0,56.589473684210525,37.852631578947374,4.463157894736842,0.9263157894736843,0.16842105263157894
44,부산광역시,영도구,동삼제3동,동삼제3동제1투,1276,805,223,515,53,5,1,797,8,471,27.97992471769134,64.61731493099123,6.649937264742785,0.6273525721455459,0.12547051442910914
45,부산광역시,영도구,동삼제3동,동삼제3동제2투,1367,793,239,516,30,1,1,787,6,574,30.368487928843713,65.56543837357052,3.8119440914866582,0.12706480304955528,0.12706480304955528
46,부산광역시,영도구,동삼제3동,동삼제3동제3투,1326,687,173,476,24,3,0,676,11,639,25.591715976331358,70.41420118343196,3.5502958579881656,0.4437869822485207,0.0
47,부산광역시,영도구,동삼제3동,동삼제3동제4투,1442,912,264,600,43,5,0,912,0,530,28.947368421052634,65.78947368421053,4.714912280701754,0.5482456140350876,0.0
48,부산광역시,영도구,잘못 투입·구분된 투표지,,0,0,0,0,0,0,0,0,0,0,0.0,0.0,0.0,0.0,0.0
0,부산광역시,부산진구,거소·선상투표,,644,613,225,247,116,5,3,596,17,31,37.75167785234899,41.442953020134226,19.463087248322147,0.8389261744966443,0.5033557046979865
1,부산광역시,부산진구,관외사전투표,,29918,29915,15906,9450,3855,345,40,29596,319,3,53.743749155291255,31.92999053926206,13.025408839032302,1.1656980673063928,0.13515339910798757
2,부산광역시,부산진구,재외투표,,1398,1123,773,214,105,21,1,1114,9,275,69.38958707360861,19.210053859964095,9.425493716337522,1.8850987432675044,0.08976660682226212
3,부산광역시,부산진구,부전제1동,관내사전투표,3755,3755,1987,1440,281,25,4,3737,18,0,53.17099277495318,38.53358308803853,7.51940058870752,0.668985817500669,0.10703773080010703
4,부산광역시,부산진구,부전제1동,부전제1동제1투,2732,1395,314,942,112,9,3,1380,15,1337,22.753623188405797,68.26086956521739,8.115942028985506,0.6521739130434783,0.21739130434782608
5,부산광역시,부산진구,부전제1동,부전제1동제2투,4257,2400,633,1420,288,24,5,2370,30,1857,26.708860759493668,59.91561181434599,12.151898734177214,1.0126582278481013,0.21097046413502107
6,부산광역시,부산진구,부전제1동,부전제1동제3투,2556,1759,460,1093,184,9,2,1748,11,797,26.31578947368421,62.52860411899314,10.526315789473683,0.5148741418764302,0.11441647597254005
7,부산광역시,부산진구,부전제2동,관내사전투표,2430,2430,1349,708,318,20,8,2403,27,0,56.13816063254266,29.463171036204745,13.2334581772784,0.8322929671244279,0.3329171868497711
8,부산광역시,부산진구,부전제2동,부전제2동제1투,3277,1867,497,1160,178,19,1,1855,12,1410,26.79245283018868,62.53369272237197,9.59568733153639,1.0242587601078168,0.05390835579514825
9,부산광역시,부산진구,부전제2동,부전제2동제2투,2626,1150,253,687,188,11,0,1139,11,1476,22.21246707638279,60.31606672519754,16.505706760316066,0.9657594381035997,0.0
10,부산광역시,부산진구,부전제2동,부전제2동제3투,2529,2028,533,1355,127,6,0,2021,7,501,26.373082632360216,67.04601682335478,6.28401781296388,0.29688273132112813,0.0
11,부산광역시,부산진구,연지동,관내사전투표,4502,4502,2637,1505,290,47,4,4483,19,0,58.822217265224175,33.57126923934865,6.468882444791434,1.0484050858799911,0.08922596475574393
12,부산광역시,부산진구,연지동,연지동제1투,2514,2005,727,1140,118,17,1,2003,2,509,36.2955566650025,56.91462805791313,5.891163255117323,0.8487269096355468,0.04992511233150275
13,부산광역시,부산진구,연지동,연지동제2투,2197,1530,348,1072,89,13,0,1522,8,667,22.864651773981603,70.43363994743758,5.847568988173456,0.8541392904073587,0.0
14,부산광역시,부산진구,연지동,연지동제3투,1762,1144,236,839,51,9,2,1137,7,618,20.756376429199648,73.79067722075638,4.485488126649076,0.79155672823219,0.1759014951627089
15,부산광역시,부산진구,연지동,연지동제4투,2576,1790,483,1160,110,21,1,1775,15,786,27.211267605633804,65.35211267605634,6.197183098591549,1.1830985915492958,0.056338028169014086
16,부산광역시,부산진구,연지동,연지동제5투,2318,1694,512,1055,106,12,3,1688,6,624,30.33175355450237,62.5,6.279620853080568,0.7109004739336493,0.17772511848341233
17,부산광역시,부산진구,연지동,연지동제6투,3468,2674,918,1505,215,22,2,2662,12,794,34.48534936138242,56.53643876784372,8.07663410969196,0.8264462809917356,0.07513148009015778
18,부산광역시,부산진구,초읍동,관내사전투표,4159,4159,2315,1557,229,27,5,4133,26,0,56.012581659811275,37.67239293491411,5.540769416888459,0.6532784902008226,0.12097749818533754
19,부산광역시,부산진구,초읍동,초읍동제1투,2939,2170,717,1289,131,15,1,2153,17,769,33.30236878773804,59.86994890849977,6.0845332094751505,0.6967022758941013,0.046446818392940084
20,부산광역시,부산진구,초읍동,초읍동제2투,2213,1585,339,1174,52,5,1,1571,14,628,21.578612348822407,74.72947167409293,3.3099936346276255,0.31826861871419476,0.06365372374283895
21,부산광역시,부산진구,초읍동,초읍동제3투,1565,990,197,752,34,3,0,986,4,575,19.97971602434077,76.26774847870182,3.4482758620689653,0.3042596348884381,0.0
22,부산광역시,부산진구,초읍동,초읍동제4투,1598,1103,280,752,57,8,0,1097,6,495,25.52415679124886,68.55059252506837,5.195989061075661,0.7292616226071102,0.0
23,부산광역시,부산진구,초읍동,초읍동제5투,2377,1555,459,982,87,15,3,1546,9,822,29.689521345407506,63.518758085381634,5.627425614489004,0.9702457956015523,0.19404915912031048
24,부산광역시,부산진구,초읍동,초읍동제6투,2849,2020,579,1281,132,9,1,2002,18,829,28.92107892107892,63.98601398601399,6.593406593406594,0.4495504495504496,0.04995004995004995
25,부산광역시,부산진구,양정제1동,관내사전투표,4314,4314,2470,1440,336,26,2,4274,40,0,57.79129620963969,33.69209171736078,7.861488067384183,0.6083294337856809,0.04679457182966776
26,부산광역시,부산진구,양정제1동,양정제1동제1투,1477,956,246,631,68,5,0,950,6,521,25.894736842105264,66.42105263157895,7.157894736842104,0.5263157894736842,0.0
27,부산광역시,부산진구,양정제1동,양정제1동제2투,2513,1976,582,1237,124,21,0,1964,12,537,29.633401221995925,62.983706720977594,6.313645621181263,1.0692464358452138,0.0
28,부산광역시,부산진구,양정제1동,양정제1동제3투,2844,2271,654,1434,146,25,0,2259,12,573,28.950863213811424,63.47941567065073,6.463036741921203,1.1066843736166445,0.0
29,부산광역시,부산진구,양정제1동,양정제1동제4투,2934,1904,458,1250,160,23,1,1892,12,1030,24.207188160676534,66.06765327695561,8.456659619450317,1.215644820295983,0.052854122621564484
30,부산광역시,부산진구,양정제1동,양정제1동제5투,1940,1239,285,820,103,12,4,1224,15,701,23.284313725490197,66.99346405228758,8.415032679738562,0.9803921568627451,0.32679738562091504
31,부산광역시,부산진구,양정제2동,관내사전투표,2129,2129,1260,625,204,24,0,2113,16,0,59.630856601987695,29.578797917652626,9.654519640321817,1.135825840037861,0.0
32,부산광역시,부산진구,양정제2동,양정제2동제1투,2887,1688,505,958,188,16,1,1668,20,1199,30.2757793764988,57.434052757793765,11.270983213429256,0.9592326139088728,0.05995203836930455
33,부산광역시,부산진구,양정제2동,양정제2동제2투,3587,2309,684,1376,185,24,6,2275,34,1278,30.065934065934062,60.48351648351649,8.131868131868131,1.054945054945055,0.26373626373626374
34,부산광역시,부산진구,양정제2동,양정제2동제3투,2234,1482,401,906,151,15,0,1473,9,752,27.22335369993211,61.5071283095723,10.251188051595383,1.0183299389002036,0.0
35,부산광역시,부산진구,양정제2동,양정제2동제4투,3006,2306,794,1202,268,29,1,2294,12,700,34.612031386224935,52.39755884917175,11.682650392327812,1.264167393199651,0.043591979075850044
36,부산광역시,부산진구,전포제1동,관내사전투표,3688,3688,2006,1219,389,31,3,3648,40,0,54.989035087719294,33.415570175438596,10.663377192982457,0.849780701754386,0.08223684210526315
37,부산광역시,부산진구,전포제1동,전포제1동제1투,2838,1500,353,940,172,13,5,1483,17,1338,23.803101820633852,63.38503034389751,11.59811193526635,0.8766014834794336,0.33715441672285906
38,부산광역시,부산진구,전포제1동,전포제1동제2투,2109,1307,350,847,81,12,2,1292,15,802,27.089783281733748,65.55727554179566,6.269349845201239,0.9287925696594427,0.15479876160990713
39,부산광역시,부산진구,전포제1동,전포제1동제3투,2961,1667,478,929,219,18,1,1645,22,1294,29.05775075987842,56.474164133738604,13.31306990881459,1.094224924012158,0.060790273556231005
40,부산광역시,부산진구,전포제1동,전포제1동제4투,2122,1313,341,859,94,11,0,1305,8,809,26.130268199233715,65.82375478927203,7.203065134099616,0.8429118773946359,0.0
41,부산광역시,부산진구,전포제1동,전포제1동제5투,2647,2046,693,1068,240,22,3,2026,20,601,34.205330700888446,52.7147087857848,11.846001974333662,1.085883514313919,0.14807502467917077
42,부산광역시,부산진구,전포제2동,관내사전투표,3563,3563,2026,1237,242,28,1,3534,29,0,57.328805885681945,35.00282965478211,6.847764572722127,0.7923033389926429,0.028296547821165818
43,부산광역시,부산진구,전포제2동,전포제2동제1투,2587,1604,389,1096,96,12,0,1593,11,983,24.419334588826114,68.80100439422473,6.0263653483992465,0.7532956685499058,0.0
44,부산광역시,부산진구,전포제2동,전포제2동제2투,3787,2832,956,1539,284,28,3,2810,22,955,34.021352313167256,54.768683274021356,10.1067615658363,0.99644128113879,0.10676156583629894
45,부산광역시,부산진구,전포제2동,전포제2동제3투,2280,1616,465,1040,85,16,0,1606,10,664,28.953922789539227,64.75716064757161,5.292652552926526,0.9962640099626401,0.0
46,부산광역시,부산진구,전포제2동,전포제2동제4투,1917,1232,295,850,71,5,1,1222,10,685,24.14075286415712,69.55810147299509,5.810147299509002,0.4091653027823241,0.08183306055646482
47,부산광역시,부산진구,전포제2동,전포제2동제5투,3933,2440,624,1548,222,25,3,2422,18,1493,25.763831544178366,63.914120561519404,9.16597853014038,1.032204789430223,0.12386457473162675
48,부산광역시,부산진구,부암제1동,관내사전투표,3511,3511,2158,1067,245,29,2,3501,10,0,61.639531562410745,30.477006569551556,6.9980005712653535,0.8283347614967151,0.057126535275635534
49,부산광역시,부산진구,부암제1동,부암제1동제1투,2093,1272,331,802,111,12,0,1256,16,821,26.35350318471338,63.853503184713375,8.837579617834395,0.9554140127388535,0.0
50,부산광역시,부산진구,부암제1동,부암제1동제2투,2397,1810,686,945,142,22,2,1797,13,587,38.17473567056205,52.587646076794655,7.90205898720089,1.2242626599888704,0.11129660545353368
51,부산광역시,부산진구,부암제1동,부암제1동제3투,1975,1222,361,762,82,8,2,1215,7,753,29.7119341563786,62.71604938271606,6.748971193415638,0.6584362139917695,0.1646090534979424
52,부산광역시,부산진구,부암제1동,부암제1동제4투,3596,2471,725,1543,165,17,1,2451,20,1125,29.579763361893104,62.95389636882906,6.731946144430845,0.69359445124439,0.04079967360261118
53,부산광역시,부산진구,부암제1동,부암제1동제5투,3539,2484,746,1531,175,20,2,2474,10,1055,30.1535974130962,61.883589329021824,7.073565076798706,0.8084074373484237,0.08084074373484236
54,부산광역시,부산진구,부암제3동,관내사전투표,4366,4366,2663,1401,244,36,4,4348,18,0,61.24655013799448,32.221711131554734,5.611775528978841,0.8279668813247469,0.09199632014719411
55,부산광역시,부산진구,부암제3동,부암제3동제1투,3346,2129,506,1503,95,8,2,2114,15,1217,23.935666982024596,71.09744560075686,4.493850520340587,0.3784295175023652,0.0946073793755913
56,부산광역시,부산진구,부암제3동,부암제3동제2투,2545,1954,613,1187,126,12,1,1939,15,591,31.614234141309954,61.217122227952544,6.4981949458483745,0.6188757091284167,0.0515729757607014
57,부산광역시,부산진구,부암제3동,부암제3동제3투,1223,869,354,419,79,10,1,863,6,354,41.01969872537659,48.551564310544606,9.154113557358054,1.1587485515643106,0.11587485515643105
58,부산광역시,부산진구,부암제3동,부암제3동제4투,2630,2003,869,938,164,17,1,1989,14,627,43.6902966314731,47.15937657114127,8.24534942182001,0.8547008547008548,0.050276520864756154
59,부산광역시,부산진구,부암제3동,부암제3동제5투,3023,2321,909,1132,237,26,0,2304,17,702,39.453125,49.13194444444444,10.286458333333332,1.128472222222222,0.0
60,부산광역시,부산진구,당감제1동,관내사전투표,3606,3606,2097,1281,183,24,2,3587,19,0,58.46110956230833,35.71229439643156,5.1017563423473655,0.6690827989963758,0.05575689991636465
61,부산광역시,부산진구,당감제1동,당감제1동제1투,1738,1139,297,782,40,5,2,1126,13,599,26.376554174067497,69.44937833037301,3.5523978685612785,0.4440497335701598,0.17761989342806395
62,부산광역시,부산진구,당감제1동,당감제1동제2투,2168,1477,374,1008,68,16,0,1466,11,691,25.51159618008186,68.75852660300137,4.638472032742155,1.0914051841746248,0.0
63,부산광역시,부산진구,당감제1동,당감제1동제3투,1625,992,251,673,57,7,0,988,4,633,25.40485829959514,68.11740890688259,5.769230769230769,0.708502024291498,0.0
64,부산광역시,부산진구,당감제1동,당감제1동제4투,3193,2139,682,1266,153,23,2,2126,13,1054,32.07902163687677,59.54844778927564,7.196613358419568,1.0818438381937912,0.09407337723424271
65,부산광역시,부산진구,당감제1동,당감제1동제5투,2068,1627,620,890,92,14,1,1617,10,441,38.3426097711812,55.04019789734076,5.6895485466914035,0.8658008658008658,0.06184291898577613
66,부산광역시,부산진구,당감제1동,당감제1동제6투,2326,1819,718,928,147,14,2,1809,10,507,39.69043670536208,51.299060254284136,8.12603648424544,0.7739082365948038,0.11055831951354339
67,부산광역시,부산진구,당감제2동,관내사전투표,2939,2939,1664,965,265,17,4,2915,24,0,57.084048027444254,33.104631217838765,9.090909090909092,0.5831903945111492,0.13722126929674097
68,부산광역시,부산진구,당감제2동,당감제2동제1투,2605,1719,445,1089,155,12,1,1702,17,886,26.145710928319627,63.98354876615746,9.106933019976498,0.7050528789659225,0.05875440658049354
69,부산광역시,부산진구,당감제2동,당감제2동제2투,2560,1914,671,1059,159,11,2,1902,12,646,35.27865404837014,55.678233438485805,8.3596214511041,0.5783385909568874,0.10515247108307045
70,부산광역시,부산진구,당감제2동,당감제2동제3투,1908,1535,524,909,86,11,1,1531,4,373,34.225996080992815,59.37295885042456,5.6172436316133245,0.7184846505551926,0.06531678641410843
71,부산광역시,부산진구,당감제4동,관내사전투표,2554,2554,1574,816,132,18,4,2544,10,0,61.87106918238994,32.075471698113205,5.188679245283019,0.7075471698113208,0.15723270440251574
72,부산광역시,부산진구,당감제4동,당감제4동제1투,1091,669,174,456,29,9,0,668,1,422,26.047904191616766,68.26347305389223,4.341317365269461,1.347305389221557,0.0
73,부산광역시,부산진구,당감제4동,당감제4동제2투,1818,1124,324,727,56,6,1,1114,10,694,29.084380610412925,65.26032315978456,5.026929982046679,0.5385996409335727,0.08976660682226212
74,부산광역시,부산진구,당감제4동,당감제4동제3투,3071,2117,796,1158,137,16,1,2108,9,954,37.76091081593928,54.93358633776091,6.499051233396584,0.7590132827324478,0.04743833017077799
75,부산광역시,부산진구,가야제1동,관내사전투표,3521,3521,1897,1321,249,23,3,3493,28,0,54.30861723446894,37.81849413111938,7.128542799885486,0.6584597766962497,0.08588605782994561
76,부산광역시,부산진구,가야제1동,가야제1동제1투,1977,1295,377,835,60,10,1,1283,12,682,29.384255650818393,65.08183943881528,4.676539360872954,0.779423226812159,0.0779423226812159
77,부산광역시,부산진구,가야제1동,가야제1동제2투,2062,1269,391,779,73,13,4,1260,9,793,31.03174603174603,61.82539682539683,5.7936507936507935,1.0317460317460316,0.31746031746031744
78,부산광역시,부산진구,가야제1동,가야제1동제3투,1763,1171,337,757,65,10,0,1169,2,592,28.828058169375538,64.75620188195037,5.560307955517536,0.8554319931565441,0.0
79,부산광역시,부산진구,가야제1동,가야제1동제4투,1826,1202,306,769,105,9,1,1190,12,624,25.71428571428571,64.6218487394958,8.823529411764707,0.7563025210084033,0.08403361344537816
80,부산광역시,부산진구,가야제1동,가야제1동제5투,1353,860,239,546,61,6,1,853,7,493,28.01875732708089,64.00937866354045,7.151230949589683,0.7033997655334115,0.11723329425556857
81,부산광역시,부산진구,가야제1동,가야제1동제6투,1320,725,176,441,93,7,1,718,7,595,24.512534818941504,61.42061281337048,12.952646239554316,0.9749303621169917,0.1392757660167131
82,부산광역시,부산진구,가야제2동,관내사전투표,3093,3093,1699,1114,236,18,5,3072,21,0,55.305989583333336,36.26302083333333,7.682291666666667,0.5859375,0.16276041666666669
83,부산광역시,부산진구,가야제2동,가야제2동제1투,3607,2620,820,1574,186,19,3,2602,18,987,31.51421983089931,60.491929285165256,7.148347425057648,0.7302075326671791,0.11529592621060722
84,부산광역시,부산진구,가야제2동,가야제2동제2투,2344,1704,425,1136,120,13,1,1695,9,640,25.073746312684364,67.02064896755162,7.079646017699115,0.7669616519174041,0.058997050147492625
85,부산광역시,부산진구,가야제2동,가야제2동제3투,1887,1314,359,866,73,7,1,1306,8,573,27.488514548238896,66.3093415007657,5.5895865237366005,0.5359877488514548,0.0765696784073507
86,부산광역시,부산진구,가야제2동,가야제2동제4투,2681,1982,533,1284,136,13,2,1968,14,699,27.083333333333332,65.2439024390244,6.910569105691057,0.660569105691057,0.10162601626016261
87,부산광역시,부산진구,개금제1동,관내사전투표,4280,4280,2297,1536,385,21,3,4242,38,0,54.14898632720415,36.20933521923621,9.075907590759076,0.49504950495049505,0.07072135785007072
88,부산광역시,부산진구,개금제1동,개금제1동제1투,2651,1782,547,979,217,20,1,1764,18,869,31.00907029478458,55.498866213151935,12.3015873015873,1.1337868480725624,0.05668934240362812
89,부산광역시,부산진구,개금제1동,개금제1동제2투,2554,1650,462,1045,109,17,1,1634,16,904,28.274173806609546,63.95348837209303,6.670746634026928,1.040391676866585,0.06119951040391676
90,부산광역시,부산진구,개금제1동,개금제1동제3투,2640,1665,452,1042,142,16,3,1655,10,975,27.31117824773414,62.9607250755287,8.580060422960726,0.9667673716012084,0.18126888217522658
91,부산광역시,부산진구,개금제1동,개금제1동제4투,3162,2386,858,1313,169,27,2,2369,17,776,36.217813423385394,55.424229632756436,7.133811734909244,1.1397214014352046,0.08442380751371886
92,부산광역시,부산진구,개금제2동,관내사전투표,2309,2309,1276,828,170,18,0,2292,17,0,55.67190226876091,36.12565445026178,7.4171029668411865,0.7853403141361256,0.0
93,부산광역시,부산진구,개금제2동,개금제2동제1투,1809,1148,325,747,58,9,1,1140,8,661,28.50877192982456,65.52631578947368,5.087719298245614,0.7894736842105263,0.08771929824561403
94,부산광역시,부산진구,개금제2동,개금제2동제2투,1529,931,246,613,53,8,1,921,10,598,26.710097719869708,66.55808903365906,5.754614549402823,0.8686210640608035,0.10857763300760044
95,부산광역시,부산진구,개금제2동,개금제2동제3투,2383,1793,531,1070,162,19,1,1783,10,590,29.78126752664049,60.01121704991588,9.085810431856421,1.065619742007852,0.056085249579360626
96,부산광역시,부산진구,개금제3동,관내사전투표,3930,3930,2340,1345,192,19,5,3901,29,0,59.98461932837734,34.47833888746475,4.921814919251474,0.4870546013842604,0.12817226352217378
97,부산광역시,부산진구,개금제3동,개금제3동제1투,1469,917,221,635,47,8,1,912,5,552,24.232456140350877,69.62719298245614,5.1535087719298245,0.8771929824561403,0.10964912280701754
98,부산광역시,부산진구,개금제3동,개금제3동제2투,2069,1410,439,855,97,11,2,1404,6,659,31.267806267806268,60.89743589743589,6.908831908831909,0.7834757834757835,0.14245014245014245
99,부산광역시,부산진구,개금제3동,개금제3동제3투,2425,1752,598,999,118,22,3,1740,12,673,34.367816091954026,57.41379310344827,6.781609195402299,1.264367816091954,0.1724137931034483
100,부산광역시,부산진구,개금제3동,개금제3동제4투,2515,1960,760,1053,121,9,1,1944,16,555,39.09465020576132,54.166666666666664,6.224279835390947,0.4629629629629629,0.051440329218107
101,부산광역시,부산진구,개금제3동,개금제3동제5투,1717,1151,347,745,43,9,1,1145,6,566,30.305676855895197,65.06550218340611,3.755458515283843,0.7860262008733625,0.08733624454148471
102,부산광역시,부산진구,개금제3동,개금제3동제6투,2096,1470,412,941,97,9,1,1460,10,626,28.21917808219178,64.45205479452055,6.6438356164383565,0.6164383561643836,0.0684931506849315
103,부산광역시,부산진구,개금제3동,개금제3동제7투,2222,1798,581,1070,122,12,1,1786,12,424,32.53079507278835,59.910414333706605,6.83090705487122,0.6718924972004479,0.055991041433370664
104,부산광역시,부산진구,개금제3동,개금제3동제8투,2070,1646,548,950,116,18,2,1634,12,424,33.53733170134639,58.139534883720934,7.099143206854346,1.101591187270502,0.12239902080783352
105,부산광역시,부산진구,범천제1동,관내사전투표,2935,2935,1650,906,317,31,5,2909,26,0,56.72052251632863,31.14472327260227,10.897215537985563,1.0656583018219319,0.1718803712616019
106,부산광역시,부산진구,범천제1동,범천제1동제1투,3972,2479,628,1623,193,16,2,2462,17,1493,25.507717303005688,65.92201462225833,7.839155158407799,0.6498781478472786,0.08123476848090982
107,부산광역시,부산진구,범천제1동,범천제1동제2투,4066,2279,588,1382,261,18,2,2251,28,1787,26.12172367836517,61.39493558418481,11.594846734784541,0.7996446023989338,0.0888494002665482
108,부산광역시,부산진구,범천제2동,관내사전투표,3264,3263,1656,1373,192,21,2,3244,19,1,51.048088779284825,42.324290998766955,5.9186189889025895,0.6473489519112207,0.06165228113440197
109,부산광역시,부산진구,범천제2동,범천제2동제1투,2902,1880,533,1166,145,20,1,1865,15,1022,28.579088471849868,62.520107238605895,7.774798927613941,1.0723860589812333,0.05361930294906167
110,부산광역시,부산진구,범천제2동,범천제2동제2투,2323,1402,480,764,124,14,3,1385,17,921,34.65703971119133,55.162454873646205,8.953068592057761,1.0108303249097472,0.21660649819494585
111,부산광역시,부산진구,범천제2동,범천제2동제3투,1088,607,141,445,13,3,2,604,3,481,23.344370860927153,73.67549668874173,2.152317880794702,0.49668874172185434,0.33112582781456956
112,부산광역시,부산진구,범천제2동,범천제2동제4투,2277,1556,466,951,110,12,0,1539,17,721,30.27940220922677,61.79337231968811,7.147498375568551,0.7797270955165692,0.0
113,부산광역시,부산진구,범천제2동,범천제2동제5투,2167,1529,489,913,100,10,4,1516,13,638,32.25593667546175,60.224274406332455,6.596306068601583,0.6596306068601583,0.2638522427440633
114,부산광역시,부산진구,범천제2동,범천제2동제6투,2435,1750,539,1024,162,13,2,1740,10,685,30.977011494252878,58.85057471264368,9.310344827586208,0.7471264367816092,0.11494252873563218
115,부산광역시,부산진구,잘못 투입·구분된 투표지,,0,0,0,0,0,0,0,0,0,0,0.0,0.0,0.0,0.0,0.0
0,부산광역시,동래구,거소·선상투표,,428,410,153,167,70,3,1,394,16,18,38.83248730964467,42.38578680203046,17.766497461928935,0.7614213197969544,0.25380710659898476
1,부산광역시,동래구,관외사전투표,,24623,24623,13056,8030,3002,274,28,24390,233,0,53.53013530135301,32.92332923329233,12.308323083230832,1.1234112341123412,0.11480114801148011
2,부산광역시,동래구,재외투표,,1312,1060,695,246,95,14,3,1053,7,252,66.00189933523268,23.36182336182336,9.021842355175687,1.3295346628679963,0.2849002849002849
3,부산광역시,동래구,수민동,관내사전투표,4744,4744,2700,1628,344,41,6,4719,25,0,57.21551176096631,34.4988344988345,7.289680016952745,0.8688281415554142,0.12714558169103624
4,부산광역시,동래구,수민동,수민동제1투,2333,1515,399,986,100,12,2,1499,16,818,26.617745163442297,65.77718478985992,6.671114076050701,0.8005336891260841,0.13342228152101399
5,부산광역시,동래구,수민동,수민동제2투,3429,2492,768,1526,165,19,2,2480,12,937,30.967741935483872,61.532258064516135,6.653225806451612,0.7661290322580645,0.08064516129032258
6,부산광역시,동래구,수민동,수민동제3투,2445,1620,395,1121,81,8,1,1606,14,825,24.59526774595268,69.80074719800747,5.043586550435865,0.49813200498132004,0.062266500622665005
7,부산광역시,동래구,수민동,수민동제4투,2993,2257,739,1288,206,12,1,2246,11,736,32.90293855743544,57.34639358860196,9.17186108637578,0.5342831700801425,0.04452359750667854
8,부산광역시,동래구,수민동,수민동제5투,1616,1196,253,859,71,9,0,1192,4,420,21.2248322147651,72.06375838926175,5.956375838926174,0.7550335570469799,0.0
9,부산광역시,동래구,수민동,수민동제6투,2539,1922,612,1124,147,21,2,1906,16,617,32.10912906610703,58.97166841552991,7.712486883525709,1.1017838405036726,0.1049317943336831
10,부산광역시,동래구,수민동,수민동제7투,2297,1764,524,1095,110,23,2,1754,10,533,29.874572405929307,62.428734321550735,6.2713797035347785,1.3112884834663627,0.11402508551881414
11,부산광역시,동래구,복산동,관내사전투표,2721,2721,1478,1049,153,29,3,2712,9,0,54.498525073746315,38.67994100294985,5.641592920353982,1.0693215339233038,0.11061946902654868
12,부산광역시,동래구,복산동,복산동제1투,2913,2056,367,1577,71,24,1,2040,16,857,17.99019607843137,77.30392156862746,3.480392156862745,1.1764705882352942,0.049019607843137254
13,부산광역시,동래구,복산동,복산동제2투,2173,1426,331,1010,65,10,3,1419,7,747,23.32628611698379,71.1768851303735,4.580690627202255,0.7047216349541932,0.21141649048625794
14,부산광역시,동래구,명륜동,관내사전투표,4468,4468,2559,1466,368,45,6,4444,24,0,57.58325832583259,32.98829882988299,8.28082808280828,1.0126012601260126,0.135013501350135
15,부산광역시,동래구,명륜동,명륜동제1투,3374,2354,646,1505,169,16,3,2339,15,1020,27.618640444634458,64.34373663958957,7.225309961522018,0.6840530141085934,0.12825994014536127
16,부산광역시,동래구,명륜동,명륜동제2투,2101,1578,514,885,162,9,0,1570,8,523,32.738853503184714,56.36942675159236,10.318471337579618,0.5732484076433121,0.0
17,부산광역시,동래구,명륜동,명륜동제3투,3058,2274,594,1454,194,18,0,2260,14,784,26.28318584070796,64.3362831858407,8.584070796460178,0.7964601769911505,0.0
18,부산광역시,동래구,명륜동,명륜동제4투,1806,1270,387,789,76,7,2,1261,9,536,30.68992862807296,62.56938937351308,6.026962727993656,0.5551149881046789,0.1586042823156225
19,부산광역시,동래구,명륜동,명륜동제5투,3291,2671,1033,1391,200,34,3,2661,10,620,38.81999248402856,52.27358136039083,7.51597143930853,1.2777151446824502,0.11273957158962795
20,부산광역시,동래구,온천제1동,관내사전투표,4327,4327,2436,1489,341,33,2,4301,26,0,56.63799116484538,34.61985584747733,7.928388746803069,0.7672634271099744,0.046500813764240874
21,부산광역시,동래구,온천제1동,온천제1동제1투,3137,2127,543,1429,136,13,1,2122,5,1010,25.589066918001883,67.3421300659755,6.4090480678605095,0.6126295947219604,0.0471253534401508
22,부산광역시,동래구,온천제1동,온천제1동제2투,2169,1391,351,933,87,13,0,1384,7,778,25.36127167630058,67.41329479768787,6.286127167630058,0.9393063583815029,0.0
23,부산광역시,동래구,온천제1동,온천제1동제3투,3542,2179,609,1368,160,21,2,2160,19,1363,28.194444444444443,63.33333333333333,7.4074074074074066,0.9722222222222222,0.0925925925925926
24,부산광역시,동래구,온천제1동,온천제1동제4투,3433,2380,715,1370,259,22,0,2366,14,1053,30.21978021978022,57.903634826711745,10.946745562130179,0.9298393913778529,0.0
25,부산광역시,동래구,온천제1동,온천제1동제5투,3124,2416,852,1292,244,21,0,2409,7,708,35.36737235367372,53.63221253632212,10.12868410128684,0.8717310087173101,0.0
26,부산광역시,동래구,온천제1동,온천제1동제6투,3133,2354,755,1341,216,29,0,2341,13,779,32.25117471166168,57.28321230243486,9.22682614267407,1.2387868432293891,0.0
27,부산광역시,동래구,온천제1동,온천제1동제7투,1513,1228,443,657,110,11,0,1221,7,285,36.28173628173628,53.8083538083538,9.00900900900901,0.9009009009009009,0.0
28,부산광역시,동래구,온천제2동,관내사전투표,4272,4272,2405,1472,318,45,2,4242,30,0,56.69495520980669,34.7006129184347,7.4964639321074955,1.0608203677510608,0.04714757190004715
29,부산광역시,동래구,온천제2동,온천제2동제1투,2608,1856,482,1179,158,18,3,1840,16,752,26.195652173913043,64.07608695652173,8.58695652173913,0.9782608695652175,0.16304347826086957
30,부산광역시,동래구,온천제2동,온천제2동제2투,2421,1735,423,1184,105,16,0,1728,7,686,24.479166666666664,68.51851851851852,6.076388888888888,0.9259259259259258,0.0
31,부산광역시,동래구,온천제2동,온천제2동제3투,2344,1806,289,1396,97,15,1,1798,8,538,16.073414905450502,77.64182424916574,5.394883203559511,0.8342602892102335,0.05561735261401557
32,부산광역시,동래구,온천제2동,온천제2동제4투,2687,2227,846,1130,208,26,0,2210,17,460,38.28054298642534,51.13122171945701,9.411764705882353,1.1764705882352942,0.0
33,부산광역시,동래구,온천제2동,온천제2동제5투,1546,1007,232,718,47,4,1,1002,5,539,23.15369261477046,71.6566866267465,4.69061876247505,0.39920159680638717,0.09980039920159679
34,부산광역시,동래구,온천제2동,온천제2동제6투,1763,1358,480,728,126,12,1,1347,11,405,35.634743875278396,54.046028210838905,9.35412026726058,0.8908685968819599,0.07423904974016332
35,부산광역시,동래구,온천제3동,관내사전투표,5340,5340,2876,1994,395,37,5,5307,33,0,54.19257584322593,37.573016770303376,7.442999811569625,0.697192387412851,0.0942151874882231
36,부산광역시,동래구,온천제3동,온천제3동제1투,3629,2562,814,1534,169,29,3,2549,13,1067,31.93409180070616,60.1804629266379,6.63005100039231,1.1377010592389172,0.11769321302471558
37,부산광역시,동래구,온천제3동,온천제3동제2투,2917,1990,547,1282,124,20,1,1974,16,927,27.710233029381964,64.94427558257345,6.281661600810537,1.0131712259371835,0.050658561296859174
38,부산광역시,동래구,온천제3동,온천제3동제3투,3797,2502,635,1616,211,15,6,2483,19,1295,25.573902537253325,65.08256141763995,8.497784937575513,0.6041079339508658,0.24164317358034634
39,부산광역시,동래구,온천제3동,온천제3동제4투,2554,1782,527,1109,124,15,0,1775,7,772,29.690140845070424,62.478873239436616,6.985915492957746,0.8450704225352111,0.0
40,부산광역시,동래구,온천제3동,온천제3동제5투,2772,1847,511,1180,130,10,2,1833,14,925,27.877795962902347,64.37534097108565,7.092198581560284,0.5455537370430987,0.10911074740861974
41,부산광역시,동래구,온천제3동,온천제3동제6투,2684,1936,528,1255,124,12,1,1920,16,748,27.500000000000004,65.36458333333334,6.458333333333334,0.625,0.052083333333333336
42,부산광역시,동래구,온천제3동,온천제3동제7투,3475,2476,738,1529,179,13,0,2459,17,999,30.012200081333873,62.17974786498577,7.27938186254575,0.5286701911346076,0.0
43,부산광역시,동래구,사직제1동,관내사전투표,2966,2966,1618,1090,212,24,1,2945,21,0,54.940577249575554,37.011884550084886,7.1986417657045845,0.8149405772495755,0.03395585738539898
44,부산광역시,동래구,사직제1동,사직제1동제1투,3247,2218,550,1475,161,16,0,2202,16,1029,24.97729336966394,66.98455949137147,7.311534968210717,0.7266121707538601,0.0
45,부산광역시,동래구,사직제1동,사직제1동제2투,3094,2197,655,1333,174,19,0,2181,16,897,30.032095369096744,61.11875286565795,7.977991746905088,0.871160018340211,0.0
46,부산광역시,동래구,사직제2동,관내사전투표,4601,4601,2846,1393,294,44,5,4582,19,0,62.11261457878655,30.401571366215624,6.4164120471409865,0.9602793539938891,0.10912265386294195
47,부산광역시,동래구,사직제2동,사직제2동제1투,1739,1348,487,735,100,16,0,1338,10,391,36.39760837070254,54.932735426008975,7.473841554559043,1.195814648729447,0.0
48,부산광역시,동래구,사직제2동,사직제2동제2투,2707,1939,654,1103,151,19,1,1928,11,768,33.921161825726145,57.209543568464724,7.831950207468879,0.9854771784232365,0.05186721991701245
49,부산광역시,동래구,사직제2동,사직제2동제3투,2051,1513,492,870,121,21,1,1505,8,538,32.691029900332225,57.80730897009967,8.039867109634551,1.3953488372093024,0.0664451827242525
50,부산광역시,동래구,사직제2동,사직제2동제4투,2098,1490,433,931,99,15,3,1481,9,608,29.237002025658338,62.86293045239702,6.684672518568535,1.012829169480081,0.2025658338960162
51,부산광역시,동래구,사직제2동,사직제2동제5투,1528,1156,405,662,77,5,0,1149,7,372,35.24804177545692,57.61531766753699,6.70147954743255,0.4351610095735422,0.0
52,부산광역시,동래구,사직제2동,사직제2동제6투,2500,1906,650,1036,186,21,4,1897,9,594,34.26462836056932,54.61254612546126,9.804955192409066,1.107011070110701,0.21085925144965736
53,부산광역시,동래구,사직제3동,관내사전투표,2979,2979,1696,1044,186,24,2,2952,27,0,57.45257452574526,35.36585365853659,6.300813008130081,0.8130081300813009,0.06775067750677506
54,부산광역시,동래구,사직제3동,사직제3동제1투,1983,1258,310,827,97,12,0,1246,12,725,24.879614767255216,66.37239165329053,7.784911717495987,0.9630818619582664,0.0
55,부산광역시,동래구,사직제3동,사직제3동제2투,3306,2472,829,1385,218,24,1,2457,15,834,33.74033374033374,56.36955636955637,8.872608872608872,0.9768009768009768,0.0407000407000407
56,부산광역시,동래구,사직제3동,사직제3동제3투,1865,1329,323,901,91,9,0,1324,5,536,24.395770392749245,68.05135951661632,6.873111782477341,0.6797583081570997,0.0
57,부산광역시,동래구,사직제3동,사직제3동제4투,2199,1530,376,1036,87,11,2,1512,18,669,24.867724867724867,68.51851851851852,5.753968253968254,0.7275132275132274,0.13227513227513227
58,부산광역시,동래구,안락제1동,관내사전투표,3693,3693,1999,1433,220,22,0,3674,19,0,54.40936309199782,39.00381056069679,5.9880239520958085,0.5988023952095809,0.0
59,부산광역시,동래구,안락제1동,안락제1동제1투,2318,1691,407,1179,82,9,2,1679,12,627,24.240619416319237,70.22036926742108,4.883859440142943,0.5360333531864204,0.11911852293031568
60,부산광역시,동래구,안락제1동,안락제1동제2투,1997,1484,439,918,100,18,1,1476,8,513,29.742547425474253,62.19512195121951,6.775067750677506,1.2195121951219512,0.06775067750677506
61,부산광역시,동래구,안락제1동,안락제1동제3투,1901,1168,266,818,68,8,2,1162,6,733,22.89156626506024,70.39586919104991,5.851979345955249,0.6884681583476765,0.17211703958691912
62,부산광역시,동래구,안락제1동,안락제1동제4투,1941,1220,292,846,64,10,2,1214,6,721,24.052718286655683,69.68698517298188,5.2718286655683695,0.8237232289950577,0.16474464579901155
63,부산광역시,동래구,안락제2동,관내사전투표,3698,3698,2072,1355,223,25,1,3676,22,0,56.36561479869423,36.860718171926,6.066376496191513,0.6800870511425462,0.02720348204570185
64,부산광역시,동래구,안락제2동,안락제2동제1투,1816,1196,258,846,73,10,3,1190,6,620,21.680672268907564,71.09243697478992,6.134453781512605,0.8403361344537815,0.25210084033613445
65,부산광역시,동래구,안락제2동,안락제2동제2투,1375,904,201,640,53,4,0,898,6,471,22.383073496659243,71.26948775055679,5.902004454342984,0.4454342984409799,0.0
66,부산광역시,동래구,안락제2동,안락제2동제3투,3023,2387,612,1582,161,15,1,2371,16,636,25.81189371573176,66.72290172922818,6.790383804301982,0.6326444538169549,0.04217629692113033
67,부산광역시,동래구,안락제2동,안락제2동제4투,1894,1536,513,874,125,17,1,1530,6,358,33.52941176470588,57.124183006535944,8.169934640522875,1.1111111111111112,0.065359477124183
68,부산광역시,동래구,안락제2동,안락제2동제5투,2139,1510,395,997,95,14,1,1502,8,629,26.2982689747004,66.37816245006658,6.324900133155792,0.9320905459387484,0.06657789613848203
69,부산광역시,동래구,안락제2동,안락제2동제6투,2602,1846,630,1072,119,16,1,1838,8,756,34.276387377584335,58.32426550598476,6.474428726877041,0.8705114254624592,0.0544069640914037
70,부산광역시,동래구,안락제2동,안락제2동제7투,2960,2377,925,1224,190,21,2,2362,15,583,39.16172734970364,51.82049110922947,8.044030482641828,0.8890770533446233,0.0846740050804403
71,부산광역시,동래구,명장제1동,관내사전투표,2687,2686,1427,1064,165,15,5,2676,10,1,53.32585949177877,39.76083707025411,6.165919282511211,0.5605381165919282,0.18684603886397608
72,부산광역시,동래구,명장제1동,명장제1동제1투,1919,1263,319,866,59,5,1,1250,13,656,25.52,69.28,4.72,0.4,0.08
73,부산광역시,동래구,명장제1동,명장제1동제2투,1864,1325,298,937,70,13,1,1319,6,539,22.592873388931007,71.03866565579985,5.307050796057619,0.9855951478392722,0.0758150113722517
74,부산광역시,동래구,명장제1동,명장제1동제3투,1587,1153,287,797,53,12,0,1149,4,434,24.978241949521323,69.36466492602263,4.6127067014795475,1.0443864229765014,0.0
75,부산광역시,동래구,명장제1동,명장제1동제4투,2663,2017,678,1152,150,23,3,2006,11,646,33.79860418743769,57.42771684945165,7.477567298105684,1.1465603190428715,0.14955134596211367
76,부산광역시,동래구,명장제2동,관내사전투표,2333,2333,1212,960,127,14,1,2314,19,0,52.37683664649957,41.48660328435609,5.488331892826275,0.6050129645635264,0.043215211754537596
77,부산광역시,동래구,명장제2동,명장제2동제1투,2336,1650,406,1130,88,12,3,1639,11,686,24.771201952410006,68.9444783404515,5.369127516778524,0.7321537522879805,0.18303843807199513
78,부산광역시,동래구,명장제2동,명장제2동제2투,1838,1264,299,883,63,9,1,1255,9,574,23.824701195219124,70.35856573705179,5.0199203187251,0.7171314741035857,0.0796812749003984
79,부산광역시,동래구,명장제2동,명장제2동제3투,1769,1205,297,843,45,8,0,1193,12,564,24.895222129086335,70.66219614417435,3.7720033528918693,0.6705783738474435,0.0
80,부산광역시,동래구,명장제2동,명장제2동제4투,2271,1573,449,1010,92,5,2,1558,15,698,28.81899871630295,64.82670089858793,5.905006418485238,0.3209242618741977,0.12836970474967907
81,부산광역시,동래구,잘못 투입·구분된 투표지,,0,1,0,1,0,0,0,1,0,-1,0.0,100.0,0.0,0.0,0.0
0,부산광역시,남구,거소·선상투표,,532,488,184,183,94,6,2,469,19,44,39.23240938166311,39.01918976545842,20.042643923240938,1.279317697228145,0.42643923240938164
1,부산광역시,남구,관외사전투표,,20283,20279,10619,6664,2565,226,10,20084,195,4,52.87293367855009,33.18064130651265,12.771360286795458,1.125273849830711,0.04979087831109341
2,부산광역시,남구,재외투표,,1268,1035,660,249,108,8,0,1025,10,233,64.39024390243902,24.29268292682927,10.536585365853659,0.7804878048780488,0.0
3,부산광역시,남구,대연제1동,관내사전투표,3706,3706,2046,1243,347,36,4,3676,30,0,55.65832426550599,33.8139281828074,9.439608269858542,0.9793253536452665,0.1088139281828074
4,부산광역시,남구,대연제1동,대연제1동제1투,3379,2072,451,1358,226,20,5,2060,12,1307,21.893203883495147,65.92233009708738,10.970873786407767,0.9708737864077669,0.24271844660194172
5,부산광역시,남구,대연제1동,대연제1동제2투,3298,2060,494,1302,237,12,1,2046,14,1238,24.144672531769306,63.63636363636363,11.58357771260997,0.5865102639296188,0.04887585532746823
6,부산광역시,남구,대연제1동,대연제1동제3투,3088,1930,487,1284,129,14,2,1916,14,1158,25.417536534446768,67.01461377870564,6.732776617954071,0.7306889352818371,0.10438413361169101
7,부산광역시,남구,대연제3동,관내사전투표,5397,5397,3094,1523,681,45,8,5351,46,0,57.82096804335638,28.46196972528499,12.726593160156979,0.8409643057372453,0.14950476546439917
8,부산광역시,남구,대연제3동,대연제3동제1투,2635,1765,403,1061,271,11,2,1748,17,870,23.05491990846682,60.69794050343249,15.503432494279176,0.6292906178489702,0.11441647597254005
9,부산광역시,남구,대연제3동,대연제3동제2투,2646,1909,607,1180,90,17,0,1894,15,737,32.04857444561774,62.30200633579726,4.7518479408658925,0.8975712777191129,0.0
10,부산광역시,남구,대연제3동,대연제3동제3투,3148,2001,501,1179,285,14,3,1982,19,1147,25.27749747729566,59.4853683148335,14.37941473259334,0.7063572149344097,0.15136226034308778
11,부산광역시,남구,대연제3동,대연제3동제4투,2866,2054,603,1222,199,17,4,2045,9,812,29.486552567237162,59.75550122249389,9.731051344743276,0.8312958435207823,0.19559902200488996
12,부산광역시,남구,대연제3동,대연제3동제5투,2569,1959,692,1133,104,19,3,1951,8,610,35.46899026140441,58.072783188108666,5.330599692465402,0.9738595592004101,0.1537672988211174
13,부산광역시,남구,대연제3동,대연제3동제6투,2842,2114,749,1164,180,9,2,2104,10,728,35.59885931558935,55.32319391634981,8.555133079847907,0.42775665399239543,0.09505703422053231
14,부산광역시,남구,대연제3동,대연제3동제7투,2384,1720,506,1042,145,15,0,1708,12,664,29.625292740046838,61.007025761124126,8.489461358313816,0.8782201405152225,0.0
15,부산광역시,남구,대연제3동,대연제3동제8투,2126,1727,473,1076,161,8,1,1719,8,399,27.515997673065733,62.59453170447935,9.365910413030832,0.4653868528214078,0.058173356602675974
16,부산광역시,남구,대연제4동,관내사전투표,2416,2416,1370,894,126,12,2,2404,12,0,56.9883527454243,37.18801996672213,5.241264559068219,0.49916805324459235,0.08319467554076539
17,부산광역시,남구,대연제4동,대연제4동제1투,2849,2048,605,1256,155,20,0,2036,12,801,29.715127701375245,61.68958742632613,7.6129666011787815,0.9823182711198428,0.0
18,부산광역시,남구,대연제4동,대연제4동제2투,1440,923,185,687,36,6,2,916,7,517,20.19650655021834,75.0,3.9301310043668125,0.6550218340611353,0.21834061135371177
19,부산광역시,남구,대연제4동,대연제4동제3투,1775,1179,343,770,52,5,1,1171,8,596,29.29120409906063,65.75576430401367,4.44064901793339,0.4269854824935952,0.08539709649871904
20,부산광역시,남구,대연제4동,대연제4동제4투,2088,1684,730,805,129,12,1,1677,7,404,43.530113297555154,48.00238521168754,7.6923076923076925,0.7155635062611807,0.05963029218843172
21,부산광역시,남구,대연제5동,관내사전투표,3903,3903,2108,1433,297,27,5,3870,33,0,54.4702842377261,37.02842377260982,7.674418604651163,0.6976744186046512,0.12919896640826875
22,부산광역시,남구,대연제5동,대연제5동제1투,3136,2071,540,1342,148,22,2,2054,17,1065,26.29016553067186,65.33592989289193,7.205452775073027,1.071080817916261,0.09737098344693282
23,부산광역시,남구,대연제5동,대연제5동제2투,2244,1408,330,936,115,16,3,1400,8,836,23.57142857142857,66.85714285714286,8.214285714285714,1.1428571428571428,0.2142857142857143
24,부산광역시,남구,대연제5동,대연제5동제3투,2032,1354,391,838,108,10,0,1347,7,678,29.02746844840386,62.212323682256866,8.017817371937639,0.7423904974016332,0.0
25,부산광역시,남구,대연제5동,대연제5동제4투,2172,1571,474,913,159,17,0,1563,8,601,30.326295585412666,58.413307741522715,10.17274472168906,1.0876519513755598,0.0
26,부산광역시,남구,대연제6동,관내사전투표,3863,3863,2275,1207,319,35,1,3837,26,0,59.291112848579616,31.45686734427938,8.31378681261402,0.9121709669012249,0.026062027625749284
27,부산광역시,남구,대연제6동,대연제6동제1투,2527,1756,430,1173,122,16,0,1741,15,771,24.69844916714532,67.37507179781734,7.00746697300402,0.9190120620333142,0.0
28,부산광역시,남구,대연제6동,대연제6동제2투,1715,1176,315,771,72,9,2,1169,7,539,26.94610778443114,65.95380667236954,6.159110350727117,0.7698887938408896,0.1710863986313088
29,부산광역시,남구,대연제6동,대연제6동제3투,2294,1811,602,987,185,23,4,1801,10,483,33.4258745141588,54.80288728484175,10.272071071626874,1.2770682953914492,0.22209883398112162
30,부산광역시,남구,대연제6동,대연제6동제4투,1952,1539,520,875,121,16,1,1533,6,413,33.92041748206132,57.077625570776256,7.893020221787345,1.0437051532941943,0.06523157208088715
31,부산광역시,남구,용호제1동,관내사전투표,3122,3122,1657,1290,138,22,0,3107,15,0,53.33118764081107,41.51915030576118,4.441583521081429,0.7080785323463148,0.0
32,부산광역시,남구,용호제1동,용호제1동제1투,1864,1020,243,717,42,9,0,1011,9,844,24.03560830860534,70.91988130563797,4.154302670623145,0.8902077151335311,0.0
33,부산광역시,남구,용호제1동,용호제1동제2투,1983,1238,263,910,52,5,1,1231,7,745,21.364744110479286,73.92363931762794,4.224207961007311,0.4061738424045491,0.08123476848090982
34,부산광역시,남구,용호제1동,용호제1동제3투,2056,1290,315,899,58,8,3,1283,7,766,24.551831644583007,70.0701480904131,4.520654715510522,0.6235385814497272,0.23382696804364772
35,부산광역시,남구,용호제1동,용호제1동제4투,2983,2292,805,1300,152,22,1,2280,12,691,35.30701754385965,57.01754385964912,6.666666666666667,0.9649122807017544,0.043859649122807015
36,부산광역시,남구,용호제1동,용호제1동제5투,3154,2307,677,1441,148,28,2,2296,11,847,29.486062717770032,62.76132404181185,6.445993031358885,1.2195121951219512,0.08710801393728224
37,부산광역시,남구,용호제1동,용호제1동제6투,3075,2330,631,1518,155,16,2,2322,8,745,27.174849267872524,65.37467700258398,6.675279931093884,0.6890611541774333,0.08613264427217916
38,부산광역시,남구,용호제1동,용호제1동제7투,3305,2476,613,1675,160,17,0,2465,11,829,24.86815415821501,67.95131845841786,6.490872210953347,0.6896551724137931,0.0
39,부산광역시,남구,용호제1동,용호제1동제8투,2272,1719,579,992,120,21,0,1712,7,553,33.820093457943926,57.943925233644855,7.009345794392523,1.2266355140186915,0.0
40,부산광역시,남구,용호제1동,용호제1동제9투,2559,2063,509,1361,166,22,0,2058,5,496,24.732750242954324,66.13216715257532,8.066083576287658,1.0689990281827018,0.0
41,부산광역시,남구,용호제1동,용호제1동제10투,2672,2139,488,1476,159,10,1,2134,5,533,22.86785379568885,69.16588566073102,7.450796626054358,0.4686035613870665,0.046860356138706656
42,부산광역시,남구,용호제2동,관내사전투표,2739,2739,1473,1119,115,12,1,2720,19,0,54.15441176470588,41.13970588235294,4.227941176470589,0.4411764705882353,0.03676470588235294
43,부산광역시,남구,용호제2동,용호제2동제1투,2543,1625,350,1173,87,3,1,1614,11,918,21.685254027261465,72.67657992565056,5.390334572490707,0.18587360594795538,0.061957868649318466
44,부산광역시,남구,용호제2동,용호제2동제2투,1868,1297,434,759,86,12,2,1293,4,571,33.56535189481825,58.70069605568445,6.651198762567673,0.9280742459396751,0.15467904098994587
45,부산광역시,남구,용호제2동,용호제2동제3투,2097,1581,501,963,100,11,2,1577,4,516,31.769181991122387,61.06531388712746,6.3411540900443875,0.6975269499048826,0.12682308180088775
46,부산광역시,남구,용호제2동,용호제2동제4투,2727,2160,658,1368,114,12,1,2153,7,567,30.562006502554574,63.539247561542034,5.294937296795169,0.5573618207152811,0.046446818392940084
47,부산광역시,남구,용호제2동,용호제2동제5투,2472,1860,642,1038,146,22,0,1848,12,612,34.74025974025974,56.16883116883117,7.900432900432901,1.1904761904761905,0.0
48,부산광역시,남구,용호제3동,관내사전투표,5087,5087,2791,1893,335,38,2,5059,28,0,55.16900573235818,37.4184621466693,6.621862028068788,0.7511365882585491,0.0395335046451868
49,부산광역시,남구,용호제3동,용호제3동제1투,1492,1014,272,669,56,7,0,1004,10,478,27.091633466135455,66.63346613545816,5.577689243027888,0.697211155378486,0.0
50,부산광역시,남구,용호제3동,용호제3동제2투,1119,723,183,488,43,4,0,718,5,396,25.487465181058493,67.96657381615599,5.988857938718663,0.5571030640668524,0.0
51,부산광역시,남구,용호제3동,용호제3동제3투,1698,1023,255,715,41,4,1,1016,7,675,25.098425196850393,70.3740157480315,4.035433070866142,0.39370078740157477,0.09842519685039369
52,부산광역시,남구,용호제3동,용호제3동제4투,2015,1443,430,923,73,7,2,1435,8,572,29.965156794425084,64.3205574912892,5.087108013937282,0.4878048780487805,0.13937282229965156
53,부산광역시,남구,용호제4동,관내사전투표,2615,2615,1570,868,147,16,3,2604,11,0,60.29185867895546,33.33333333333333,5.64516129032258,0.6144393241167435,0.1152073732718894
54,부산광역시,남구,용호제4동,용호제4동제1투,2388,1605,526,966,75,18,0,1585,20,783,33.186119873817034,60.94637223974764,4.73186119873817,1.135646687697161,0.0
55,부산광역시,남구,용호제4동,용호제4동제2투,2055,1299,327,895,57,9,3,1291,8,756,25.329202168861347,69.32610379550735,4.415182029434547,0.69713400464756,0.23237800154918667
56,부산광역시,남구,용당동,관내사전투표,1562,1562,957,472,110,16,2,1557,5,0,61.46435452793835,30.31470777135517,7.064868336544637,1.0276172125883107,0.12845215157353884
57,부산광역시,남구,용당동,용당동제1투,1026,731,210,487,22,5,0,724,7,295,29.005524861878452,67.26519337016575,3.0386740331491713,0.6906077348066298,0.0
58,부산광역시,남구,용당동,용당동제2투,1431,952,261,605,75,6,3,950,2,479,27.473684210526315,63.68421052631579,7.894736842105263,0.631578947368421,0.3157894736842105
59,부산광역시,남구,용당동,용당동제3투,2111,1602,494,1010,77,9,0,1590,12,509,31.069182389937104,63.52201257861635,4.8427672955974845,0.5660377358490566,0.0
60,부산광역시,남구,감만제1동,관내사전투표,1512,1512,903,505,89,5,1,1503,9,0,60.079840319361274,33.59946773120426,5.921490352628077,0.332667997338656,0.0665335994677312
61,부산광역시,남구,감만제1동,감만제1동제1투,1360,906,308,515,68,8,0,899,7,454,34.260289210233594,57.28587319243604,7.563959955506118,0.8898776418242491,0.0
62,부산광역시,남구,감만제1동,감만제1동제2투,1253,747,195,491,49,6,0,741,6,506,26.31578947368421,66.26180836707152,6.612685560053981,0.8097165991902834,0.0
63,부산광역시,남구,감만제1동,감만제1동제3투,2225,1717,630,960,99,15,3,1707,10,508,36.90685413005272,56.239015817223205,5.799648506151142,0.8787346221441126,0.17574692442882248
64,부산광역시,남구,감만제2동,관내사전투표,1803,1803,981,706,94,9,3,1793,10,0,54.712771890686,39.37534857780257,5.242610150585611,0.501952035694367,0.16731734523145567
65,부산광역시,남구,감만제2동,감만제2동제1투,1847,1160,340,740,57,12,2,1151,9,687,29.53953084274544,64.29192006950478,4.952215464813206,1.0425716768027802,0.1737619461337967
66,부산광역시,남구,감만제2동,감만제2동제2투,1983,1291,335,879,62,9,0,1285,6,692,26.07003891050584,68.40466926070039,4.824902723735409,0.7003891050583658,0.0
67,부산광역시,남구,우암동,관내사전투표,1940,1940,1115,713,91,10,0,1929,11,0,57.80196993260757,36.96215655780197,4.717470191809228,0.5184033177812338,0.0
68,부산광역시,남구,우암동,우암동제1투,1264,953,332,555,53,9,0,949,4,311,34.98419388830348,58.48261327713382,5.584826132771338,0.9483667017913594,0.0
69,부산광역시,남구,우암동,우암동제2투,2114,1508,449,976,62,12,2,1501,7,606,29.913391072618257,65.02331778814124,4.130579613590939,0.7994670219853431,0.13324450366422386
70,부산광역시,남구,우암동,우암동제3투,2367,1782,557,1106,97,10,0,1770,12,585,31.468926553672315,62.485875706214685,5.480225988700565,0.5649717514124294,0.0
71,부산광역시,남구,우암동,우암동제4투,1758,1125,289,787,30,6,3,1115,10,633,25.91928251121076,70.5829596412556,2.690582959641256,0.5381165919282511,0.26905829596412556
72,부산광역시,남구,문현제1동,관내사전투표,2633,2633,1434,1019,148,15,2,2618,15,0,54.77463712757831,38.92284186401834,5.653170359052712,0.5729564553093965,0.07639419404125286
73,부산광역시,남구,문현제1동,문현제1동제1투,1596,1050,291,677,68,7,0,1043,7,546,27.900287631831254,64.90891658676894,6.519654841802493,0.6711409395973155,0.0
74,부산광역시,남구,문현제1동,문현제1동제2투,1339,942,287,585,61,3,0,936,6,397,30.662393162393165,62.5,6.517094017094018,0.3205128205128205,0.0
75,부산광역시,남구,문현제1동,문현제1동제3투,1935,1287,370,826,73,14,1,1284,3,648,28.81619937694704,64.33021806853583,5.685358255451713,1.0903426791277258,0.0778816199376947
76,부산광역시,남구,문현제1동,문현제1동제4투,1235,748,196,509,34,5,0,744,4,487,26.344086021505376,68.41397849462365,4.56989247311828,0.6720430107526881,0.0
77,부산광역시,남구,문현제2동,관내사전투표,1573,1573,845,589,117,9,1,1561,12,0,54.1319666880205,37.732222934016654,7.495195387572069,0.5765534913516976,0.06406149903907751
78,부산광역시,남구,문현제2동,문현제2동제1투,1622,1030,278,663,68,5,0,1014,16,592,27.416173570019726,65.38461538461539,6.70611439842209,0.4930966469428008,0.0
79,부산광역시,남구,문현제2동,문현제2동제2투,1445,882,242,538,78,14,0,872,10,563,27.75229357798165,61.69724770642202,8.944954128440367,1.6055045871559634,0.0
80,부산광역시,남구,문현제2동,문현제2동제3투,2061,1305,347,841,100,9,2,1299,6,756,26.712856043110083,64.74210931485759,7.698229407236336,0.6928406466512702,0.15396458814472672
81,부산광역시,남구,문현제3동,관내사전투표,2847,2847,1621,1022,172,16,0,2831,16,0,57.25891910985518,36.100317908866124,6.075591663723066,0.565171317555634,0.0
82,부산광역시,남구,문현제3동,문현제3동제1투,1723,1217,356,731,102,15,2,1206,11,506,29.519071310116086,60.61359867330016,8.45771144278607,1.2437810945273633,0.16583747927031509
83,부산광역시,남구,문현제3동,문현제3동제2투,2374,1592,430,1019,109,15,3,1576,16,782,27.284263959390863,64.65736040609137,6.916243654822335,0.951776649746193,0.1903553299492386
84,부산광역시,남구,문현제3동,문현제3동제3투,2930,2151,678,1269,174,15,2,2138,13,779,31.711880261927032,59.35453695042096,8.13844714686623,0.7015902712815716,0.09354536950420954
85,부산광역시,남구,문현제3동,문현제3동제4투,2181,1545,496,935,89,16,1,1537,8,636,32.270657124268055,60.83279115159401,5.790500975927131,1.040988939492518,0.06506180871828238
86,부산광역시,남구,문현제4동,관내사전투표,2048,2048,1128,755,139,14,2,2038,10,0,55.34838076545633,37.04612365063788,6.820412168792934,0.6869479882237487,0.09813542688910697
87,부산광역시,남구,문현제4동,문현제4동제1투,1159,824,219,560,34,5,2,820,4,335,26.707317073170735,68.29268292682927,4.146341463414634,0.6097560975609756,0.24390243902439024
88,부산광역시,남구,문현제4동,문현제4동제2투,2297,1547,350,1084,103,6,0,1543,4,750,22.683084899546337,70.25275437459496,6.675307841866494,0.38885288399222295,0.0
89,부산광역시,남구,문현제4동,문현제4동제3투,1769,1133,311,742,67,6,1,1127,6,636,27.595385980479147,65.83850931677019,5.944986690328305,0.5323868677905945,0.08873114463176575
90,부산광역시,남구,잘못 투입·구분된 투표지,,0,0,0,0,0,0,0,0,0,0,0.0,0.0,0.0,0.0,0.0
0,부산광역시,북구,거소·선상투표,,445,422,150,179,69,3,4,405,17,23,37.03703703703704,44.19753086419753,17.037037037037038,0.7407407407407408,0.9876543209876543
1,부산광역시,북구,관외사전투표,,20146,20138,10764,6460,2500,188,19,19931,207,8,54.00632181024535,32.41182078169685,12.543274296322313,0.9432542270834378,0.09532888465204957
2,부산광역시,북구,재외투표,,895,738,483,155,86,8,0,732,6,157,65.98360655737704,21.174863387978142,11.748633879781421,1.092896174863388,0.0
3,부산광역시,북구,구포제1동,관내사전투표,3370,3370,1722,1436,173,15,4,3350,20,0,51.40298507462686,42.86567164179104,5.164179104477612,0.44776119402985076,0.11940298507462686
4,부산광역시,북구,구포제1동,구포제1동제1투,1711,1001,284,631,67,6,3,991,10,710,28.65792129162462,63.673057517658926,6.760847628657922,0.6054490413723511,0.30272452068617556
5,부산광역시,북구,구포제1동,구포제1동제2투,2289,1480,462,897,104,8,3,1474,6,809,31.343283582089555,60.85481682496607,7.055630936227951,0.5427408412483039,0.20352781546811397
6,부산광역시,북구,구포제1동,구포제1동제3투,1734,1070,298,691,66,4,3,1062,8,664,28.06026365348399,65.06591337099812,6.214689265536723,0.3766478342749529,0.2824858757062147
7,부산광역시,북구,구포제1동,구포제1동제4투,1762,1145,414,649,64,11,0,1138,7,617,36.37961335676626,57.0298769771529,5.623901581722319,0.9666080843585236,0.0
8,부산광역시,북구,구포제1동,구포제1동제5투,2179,1630,526,973,107,11,1,1618,12,549,32.509270704573545,60.13597033374537,6.61310259579728,0.6798516687268232,0.061804697156983925
9,부산광역시,북구,구포제2동,관내사전투표,3105,3105,1776,1107,181,24,2,3090,15,0,57.4757281553398,35.8252427184466,5.857605177993527,0.7766990291262136,0.06472491909385113
10,부산광역시,북구,구포제2동,구포제2동제1투,1985,1209,324,798,74,8,1,1205,4,776,26.887966804979254,66.22406639004149,6.141078838174273,0.6639004149377593,0.08298755186721991
11,부산광역시,북구,구포제2동,구포제2동제2투,1921,1142,356,691,76,11,8,1142,0,779,31.17338003502627,60.50788091068301,6.654991243432574,0.9632224168126094,0.7005253940455342
12,부산광역시,북구,구포제2동,구포제2동제3투,2869,1977,626,1177,141,20,1,1965,12,892,31.857506361323157,59.89821882951654,7.175572519083969,1.0178117048346056,0.05089058524173028
13,부산광역시,북구,구포제2동,구포제2동제4투,2550,1676,512,1033,103,17,1,1666,10,874,30.732292917166866,62.0048019207683,6.182472989195678,1.0204081632653061,0.060024009603841535
14,부산광역시,북구,구포제2동,구포제2동제5투,2922,2272,806,1286,155,12,2,2261,11,650,35.64794338788147,56.87748783724016,6.855373728438743,0.5307386112339673,0.08845643520566121
15,부산광역시,북구,구포제2동,구포제2동제6투,1127,658,191,415,39,6,1,652,6,469,29.29447852760736,63.65030674846626,5.98159509202454,0.9202453987730062,0.15337423312883436
16,부산광역시,북구,구포제2동,구포제2동제7투,2008,1587,633,809,120,15,0,1577,10,421,40.139505389980975,51.2999365884591,7.609384908053266,0.9511731135066582,0.0
17,부산광역시,북구,구포제3동,관내사전투표,3232,3232,1863,1141,187,17,4,3212,20,0,58.00124533001245,35.52303860523038,5.821917808219178,0.5292652552926526,0.12453300124533001
18,부산광역시,북구,구포제3동,구포제3동제1투,1765,1047,312,665,58,7,1,1043,4,718,29.913710450623203,63.758389261744966,5.560882070949185,0.6711409395973155,0.09587727708533077
19,부산광역시,북구,구포제3동,구포제3동제2투,1764,1037,290,667,69,7,0,1033,4,727,28.07357212003872,64.56921587608906,6.679574056147144,0.6776379477250726,0.0
20,부산광역시,북구,구포제3동,구포제3동제3투,1988,1171,372,702,81,10,0,1165,6,817,31.931330472103003,60.25751072961374,6.9527896995708165,0.8583690987124464,0.0
21,부산광역시,북구,구포제3동,구포제3동제4투,2068,1363,422,843,75,11,2,1353,10,705,31.189948263118993,62.3059866962306,5.543237250554324,0.8130081300813009,0.14781966001478197
22,부산광역시,북구,구포제3동,구포제3동제5투,1575,916,294,558,51,8,0,911,5,659,32.27222832052689,61.25137211855104,5.598243688254665,0.8781558726673985,0.0
23,부산광역시,북구,구포제3동,구포제3동제6투,2012,1202,335,784,62,8,2,1191,11,810,28.127623845507976,65.82703610411419,5.205709487825357,0.6717044500419815,0.16792611251049538
24,부산광역시,북구,금곡동,관내사전투표,4912,4912,3045,1564,237,33,3,4882,30,0,62.37197869725522,32.036050798852926,4.854567800081934,0.6759524784924211,0.061450225317492835
25,부산광역시,북구,금곡동,금곡동제1투,1828,1372,415,866,60,15,2,1358,14,456,30.559646539027984,63.770250368188506,4.418262150220913,1.1045655375552283,0.14727540500736377
26,부산광역시,북구,금곡동,금곡동제2투,1821,1332,447,792,66,12,3,1320,12,489,33.86363636363636,60.0,5.0,0.9090909090909091,0.22727272727272727
27,부산광역시,북구,금곡동,금곡동제3투,1885,1375,423,863,72,7,1,1366,9,510,30.96632503660322,63.17715959004392,5.27086383601757,0.5124450951683748,0.07320644216691069
28,부산광역시,북구,금곡동,금곡동제4투,2084,1686,569,983,99,12,2,1665,21,398,34.174174174174176,59.03903903903904,5.9459459459459465,0.7207207207207207,0.12012012012012012
29,부산광역시,북구,금곡동,금곡동제5투,1444,972,293,634,30,5,4,966,6,472,30.33126293995859,65.63146997929607,3.1055900621118013,0.5175983436853002,0.4140786749482402
30,부산광역시,북구,금곡동,금곡동제6투,1466,1061,348,635,65,4,2,1054,7,405,33.017077798861486,60.24667931688804,6.1669829222011385,0.3795066413662239,0.18975332068311196
31,부산광역시,북구,금곡동,금곡동제7투,2002,1473,470,883,97,13,1,1464,9,529,32.10382513661202,60.31420765027322,6.62568306010929,0.8879781420765027,0.06830601092896176
32,부산광역시,북구,금곡동,금곡동제8투,1443,927,272,613,28,2,4,919,8,516,29.59738846572361,66.70293797606094,3.0467899891186074,0.2176278563656148,0.4352557127312296
33,부산광역시,북구,금곡동,금곡동제9투,1607,1206,362,731,94,8,2,1197,9,401,30.242272347535504,61.06934001670844,7.852965747702589,0.6683375104427736,0.1670843776106934
34,부산광역시,북구,금곡동,금곡동제10투,2097,1438,430,891,96,11,1,1429,9,659,30.09097270818754,62.35129461161652,6.717984604618614,0.7697690692792162,0.06997900629811056
35,부산광역시,북구,금곡동,금곡동제11투,2681,2077,834,1045,175,13,2,2069,8,604,40.309328177863705,50.50749154180764,8.45819236346061,0.6283228612856452,0.09666505558240696
36,부산광역시,북구,금곡동,금곡동제12투,2804,2191,904,1053,188,21,2,2168,23,613,41.69741697416974,48.57011070110701,8.671586715867159,0.9686346863468636,0.09225092250922509
37,부산광역시,북구,화명제1동,관내사전투표,5853,5853,3521,1804,441,45,4,5815,38,0,60.55030094582975,31.023215821152196,7.583834909716251,0.7738607050730868,0.06878761822871883
38,부산광역시,북구,화명제1동,화명제1동제1투,2048,1504,493,859,113,18,0,1483,21,544,33.2434254888739,57.923128792987185,7.619689817936615,1.2137559002022926,0.0
39,부산광역시,북구,화명제1동,화명제1동제2투,2673,2037,661,1172,172,18,2,2025,12,636,32.641975308641975,57.876543209876544,8.493827160493828,0.8888888888888888,0.09876543209876544
40,부산광역시,북구,화명제1동,화명제1동제3투,1847,1424,510,784,112,10,0,1416,8,423,36.016949152542374,55.367231638418076,7.909604519774012,0.7062146892655368,0.0
41,부산광역시,북구,화명제1동,화명제1동제4투,1853,1394,543,707,119,11,2,1382,12,459,39.29088277858177,51.157742402315485,8.610709117221418,0.7959479015918958,0.1447178002894356
42,부산광역시,북구,화명제1동,화명제1동제5투,3162,2499,874,1400,186,24,3,2487,12,663,35.142742259750705,56.29272215520707,7.478890229191798,0.9650180940892641,0.12062726176115801
43,부산광역시,북구,화명제1동,화명제1동제6투,2955,2395,719,1483,166,14,1,2383,12,560,30.172052035249685,62.23248006714226,6.966009232060428,0.5874947545111204,0.0419639110365086
44,부산광역시,북구,화명제1동,화명제1동제7투,2901,2396,774,1416,181,12,1,2384,12,505,32.466442953020135,59.395973154362416,7.592281879194631,0.5033557046979865,0.04194630872483222
45,부산광역시,북구,화명제1동,화명제1동제8투,3055,2425,708,1508,184,15,1,2416,9,630,29.304635761589402,62.41721854304636,7.6158940397351,0.6208609271523179,0.041390728476821195
46,부산광역시,북구,화명제1동,화명제1동제9투,1696,1285,431,717,123,8,0,1279,6,411,33.69820172009382,56.05942142298671,9.616888193901485,0.6254886630179828,0.0
47,부산광역시,북구,화명제1동,화명제1동제10투,1135,901,349,456,81,11,0,897,4,234,38.90746934225195,50.836120401337794,9.03010033444816,1.2263099219620959,0.0
48,부산광역시,북구,화명제2동,관내사전투표,2968,2968,1730,986,202,31,5,2954,14,0,58.56465809072444,33.37846987136086,6.838185511171294,1.049424509140149,0.16926201760324985
49,부산광역시,북구,화명제2동,화명제2동제1투,2542,1907,623,1115,134,15,4,1891,16,635,32.94553146483342,58.963511369645694,7.086197778952935,0.7932310946589107,0.21152829190904282
50,부산광역시,북구,화명제2동,화명제2동제2투,2947,2083,645,1262,146,15,2,2070,13,864,31.15942028985507,60.96618357487923,7.053140096618357,0.7246376811594203,0.0966183574879227
51,부산광역시,북구,화명제2동,화명제2동제3투,2622,1831,583,1073,147,17,2,1822,9,791,31.99780461031833,58.89132821075741,8.068057080131723,0.9330406147091108,0.10976948408342481
52,부산광역시,북구,화명제2동,화명제2동제4투,1766,1433,514,808,87,18,1,1428,5,333,35.99439775910364,56.582633053221286,6.092436974789916,1.2605042016806722,0.0700280112044818
53,부산광역시,북구,화명제3동,관내사전투표,5386,5386,3415,1479,423,51,2,5370,16,0,63.59404096834265,27.541899441340785,7.877094972067039,0.9497206703910615,0.037243947858472994
54,부산광역시,북구,화명제3동,화명제3동제1투,3251,2580,901,1393,230,34,2,2560,20,671,35.1953125,54.41406250000001,8.984375,1.328125,0.078125
55,부산광역시,북구,화명제3동,화명제3동제2투,1828,1467,576,750,124,9,3,1462,5,361,39.398084815321475,51.29958960328317,8.481532147742818,0.615595075239398,0.2051983584131327
56,부산광역시,북구,화명제3동,화명제3동제3투,2355,1645,448,1038,125,20,1,1632,13,710,27.450980392156865,63.60294117647059,7.659313725490197,1.2254901960784315,0.061274509803921566
57,부산광역시,북구,화명제3동,화명제3동제4투,2113,1609,517,945,119,19,0,1600,9,504,32.3125,59.06249999999999,7.4375,1.1875,0.0
58,부산광역시,북구,화명제3동,화명제3동제5투,1125,886,288,521,64,12,0,885,1,239,32.54237288135593,58.87005649717514,7.231638418079096,1.3559322033898304,0.0
59,부산광역시,북구,화명제3동,화명제3동제6투,2680,2202,772,1237,159,16,3,2187,15,478,35.29949702789209,56.56149977137631,7.270233196159122,0.7315957933241883,0.1371742112482853
60,부산광역시,북구,화명제3동,화명제3동제7투,3048,2430,808,1395,190,15,2,2410,20,618,33.52697095435684,57.8838174273859,7.883817427385892,0.6224066390041494,0.08298755186721991
61,부산광역시,북구,덕천제1동,관내사전투표,2491,2491,1329,957,165,21,1,2473,18,0,53.74039627982208,38.697937727456534,6.672058228871816,0.8491710473109584,0.040436716538617065
62,부산광역시,북구,덕천제1동,덕천제1동제1투,2158,1561,458,999,87,7,1,1552,9,597,29.510309278350515,64.36855670103093,5.605670103092784,0.4510309278350515,0.06443298969072164
63,부산광역시,북구,덕천제1동,덕천제1동제2투,1975,1339,327,854,129,14,2,1326,13,636,24.660633484162897,64.40422322775264,9.728506787330318,1.0558069381598794,0.1508295625942685
64,부산광역시,북구,덕천제1동,덕천제1동제3투,2283,1574,471,924,143,16,2,1556,18,709,30.26992287917738,59.383033419023135,9.190231362467866,1.0282776349614395,0.12853470437017994
65,부산광역시,북구,덕천제1동,덕천제1동제4투,2309,1554,456,1009,63,8,2,1538,16,755,29.648894668400523,65.60468140442133,4.096228868660598,0.5201560468140443,0.13003901170351106
66,부산광역시,북구,덕천제2동,관내사전투표,2910,2910,1617,1017,232,26,1,2893,17,0,55.893536121673,35.153819564465955,8.019357068786727,0.8987210508123057,0.034566194262011754
67,부산광역시,북구,덕천제2동,덕천제2동제1투,2065,1288,319,867,82,10,1,1279,9,777,24.941360437842064,67.78733385457389,6.411258795934324,0.7818608287724784,0.07818608287724785
68,부산광역시,북구,덕천제2동,덕천제2동제2투,1611,955,239,632,69,7,3,950,5,656,25.157894736842106,66.52631578947368,7.2631578947368425,0.7368421052631579,0.3157894736842105
69,부산광역시,북구,덕천제2동,덕천제2동제3투,1934,1301,463,741,79,7,0,1290,11,633,35.89147286821706,57.44186046511628,6.124031007751938,0.5426356589147286,0.0
70,부산광역시,북구,덕천제2동,덕천제2동제4투,1667,1096,294,723,67,6,2,1092,4,571,26.923076923076923,66.20879120879121,6.135531135531135,0.5494505494505495,0.18315018315018314
71,부산광역시,북구,덕천제3동,관내사전투표,1850,1850,1048,692,85,12,0,1837,13,0,57.04953728905825,37.6701143168209,4.627109417528579,0.6532389765922699,0.0
72,부산광역시,북구,덕천제3동,덕천제3동제1투,1277,863,291,503,58,4,0,856,7,414,33.99532710280374,58.76168224299065,6.775700934579438,0.46728971962616817,0.0
73,부산광역시,북구,덕천제3동,덕천제3동제2투,1788,1076,272,721,70,5,1,1069,7,712,25.444340505144996,67.44621141253508,6.548175865294668,0.4677268475210477,0.09354536950420954
74,부산광역시,북구,덕천제3동,덕천제3동제3투,1800,1176,333,744,81,5,2,1165,11,624,28.583690987124466,63.862660944206006,6.9527896995708165,0.4291845493562232,0.17167381974248927
75,부산광역시,북구,덕천제3동,덕천제3동제4투,1254,731,213,488,18,5,0,724,7,523,29.41988950276243,67.40331491712708,2.4861878453038675,0.6906077348066298,0.0
76,부산광역시,북구,만덕제1동,관내사전투표,3615,3615,2003,1361,207,24,3,3598,17,0,55.6698165647582,37.82657031684269,5.75319622012229,0.6670372429127293,0.08337965536409116
77,부산광역시,북구,만덕제1동,만덕제1동제1투,1915,1327,371,839,90,11,2,1313,14,588,28.25590251332826,63.8994668697639,6.854531607006854,0.8377760853008377,0.15232292460015232
78,부산광역시,북구,만덕제1동,만덕제1동제2투,2598,1981,779,937,214,33,2,1965,16,617,39.64376590330789,47.68447837150127,10.89058524173028,1.6793893129770994,0.10178117048346055
79,부산광역시,북구,만덕제1동,만덕제1동제3투,2271,1558,442,1007,80,17,4,1550,8,713,28.516129032258064,64.96774193548387,5.161290322580645,1.096774193548387,0.25806451612903225
80,부산광역시,북구,만덕제1동,만덕제1동제4투,2187,1695,576,932,156,20,2,1686,9,492,34.16370106761566,55.27876631079478,9.252669039145907,1.1862396204033214,0.11862396204033215
81,부산광역시,북구,만덕제2동,관내사전투표,4507,4507,2633,1563,243,31,2,4472,35,0,58.87745974955278,34.95080500894455,5.433810375670841,0.6932021466905188,0.044722719141323794
82,부산광역시,북구,만덕제2동,만덕제2동제1투,1436,972,211,703,48,6,0,968,4,464,21.797520661157023,72.62396694214877,4.958677685950414,0.6198347107438017,0.0
83,부산광역시,북구,만덕제2동,만덕제2동제2투,1812,1218,378,715,101,12,0,1206,12,594,31.343283582089555,59.28689883913765,8.374792703150911,0.9950248756218906,0.0
84,부산광역시,북구,만덕제2동,만덕제2동제3투,1968,1365,378,908,55,16,1,1358,7,603,27.835051546391753,66.86303387334314,4.0500736377025035,1.1782032400589102,0.07363770250368189
85,부산광역시,북구,만덕제2동,만덕제2동제4투,1643,1183,315,774,77,6,0,1172,11,460,26.87713310580205,66.04095563139933,6.5699658703071675,0.5119453924914675,0.0
86,부산광역시,북구,만덕제2동,만덕제2동제5투,1523,1222,577,532,78,23,0,1210,12,301,47.68595041322314,43.96694214876033,6.446280991735537,1.9008264462809916,0.0
87,부산광역시,북구,만덕제2동,만덕제2동제6투,2190,1626,580,916,107,11,4,1618,8,564,35.84672435105068,56.61310259579728,6.61310259579728,0.6798516687268232,0.2472187886279357
88,부산광역시,북구,만덕제2동,만덕제2동제7투,2933,2194,896,1073,194,11,1,2175,19,739,41.195402298850574,49.333333333333336,8.919540229885058,0.5057471264367815,0.04597701149425287
89,부산광역시,북구,만덕제2동,만덕제2동제8투,1986,1474,453,919,82,12,1,1467,7,512,30.879345603271986,62.64485344239945,5.589638718473075,0.81799591002045,0.0681663258350375
90,부산광역시,북구,만덕제3동,관내사전투표,3394,3394,1885,1266,196,22,5,3374,20,0,55.868405453467695,37.522228808535864,5.809128630705394,0.6520450503852994,0.14819205690574985
91,부산광역시,북구,만덕제3동,만덕제3동제1투,2916,2034,543,1338,127,11,3,2022,12,882,26.85459940652819,66.17210682492582,6.280909990108803,0.5440158259149357,0.1483679525222552
92,부산광역시,북구,만덕제3동,만덕제3동제2투,2323,1775,558,1102,100,6,1,1767,8,548,31.57894736842105,62.365591397849464,5.659309564233164,0.3395585738539898,0.056593095642331635
93,부산광역시,북구,만덕제3동,만덕제3동제3투,2537,1724,458,1127,119,12,1,1717,7,813,26.67443214909726,65.6377402446127,6.9306930693069315,0.6988934187536401,0.05824111822947001
94,부산광역시,북구,만덕제3동,만덕제3동제4투,2564,1903,662,1073,139,15,1,1890,13,661,35.026455026455025,56.77248677248677,7.3544973544973535,0.7936507936507936,0.052910052910052914
95,부산광역시,북구,잘못 투입·구분된 투표지,,0,0,0,0,0,0,0,0,0,0,0.0,0.0,0.0,0.0,0.0
0,부산광역시,해운대구,거소·선상투표,,660,629,214,282,100,5,3,604,25,31,35.430463576158935,46.688741721854306,16.55629139072848,0.8278145695364238,0.49668874172185434
1,부산광역시,해운대구,관외사전투표,,28450,28445,14190,10135,3603,248,32,28208,237,5,50.30487804878049,35.929523539421446,12.772972206466251,0.8791832104367556,0.11344299489506524
2,부산광역시,해운대구,재외투표,,2156,1694,1055,443,165,22,1,1686,8,462,62.57413997627521,26.27520759193357,9.786476868327403,1.3048635824436536,0.05931198102016608
3,부산광역시,해운대구,우제1동,관내사전투표,3264,3264,1830,1163,229,21,3,3246,18,0,56.37707948243993,35.82871226124461,7.054836722119531,0.6469500924214419,0.09242144177449169
4,부산광역시,해운대구,우제1동,우제1동제1투,1920,1128,276,779,59,4,1,1119,9,792,24.664879356568363,69.61572832886506,5.272564789991064,0.3574620196604111,0.08936550491510277
5,부산광역시,해운대구,우제1동,우제1동제2투,2571,1823,509,1184,96,20,2,1811,12,748,28.106018774157924,65.37824406405302,5.30093870789619,1.1043622308117063,0.11043622308117064
6,부산광역시,해운대구,우제1동,우제1동제3투,2201,1415,290,1041,64,12,2,1409,6,786,20.581973030518096,73.88218594748048,4.5422285308729595,0.8516678495386799,0.14194464158977999
7,부산광역시,해운대구,우제1동,우제1동제4투,2980,1791,393,1241,135,10,0,1779,12,1189,22.09106239460371,69.75829117481732,7.588532883642496,0.5621135469364812,0.0
8,부산광역시,해운대구,우제1동,우제1동제5투,2602,2039,503,1390,125,12,0,2030,9,563,24.778325123152708,68.4729064039409,6.157635467980295,0.5911330049261084,0.0
9,부산광역시,해운대구,우제1동,우제1동제6투,2162,1469,402,924,123,14,2,1465,4,693,27.44027303754266,63.0716723549488,8.395904436860068,0.955631399317406,0.13651877133105803
10,부산광역시,해운대구,우제2동,관내사전투표,4575,4575,2607,1616,298,29,5,4555,20,0,57.23380900109769,35.4774972557629,6.542261251372119,0.6366630076838639,0.10976948408342481
11,부산광역시,해운대구,우제2동,우제2동제1투,3435,2586,656,1721,175,19,2,2573,13,849,25.495530509133307,66.88690244850369,6.801399144966965,0.7384376214535562,0.0777302759424796
12,부산광역시,해운대구,우제2동,우제2동제2투,3146,2327,672,1439,183,15,3,2312,15,819,29.06574394463668,62.240484429065745,7.91522491349481,0.6487889273356401,0.12975778546712802
13,부산광역시,해운대구,우제2동,우제2동제3투,2656,1871,411,1292,141,15,2,1861,10,785,22.084900591080064,69.4250403009135,7.576571735626008,0.8060182697474476,0.10746910263299302
14,부산광역시,해운대구,우제2동,우제2동제4투,2605,1925,430,1354,109,13,7,1913,12,680,22.47778358599059,70.77888133821223,5.6978567694720335,0.6795608991113434,0.36591740721380034
15,부산광역시,해운대구,우제2동,우제2동제5투,2988,2278,580,1508,161,16,0,2265,13,710,25.607064017660043,66.57836644591612,7.108167770419425,0.7064017660044151,0.0
16,부산광역시,해운대구,우제2동,우제2동제6투,2581,1878,386,1342,135,9,0,1872,6,703,20.61965811965812,71.6880341880342,7.211538461538461,0.4807692307692308,0.0
17,부산광역시,해운대구,우제3동,관내사전투표,4440,4440,2142,1864,386,25,3,4420,20,0,48.46153846153846,42.171945701357465,8.733031674208144,0.5656108597285068,0.06787330316742081
18,부산광역시,해운대구,우제3동,우제3동제1투,2817,2003,368,1488,127,9,3,1995,8,814,18.44611528822055,74.58646616541354,6.3659147869674175,0.4511278195488722,0.15037593984962408
19,부산광역시,해운대구,우제3동,우제3동제2투,2720,2113,397,1581,118,9,2,2107,6,607,18.841955386805886,75.03559563360228,5.600379686758425,0.42714760322733747,0.09492168960607499
20,부산광역시,해운대구,우제3동,우제3동제3투,2237,1654,219,1360,56,9,3,1647,7,583,13.296903460837886,82.57437765634486,3.400121432908318,0.546448087431694,0.18214936247723132
21,부산광역시,해운대구,우제3동,우제3동제4투,3286,2236,322,1757,150,5,0,2234,2,1050,14.4136078782453,78.64816472694717,6.714413607878246,0.22381378692927484,0.0
22,부산광역시,해운대구,우제3동,우제3동제5투,3000,2199,362,1628,192,11,0,2193,6,801,16.507067943456452,74.23620611035112,8.755129958960328,0.5015959872321021,0.0
23,부산광역시,해운대구,우제3동,우제3동제6투,2400,1816,316,1334,150,11,1,1812,4,584,17.439293598233995,73.62030905077262,8.27814569536424,0.6070640176600441,0.05518763796909492
24,부산광역시,해운대구,중제1동,관내사전투표,4863,4863,2658,1764,372,38,5,4837,26,0,54.951416167045686,36.46888567293777,7.690717386810006,0.7856109158569361,0.10336985734959686
25,부산광역시,해운대구,중제1동,중제1동제1투,3630,2341,404,1780,138,11,1,2334,7,1289,17.309340188517567,76.26392459297342,5.912596401028278,0.4712939160239932,0.042844901456726654
26,부산광역시,해운대구,중제1동,중제1동제2투,3598,2476,622,1649,177,16,0,2464,12,1122,25.243506493506494,66.9237012987013,7.183441558441558,0.6493506493506493,0.0
27,부산광역시,해운대구,중제1동,중제1동제3투,2715,1847,555,1108,156,14,1,1834,13,868,30.261723009814613,60.414394765539804,8.505997818974919,0.7633587786259541,0.05452562704471102
28,부산광역시,해운대구,중제1동,중제1동제4투,2930,1974,561,1244,134,16,0,1955,19,956,28.695652173913043,63.631713554987215,6.854219948849105,0.8184143222506393,0.0
29,부산광역시,해운대구,중제1동,중제1동제5투,2922,1972,527,1268,145,16,0,1956,16,950,26.942740286298566,64.82617586912065,7.413087934560328,0.81799591002045,0.0
30,부산광역시,해운대구,중제2동,관내사전투표,2950,2950,1723,972,213,25,1,2934,16,0,58.725289706884794,33.12883435582822,7.259713701431493,0.8520790729379687,0.03408316291751875
31,부산광역시,해운대구,중제2동,중제2동제1투,947,576,145,394,29,6,0,574,2,371,25.261324041811843,68.6411149825784,5.052264808362369,1.0452961672473868,0.0
32,부산광역시,해운대구,중제2동,중제2동제2투,2429,1496,431,949,86,14,1,1481,15,933,29.10195813639433,64.07832545577313,5.806887238352465,0.9453072248480756,0.0675219446320054
33,부산광역시,해운대구,중제2동,중제2동제3투,2509,1562,332,1122,90,11,0,1555,7,947,21.35048231511254,72.15434083601286,5.787781350482315,0.707395498392283,0.0
34,부산광역시,해운대구,중제2동,중제2동제4투,3170,2285,581,1516,165,11,1,2274,11,885,25.549692172383466,66.66666666666666,7.255936675461741,0.4837291116974494,0.04397537379067722
35,부산광역시,해운대구,좌제1동,관내사전투표,4269,4269,2517,1320,363,29,2,4231,38,0,59.48948239186953,31.198298274639562,8.57953202552588,0.6854171590640511,0.04727014890096904
36,부산광역시,해운대구,좌제1동,좌제1동제1투,2531,1481,367,938,146,11,5,1467,14,1050,25.01704158145876,63.94001363326517,9.952283571915475,0.7498295841854125,0.34083162917518744
37,부산광역시,해운대구,좌제1동,좌제1동제2투,2184,1609,456,1028,102,10,2,1598,11,575,28.53566958698373,64.33041301627034,6.382978723404255,0.6257822277847309,0.1251564455569462
38,부산광역시,해운대구,좌제1동,좌제1동제3투,2374,1785,567,1062,130,17,1,1777,8,589,31.907709622960045,59.76364659538548,7.315700619020822,0.9566685424873381,0.056274620146314014
39,부산광역시,해운대구,좌제1동,좌제1동제4투,2826,2167,619,1366,150,15,1,2151,16,659,28.777312877731287,63.50534635053463,6.97350069735007,0.697350069735007,0.046490004649000466
40,부산광역시,해운대구,좌제2동,관내사전투표,5439,5439,3323,1685,355,43,5,5411,28,0,61.41193864350397,31.14026982073554,6.560709665496212,0.7946775087784144,0.09240436148586213
41,부산광역시,해운대구,좌제2동,좌제2동제1투,2803,1770,477,1129,132,10,1,1749,21,1033,27.27272727272727,64.55117209834191,7.547169811320755,0.5717552887364208,0.05717552887364208
42,부산광역시,해운대구,좌제2동,좌제2동제2투,3514,2122,540,1312,230,19,2,2103,19,1392,25.677603423680456,62.38706609605325,10.936757013789824,0.9034712315739419,0.0951022349025202
43,부산광역시,해운대구,좌제2동,좌제2동제3투,2536,1772,490,1126,128,12,1,1757,15,764,27.88844621513944,64.08651109846329,7.285145133750712,0.6829823562891292,0.056915196357427436
44,부산광역시,해운대구,좌제2동,좌제2동제4투,2261,1633,536,944,131,11,2,1624,9,628,33.004926108374384,58.128078817733986,8.066502463054187,0.6773399014778325,0.12315270935960591
45,부산광역시,해운대구,좌제2동,좌제2동제5투,2634,2011,617,1241,117,24,1,2000,11,623,30.85,62.050000000000004,5.8500000000000005,1.2,0.05
46,부산광역시,해운대구,좌제2동,좌제2동제6투,2155,1595,470,990,107,15,1,1583,12,560,29.69046114971573,62.53948199620973,6.759317751105495,0.9475679090334808,0.06317119393556538
47,부산광역시,해운대구,좌제2동,좌제2동제7투,2119,1523,384,1036,84,12,1,1517,6,596,25.313117996044827,68.29268292682927,5.537244561634806,0.7910349373764008,0.06591957811470006
48,부산광역시,해운대구,좌제3동,관내사전투표,3653,3653,2205,1140,264,27,1,3637,16,0,60.62689029419851,31.344514709925765,7.258729722298598,0.7423700852350839,0.027495188342040146
49,부산광역시,해운대구,좌제3동,좌제3동제1투,2379,1667,477,1037,133,9,1,1657,10,712,28.786964393482194,62.58298129149065,8.026554013277007,0.5431502715751357,0.06035003017501509
50,부산광역시,해운대구,좌제3동,좌제3동제2투,1800,1273,367,816,67,11,3,1264,9,527,29.03481012658228,64.55696202531645,5.3006329113924044,0.870253164556962,0.23734177215189875
51,부산광역시,해운대구,좌제3동,좌제3동제3투,2073,1487,420,946,101,11,0,1478,9,586,28.416779431664413,64.00541271989174,6.833558863328823,0.7442489851150204,0.0
52,부산광역시,해운대구,좌제3동,좌제3동제4투,2145,1549,368,1057,102,13,3,1543,6,596,23.849643551523005,68.50291639662994,6.610499027867791,0.8425145819831497,0.19442644199611148
53,부산광역시,해운대구,좌제4동,관내사전투표,5244,5244,3278,1505,373,52,3,5211,33,0,62.90539243907119,28.881212819036655,7.1579351372097495,0.9978890807906352,0.05757052389176742
54,부산광역시,해운대구,좌제4동,좌제4동제1투,1894,1374,410,845,102,9,2,1368,6,520,29.97076023391813,61.76900584795322,7.456140350877193,0.6578947368421052,0.14619883040935672
55,부산광역시,해운대구,좌제4동,좌제4동제2투,1277,935,304,520,100,7,1,932,3,342,32.61802575107296,55.793991416309005,10.72961373390558,0.7510729613733905,0.1072961373390558
56,부산광역시,해운대구,좌제4동,좌제4동제3투,2191,1630,515,957,124,19,3,1618,12,561,31.829419035846723,59.147095179233624,7.663782447466007,1.1742892459826948,0.1854140914709518
57,부산광역시,해운대구,좌제4동,좌제4동제4투,2356,1767,481,1127,122,23,1,1754,13,589,27.423033067274798,64.25313568985177,6.955530216647662,1.3112884834663627,0.05701254275940707
58,부산광역시,해운대구,좌제4동,좌제4동제5투,2232,1799,548,1117,108,12,0,1785,14,433,30.70028011204482,62.57703081232493,6.050420168067227,0.6722689075630253,0.0
59,부산광역시,해운대구,좌제4동,좌제4동제6투,2190,1697,506,1055,113,17,0,1691,6,493,29.923122412773505,62.38911886457718,6.682436428149025,1.0053222945002958,0.0
60,부산광역시,해운대구,송정동,관내사전투표,1994,1994,1106,737,124,14,2,1983,11,0,55.77407967725668,37.16591023701463,6.253151790216843,0.7060010085728694,0.10085728693898136
61,부산광역시,해운대구,송정동,송정동제1투,1969,1111,238,778,78,3,3,1100,11,858,21.636363636363637,70.72727272727273,7.090909090909091,0.27272727272727276,0.27272727272727276
62,부산광역시,해운대구,송정동,송정동제2투,2373,1591,445,1058,75,6,2,1586,5,782,28.058007566204285,66.70870113493065,4.7288776796973515,0.37831021437578816,0.12610340479192939
63,부산광역시,해운대구,송정동,송정동제3투,1480,1003,297,645,48,5,1,996,7,477,29.819277108433734,64.7590361445783,4.819277108433735,0.5020080321285141,0.1004016064257028
64,부산광역시,해운대구,반여제1동,관내사전투표,5123,5123,3187,1561,304,37,7,5096,27,0,62.5392464678179,30.631868131868135,5.965463108320251,0.7260596546310832,0.13736263736263737
65,부산광역시,해운대구,반여제1동,반여제1동제1투,1476,1024,288,672,51,8,0,1019,5,452,28.26300294406281,65.94700686947988,5.004906771344456,0.7850834151128557,0.0
66,부산광역시,해운대구,반여제1동,반여제1동제2투,2373,1656,479,1045,101,16,1,1642,14,717,29.17174177831912,63.64190012180268,6.151035322777101,0.9744214372716199,0.06090133982947624
67,부산광역시,해운대구,반여제1동,반여제1동제3투,2302,1806,554,1101,109,26,3,1793,13,496,30.89793641940881,61.40546569994423,6.079196876742889,1.4500836586726158,0.16731734523145567
68,부산광역시,해운대구,반여제1동,반여제1동제4투,3084,2249,667,1352,200,18,2,2239,10,835,29.790084859312195,60.384100044662794,8.932559178204555,0.8039303260384101,0.08932559178204555
69,부산광역시,해운대구,반여제1동,반여제1동제5투,2367,1813,604,1065,114,21,1,1805,8,554,33.46260387811634,59.0027700831025,6.315789473684211,1.1634349030470914,0.0554016620498615
70,부산광역시,해운대구,반여제1동,반여제1동제6투,1962,1553,637,793,104,13,1,1548,5,409,41.149870801033586,51.22739018087855,6.718346253229974,0.8397932816537468,0.06459948320413438
71,부산광역시,해운대구,반여제1동,반여제1동제7투,2802,2123,779,1133,180,17,3,2112,11,679,36.884469696969695,53.645833333333336,8.522727272727272,0.8049242424242424,0.14204545454545456
72,부산광역시,해운대구,반여제1동,반여제1동제8투,2309,1803,577,1092,108,15,0,1792,11,506,32.198660714285715,60.9375,6.026785714285714,0.8370535714285714,0.0
73,부산광역시,해운대구,반여제1동,반여제1동제9투,2851,2255,860,1219,147,21,2,2249,6,596,38.239217429968875,54.20186749666518,6.536238328145842,0.9337483325922632,0.08892841262783459
74,부산광역시,해운대구,반여제2동,관내사전투표,2781,2781,1449,1174,117,17,4,2761,20,0,52.48098515030786,42.520825787758056,4.2375950742484605,0.6157189424121695,0.14487504527345166
75,부산광역시,해운대구,반여제2동,반여제2동제1투,1952,1226,320,814,77,6,0,1217,9,726,26.294165981922763,66.88578471651603,6.327033689400165,0.4930156121610517,0.0
76,부산광역시,해운대구,반여제2동,반여제2동제2투,1554,925,288,569,52,4,3,916,9,629,31.4410480349345,62.117903930131,5.676855895196507,0.43668122270742354,0.32751091703056767
77,부산광역시,해운대구,반여제2동,반여제2동제3투,2209,1219,294,850,61,6,0,1211,8,990,24.277456647398843,70.18992568125516,5.037159372419488,0.495458298926507,0.0
78,부산광역시,해운대구,반여제2동,반여제2동제4투,1480,933,273,596,47,7,3,926,7,547,29.481641468682508,64.36285097192224,5.075593952483802,0.755939524838013,0.32397408207343414
79,부산광역시,해운대구,반여제3동,관내사전투표,1788,1788,924,749,94,7,1,1775,13,0,52.056338028169016,42.19718309859155,5.295774647887324,0.39436619718309857,0.056338028169014086
80,부산광역시,해운대구,반여제3동,반여제3동제1투,1621,914,227,628,42,9,1,907,7,707,25.027563395810365,69.23925027563396,4.630650496141125,0.9922822491730982,0.11025358324145534
81,부산광역시,해운대구,반여제3동,반여제3동제2투,1445,857,228,567,45,11,1,852,5,588,26.76056338028169,66.54929577464789,5.28169014084507,1.2910798122065728,0.11737089201877934
82,부산광역시,해운대구,반여제3동,반여제3동제3투,1694,1001,263,677,41,7,1,989,12,693,26.59251769464105,68.45298281092013,4.145601617795753,0.7077856420626896,0.10111223458038424
83,부산광역시,해운대구,반여제4동,관내사전투표,2313,2313,1300,846,130,13,3,2292,21,0,56.719022687609076,36.910994764397905,5.671902268760907,0.5671902268760907,0.13089005235602094
84,부산광역시,해운대구,반여제4동,반여제4동제1투,1992,1362,402,856,79,9,5,1351,11,630,29.755736491487788,63.36047372316802,5.847520355292376,0.6661732050333087,0.3700962250185048
85,부산광역시,해운대구,반여제4동,반여제4동제2투,1847,1239,307,837,86,3,0,1233,6,608,24.898621248986213,67.88321167883211,6.974858069748581,0.24330900243309003,0.0
86,부산광역시,해운대구,반여제4동,반여제4동제3투,2456,1983,774,1042,135,22,4,1977,6,473,39.150227617602425,52.70612038442084,6.828528072837632,1.112797167425392,0.20232675771370764
87,부산광역시,해운대구,반여제4동,반여제4동제4투,2463,1933,696,1059,149,17,0,1921,12,530,36.23112961998959,55.127537740760026,7.756376887038001,0.8849557522123894,0.0
88,부산광역시,해운대구,반송제1동,관내사전투표,3322,3322,1627,1503,147,21,2,3300,22,0,49.303030303030305,45.54545454545455,4.454545454545455,0.6363636363636364,0.06060606060606061
89,부산광역시,해운대구,반송제1동,반송제1동제1투,1134,619,173,418,25,1,0,617,2,515,28.038897893030796,67.74716369529983,4.051863857374392,0.1620745542949757,0.0
90,부산광역시,해운대구,반송제1동,반송제1동제2투,1166,684,173,469,35,3,0,680,4,482,25.441176470588232,68.97058823529412,5.147058823529411,0.4411764705882353,0.0
91,부산광역시,해운대구,반송제1동,반송제1동제3투,1092,657,192,420,37,3,1,653,4,435,29.402756508422666,64.31852986217457,5.66615620214395,0.45941807044410415,0.1531393568147014
92,부산광역시,해운대구,반송제1동,반송제1동제4투,1150,674,165,464,34,3,3,669,5,476,24.663677130044842,69.35724962630793,5.082212257100149,0.4484304932735426,0.4484304932735426
93,부산광역시,해운대구,반송제1동,반송제1동제5투,1287,703,181,482,31,4,0,698,5,584,25.931232091690543,69.05444126074498,4.441260744985674,0.5730659025787965,0.0
94,부산광역시,해운대구,반송제1동,반송제1동제6투,1357,764,215,492,43,8,1,759,5,593,28.326745718050066,64.82213438735178,5.665349143610013,1.0540184453227932,0.13175230566534915
95,부산광역시,해운대구,반송제1동,반송제1동제7투,179,122,24,92,4,0,0,120,2,57,20.0,76.66666666666667,3.3333333333333335,0.0,0.0
96,부산광역시,해운대구,반송제2동,관내사전투표,4758,4758,2475,2051,174,24,7,4731,27,0,52.3145212428662,43.35235679560346,3.6778693722257447,0.507292327203551,0.14796026210103572
97,부산광역시,해운대구,반송제2동,반송제2동제1투,1720,1168,281,828,47,5,1,1162,6,552,24.182444061962137,71.25645438898451,4.044750430292599,0.4302925989672977,0.08605851979345956
98,부산광역시,해운대구,반송제2동,반송제2동제2투,2092,1297,393,816,77,5,1,1292,5,795,30.41795665634675,63.1578947368421,5.959752321981425,0.38699690402476783,0.07739938080495357
99,부산광역시,해운대구,반송제2동,반송제2동제3투,1206,657,171,448,33,1,1,654,3,549,26.146788990825687,68.50152905198776,5.045871559633028,0.1529051987767584,0.1529051987767584
100,부산광역시,해운대구,반송제2동,반송제2동제4투,2332,1491,446,966,60,6,3,1481,10,841,30.114787305874408,65.22619851451722,4.051316677920324,0.4051316677920324,0.2025658338960162
101,부산광역시,해운대구,반송제2동,반송제2동제5투,2220,1477,407,980,74,5,3,1469,8,743,27.705922396187884,66.71204901293397,5.037440435670524,0.3403675970047651,0.2042205582028591
102,부산광역시,해운대구,반송제2동,반송제2동제6투,1381,822,200,581,22,5,2,810,12,559,24.691358024691358,71.7283950617284,2.7160493827160495,0.6172839506172839,0.24691358024691357
103,부산광역시,해운대구,반송제2동,반송제2동제7투,1969,1245,393,762,69,12,3,1239,6,724,31.719128329297817,61.50121065375303,5.569007263922518,0.9685230024213075,0.24213075060532688
104,부산광역시,해운대구,재송제1동,관내사전투표,5090,5090,2845,1814,364,30,4,5057,33,0,56.258651374332615,35.87106980423176,7.197943444730077,0.5932370970931382,0.07909827961241843
105,부산광역시,해운대구,재송제1동,재송제1동제1투,2982,1841,452,1185,170,14,2,1823,18,1141,24.794295117937466,65.00274273176083,9.325287986834887,0.7679648930334613,0.10970927043335163
106,부산광역시,해운대구,재송제1동,재송제1동제2투,2626,1724,429,1149,111,21,2,1712,12,902,25.058411214953267,67.11448598130842,6.483644859813084,1.2266355140186915,0.11682242990654204
107,부산광역시,해운대구,재송제1동,재송제1동제3투,2222,1470,425,945,80,13,1,1464,6,752,29.030054644808743,64.54918032786885,5.46448087431694,0.8879781420765027,0.06830601092896176
108,부산광역시,해운대구,재송제1동,재송제1동제4투,3351,2610,1036,1325,220,16,0,2597,13,741,39.892183288409704,51.02040816326531,8.471313053523296,0.6160954948016942,0.0
109,부산광역시,해운대구,재송제1동,재송제1동제5투,3745,2831,717,1809,261,28,0,2815,16,914,25.47069271758437,64.26287744227353,9.271758436944937,0.9946714031971581,0.0
110,부산광역시,해운대구,재송제1동,재송제1동제6투,3394,2511,630,1600,251,19,1,2501,10,883,25.189924030387843,63.974410235905644,10.035985605757697,0.7596961215513794,0.03998400639744103
111,부산광역시,해운대구,재송제1동,재송제1동제7투,2212,1800,681,951,137,20,1,1790,10,412,38.04469273743017,53.12849162011173,7.653631284916202,1.1173184357541899,0.055865921787709494
112,부산광역시,해운대구,재송제2동,관내사전투표,3751,3751,2200,1302,191,28,2,3723,28,0,59.092130002686005,34.971796937953265,5.13027128659683,0.75208165457964,0.05372011818426001
113,부산광역시,해운대구,재송제2동,재송제2동제1투,1820,1100,303,698,81,9,1,1092,8,720,27.747252747252748,63.91941391941391,7.417582417582418,0.8241758241758242,0.09157509157509157
114,부산광역시,해운대구,재송제2동,재송제2동제2투,1543,903,254,573,61,11,0,899,4,640,28.25361512791991,63.73748609566184,6.7853170189099,1.2235817575083427,0.0
115,부산광역시,해운대구,재송제2동,재송제2동제3투,2064,1304,400,802,78,11,1,1292,12,760,30.959752321981426,62.07430340557275,6.037151702786378,0.8513931888544891,0.07739938080495357
116,부산광역시,해운대구,재송제2동,재송제2동제4투,1918,1297,382,806,85,9,4,1286,11,621,29.704510108864696,62.674961119751174,6.60964230171073,0.6998444790046656,0.3110419906687403
117,부산광역시,해운대구,재송제2동,재송제2동제5투,833,538,183,314,32,7,1,537,1,295,34.07821229050279,58.47299813780261,5.95903165735568,1.303538175046555,0.186219739292365
118,부산광역시,해운대구,재송제2동,재송제2동제6투,1434,884,262,560,53,3,0,878,6,550,29.84054669703872,63.781321184510254,6.0364464692482915,0.3416856492027335,0.0
119,부산광역시,해운대구,재송제2동,재송제2동제7투,2147,1428,454,865,90,9,2,1420,8,719,31.971830985915496,60.91549295774647,6.338028169014084,0.6338028169014085,0.14084507042253522
120,부산광역시,해운대구,재송제2동,재송제2동제8투,2060,1466,543,839,62,7,2,1453,13,594,37.37095664143152,57.742601514108735,4.267033723331039,0.4817618719889883,0.13764624913971094
121,부산광역시,해운대구,잘못 투입·구분된 투표지,,0,0,0,0,0,0,0,0,0,0,0.0,0.0,0.0,0.0,0.0
0,부산광역시,기장군,거소·선상투표,,417,397,101,225,46,3,2,377,20,20,26.790450928381965,59.6816976127321,12.20159151193634,0.7957559681697612,0.5305039787798408
1,부산광역시,기장군,관외사전투표,,14111,14111,7360,4842,1652,125,19,13998,113,0,52.57893984854979,34.59065580797257,11.801685955136449,0.8929847121017288,0.13573367623946278
2,부산광역시,기장군,재외투표,,630,499,320,116,52,9,0,497,2,131,64.38631790744466,23.340040241448694,10.46277665995976,1.8108651911468814,0.0
3,부산광역시,기장군,기장읍,관내사전투표,8467,8467,4683,3228,450,52,2,8415,52,0,55.650623885918,38.36007130124777,5.347593582887701,0.6179441473559121,0.023767082590612002
4,부산광역시,기장군,기장읍,기장읍제1투,2564,1594,512,958,93,15,2,1580,14,970,32.40506329113924,60.63291139240506,5.886075949367089,0.949367088607595,0.12658227848101267
5,부산광역시,기장군,기장읍,기장읍제2투,3143,2068,628,1270,133,22,0,2053,15,1075,30.589381393083293,61.860691670725764,6.478324403312226,1.071602532878714,0.0
6,부산광역시,기장군,기장읍,기장읍제3투,2831,1992,738,1072,145,19,4,1978,14,839,37.31041456016178,54.19615773508595,7.330637007077856,0.9605662285136503,0.20222446916076847
7,부산광역시,기장군,기장읍,기장읍제4투,3714,2264,680,1411,130,20,5,2246,18,1450,30.27604630454141,62.822796081923414,5.78806767586821,0.8904719501335707,0.22261798753339268
8,부산광역시,기장군,기장읍,기장읍제5투,2506,1572,485,978,90,10,1,1564,8,934,31.01023017902813,62.53196930946292,5.754475703324808,0.639386189258312,0.0639386189258312
9,부산광역시,기장군,기장읍,기장읍제6투,3422,2018,591,1241,151,19,2,2004,14,1404,29.491017964071858,61.92614770459082,7.53493013972056,0.9481037924151697,0.09980039920159679
10,부산광역시,기장군,기장읍,기장읍제7투,3417,2395,627,1629,113,14,4,2387,8,1022,26.26728110599078,68.24465856723921,4.733975701717638,0.5865102639296188,0.1675743611227482
11,부산광역시,기장군,기장읍,기장읍제8투,2862,1620,469,984,141,10,1,1605,15,1242,29.221183800623052,61.308411214953274,8.785046728971963,0.6230529595015576,0.06230529595015576
12,부산광역시,기장군,기장읍,기장읍제9투,1386,865,200,641,17,2,1,861,4,521,23.228803716608596,74.44831591173055,1.9744483159117305,0.23228803716608595,0.11614401858304298
13,부산광역시,기장군,기장읍,기장읍제10투,2099,1434,391,939,83,9,3,1425,9,665,27.43859649122807,65.89473684210526,5.824561403508772,0.631578947368421,0.21052631578947367
14,부산광역시,기장군,기장읍,기장읍제11투,446,292,49,233,7,1,0,290,2,154,16.896551724137932,80.3448275862069,2.413793103448276,0.3448275862068966,0.0
15,부산광역시,기장군,기장읍,기장읍제12투,649,613,3,608,0,0,0,611,2,36,0.4909983633387889,99.50900163666121,0.0,0.0,0.0
16,부산광역시,기장군,기장읍,기장읍제13투,2232,1152,294,740,99,8,1,1142,10,1080,25.74430823117338,64.79859894921191,8.669001751313484,0.7005253940455342,0.08756567425569177
17,부산광역시,기장군,기장읍,기장읍제14투,1731,1304,434,776,68,13,0,1291,13,427,33.61735089078234,60.108443067389615,5.267234701781565,1.0069713400464757,0.0
18,부산광역시,기장군,장안읍,관내사전투표,1904,1904,998,727,154,14,1,1894,10,0,52.692713833157335,38.384371700105596,8.130939809926083,0.7391763463569165,0.05279831045406547
19,부산광역시,기장군,장안읍,장안읍제1투,1274,823,134,637,44,3,1,819,4,451,16.36141636141636,77.77777777777779,5.372405372405373,0.3663003663003663,0.1221001221001221
20,부산광역시,기장군,장안읍,장안읍제2투,794,511,100,393,16,0,0,509,2,283,19.646365422396855,77.21021611001964,3.143418467583497,0.0,0.0
21,부산광역시,기장군,장안읍,장안읍제3투,648,389,94,269,18,0,1,382,7,259,24.60732984293194,70.41884816753927,4.712041884816754,0.0,0.2617801047120419
22,부산광역시,기장군,장안읍,장안읍제4투,996,633,141,444,36,4,1,626,7,363,22.523961661341854,70.92651757188499,5.7507987220447285,0.6389776357827476,0.1597444089456869
23,부산광역시,기장군,장안읍,장안읍제5투,1060,716,166,517,28,4,0,715,1,344,23.216783216783217,72.3076923076923,3.9160839160839163,0.5594405594405595,0.0
24,부산광역시,기장군,장안읍,장안읍제6투,853,723,192,391,126,3,1,713,10,130,26.928471248246844,54.83870967741935,17.67180925666199,0.42075736325385693,0.1402524544179523
25,부산광역시,기장군,정관읍,관내사전투표,11233,11233,7697,2726,690,67,4,11184,49,0,68.82153075822603,24.374105865522175,6.169527896995708,0.5990701001430615,0.035765379113018594
26,부산광역시,기장군,정관읍,정관읍제1투,3379,1908,727,970,183,8,3,1891,17,1471,38.44526705446854,51.29561078794289,9.67741935483871,0.42305658381808564,0.15864621893178213
27,부산광역시,기장군,정관읍,정관읍제2투,2536,1724,666,912,116,19,0,1713,11,812,38.879159369527144,53.239929947460595,6.771745475773497,1.1091652072387623,0.0
28,부산광역시,기장군,정관읍,정관읍제3투,521,375,81,278,12,2,1,374,1,146,21.65775401069519,74.33155080213903,3.2085561497326207,0.53475935828877,0.267379679144385
29,부산광역시,기장군,정관읍,정관읍제4투,3075,2268,1015,1042,174,24,3,2258,10,807,44.951284322409215,46.14703277236492,7.705934455270151,1.0628875110717448,0.1328609388839681
30,부산광역시,기장군,정관읍,정관읍제5투,3965,2878,1425,1192,210,27,3,2857,21,1087,49.877493874693734,41.72208610430522,7.350367518375919,0.9450472523626182,0.10500525026251313
31,부산광역시,기장군,정관읍,정관읍제6투,3160,2144,806,1180,131,10,1,2128,16,1016,37.87593984962406,55.45112781954887,6.156015037593985,0.4699248120300752,0.046992481203007516
32,부산광역시,기장군,정관읍,정관읍제7투,3125,2200,1103,889,177,19,2,2190,10,925,50.36529680365297,40.593607305936075,8.082191780821917,0.8675799086757991,0.091324200913242
33,부산광역시,기장군,정관읍,정관읍제8투,3957,2950,1392,1289,212,37,3,2933,17,1007,47.459938629389704,43.94817592908285,7.228094101602454,1.261506989430617,0.10228435049437436
34,부산광역시,기장군,정관읍,정관읍제9투,2582,1744,685,938,90,17,2,1732,12,838,39.54965357967667,54.15704387990762,5.196304849884527,0.9815242494226328,0.11547344110854503
35,부산광역시,기장군,정관읍,정관읍제10투,3365,2555,1239,1066,208,18,3,2534,21,810,48.89502762430939,42.06787687450671,8.208366219415943,0.7103393843725335,0.11838989739542227
36,부산광역시,기장군,정관읍,정관읍제11투,1871,1291,493,723,60,8,1,1285,6,580,38.36575875486382,56.264591439688715,4.669260700389105,0.622568093385214,0.07782101167315175
37,부산광역시,기장군,정관읍,정관읍제12투,2128,1410,603,690,102,9,0,1404,6,718,42.94871794871795,49.14529914529914,7.264957264957266,0.641025641025641,0.0
38,부산광역시,기장군,정관읍,정관읍제13투,1884,1248,507,613,104,17,0,1241,7,636,40.854149879129736,49.39564867042707,8.38033843674456,1.36986301369863,0.0
39,부산광역시,기장군,정관읍,정관읍제14투,2146,1380,605,664,90,11,0,1370,10,766,44.16058394160584,48.46715328467153,6.569343065693431,0.8029197080291971,0.0
40,부산광역시,기장군,정관읍,정관읍제15투,1981,1360,512,760,64,11,1,1348,12,621,37.98219584569733,56.37982195845698,4.747774480712167,0.8160237388724036,0.0741839762611276
41,부산광역시,기장군,정관읍,정관읍제16투,2685,1973,803,1021,116,19,2,1961,12,712,40.9484956654768,52.06527281998981,5.915349311575727,0.9688934217236104,0.10198878123406425
42,부산광역시,기장군,일광읍,관내사전투표,4573,4573,2551,1645,329,25,2,4552,21,0,56.04130052724078,36.13796133567663,7.227592267135326,0.5492091388400703,0.04393673110720562
43,부산광역시,기장군,일광읍,일광읍제1투,969,562,97,443,16,1,2,559,3,407,17.352415026833633,79.24865831842575,2.862254025044723,0.17889087656529518,0.35778175313059035
44,부산광역시,기장군,일광읍,일광읍제2투,1236,809,147,629,23,2,1,802,7,427,18.329177057356606,78.428927680798,2.8678304239401498,0.24937655860349126,0.12468827930174563
45,부산광역시,기장군,일광읍,일광읍제3투,381,273,46,205,17,2,0,270,3,108,17.037037037037038,75.92592592592592,6.296296296296296,0.7407407407407408,0.0
46,부산광역시,기장군,일광읍,일광읍제4투,514,360,51,292,16,1,0,360,0,154,14.166666666666666,81.11111111111111,4.444444444444445,0.2777777777777778,0.0
47,부산광역시,기장군,일광읍,일광읍제5투,2820,1903,446,1305,128,10,1,1890,13,917,23.597883597883598,69.04761904761905,6.772486772486773,0.5291005291005291,0.052910052910052914
48,부산광역시,기장군,일광읍,일광읍제6투,2744,2019,840,930,215,18,3,2006,13,725,41.874376869391824,46.360917248255234,10.717846460618146,0.897308075772682,0.14955134596211367
49,부산광역시,기장군,일광읍,일광읍제7투,3203,2327,882,1199,211,19,4,2315,12,876,38.09935205183586,51.792656587473004,9.114470842332613,0.8207343412526997,0.17278617710583152
50,부산광역시,기장군,일광읍,일광읍제8투,2667,2060,785,1006,237,18,2,2048,12,607,38.330078125,49.12109375,11.572265625,0.87890625,0.09765625
51,부산광역시,기장군,일광읍,일광읍제9투,2597,1930,735,1009,159,15,3,1921,9,667,38.26132222800624,52.52472670484123,8.27693909422176,0.7808433107756376,0.15616866215512754
52,부산광역시,기장군,철마면,관내사전투표,887,887,480,356,40,6,2,884,3,0,54.29864253393665,40.27149321266968,4.524886877828054,0.6787330316742082,0.22624434389140274
53,부산광역시,기장군,철마면,철마면제1투,1039,689,99,558,18,4,4,683,6,350,14.494875549048317,81.69838945827233,2.635431918008785,0.5856515373352855,0.5856515373352855
54,부산광역시,기장군,철마면,철마면제2투,749,537,129,365,34,2,0,530,7,212,24.339622641509433,68.86792452830188,6.415094339622642,0.37735849056603776,0.0
55,부산광역시,기장군,철마면,철마면제3투,3100,2177,705,1329,107,22,2,2165,12,923,32.5635103926097,61.38568129330254,4.9422632794457275,1.0161662817551964,0.09237875288683603
56,부산광역시,기장군,잘못 투입·구분된 투표지,,0,0,0,0,0,0,0,0,0,0,0.0,0.0,0.0,0.0,0.0
0,부산광역시,사하구,거소·선상투표,,618,585,225,231,94,8,5,563,22,33,39.96447602131439,41.03019538188277,16.69626998223801,1.4209591474245116,0.8880994671403196
1,부산광역시,사하구,관외사전투표,,19681,19680,10506,6397,2359,165,23,19450,230,1,54.01542416452442,32.88946015424165,12.12853470437018,0.8483290488431876,0.11825192802056556
2,부산광역시,사하구,재외투표,,1128,898,612,167,97,11,0,887,11,230,68.9966178128523,18.82750845546787,10.935738444193912,1.2401352874859075,0.0
3,부산광역시,사하구,괴정제1동,관내사전투표,3701,3701,2069,1399,184,27,2,3681,20,0,56.20755229557186,38.00597663678349,4.998641673458299,0.7334963325183375,0.05433306166802499
4,부산광역시,사하구,괴정제1동,괴정제1동제1투,1943,1281,329,882,58,7,0,1276,5,662,25.783699059561126,69.12225705329153,4.545454545454546,0.54858934169279,0.0
5,부산광역시,사하구,괴정제1동,괴정제1동제2투,2206,1468,340,1044,58,13,4,1459,9,738,23.303632625085672,71.55586017820424,3.9753255654557917,0.8910212474297465,0.2741603838245374
6,부산광역시,사하구,괴정제1동,괴정제1동제3투,2448,1653,439,1097,104,6,3,1649,4,795,26.622195269860523,66.52516676773801,6.306852637962401,0.3638568829593693,0.18192844147968465
7,부산광역시,사하구,괴정제1동,괴정제1동제4투,1753,1219,333,776,85,11,2,1207,12,534,27.5890637945319,64.29163214581607,7.042253521126761,0.9113504556752278,0.16570008285004142
8,부산광역시,사하구,괴정제1동,괴정제1동제5투,2016,1373,436,854,68,7,2,1367,6,643,31.894659839063642,62.472567666422826,4.974396488661302,0.5120702267739575,0.1463057790782736
9,부산광역시,사하구,괴정제2동,관내사전투표,2254,2254,1341,791,100,11,1,2244,10,0,59.759358288770045,35.249554367201426,4.45632798573975,0.49019607843137253,0.044563279857397504
10,부산광역시,사하구,괴정제2동,괴정제2동제1투,1826,1182,342,773,48,7,0,1170,12,644,29.230769230769234,66.06837606837607,4.102564102564102,0.5982905982905984,0.0
11,부산광역시,사하구,괴정제2동,괴정제2동제2투,3006,2179,766,1220,157,19,1,2163,16,827,35.41377716134998,56.40314378178456,7.258437355524734,0.8784096162736941,0.04623208506703652
12,부산광역시,사하구,괴정제2동,괴정제2동제3투,2291,1391,336,940,88,17,1,1382,9,900,24.312590448625183,68.01736613603472,6.367583212735166,1.2301013024602026,0.0723589001447178
13,부산광역시,사하구,괴정제2동,괴정제2동제4투,1776,1192,343,781,44,15,4,1187,5,584,28.89637742207245,65.79612468407751,3.7068239258635214,1.2636899747262005,0.33698399326032014
14,부산광역시,사하구,괴정제3동,관내사전투표,2831,2831,1512,1164,128,16,2,2822,9,0,53.579021970233875,41.24734231041815,4.5357902197023385,0.5669737774627923,0.07087172218284904
15,부산광역시,사하구,괴정제3동,괴정제3동제1투,2254,1422,373,932,89,12,2,1408,14,832,26.49147727272727,66.19318181818183,6.3210227272727275,0.8522727272727272,0.14204545454545456
16,부산광역시,사하구,괴정제3동,괴정제3동제2투,2207,1457,361,991,86,8,1,1447,10,750,24.948168624740845,68.48652384243262,5.9433310297166555,0.55286800276434,0.0691085003455425
17,부산광역시,사하구,괴정제3동,괴정제3동제3투,2682,1793,513,1144,101,19,1,1778,15,889,28.852643419572555,64.34195725534309,5.680539932508436,1.0686164229471318,0.05624296962879641
18,부산광역시,사하구,괴정제4동,관내사전투표,2733,2733,1561,984,165,8,0,2718,15,0,57.431935246504786,36.20309050772627,6.070640176600441,0.29433406916850624,0.0
19,부산광역시,사하구,괴정제4동,괴정제4동제1투,2280,1563,431,1021,90,6,2,1550,13,717,27.806451612903228,65.87096774193549,5.806451612903226,0.3870967741935484,0.12903225806451613
20,부산광역시,사하구,괴정제4동,괴정제4동제2투,2255,1557,467,970,103,10,0,1550,7,698,30.129032258064512,62.58064516129033,6.645161290322581,0.6451612903225806,0.0
21,부산광역시,사하구,괴정제4동,괴정제4동제3투,1038,682,169,461,36,6,2,674,8,356,25.07418397626113,68.39762611275965,5.341246290801187,0.8902077151335311,0.2967359050445104
22,부산광역시,사하구,괴정제4동,괴정제4동제4투,2951,2161,792,1175,164,19,1,2151,10,790,36.82008368200837,54.62575546257554,7.624360762436076,0.8833100883310088,0.046490004649000466
23,부산광역시,사하구,당리동,관내사전투표,5064,5064,2882,1790,326,34,5,5037,27,0,57.216597180861626,35.53702600754418,6.472106412547152,0.6750049632717888,0.09926543577526306
24,부산광역시,사하구,당리동,당리동제1투,2857,2153,776,1201,140,15,1,2133,20,704,36.380684481950304,56.30567276136896,6.563525550867324,0.7032348804500703,0.04688232536333802
25,부산광역시,사하구,당리동,당리동제2투,2140,1482,429,943,85,15,1,1473,9,658,29.124236252545828,64.01900882552613,5.770536320434488,1.0183299389002036,0.0678886625933469
26,부산광역시,사하구,당리동,당리동제3투,1817,1223,314,833,59,8,2,1216,7,594,25.822368421052634,68.50328947368422,4.8519736842105265,0.6578947368421052,0.1644736842105263
27,부산광역시,사하구,당리동,당리동제4투,2043,1335,382,856,71,15,0,1324,11,708,28.851963746223564,64.6525679758308,5.362537764350453,1.1329305135951662,0.0
28,부산광역시,사하구,당리동,당리동제5투,1604,1075,308,682,67,9,2,1068,7,529,28.83895131086142,63.857677902621724,6.273408239700375,0.8426966292134831,0.18726591760299627
29,부산광역시,사하구,당리동,당리동제6투,1949,1392,402,888,89,6,1,1386,6,557,29.004329004329005,64.06926406926407,6.421356421356421,0.4329004329004329,0.07215007215007214
30,부산광역시,사하구,당리동,당리동제7투,1844,1287,354,836,80,6,0,1276,11,557,27.74294670846395,65.51724137931035,6.269592476489027,0.4702194357366771,0.0
31,부산광역시,사하구,하단제1동,관내사전투표,4351,4351,2454,1450,388,37,5,4334,17,0,56.62205814490079,33.456391324411626,8.952468850946008,0.8537148131056761,0.11536686663590216
32,부산광역시,사하구,하단제1동,하단제1동제1투,2156,1393,368,899,98,11,2,1378,15,763,26.705370101596515,65.23947750362845,7.111756168359943,0.7982583454281567,0.14513788098693758
33,부산광역시,사하구,하단제1동,하단제1동제2투,2747,1581,453,941,159,11,3,1567,14,1166,28.90874282067645,60.051052967453735,10.146777281429484,0.7019783024888321,0.1914486279514997
34,부산광역시,사하구,하단제1동,하단제1동제3투,3187,1967,582,1167,183,17,0,1949,18,1220,29.86146741918933,59.876859928168294,9.389430477167778,0.8722421754746024,0.0
35,부산광역시,사하구,하단제1동,하단제1동제4투,2823,2229,772,1287,135,21,2,2217,12,594,34.82183130356337,58.05142083897158,6.089309878213803,0.9472259810554804,0.09021199819576003
36,부산광역시,사하구,하단제1동,하단제1동제5투,2360,1854,626,1084,122,12,1,1845,9,506,33.92953929539295,58.75338753387533,6.612466124661247,0.6504065040650406,0.05420054200542006
37,부산광역시,사하구,하단제2동,관내사전투표,3609,3609,2108,1135,317,27,2,3589,20,0,58.735023683477294,31.62440791306771,8.832543884090276,0.7522986904430203,0.05572582892170522
38,부산광역시,사하구,하단제2동,하단제2동제1투,2673,1859,535,1178,115,19,3,1850,9,814,28.91891891891892,63.67567567567568,6.216216216216217,1.027027027027027,0.16216216216216214
39,부산광역시,사하구,하단제2동,하단제2동제2투,3796,2446,671,1495,241,19,3,2429,17,1350,27.624536846438865,61.547962124331,9.921778509674763,0.7822149032523672,0.12350761630300536
40,부산광역시,사하구,하단제2동,하단제2동제3투,3394,1996,552,1189,222,14,1,1978,18,1398,27.906976744186046,60.111223458038424,11.223458038422649,0.7077856420626896,0.05055611729019212
41,부산광역시,사하구,하단제2동,하단제2동제4투,3852,2631,752,1547,273,27,4,2603,28,1221,28.8897426046869,59.43142527852478,10.487898578563195,1.0372646945831734,0.1536688436419516
42,부산광역시,사하구,하단제2동,하단제2동제5투,2619,1878,615,1080,163,8,1,1867,11,741,32.94054633101232,57.84681306909481,8.730583824317087,0.42849491162292447,0.05356186395286556
43,부산광역시,사하구,신평제1동,관내사전투표,3580,3580,2069,1247,215,27,1,3559,21,0,58.13430738971621,35.037932003371736,6.041022759202023,0.7586400674346727,0.02809778027535825
44,부산광역시,사하구,신평제1동,신평제1동제1투,3294,2207,790,1240,142,21,2,2195,12,1087,35.99088838268793,56.49202733485193,6.469248291571754,0.9567198177676537,0.09111617312072894
45,부산광역시,사하구,신평제1동,신평제1동제2투,2067,1258,375,811,46,12,4,1248,10,809,30.048076923076923,64.98397435897436,3.685897435897436,0.9615384615384616,0.3205128205128205
46,부산광역시,사하구,신평제1동,신평제1동제3투,2038,1168,330,749,69,8,1,1157,11,870,28.522039757994815,64.73638720829732,5.963699222126189,0.6914433880726015,0.08643042350907519
47,부산광역시,사하구,신평제1동,신평제1동제4투,2121,1361,423,858,67,5,1,1354,7,760,31.240768094534708,63.36779911373708,4.948301329394387,0.3692762186115214,0.07385524372230429
48,부산광역시,사하구,신평제2동,관내사전투표,3902,3902,2324,1234,267,44,4,3873,29,0,60.00516395558998,31.861605990188487,6.893880712625871,1.136070229796024,0.10327911179963851
49,부산광역시,사하구,신평제2동,신평제2동제1투,1959,1094,317,681,73,10,4,1085,9,865,29.216589861751153,62.764976958525345,6.728110599078341,0.9216589861751152,0.3686635944700461
50,부산광역시,사하구,신평제2동,신평제2동제2투,2755,2043,675,1203,129,23,2,2032,11,712,33.218503937007874,59.20275590551181,6.3484251968503935,1.1318897637795275,0.09842519685039369
51,부산광역시,사하구,신평제2동,신평제2동제3투,2117,1498,497,846,130,10,1,1484,14,619,33.490566037735846,57.00808625336927,8.76010781671159,0.6738544474393532,0.06738544474393532
52,부산광역시,사하구,신평제2동,신평제2동제4투,3181,2258,793,1248,183,23,2,2249,9,923,35.26011560693642,55.49132947976878,8.136949755446865,1.0226767452200978,0.08892841262783459
53,부산광역시,사하구,장림제1동,관내사전투표,3322,3322,2010,1068,199,23,2,3302,20,0,60.87219866747425,32.34403391883707,6.026650514839491,0.6965475469412478,0.06056935190793458
54,부산광역시,사하구,장림제1동,장림제1동제1투,2909,1965,655,1093,181,18,2,1949,16,944,33.6069779374038,56.08004104669061,9.286813750641354,0.9235505387378143,0.1026167265264238
55,부산광역시,사하구,장림제1동,장림제1동제2투,1829,1029,282,675,54,5,1,1017,12,800,27.728613569321535,66.3716814159292,5.3097345132743365,0.4916420845624385,0.09832841691248771
56,부산광역시,사하구,장림제1동,장림제1동제3투,3093,2176,983,1029,138,17,2,2169,7,917,45.320424158598435,47.441217150760714,6.36237897648686,0.7837713231904103,0.09220839096357768
57,부산광역시,사하구,장림제2동,관내사전투표,3629,3628,2150,1263,170,28,1,3612,16,1,59.523809523809526,34.966777408637874,4.706533776301218,0.7751937984496124,0.02768549280177187
58,부산광역시,사하구,장림제2동,장림제2동제1투,1944,1050,273,696,66,8,1,1044,6,894,26.14942528735632,66.66666666666666,6.321839080459771,0.7662835249042145,0.09578544061302681
59,부산광역시,사하구,장림제2동,장림제2동제2투,2413,1628,613,865,113,24,2,1617,11,785,37.90970933828077,53.49412492269635,6.988249845392702,1.4842300556586272,0.12368583797155226
60,부산광역시,사하구,장림제2동,장림제2동제3투,2541,1712,614,969,108,15,2,1708,4,829,35.94847775175644,56.733021077283375,6.323185011709602,0.8782201405152225,0.117096018735363
61,부산광역시,사하구,장림제2동,장림제2동제4투,2481,1651,512,1026,90,13,1,1642,9,830,31.181485992691837,62.48477466504263,5.481120584652863,0.7917174177831912,0.06090133982947624
62,부산광역시,사하구,장림제2동,장림제2동제5투,3581,2392,845,1315,199,20,1,2380,12,1189,35.50420168067227,55.25210084033614,8.361344537815125,0.8403361344537815,0.04201680672268908
63,부산광역시,사하구,장림제2동,장림제2동제6투,3230,2183,847,1170,131,18,0,2166,17,1047,39.10433979686057,54.016620498614955,6.048014773776546,0.8310249307479225,0.0
64,부산광역시,사하구,다대제1동,관내사전투표,5293,5293,3319,1636,281,33,4,5273,20,0,62.94329603641191,31.025981414754412,5.329034705101461,0.6258296984638726,0.07585814526834819
65,부산광역시,사하구,다대제1동,다대제1동제1투,2407,1579,469,987,107,10,2,1575,4,828,29.777777777777775,62.66666666666667,6.7936507936507935,0.6349206349206349,0.12698412698412698
66,부산광역시,사하구,다대제1동,다대제1동제2투,2201,1401,399,890,89,13,0,1391,10,800,28.6843997124371,63.982746225736875,6.398274622573688,0.9345794392523363,0.0
67,부산광역시,사하구,다대제1동,다대제1동제3투,1540,992,301,622,58,6,0,987,5,548,30.49645390070922,63.0192502532928,5.8763931104356635,0.60790273556231,0.0
68,부산광역시,사하구,다대제1동,다대제1동제4투,2044,1521,559,865,82,6,1,1513,8,523,36.94646397884997,57.17118307997357,5.419695968274951,0.39656311962987445,0.06609385327164573
69,부산광역시,사하구,다대제1동,다대제1동제5투,2141,1448,519,836,77,11,0,1443,5,693,35.96673596673597,57.93485793485793,5.336105336105336,0.7623007623007623,0.0
70,부산광역시,사하구,다대제1동,다대제1동제6투,1661,1025,440,509,53,10,2,1014,11,636,43.39250493096647,50.197238658777124,5.226824457593689,0.9861932938856016,0.19723865877712032
71,부산광역시,사하구,다대제1동,다대제1동제7투,2352,1773,571,1075,109,10,2,1767,6,579,32.314657611771366,60.837577815506506,6.168647425014148,0.5659309564233164,0.11318619128466327
72,부산광역시,사하구,다대제1동,다대제1동제8투,2674,1690,536,1054,82,8,0,1680,10,984,31.9047619047619,62.73809523809524,4.880952380952381,0.4761904761904762,0.0
73,부산광역시,사하구,다대제1동,다대제1동제9투,3099,2289,944,1155,156,12,5,2272,17,810,41.54929577464789,50.8362676056338,6.866197183098592,0.528169014084507,0.22007042253521128
74,부산광역시,사하구,다대제1동,다대제1동제10투,2428,1886,827,928,108,9,4,1876,10,542,44.083155650319824,49.46695095948827,5.756929637526652,0.4797441364605544,0.21321961620469082
75,부산광역시,사하구,다대제2동,관내사전투표,5088,5088,2959,1774,296,31,1,5061,27,0,58.466706184548514,35.05236119344003,5.848646512546927,0.6125271685437661,0.019758940920766646
76,부산광역시,사하구,다대제2동,다대제2동제1투,1865,1422,527,779,89,16,4,1415,7,443,37.24381625441696,55.0530035335689,6.289752650176679,1.1307420494699647,0.2826855123674912
77,부산광역시,사하구,다대제2동,다대제2동제2투,2020,1582,518,940,99,13,0,1570,12,438,32.9936305732484,59.87261146496815,6.305732484076433,0.8280254777070064,0.0
78,부산광역시,사하구,다대제2동,다대제2동제3투,2093,1367,358,920,63,15,2,1358,9,726,26.362297496318117,67.74668630338734,4.639175257731959,1.1045655375552283,0.14727540500736377
79,부산광역시,사하구,다대제2동,다대제2동제4투,2109,1393,495,804,73,8,2,1382,11,716,35.817655571635306,58.17655571635311,5.2821997105644,0.5788712011577424,0.1447178002894356
80,부산광역시,사하구,다대제2동,다대제2동제5투,3072,2129,632,1319,152,18,0,2121,8,943,29.797265440829797,62.187647336162186,7.166430928807166,0.8486562942008486,0.0
81,부산광역시,사하구,다대제2동,다대제2동제6투,2591,1890,605,1132,131,13,1,1882,8,701,32.146652497343254,60.148777895855474,6.9606801275239105,0.6907545164718385,0.053134962805526036
82,부산광역시,사하구,다대제2동,다대제2동제7투,1858,1102,294,746,35,9,3,1087,15,756,27.04691812327507,68.62925482980681,3.219871205151794,0.8279668813247469,0.27598896044158233
83,부산광역시,사하구,구평동,관내사전투표,2181,2181,1364,656,125,16,4,2165,16,0,63.00230946882217,30.300230946882216,5.773672055427252,0.7390300230946882,0.18475750577367206
84,부산광역시,사하구,구평동,구평동제1투,1586,1175,479,605,76,5,1,1166,9,411,41.080617495711834,51.886792452830186,6.518010291595197,0.42881646655231564,0.08576329331046312
85,부산광역시,사하구,구평동,구평동제2투,1733,1119,283,769,50,8,1,1111,8,614,25.472547254725477,69.21692169216922,4.5004500450045,0.7200720072007201,0.09000900090009001
86,부산광역시,사하구,구평동,구평동제3투,209,130,27,95,4,3,0,129,1,79,20.930232558139537,73.64341085271317,3.10077519379845,2.3255813953488373,0.0
87,부산광역시,사하구,구평동,구평동제4투,3597,2416,877,1284,206,30,1,2398,18,1181,36.5721434528774,53.544620517097584,8.590492076730609,1.2510425354462051,0.041701417848206836
88,부산광역시,사하구,감천제1동,관내사전투표,3202,3202,1794,1208,151,27,4,3184,18,0,56.34422110552764,37.93969849246231,4.742462311557789,0.8479899497487438,0.12562814070351758
89,부산광역시,사하구,감천제1동,감천제1동제1투,1814,1082,288,724,49,10,2,1073,9,732,26.84063373718546,67.47437092264678,4.566635601118359,0.9319664492078285,0.1863932898415657
90,부산광역시,사하구,감천제1동,감천제1동제2투,1658,1019,260,698,46,7,2,1013,6,639,25.666337611056267,68.90424481737413,4.54096742349457,0.6910167818361304,0.19743336623889435
91,부산광역시,사하구,감천제1동,감천제1동제3투,1596,950,281,606,46,6,2,941,9,646,29.861849096705633,64.39957492029755,4.888416578108395,0.6376195536663124,0.21253985122210414
92,부산광역시,사하구,감천제1동,감천제1동제4투,1604,1229,481,656,67,9,4,1217,12,375,39.52341824157765,53.90304026294166,5.5053410024650775,0.7395234182415776,0.3286770747740345
93,부산광역시,사하구,감천제1동,감천제1동제5투,1985,1396,463,820,84,14,2,1383,13,589,33.47794649313087,59.291395516992054,6.073752711496746,1.0122921185827911,0.14461315979754158
94,부산광역시,사하구,감천제1동,감천제1동제6투,2027,1454,428,941,68,7,1,1445,9,573,29.619377162629757,65.12110726643598,4.705882352941177,0.4844290657439446,0.06920415224913494
95,부산광역시,사하구,감천제2동,관내사전투표,776,776,381,353,27,5,2,768,8,0,49.609375,45.96354166666667,3.515625,0.6510416666666667,0.26041666666666663
96,부산광역시,사하구,감천제2동,감천제2동제1투,1312,700,181,477,31,4,2,695,5,612,26.0431654676259,68.63309352517986,4.460431654676259,0.5755395683453237,0.28776978417266186
97,부산광역시,사하구,감천제2동,감천제2동제2투,1184,735,196,501,25,3,3,728,7,449,26.923076923076923,68.81868131868131,3.4340659340659343,0.4120879120879121,0.4120879120879121
98,부산광역시,사하구,감천제2동,감천제2동제3투,846,478,141,317,10,2,2,472,6,368,29.8728813559322,67.16101694915254,2.11864406779661,0.423728813559322,0.423728813559322
99,부산광역시,사하구,잘못 투입·구분된 투표지,,0,0,0,0,0,0,0,0,0,0,0.0,0.0,0.0,0.0,0.0
0,부산광역시,금정구,거소·선상투표,,382,354,128,148,60,2,2,340,14,28,37.64705882352941,43.529411764705884,17.647058823529413,0.5882352941176471,0.5882352941176471
1,부산광역시,금정구,관외사전투표,,16316,16316,8392,5445,2111,191,16,16155,161,0,51.946765707211384,33.70473537604457,13.067161869390281,1.1822965026307646,0.09904054472299599
2,부산광역시,금정구,재외투표,,1199,979,634,231,98,9,0,972,7,220,65.22633744855966,23.765432098765434,10.08230452674897,0.9259259259259258,0.0
3,부산광역시,금정구,서제1동,관내사전투표,923,923,469,411,26,9,2,917,6,0,51.14503816793893,44.82006543075245,2.8353326063249726,0.9814612868047983,0.21810250817884408
4,부산광역시,금정구,서제1동,서제1동제1투,1910,1188,278,843,45,8,3,1177,11,722,23.619371282922685,71.62276975361087,3.8232795242141036,0.6796941376380629,0.2548853016142736
5,부산광역시,금정구,서제1동,서제1동제2투,895,562,166,353,33,2,0,554,8,333,29.96389891696751,63.718411552346566,5.956678700361011,0.36101083032490977,0.0
6,부산광역시,금정구,서제2동,관내사전투표,1664,1664,784,783,80,9,0,1656,8,0,47.34299516908212,47.28260869565217,4.830917874396135,0.5434782608695652,0.0
7,부산광역시,금정구,서제2동,서제2동제1투,1799,1237,366,796,60,6,0,1228,9,562,29.80456026058632,64.82084690553745,4.88599348534202,0.4885993485342019,0.0
8,부산광역시,금정구,서제2동,서제2동제2투,1617,1009,222,732,43,4,1,1002,7,608,22.15568862275449,73.05389221556887,4.291417165668663,0.39920159680638717,0.09980039920159679
9,부산광역시,금정구,서제2동,서제2동제3투,1774,1109,305,730,59,8,1,1103,6,665,27.651858567543066,66.18313689936537,5.349048050770626,0.7252946509519492,0.09066183136899365
10,부산광역시,금정구,서제3동,관내사전투표,2426,2426,1154,1177,74,8,2,2415,11,0,47.784679089026916,48.737060041407865,3.064182194616977,0.33126293995859213,0.08281573498964803
11,부산광역시,금정구,서제3동,서제3동제1투,1584,973,231,695,32,8,2,968,5,611,23.863636363636363,71.79752066115702,3.3057851239669422,0.8264462809917356,0.2066115702479339
12,부산광역시,금정구,서제3동,서제3동제2투,1551,988,265,647,67,4,1,984,4,563,26.93089430894309,65.7520325203252,6.808943089430894,0.40650406504065045,0.10162601626016261
13,부산광역시,금정구,서제3동,서제3동제3투,2913,1713,369,1238,81,12,2,1702,11,1200,21.680376028202115,72.73795534665099,4.759106933019976,0.7050528789659225,0.11750881316098707
14,부산광역시,금정구,금사회동동,관내사전투표,1913,1913,917,887,83,13,3,1903,10,0,48.18707304256437,46.610614818707305,4.361534419337888,0.6831318970047293,0.1576458223857068
15,부산광역시,금정구,금사회동동,금사회동동제1투,1287,783,174,568,34,4,1,781,2,504,22.279129321382843,72.72727272727273,4.353393085787452,0.5121638924455826,0.12804097311139565
16,부산광역시,금정구,금사회동동,금사회동동제2투,1694,1054,250,739,54,2,1,1046,8,640,23.900573613766728,70.65009560229446,5.162523900573614,0.19120458891013384,0.09560229445506692
17,부산광역시,금정구,금사회동동,금사회동동제3투,1328,891,217,611,47,7,1,883,8,437,24.575311438278597,69.19592298980749,5.322763306908267,0.7927519818799547,0.11325028312570783
18,부산광역시,금정구,부곡제1동,관내사전투표,2392,2392,1217,1011,125,20,3,2376,16,0,51.22053872053872,42.55050505050505,5.260942760942761,0.8417508417508417,0.12626262626262627
19,부산광역시,금정구,부곡제1동,부곡제1동제1투,3061,1920,390,1397,111,16,0,1914,6,1141,20.37617554858934,72.98850574712644,5.799373040752351,0.8359456635318705,0.0
20,부산광역시,금정구,부곡제1동,부곡제1동제2투,1288,836,230,578,20,5,0,833,3,452,27.611044417767104,69.38775510204081,2.4009603841536618,0.6002400960384154,0.0
21,부산광역시,금정구,부곡제2동,관내사전투표,3112,3112,1714,1118,228,32,3,3095,17,0,55.37964458804523,36.12277867528271,7.366720516962843,1.0339256865912763,0.09693053311793215
22,부산광역시,금정구,부곡제2동,부곡제2동제1투,1448,973,285,609,69,5,1,969,4,475,29.411764705882355,62.848297213622295,7.120743034055728,0.5159958720330238,0.10319917440660474
23,부산광역시,금정구,부곡제2동,부곡제2동제2투,2374,1571,361,1065,122,11,3,1562,9,803,23.111395646606915,68.18181818181817,7.810499359795134,0.7042253521126761,0.19206145966709345
24,부산광역시,금정구,부곡제2동,부곡제2동제3투,3187,2265,626,1419,176,22,4,2247,18,922,27.859368046283933,63.150867823765026,7.832665776591011,0.9790832220738763,0.1780151312861593
25,부산광역시,금정구,부곡제2동,부곡제2동제4투,2908,2358,774,1406,149,18,1,2348,10,550,32.96422487223168,59.88074957410562,6.345826235093696,0.7666098807495741,0.04258943781942078
26,부산광역시,금정구,부곡제3동,관내사전투표,4351,4351,2457,1452,363,46,2,4320,31,0,56.875,33.611111111111114,8.402777777777779,1.0648148148148149,0.0462962962962963
27,부산광역시,금정구,부곡제3동,부곡제3동제1투,786,551,140,373,33,2,0,548,3,235,25.547445255474454,68.06569343065694,6.021897810218978,0.36496350364963503,0.0
28,부산광역시,금정구,부곡제3동,부곡제3동제2투,1672,1054,244,714,70,17,2,1047,7,618,23.304680038204392,68.19484240687679,6.685768863419293,1.6236867239732569,0.19102196752626552
29,부산광역시,금정구,부곡제3동,부곡제3동제3투,3471,2498,621,1658,171,33,1,2484,14,973,25.0,66.74718196457327,6.884057971014493,1.328502415458937,0.040257648953301126
30,부산광역시,금정구,부곡제3동,부곡제3동제4투,2621,2044,586,1299,127,18,1,2031,13,577,28.852781880846873,63.95864106351551,6.253077301821763,0.8862629246676514,0.04923682914820286
31,부산광역시,금정구,부곡제4동,관내사전투표,2966,2966,1495,1235,195,22,4,2951,15,0,50.66079295154186,41.85022026431718,6.607929515418502,0.7455099966113182,0.13554727211114878
32,부산광역시,금정구,부곡제4동,부곡제4동제1투,2250,1497,350,1002,119,13,3,1487,10,753,23.53732347007397,67.38399462004035,8.002689979825153,0.8742434431741762,0.20174848688634836
33,부산광역시,금정구,부곡제4동,부곡제4동제2투,1764,1239,293,853,80,5,1,1232,7,525,23.782467532467532,69.23701298701299,6.493506493506493,0.4058441558441558,0.08116883116883117
34,부산광역시,금정구,부곡제4동,부곡제4동제3투,1113,682,157,493,24,5,1,680,2,431,23.08823529411765,72.5,3.5294117647058822,0.7352941176470588,0.14705882352941177
35,부산광역시,금정구,부곡제4동,부곡제4동제4투,1603,1056,256,722,65,8,0,1051,5,547,24.357754519505235,68.6964795432921,6.1845861084681255,0.7611798287345386,0.0
36,부산광역시,금정구,장전제1동,관내사전투표,4323,4323,2136,1212,863,62,6,4279,44,0,49.91820518812807,28.324374853937833,20.16826361299369,1.448936667445665,0.14021967749474176
37,부산광역시,금정구,장전제1동,장전제1동제1투,2626,1770,418,1012,298,19,2,1749,21,856,23.89937106918239,57.861635220125784,17.03830760434534,1.0863350485991996,0.11435105774728416
38,부산광역시,금정구,장전제1동,장전제1동제2투,3318,2338,477,1353,459,20,2,2311,27,980,20.640415404586758,58.54608394634357,19.861531804413673,0.865426222414539,0.08654262224145391
39,부산광역시,금정구,장전제1동,장전제1동제3투,1932,1284,294,838,134,5,0,1271,13,648,23.131392604248624,65.93233674272227,10.54287962234461,0.3933910306845004,0.0
40,부산광역시,금정구,장전제1동,장전제1동제4투,2330,1732,560,980,157,23,3,1723,9,598,32.50145095763204,56.877539175856064,9.112013929193267,1.3348810214741729,0.17411491584445735
41,부산광역시,금정구,장전제2동,관내사전투표,4174,4174,2347,1400,364,30,3,4144,30,0,56.63610038610039,33.78378378378378,8.783783783783784,0.7239382239382239,0.07239382239382239
42,부산광역시,금정구,장전제2동,장전제2동제1투,1538,864,185,601,63,7,2,858,6,674,21.56177156177156,70.04662004662005,7.3426573426573425,0.8158508158508158,0.2331002331002331
43,부산광역시,금정구,장전제2동,장전제2동제2투,2904,2039,487,1375,148,15,0,2025,14,865,24.049382716049383,67.90123456790124,7.3086419753086425,0.7407407407407408,0.0
44,부산광역시,금정구,장전제2동,장전제2동제3투,2502,1866,623,1059,150,22,0,1854,12,636,33.60302049622438,57.11974110032363,8.090614886731391,1.186623516720604,0.0
45,부산광역시,금정구,장전제2동,장전제2동제4투,1608,1042,202,712,111,8,2,1035,7,566,19.516908212560384,68.79227053140097,10.72463768115942,0.7729468599033816,0.1932367149758454
46,부산광역시,금정구,장전제2동,장전제2동제5투,2869,1802,471,1110,188,19,3,1791,11,1067,26.298157453936348,61.97654941373534,10.496929089893914,1.060859854829704,0.16750418760469013
47,부산광역시,금정구,장전제2동,장전제2동제6투,2931,2433,818,1385,196,25,0,2424,9,498,33.745874587458744,57.136963696369634,8.085808580858085,1.0313531353135312,0.0
48,부산광역시,금정구,선두구동,관내사전투표,861,861,449,376,27,6,0,858,3,0,52.33100233100233,43.82284382284382,3.146853146853147,0.6993006993006993,0.0
49,부산광역시,금정구,선두구동,선두구동투표소,1193,820,111,664,37,3,0,815,5,373,13.61963190184049,81.47239263803681,4.539877300613497,0.36809815950920244,0.0
50,부산광역시,금정구,청룡노포동,관내사전투표,2354,2354,1176,1032,115,19,2,2344,10,0,50.170648464163826,44.027303754266214,4.906143344709898,0.810580204778157,0.08532423208191127
51,부산광역시,금정구,청룡노포동,청룡노포동제1투,2271,1584,412,1068,88,7,0,1575,9,687,26.158730158730158,67.80952380952381,5.587301587301587,0.4444444444444444,0.0
52,부산광역시,금정구,청룡노포동,청룡노포동제2투,2504,1694,281,1319,78,7,1,1686,8,810,16.666666666666664,78.23250296559905,4.6263345195729535,0.41518386714116245,0.05931198102016608
53,부산광역시,금정구,청룡노포동,청룡노포동제3투,463,329,53,260,11,4,0,328,1,134,16.158536585365855,79.26829268292683,3.353658536585366,1.2195121951219512,0.0
54,부산광역시,금정구,남산동,관내사전투표,4662,4662,2385,1933,270,36,3,4627,35,0,51.54527771774367,41.77652906851092,5.835314458612492,0.7780419278149989,0.06483682731791658
55,부산광역시,금정구,남산동,남산동제1투,1918,1262,314,856,69,11,0,1250,12,656,25.119999999999997,68.47999999999999,5.52,0.88,0.0
56,부산광역시,금정구,남산동,남산동제2투,2109,1359,361,901,74,15,0,1351,8,750,26.720947446336048,66.69133974833457,5.477424130273871,1.1102886750555145,0.0
57,부산광역시,금정구,남산동,남산동제3투,2332,1603,441,1015,126,12,1,1595,8,729,27.64890282131661,63.63636363636363,7.899686520376176,0.7523510971786834,0.06269592476489029
58,부산광역시,금정구,남산동,남산동제4투,2616,1756,402,1191,127,16,3,1739,17,860,23.116733755031625,68.48763657274296,7.303047728579644,0.9200690051753881,0.17251293847038526
59,부산광역시,금정구,남산동,남산동제5투,2476,1678,460,1095,102,12,0,1669,9,798,27.561414020371476,65.60814859197124,6.111443978430198,0.7189934092270821,0.0
60,부산광역시,금정구,남산동,남산동제6투,3019,1889,454,1303,105,16,2,1880,9,1130,24.148936170212764,69.30851063829788,5.585106382978723,0.851063829787234,0.10638297872340426
61,부산광역시,금정구,남산동,남산동제7투,1638,1170,315,767,65,17,0,1164,6,468,27.061855670103093,65.893470790378,5.5841924398625435,1.4604810996563573,0.0
62,부산광역시,금정구,구서제1동,관내사전투표,4813,4813,2621,1779,351,43,4,4798,15,0,54.62692788661943,37.077949145477284,7.3155481450604425,0.8962067528136725,0.08336807002917883
63,부산광역시,금정구,구서제1동,구서제1동제1투,2512,1758,462,1130,135,16,2,1745,13,754,26.4756446991404,64.75644699140402,7.736389684813753,0.9169054441260744,0.1146131805157593
64,부산광역시,금정구,구서제1동,구서제1동제2투,2993,1938,498,1258,156,15,1,1928,10,1055,25.829875518672203,65.24896265560166,8.091286307053942,0.7780082987551867,0.05186721991701245
65,부산광역시,금정구,구서제1동,구서제1동제3투,2309,1761,444,1177,121,15,1,1758,3,548,25.25597269624573,66.95108077360638,6.882821387940842,0.8532423208191127,0.05688282138794084
66,부산광역시,금정구,구서제1동,구서제1동제4투,2021,1456,419,943,73,14,0,1449,7,565,28.91649413388544,65.07936507936508,5.037957211870255,0.966183574879227,0.0
67,부산광역시,금정구,구서제2동,관내사전투표,5206,5206,2966,1820,346,38,1,5171,35,0,57.35834461419454,35.19628698510927,6.691162251015277,0.7348675304583252,0.019338619222587505
68,부산광역시,금정구,구서제2동,구서제2동제1투,2658,1872,520,1182,128,21,1,1852,20,786,28.077753779697623,63.822894168466526,6.911447084233262,1.1339092872570196,0.05399568034557236
69,부산광역시,금정구,구서제2동,구서제2동제2투,2410,1726,421,1173,111,13,2,1720,6,684,24.476744186046513,68.19767441860465,6.453488372093023,0.7558139534883721,0.11627906976744186
70,부산광역시,금정구,구서제2동,구서제2동제3투,2564,1655,413,1130,99,9,0,1651,4,909,25.015142337976982,68.44336765596609,5.9963658388855245,0.5451241671714113,0.0
71,부산광역시,금정구,구서제2동,구서제2동제4투,2307,1692,394,1170,103,17,0,1684,8,615,23.39667458432304,69.47743467933492,6.116389548693587,1.009501187648456,0.0
72,부산광역시,금정구,구서제2동,구서제2동제5투,2482,1876,509,1213,129,14,1,1866,10,606,27.277599142550912,65.005359056806,6.913183279742766,0.7502679528403001,0.05359056806002144
73,부산광역시,금정구,구서제2동,구서제2동제6투,2946,2462,812,1446,173,21,0,2452,10,484,33.115823817292004,58.97226753670473,7.055464926590538,0.8564437194127243,0.0
74,부산광역시,금정구,구서제2동,구서제2동제7투,3193,2601,655,1723,185,27,0,2590,11,592,25.28957528957529,66.52509652509653,7.142857142857142,1.0424710424710426,0.0
75,부산광역시,금정구,금성동,관내사전투표,226,226,112,100,10,3,0,225,1,0,49.77777777777778,44.44444444444444,4.444444444444445,1.3333333333333335,0.0
76,부산광역시,금정구,금성동,금성동투표소,495,338,75,238,20,0,1,334,4,157,22.45508982035928,71.25748502994011,5.9880239520958085,0.0,0.29940119760479045
77,부산광역시,금정구,잘못 투입·구분된 투표지,,0,0,0,0,0,0,0,0,0,0,0.0,0.0,0.0,0.0,0.0
0,부산광역시,강서구,거소·선상투표,,186,175,73,65,32,1,0,171,4,11,42.69005847953216,38.01169590643275,18.71345029239766,0.5847953216374269,0.0
1,부산광역시,강서구,관외사전투표,,10622,10622,5548,3663,1218,80,13,10522,100,0,52.72761832351264,34.81277323702719,11.575746055882911,0.7603117278084015,0.12355065576886523
2,부산광역시,강서구,재외투표,,623,483,323,103,44,11,1,482,1,140,67.01244813278008,21.369294605809127,9.12863070539419,2.2821576763485476,0.2074688796680498
3,부산광역시,강서구,대저1동,관내사전투표,1086,1086,558,451,58,6,3,1076,10,0,51.85873605947955,41.91449814126394,5.390334572490707,0.5576208178438662,0.2788104089219331
4,부산광역시,강서구,대저1동,대저1동제1투,885,616,140,445,26,4,0,615,1,269,22.76422764227642,72.35772357723577,4.227642276422764,0.6504065040650406,0.0
5,부산광역시,강서구,대저1동,대저1동제2투,699,466,98,347,12,5,1,463,3,233,21.166306695464364,74.94600431965442,2.591792656587473,1.079913606911447,0.21598272138228944
6,부산광역시,강서구,대저1동,대저1동제3투,804,545,127,385,28,4,0,544,1,259,23.34558823529412,70.77205882352942,5.147058823529411,0.7352941176470588,0.0
7,부산광역시,강서구,대저1동,대저1동제4투,637,432,117,295,15,1,1,429,3,205,27.27272727272727,68.76456876456876,3.4965034965034967,0.2331002331002331,0.2331002331002331
8,부산광역시,강서구,대저1동,대저1동제5투,661,435,119,296,18,1,0,434,1,226,27.419354838709676,68.20276497695853,4.147465437788019,0.2304147465437788,0.0
9,부산광역시,강서구,대저2동,관내사전투표,1372,1372,727,493,134,5,1,1360,12,0,53.455882352941174,36.25,9.852941176470589,0.3676470588235294,0.07352941176470588
10,부산광역시,강서구,대저2동,대저2동제1투,1355,948,290,541,105,5,0,941,7,407,30.818278427205104,57.49202975557917,11.158342189160468,0.5313496280552604,0.0
11,부산광역시,강서구,대저2동,대저2동제2투,859,612,147,433,25,1,0,606,6,247,24.257425742574256,71.45214521452145,4.125412541254125,0.16501650165016502,0.0
12,부산광역시,강서구,대저2동,대저2동제3투,1426,916,177,685,38,8,0,908,8,510,19.493392070484582,75.44052863436124,4.185022026431718,0.881057268722467,0.0
13,부산광역시,강서구,강동동,관내사전투표,904,904,450,400,50,0,1,901,3,0,49.944506104328525,44.39511653718091,5.549389567147614,0.0,0.11098779134295228
14,부산광역시,강서구,강동동,강동동제1투,629,415,100,290,20,1,1,412,3,214,24.271844660194176,70.3883495145631,4.854368932038835,0.24271844660194172,0.24271844660194172
15,부산광역시,강서구,강동동,강동동제2투,1589,1183,543,487,130,10,2,1172,11,406,46.33105802047782,41.55290102389079,11.092150170648464,0.8532423208191127,0.17064846416382254
16,부산광역시,강서구,강동동,강동동제3투,1764,1185,262,873,39,6,1,1181,4,579,22.18458933107536,73.92040643522438,3.302286198137172,0.5080440304826418,0.0846740050804403
17,부산광역시,강서구,명지1동,관내사전투표,7795,7795,5134,1864,679,72,5,7754,41,0,66.21098787722465,24.03920557131803,8.756770698994067,0.9285530049006964,0.06448284756254836
18,부산광역시,강서구,명지1동,명지1동제1투,2400,1510,403,993,84,13,4,1497,13,890,26.920507682030724,66.33266533066133,5.61122244488978,0.8684034736138945,0.26720106880427524
19,부산광역시,강서구,명지1동,명지1동제2투,3596,2652,1132,1201,270,26,5,2634,18,944,42.97646165527714,45.5960516324981,10.250569476082005,0.9870918754745633,0.18982536066818526
20,부산광역시,강서구,명지1동,명지1동제3투,3995,2924,1162,1471,247,25,6,2911,13,1071,39.91755410511851,50.53246307110958,8.48505668155273,0.8588114050154586,0.20611473720371004
21,부산광역시,강서구,명지1동,명지1동제4투,3483,2676,1173,1240,216,29,3,2661,15,807,44.081172491544535,46.59902292371289,8.117249154453212,1.0898158586997369,0.11273957158962795
22,부산광역시,강서구,명지1동,명지1동제5투,3049,2268,877,1158,207,12,1,2255,13,781,38.891352549889135,51.352549889135254,9.17960088691796,0.532150776053215,0.044345898004434586
23,부산광역시,강서구,명지1동,명지1동제6투,2969,2323,1081,1040,168,21,3,2313,10,646,46.73584089926502,44.96325118893213,7.263294422827498,0.9079118028534372,0.12970168612191957
24,부산광역시,강서구,명지1동,명지1동제7투,3069,2290,990,1031,223,25,3,2272,18,779,43.57394366197183,45.37852112676056,9.815140845070422,1.1003521126760563,0.13204225352112675
25,부산광역시,강서구,명지1동,명지1동제8투,2117,1689,669,827,161,18,2,1677,12,428,39.89266547406082,49.31425163983303,9.600477042337507,1.073345259391771,0.11926058437686345
26,부산광역시,강서구,명지1동,명지1동제9투,3841,2626,989,1263,334,19,2,2607,19,1215,37.936325278097435,48.44649021864212,12.811660912926737,0.728807057920982,0.07671653241273495
27,부산광역시,강서구,명지2동,관내사전투표,5293,5293,3531,1298,386,50,4,5269,24,0,67.01461377870564,24.63465553235908,7.325868286202315,0.9489466691971911,0.07591573353577528
28,부산광역시,강서구,명지2동,명지2동제1투,2938,2084,765,1133,162,15,0,2075,9,854,36.86746987951807,54.602409638554214,7.807228915662651,0.7228915662650602,0.0
29,부산광역시,강서구,명지2동,명지2동제2투,1506,1109,437,577,76,12,1,1103,6,397,39.61922030825023,52.31187669990934,6.890299184043518,1.087941976427924,0.09066183136899365
30,부산광역시,강서구,명지2동,명지2동제3투,1452,1018,450,485,64,14,1,1014,4,434,44.37869822485207,47.83037475345168,6.31163708086785,1.3806706114398422,0.09861932938856016
31,부산광역시,강서구,명지2동,명지2동제4투,1786,1452,579,698,160,10,1,1448,4,334,39.98618784530387,48.204419889502766,11.049723756906078,0.6906077348066298,0.06906077348066297
32,부산광역시,강서구,명지2동,명지2동제5투,1818,1430,526,795,89,11,0,1421,9,388,37.01618578465869,55.946516537649536,6.263194933145671,0.7741027445460943,0.0
33,부산광역시,강서구,명지2동,명지2동제6투,1820,1456,551,773,115,8,0,1447,9,364,38.07878369039392,53.420870767104354,7.947477539737388,0.55286800276434,0.0
34,부산광역시,강서구,명지2동,명지2동제7투,1848,1459,351,995,98,8,1,1453,6,389,24.15691672401927,68.4790089470062,6.744666207845835,0.5505849965588437,0.06882312456985547
35,부산광역시,강서구,명지2동,명지2동제8투,1769,1322,567,640,89,15,2,1313,9,447,43.183549124143184,48.743335872048746,6.778370144706779,1.1424219345011426,0.15232292460015232
36,부산광역시,강서구,가락동,관내사전투표,548,548,297,224,21,4,1,547,1,0,54.296160877513714,40.95063985374772,3.8391224862888484,0.7312614259597806,0.18281535648994515
37,부산광역시,강서구,가락동,가락동제1투,672,438,82,338,15,1,0,436,2,234,18.807339449541285,77.52293577981652,3.4403669724770642,0.22935779816513763,0.0
38,부산광역시,강서구,가락동,가락동제2투,545,364,64,283,9,5,0,361,3,181,17.72853185595568,78.39335180055402,2.4930747922437675,1.3850415512465373,0.0
39,부산광역시,강서구,녹산동,관내사전투표,1527,1527,965,444,102,8,2,1521,6,0,63.44510190664037,29.191321499013807,6.70611439842209,0.5259697567389875,0.13149243918474687
40,부산광역시,강서구,녹산동,녹산동제1투,978,552,106,388,50,3,1,548,4,426,19.34306569343066,70.8029197080292,9.124087591240876,0.5474452554744526,0.18248175182481752
41,부산광역시,강서구,녹산동,녹산동제2투,1604,947,282,587,64,5,0,938,9,657,30.06396588486141,62.579957356076754,6.823027718550106,0.5330490405117271,0.0
42,부산광역시,강서구,녹산동,녹산동제3투,955,556,150,370,31,2,2,555,1,399,27.027027027027028,66.66666666666666,5.585585585585585,0.36036036036036034,0.36036036036036034
43,부산광역시,강서구,녹산동,녹산동제4투,3548,2366,1160,993,177,18,1,2349,17,1182,49.382716049382715,42.27330779054917,7.535121328224776,0.7662835249042145,0.04257130693912303
44,부산광역시,강서구,녹산동,녹산동제5투,2504,1777,784,838,113,23,2,1760,17,727,44.54545454545455,47.61363636363637,6.420454545454546,1.3068181818181817,0.11363636363636363
45,부산광역시,강서구,녹산동,녹산동제6투,1743,1231,476,632,105,8,2,1223,8,512,38.920686835650045,51.676206050695015,8.585445625511039,0.6541291905151267,0.1635322976287817
46,부산광역시,강서구,신호동,관내사전투표,3264,3264,2101,858,255,28,1,3243,21,0,64.78569226025284,26.456984273820538,7.863089731729881,0.8633980881899477,0.03083564600678384
47,부산광역시,강서구,신호동,신호동제1투,2878,1636,528,945,146,7,0,1626,10,1242,32.47232472324723,58.11808118081181,8.979089790897909,0.43050430504305043,0.0
48,부산광역시,강서구,신호동,신호동제2투,2920,1967,894,925,118,16,2,1955,12,953,45.728900255754475,47.31457800511509,6.035805626598465,0.8184143222506393,0.10230179028132991
49,부산광역시,강서구,신호동,신호동제3투,3108,2037,775,1112,119,21,1,2028,9,1071,38.214990138067066,54.83234714003945,5.867850098619329,1.0355029585798818,0.04930966469428008
50,부산광역시,강서구,가덕도동,관내사전투표,803,803,414,334,49,3,0,800,3,0,51.74999999999999,41.75,6.125,0.375,0.0
51,부산광역시,강서구,가덕도동,가덕도동제1투,1103,659,153,462,36,3,1,655,4,444,23.358778625954198,70.53435114503816,5.4961832061068705,0.45801526717557256,0.15267175572519084
52,부산광역시,강서구,가덕도동,가덕도동제2투,819,530,103,403,15,3,1,525,5,289,19.61904761904762,76.76190476190476,2.857142857142857,0.5714285714285714,0.19047619047619047
53,부산광역시,강서구,가덕도동,가덕도동제3투,454,284,80,195,9,0,0,284,0,170,28.169014084507044,68.66197183098592,3.169014084507042,0.0,0.0
54,부산광역시,강서구,잘못 투입·구분된 투표지,,0,0,0,0,0,0,0,0,0,0,0.0,0.0,0.0,0.0,0.0
0,부산광역시,연제구,거소·선상투표,,368,355,143,147,50,2,0,342,13,13,41.812865497076025,42.98245614035088,14.619883040935672,0.5847953216374269,0.0
1,부산광역시,연제구,관외사전투표,,19350,19348,10348,6153,2408,220,22,19151,197,2,54.03373192000418,32.1288705550624,12.573755939637618,1.1487650775416427,0.11487650775416428
2,부산광역시,연제구,재외투표,,933,773,511,153,92,12,0,768,5,160,66.53645833333334,19.921875,11.979166666666668,1.5625,0.0
3,부산광역시,연제구,거제제1동,관내사전투표,3472,3472,2147,996,270,40,3,3456,16,0,62.123842592592595,28.819444444444443,7.8125,1.1574074074074074,0.08680555555555555
4,부산광역시,연제구,거제제1동,거제제1동제1투,2490,1916,641,1127,121,14,2,1905,11,574,33.648293963254595,59.16010498687664,6.351706036745407,0.7349081364829396,0.10498687664041995
5,부산광역시,연제구,거제제1동,거제제1동제2투,2875,2242,670,1412,132,14,0,2228,14,633,30.07181328545781,63.37522441651705,5.9245960502693,0.6283662477558348,0.0
6,부산광역시,연제구,거제제1동,거제제1동제3투,1939,1441,377,955,90,11,3,1436,5,498,26.253481894150415,66.5041782729805,6.267409470752089,0.766016713091922,0.20891364902506965
7,부산광역시,연제구,거제제1동,거제제1동제4투,2062,1622,567,890,139,14,0,1610,12,440,35.21739130434783,55.27950310559007,8.633540372670808,0.8695652173913043,0.0
8,부산광역시,연제구,거제제1동,거제제1동제5투,2425,1951,619,1122,176,25,1,1943,8,474,31.85795162120432,57.74575398867731,9.058157488419969,1.2866700977869274,0.0514668039114771
9,부산광역시,연제구,거제제1동,거제제1동제6투,2143,1533,430,932,152,11,2,1527,6,610,28.159790438768827,61.0347085789129,9.954158480681075,0.7203667321545514,0.13097576948264572
10,부산광역시,연제구,거제제1동,거제제1동제7투,2462,2029,593,1258,154,12,1,2018,11,433,29.385530227948465,62.338949454905844,7.631318136769079,0.5946481665014867,0.049554013875123884
11,부산광역시,연제구,거제제2동,관내사전투표,3284,3284,1928,1023,291,25,1,3268,16,0,58.99632802937577,31.30354957160343,8.904528763769889,0.7649938800489596,0.03059975520195838
12,부산광역시,연제구,거제제2동,거제제2동제1투,1850,1371,380,870,103,13,0,1366,5,479,27.81844802342606,63.689604685212295,7.540263543191801,0.951683748169839,0.0
13,부산광역시,연제구,거제제2동,거제제2동제2투,2292,1772,600,967,177,12,2,1758,14,520,34.129692832764505,55.0056882821388,10.06825938566553,0.6825938566552902,0.11376564277588168
14,부산광역시,연제구,거제제2동,거제제2동제3투,1601,1236,320,828,68,11,4,1231,5,365,25.995125913891144,67.26238830219334,5.523964256701868,0.8935824532900082,0.3249390739236393
15,부산광역시,연제구,거제제2동,거제제2동제4투,1162,878,277,530,63,6,0,876,2,284,31.621004566210047,60.50228310502283,7.191780821917808,0.684931506849315,0.0
16,부산광역시,연제구,거제제2동,거제제2동제5투,2973,2304,908,1132,237,17,0,2294,10,669,39.58151700087184,49.34612031386225,10.331299040976461,0.7410636442894507,0.0
17,부산광역시,연제구,거제제2동,거제제2동제6투,3543,2740,986,1398,301,36,1,2722,18,803,36.22336517266716,51.35929463629684,11.058045554739163,1.322556943423953,0.03673769287288758
18,부산광역시,연제구,거제제3동,관내사전투표,2198,2198,1186,888,95,20,2,2191,7,0,54.13053400273847,40.5294386125057,4.33591967138293,0.9128251939753538,0.09128251939753537
19,부산광역시,연제구,거제제3동,거제제3동제1투,2046,1422,389,922,93,7,0,1411,11,624,27.569099929128278,65.34372785258682,6.591070163004961,0.4961020552799433,0.0
20,부산광역시,연제구,거제제3동,거제제3동제2투,1782,1218,275,860,74,4,2,1215,3,564,22.633744855967077,70.78189300411523,6.090534979423869,0.3292181069958848,0.1646090534979424
21,부산광역시,연제구,거제제3동,거제제3동제3투,1915,1384,336,953,73,13,1,1376,8,531,24.418604651162788,69.25872093023256,5.305232558139535,0.944767441860465,0.07267441860465117
22,부산광역시,연제구,거제제4동,관내사전투표,1719,1719,993,599,106,10,0,1708,11,0,58.13817330210773,35.07025761124122,6.206088992974239,0.5854800936768151,0.0
23,부산광역시,연제구,거제제4동,거제제4동제1투,2096,1390,325,978,68,6,1,1378,12,706,23.58490566037736,70.97242380261248,4.934687953555878,0.43541364296081275,0.07256894049346879
24,부산광역시,연제구,거제제4동,거제제4동제2투,1584,1138,373,679,63,11,1,1127,11,446,33.09671694764862,60.24844720496895,5.590062111801243,0.9760425909494232,0.08873114463176575
25,부산광역시,연제구,거제제4동,거제제4동제3투,1850,1332,364,877,72,10,1,1324,8,518,27.492447129909365,66.23867069486404,5.438066465256798,0.7552870090634441,0.0755287009063444
26,부산광역시,연제구,연산제1동,관내사전투표,3292,3292,1831,1212,209,20,4,3276,16,0,55.891330891330895,36.996336996337,6.379731379731379,0.6105006105006106,0.1221001221001221
27,부산광역시,연제구,연산제1동,연산제1동제1투,2023,1379,337,944,69,13,1,1364,15,644,24.70674486803519,69.20821114369502,5.058651026392962,0.9530791788856305,0.07331378299120235
28,부산광역시,연제구,연산제1동,연산제1동제2투,2632,1893,578,1128,155,17,4,1882,11,739,30.712008501594052,59.93623804463337,8.235919234856535,0.9032943676939427,0.21253985122210414
29,부산광역시,연제구,연산제1동,연산제1동제3투,1861,1168,276,815,58,9,3,1161,7,693,23.772609819121445,70.19810508182601,4.995693367786391,0.7751937984496124,0.2583979328165375
30,부산광역시,연제구,연산제1동,연산제1동제4투,2574,2072,615,1299,127,21,4,2066,6,502,29.767666989351405,62.87512100677638,6.147144240077444,1.016456921587609,0.1936108422071636
31,부산광역시,연제구,연산제2동,관내사전투표,4121,4121,2414,1273,362,35,3,4087,34,0,59.0653290922437,31.147540983606557,8.857352581355519,0.8563738683631025,0.07340347443112308
32,부산광역시,연제구,연산제2동,연산제2동제1투,3546,2517,730,1522,220,22,1,2495,22,1029,29.258517034068138,61.00200400801603,8.817635270541082,0.8817635270541082,0.04008016032064128
33,부산광역시,연제구,연산제2동,연산제2동제2투,2340,1870,609,1064,166,18,3,1860,10,470,32.74193548387097,57.204301075268816,8.9247311827957,0.967741935483871,0.16129032258064516
34,부산광역시,연제구,연산제2동,연산제2동제3투,2781,1780,487,1140,125,15,1,1768,12,1001,27.545248868778284,64.47963800904978,7.070135746606335,0.8484162895927602,0.056561085972850686
35,부산광역시,연제구,연산제2동,연산제2동제4투,2759,2111,716,1226,134,20,3,2099,12,648,34.111481657932345,58.40876607908528,6.383992377322535,0.9528346831824679,0.14292520247737017
36,부산광역시,연제구,연산제2동,연산제2동제5투,1807,1536,500,867,147,10,2,1526,10,271,32.765399737876805,56.81520314547838,9.63302752293578,0.655307994757536,0.1310615989515072
37,부산광역시,연제구,연산제3동,관내사전투표,1900,1900,1037,752,82,17,1,1889,11,0,54.89677077818952,39.80942297511911,4.340921122286924,0.8999470619375332,0.05293806246691372
38,부산광역시,연제구,연산제3동,연산제3동제1투,1490,978,233,693,39,4,1,970,8,512,24.02061855670103,71.44329896907216,4.020618556701031,0.4123711340206186,0.10309278350515465
39,부산광역시,연제구,연산제3동,연산제3동제2투,1777,1167,303,792,61,9,0,1165,2,610,26.008583690987123,67.98283261802574,5.236051502145923,0.7725321888412017,0.0
40,부산광역시,연제구,연산제3동,연산제3동제3투,2942,2268,800,1251,180,23,4,2258,10,674,35.4295837023915,55.40301151461471,7.971656333038086,1.0186005314437556,0.1771479185119575
41,부산광역시,연제구,연산제4동,관내사전투표,3285,3285,1762,1305,175,25,3,3270,15,0,53.88379204892967,39.908256880733944,5.351681957186544,0.764525993883792,0.09174311926605505
42,부산광역시,연제구,연산제4동,연산제4동제1투,1560,1193,346,763,65,9,1,1184,9,367,29.222972972972972,64.44256756756756,5.489864864864865,0.7601351351351352,0.08445945945945946
43,부산광역시,연제구,연산제4동,연산제4동제2투,2154,1367,292,967,81,15,1,1356,11,787,21.533923303834808,71.3126843657817,5.9734513274336285,1.1061946902654867,0.07374631268436578
44,부산광역시,연제구,연산제4동,연산제4동제3투,2405,1544,387,1061,72,8,2,1530,14,861,25.294117647058822,69.34640522875817,4.705882352941177,0.522875816993464,0.130718954248366
45,부산광역시,연제구,연산제4동,연산제4동제4투,2595,1808,548,1082,146,17,1,1794,14,787,30.54626532887402,60.31215161649944,8.138238573021182,0.947603121516165,0.055741360089186176
46,부산광역시,연제구,연산제4동,연산제4동제5투,1994,1256,402,712,119,6,3,1242,14,738,32.367149758454104,57.326892109500804,9.581320450885668,0.4830917874396135,0.24154589371980675
47,부산광역시,연제구,연산제5동,관내사전투표,3382,3382,1923,1068,326,28,5,3350,32,0,57.40298507462687,31.88059701492537,9.731343283582088,0.835820895522388,0.1492537313432836
48,부산광역시,연제구,연산제5동,연산제5동제1투,2715,1644,357,1131,124,14,0,1626,18,1071,21.95571955719557,69.55719557195572,7.626076260762607,0.8610086100861009,0.0
49,부산광역시,연제구,연산제5동,연산제5동제2투,2933,1770,455,1093,177,24,3,1752,18,1163,25.9703196347032,62.385844748858446,10.102739726027398,1.36986301369863,0.17123287671232876
50,부산광역시,연제구,연산제5동,연산제5동제3투,2492,1455,386,905,141,7,2,1441,14,1037,26.78695350451076,62.80360860513532,9.784871616932685,0.4857737682165163,0.13879250520471895
51,부산광역시,연제구,연산제5동,연산제5동제4투,2816,1905,534,1150,180,21,1,1886,19,911,28.31389183457052,60.97560975609756,9.544008483563097,1.1134676564156947,0.05302226935312832
52,부산광역시,연제구,연산제6동,관내사전투표,2070,2070,1147,786,109,16,1,2059,11,0,55.706653715395824,38.173870811073336,5.293831957260807,0.7770762506070907,0.04856726566294317
53,부산광역시,연제구,연산제6동,연산제6동제1투,1766,1187,305,809,55,10,0,1179,8,579,25.86938083121289,68.61747243426632,4.664970313825275,0.8481764206955046,0.0
54,부산광역시,연제구,연산제6동,연산제6동제2투,2244,1480,367,1020,74,9,1,1471,9,764,24.94901427600272,69.34058463630184,5.030591434398368,0.6118286879673691,0.06798096532970768
55,부산광역시,연제구,연산제6동,연산제6동제3투,2524,1545,396,1069,63,9,2,1539,6,979,25.730994152046783,69.46068875893438,4.093567251461988,0.5847953216374269,0.1299545159194282
56,부산광역시,연제구,연산제6동,연산제6동제4투,1710,1225,351,783,73,6,2,1215,10,485,28.888888888888886,64.44444444444444,6.008230452674898,0.49382716049382713,0.1646090534979424
57,부산광역시,연제구,연산제6동,연산제6동제5투,1650,1358,558,670,105,14,1,1348,10,292,41.3946587537092,49.70326409495549,7.789317507418398,1.0385756676557862,0.0741839762611276
58,부산광역시,연제구,연산제8동,관내사전투표,2324,2324,1285,888,124,10,1,2308,16,0,55.67590987868284,38.47487001733102,5.37261698440208,0.43327556325823224,0.04332755632582322
59,부산광역시,연제구,연산제8동,연산제8동제1투,1719,1043,245,739,40,6,0,1030,13,676,23.78640776699029,71.74757281553397,3.8834951456310676,0.5825242718446602,0.0
60,부산광역시,연제구,연산제8동,연산제8동제2투,1852,1293,367,837,62,14,1,1281,12,559,28.64949258391881,65.33957845433255,4.839968774395004,1.092896174863388,0.078064012490242
61,부산광역시,연제구,연산제8동,연산제8동제3투,1335,846,223,570,44,4,1,842,4,489,26.48456057007126,67.6959619952494,5.225653206650831,0.4750593824228029,0.11876484560570072
62,부산광역시,연제구,연산제8동,연산제8동제4투,2910,2389,948,1217,195,17,0,2377,12,521,39.88220445940261,51.198990323937736,8.203618005889778,0.715187210769878,0.0
63,부산광역시,연제구,연산제9동,관내사전투표,4018,4018,2416,1298,237,35,2,3988,30,0,60.58174523570712,32.54764292878636,5.942828485456369,0.8776328986960883,0.05015045135406219
64,부산광역시,연제구,연산제9동,연산제9동제1투,2834,2034,555,1306,135,21,2,2019,15,800,27.4888558692422,64.68548786527984,6.686478454680535,1.040118870728083,0.09905894006934125
65,부산광역시,연제구,연산제9동,연산제9동제2투,2203,1531,431,988,89,9,3,1520,11,672,28.35526315789474,65.0,5.855263157894737,0.5921052631578948,0.19736842105263158
66,부산광역시,연제구,연산제9동,연산제9동제3투,2390,1780,589,1040,130,18,0,1777,3,610,33.145751266178955,58.525604952166574,7.315700619020822,1.0129431626336522,0.0
67,부산광역시,연제구,연산제9동,연산제9동제4투,2764,2018,584,1277,124,12,8,2005,13,746,29.12718204488778,63.690773067331676,6.184538653366584,0.5985037406483791,0.399002493765586
68,부산광역시,연제구,연산제9동,연산제9동제5투,2023,1284,316,888,68,5,2,1279,5,739,24.70680218921032,69.4292415949961,5.3166536356528535,0.3909304143862392,0.1563721657544957
69,부산광역시,연제구,연산제9동,연산제9동제6투,1601,987,248,664,51,14,1,978,9,614,25.357873210633947,67.89366053169734,5.214723926380368,1.4314928425357873,0.10224948875255625
70,부산광역시,연제구,연산제9동,연산제9동제7투,2570,1910,624,1150,107,17,1,1899,11,660,32.859399684044234,60.55818852027382,5.6345444971037395,0.8952080042127435,0.0526592943654555
71,부산광역시,연제구,연산제9동,연산제9동제8투,1087,915,233,616,58,5,0,912,3,172,25.548245614035086,67.54385964912281,6.359649122807018,0.5482456140350876,0.0
72,부산광역시,연제구,연산제9동,연산제9동제9투,2724,2059,734,1115,179,18,1,2047,12,665,35.85735222276502,54.46995603321935,8.744504152418173,0.8793356130923302,0.048851978505129456
73,부산광역시,연제구,잘못 투입·구분된 투표지,,0,0,0,0,0,0,0,0,0,0,0.0,0.0,0.0,0.0,0.0
0,부산광역시,수영구,거소·선상투표,,316,293,98,121,62,1,0,282,11,23,34.751773049645394,42.90780141843972,21.98581560283688,0.3546099290780142,0.0
1,부산광역시,수영구,관외사전투표,,15588,15588,8120,5248,1883,177,22,15450,138,0,52.556634304207115,33.96763754045307,12.187702265372168,1.145631067961165,0.1423948220064725
2,부산광역시,수영구,재외투표,,1032,824,528,193,83,17,1,822,2,208,64.23357664233576,23.479318734793186,10.097323600973237,2.068126520681265,0.12165450121654502
3,부산광역시,수영구,남천제1동,관내사전투표,2494,2494,1499,786,174,23,0,2482,12,0,60.39484286865431,31.668009669621274,7.010475423045931,0.9266720386784851,0.0
4,부산광역시,수영구,남천제1동,남천제1동제1투,1788,1156,240,826,74,7,0,1147,9,632,20.92414995640802,72.01394943330428,6.451612903225806,0.6102877070619006,0.0
5,부산광역시,수영구,남천제1동,남천제1동제2투,2616,1896,460,1293,125,7,1,1886,10,720,24.390243902439025,68.55779427359491,6.6277836691410394,0.3711558854718982,0.05302226935312832
6,부산광역시,수영구,남천제1동,남천제1동제3투,3426,2557,811,1516,183,33,1,2544,13,869,31.878930817610062,59.59119496855346,7.193396226415095,1.2971698113207548,0.039308176100628936
7,부산광역시,수영구,남천제1동,남천제1동제4투,2124,1334,319,900,90,12,3,1324,10,790,24.093655589123866,67.97583081570997,6.797583081570997,0.906344410876133,0.22658610271903326
8,부산광역시,수영구,남천제2동,관내사전투표,2776,2776,1578,956,201,26,0,2761,15,0,57.15320536037668,34.62513582035495,7.279971024990946,0.9416877942774358,0.0
9,부산광역시,수영구,남천제2동,남천제2동제1투,2200,1485,338,1041,90,8,4,1481,4,715,22.822417285617828,70.29034436191762,6.076975016880486,0.5401755570560433,0.2700877785280216
10,부산광역시,수영구,남천제2동,남천제2동제2투,2393,1640,350,1190,84,12,0,1636,4,753,21.39364303178484,72.73838630806846,5.134474327628362,0.7334963325183375,0.0
11,부산광역시,수영구,남천제2동,남천제2동제3투,3352,2601,486,1911,175,15,1,2588,13,751,18.778979907264297,73.84080370942813,6.761978361669242,0.5795981452859351,0.03863987635239567
12,부산광역시,수영구,수영동,관내사전투표,1691,1691,906,686,81,13,0,1686,5,0,53.736654804270465,40.68801897983393,4.804270462633451,0.771055753262159,0.0
13,부산광역시,수영구,수영동,수영동제1투,2474,1526,366,1043,95,10,4,1518,8,948,24.110671936758894,68.70882740447958,6.258234519104085,0.6587615283267457,0.2635046113306983
14,부산광역시,수영구,수영동,수영동제2투,2512,1685,403,1141,106,16,1,1667,18,827,24.175164967006598,68.44631073785243,6.35872825434913,0.9598080383923214,0.05998800239952009
15,부산광역시,수영구,수영동,수영동제3투,2337,1751,416,1231,82,9,0,1738,13,586,23.935558112773304,70.82853855005754,4.7180667433832,0.5178365937859608,0.0
16,부산광역시,수영구,수영동,수영동제4투,2084,1612,422,1074,101,5,1,1603,9,472,26.32563942607611,66.99937616968185,6.3006862133499695,0.3119151590767312,0.06238303181534623
17,부산광역시,수영구,망미제1동,관내사전투표,4557,4557,2542,1666,266,44,1,4519,38,0,56.251383049347204,36.86656339898208,5.8862580216862135,0.9736667404292986,0.02212878955521133
18,부산광역시,수영구,망미제1동,망미제1동제1투,2685,1847,397,1306,114,16,0,1833,14,838,21.65848336061102,71.24931805782869,6.219312602291326,0.872885979268958,0.0
19,부산광역시,수영구,망미제1동,망미제1동제2투,1891,1366,331,954,62,9,0,1356,10,525,24.410029498525073,70.35398230088495,4.572271386430678,0.6637168141592921,0.0
20,부산광역시,수영구,망미제1동,망미제1동제3투,2499,1758,491,1152,91,12,0,1746,12,741,28.121420389461626,65.97938144329896,5.211912943871707,0.6872852233676976,0.0
21,부산광역시,수영구,망미제1동,망미제1동제4투,2006,1360,370,886,80,13,0,1349,11,646,27.42772424017791,65.67828020756116,5.930318754633062,0.9636767976278725,0.0
22,부산광역시,수영구,망미제1동,망미제1동제5투,1468,992,223,704,47,10,1,985,7,476,22.63959390862944,71.47208121827411,4.771573604060913,1.015228426395939,0.10152284263959391
23,부산광역시,수영구,망미제1동,망미제1동제6투,3094,2231,636,1397,168,11,1,2213,18,863,28.739267962042476,63.12697695436059,7.591504744690465,0.49706281066425667,0.045187528242205156
24,부산광역시,수영구,망미제1동,망미제1동제7투,1893,1309,348,877,62,13,0,1300,9,584,26.769230769230766,67.46153846153847,4.769230769230769,1.0,0.0
25,부산광역시,수영구,망미제2동,관내사전투표,1617,1617,908,589,97,13,2,1609,8,0,56.43256681168427,36.606587942821626,6.028589185829708,0.8079552517091362,0.1243008079552517
26,부산광역시,수영구,망미제2동,망미제2동제1투,1457,969,265,656,40,3,0,964,5,488,27.4896265560166,68.04979253112033,4.149377593360995,0.3112033195020747,0.0
27,부산광역시,수영구,망미제2동,망미제2동제2투,2569,2004,738,1127,111,18,1,1995,9,565,36.99248120300752,56.49122807017544,5.56390977443609,0.9022556390977444,0.05012531328320802
28,부산광역시,수영구,망미제2동,망미제2동제3투,2248,1560,405,1055,76,10,2,1548,12,688,26.16279069767442,68.15245478036177,4.909560723514212,0.6459948320413437,0.12919896640826875
29,부산광역시,수영구,광안제1동,관내사전투표,4596,4596,2601,1540,370,39,6,4556,40,0,57.08955223880597,33.801580333625985,8.121158911325724,0.8560140474100089,0.13169446883230904
30,부산광역시,수영구,광안제1동,광안제1동제1투,3586,2118,514,1366,198,17,4,2099,19,1468,24.487851357789424,65.07860886136255,9.433063363506431,0.8099094807050977,0.19056693663649357
31,부산광역시,수영구,광안제1동,광안제1동제2투,2624,1861,562,1149,118,18,3,1850,11,763,30.37837837837838,62.108108108108105,6.378378378378378,0.9729729729729729,0.16216216216216214
32,부산광역시,수영구,광안제1동,광안제1동제3투,2620,1961,551,1223,149,17,2,1942,19,659,28.372811534500514,62.97631307929969,7.672502574665294,0.8753861997940269,0.10298661174047373
33,부산광역시,수영구,광안제1동,광안제1동제4투,3680,2339,596,1413,261,36,2,2308,31,1341,25.82322357019064,61.22183708838822,11.308492201039861,1.559792027729636,0.08665511265164644
34,부산광역시,수영구,광안제1동,광안제1동제5투,3190,1928,519,1170,190,23,5,1907,21,1262,27.215521761929732,61.35291033036182,9.963293130571579,1.2060828526481384,0.26219192448872575
35,부산광역시,수영구,광안제2동,관내사전투표,4051,4051,2241,1441,297,39,1,4019,32,0,55.76013933814382,35.854690221448124,7.389897984573277,0.9703906444389152,0.02488181139586962
36,부산광역시,수영구,광안제2동,광안제2동제1투,3177,2023,493,1357,139,18,2,2009,14,1154,24.539571926331508,67.54604280736685,6.918865107018417,0.8959681433549029,0.09955201592832255
37,부산광역시,수영구,광안제2동,광안제2동제2투,2693,1581,380,1041,137,13,2,1573,8,1112,24.157660521296883,66.17927527018436,8.709472345835982,0.8264462809917356,0.12714558169103624
38,부산광역시,수영구,광안제2동,광안제2동제3투,2510,1633,432,1051,117,14,1,1615,18,877,26.74922600619195,65.07739938080496,7.244582043343653,0.8668730650154799,0.061919504643962855
39,부산광역시,수영구,광안제2동,광안제2동제4투,2454,1561,420,1001,114,10,2,1547,14,893,27.149321266968325,64.70588235294117,7.369101486748546,0.6464124111182934,0.12928248222365868
40,부산광역시,수영구,광안제3동,관내사전투표,2602,2602,1421,902,227,21,3,2574,28,0,55.205905205905204,35.04273504273504,8.81895881895882,0.8158508158508158,0.11655011655011654
41,부산광역시,수영구,광안제3동,광안제3동제1투,3277,1882,457,1181,198,22,1,1859,23,1395,24.583109198493812,63.528778913394305,10.650887573964498,1.183431952662722,0.05379236148466917
42,부산광역시,수영구,광안제3동,광안제3동제2투,1772,1121,227,794,81,13,0,1115,6,651,20.35874439461883,71.21076233183857,7.26457399103139,1.1659192825112108,0.0
43,부산광역시,수영구,광안제3동,광안제3동제3투,943,653,151,463,29,3,1,647,6,290,23.338485316846985,71.5610510046368,4.482225656877898,0.46367851622874806,0.1545595054095827
44,부산광역시,수영구,광안제4동,관내사전투표,2600,2600,1521,866,169,25,1,2582,18,0,58.907823392718825,33.53989155693261,6.545313710302092,0.9682416731216111,0.03872966692486445
45,부산광역시,수영구,광안제4동,광안제4동제1투,2891,1787,437,1179,131,19,3,1769,18,1104,24.703222159412096,66.64782362916903,7.405313736574335,1.0740531373657434,0.1695873374788016
46,부산광역시,수영구,광안제4동,광안제4동제2투,2621,1790,454,1167,134,27,0,1782,8,831,25.476992143658812,65.48821548821549,7.519640852974187,1.5151515151515151,0.0
47,부산광역시,수영구,광안제4동,광안제4동제3투,2004,1420,472,827,89,14,0,1402,18,584,33.66619115549215,58.98716119828816,6.348074179743223,0.9985734664764622,0.0
48,부산광역시,수영구,민락동,관내사전투표,4273,4273,2310,1645,255,29,3,4242,31,0,54.45544554455446,38.778877887788774,6.011315417256012,0.6836397925506836,0.07072135785007072
49,부산광역시,수영구,민락동,민락동제1투,2216,1307,282,921,82,6,0,1291,16,909,21.84353214562355,71.3400464756003,6.351665375677769,0.46475600309837334,0.0
50,부산광역시,수영구,민락동,민락동제2투,2282,1285,310,863,85,17,0,1275,10,997,24.313725490196077,67.68627450980392,6.666666666666667,1.3333333333333335,0.0
51,부산광역시,수영구,민락동,민락동제3투,3265,2064,520,1369,150,10,1,2050,14,1201,25.365853658536587,66.78048780487805,7.317073170731707,0.4878048780487805,0.04878048780487805
52,부산광역시,수영구,민락동,민락동제4투,2477,1612,396,1079,112,15,2,1604,8,865,24.688279301745634,67.26932668329178,6.982543640897755,0.9351620947630923,0.12468827930174563
53,부산광역시,수영구,민락동,민락동제5투,2702,2105,594,1380,115,6,1,2096,9,597,28.33969465648855,65.83969465648855,5.486641221374046,0.2862595419847328,0.047709923664122134
54,부산광역시,수영구,민락동,민락동제6투,3376,2699,703,1756,207,15,1,2682,17,677,26.211782252050707,65.47352721849367,7.718120805369128,0.5592841163310962,0.03728560775540641
55,부산광역시,수영구,잘못 투입·구분된 투표지,,0,0,0,0,0,0,0,0,0,0,0.0,0.0,0.0,0.0,0.0
0,부산광역시,사상구,거소·선상투표,,386,370,146,138,60,1,1,346,24,16,42.19653179190752,39.884393063583815,17.341040462427745,0.2890173410404624,0.2890173410404624
1,부산광역시,사상구,관외사전투표,,14430,14429,7683,4670,1768,135,18,14274,155,1,53.825136612021865,32.71682779879501,12.386156648451731,0.9457755359394703,0.12610340479192939
2,부산광역시,사상구,재외투표,,619,511,360,99,39,8,0,506,5,108,71.14624505928853,19.565217391304348,7.707509881422925,1.5810276679841897,0.0
3,부산광역시,사상구,삼락동,관내사전투표,1733,1733,951,680,80,13,1,1725,8,0,55.130434782608695,39.42028985507247,4.63768115942029,0.7536231884057971,0.057971014492753624
4,부산광역시,사상구,삼락동,삼락동제1투,594,407,110,278,15,1,1,405,2,187,27.160493827160494,68.64197530864197,3.7037037037037033,0.24691358024691357,0.24691358024691357
5,부산광역시,사상구,삼락동,삼락동제2투,1254,715,236,437,32,6,1,712,3,539,33.146067415730336,61.37640449438202,4.49438202247191,0.8426966292134831,0.1404494382022472
6,부산광역시,사상구,삼락동,삼락동제3투,1247,769,245,463,45,6,2,761,8,478,32.19448094612352,60.84099868593955,5.913272010512484,0.7884362680683311,0.2628120893561104
7,부산광역시,사상구,모라제1동,관내사전투표,5570,5570,3103,2139,248,41,7,5538,32,0,56.0310581437342,38.62405200433369,4.478150957024196,0.7403394727338389,0.12639942217407005
8,부산광역시,사상구,모라제1동,모라제1동제1투,2373,1568,474,957,104,18,2,1555,13,805,30.482315112540192,61.543408360128616,6.688102893890675,1.157556270096463,0.12861736334405144
9,부산광역시,사상구,모라제1동,모라제1동제2투,2308,1729,561,1018,117,15,3,1714,15,579,32.730455075845974,59.39323220536756,6.826137689614936,0.8751458576429404,0.1750291715285881
10,부산광역시,사상구,모라제1동,모라제1동제3투,2524,1650,477,1044,97,14,1,1633,17,874,29.210042865891,63.931414574402936,5.939987752602572,0.8573178199632578,0.0612369871402327
11,부산광역시,사상구,모라제1동,모라제1동제4투,2598,1838,636,1069,106,17,2,1830,8,760,34.75409836065574,58.41530054644809,5.7923497267759565,0.9289617486338797,0.1092896174863388
12,부산광역시,사상구,모라제1동,모라제1동제5투,1876,1280,340,853,68,12,1,1274,6,596,26.687598116169546,66.95447409733124,5.337519623233909,0.9419152276295133,0.07849293563579278
13,부산광역시,사상구,모라제1동,모라제1동제6투,2326,1492,435,939,100,7,1,1482,10,834,29.352226720647774,63.36032388663968,6.747638326585695,0.47233468286099867,0.06747638326585695
14,부산광역시,사상구,모라제1동,모라제1동제7투,1979,1257,336,827,74,5,1,1243,14,722,27.031375703942075,66.532582461786,5.953338696701529,0.4022526146419952,0.08045052292839903
15,부산광역시,사상구,모라제3동,관내사전투표,2512,2512,1281,1109,76,21,3,2490,22,0,51.445783132530124,44.53815261044177,3.0522088353413657,0.8433734939759037,0.12048192771084339
16,부산광역시,사상구,모라제3동,모라제3동제1투,1614,995,278,640,56,13,2,989,6,619,28.109201213346815,64.71183013144591,5.6622851365015165,1.314459049544995,0.20222446916076847
17,부산광역시,사상구,모라제3동,모라제3동제2투,1151,646,158,453,24,3,0,638,8,505,24.76489028213166,71.00313479623824,3.761755485893417,0.4702194357366771,0.0
18,부산광역시,사상구,모라제3동,모라제3동제3투,1349,800,243,526,22,6,0,797,3,549,30.489335006273528,65.99749058971142,2.7603513174404015,0.7528230865746549,0.0
19,부산광역시,사상구,모라제3동,모라제3동제4투,1554,1045,348,627,53,10,1,1039,6,509,33.49374398460058,60.34648700673725,5.101058710298364,0.9624639076034648,0.0962463907603465
20,부산광역시,사상구,덕포제1동,관내사전투표,2622,2622,1500,874,204,22,2,2602,20,0,57.64796310530361,33.58954650269024,7.840122982321292,0.8455034588777863,0.07686395080707148
21,부산광역시,사상구,덕포제1동,덕포제1동제1투,2759,1944,619,1082,206,20,5,1932,12,815,32.03933747412008,56.00414078674948,10.662525879917183,1.0351966873706004,0.2587991718426501
22,부산광역시,사상구,덕포제1동,덕포제1동제2투,1503,897,260,584,34,9,3,890,7,606,29.213483146067414,65.61797752808988,3.8202247191011236,1.0112359550561798,0.33707865168539325
23,부산광역시,사상구,덕포제1동,덕포제1동제3투,2702,1828,638,1034,127,15,1,1815,13,874,35.15151515151515,56.96969696969697,6.997245179063361,0.8264462809917356,0.055096418732782364
24,부산광역시,사상구,덕포제2동,관내사전투표,2013,2013,1140,727,121,13,4,2005,8,0,56.85785536159601,36.25935162094763,6.034912718204489,0.6483790523690772,0.199501246882793
25,부산광역시,사상구,덕포제2동,덕포제2동제1투,1440,934,267,598,53,8,1,927,7,506,28.802588996763756,64.5091693635383,5.717367853290183,0.8629989212513484,0.10787486515641855
26,부산광역시,사상구,덕포제2동,덕포제2동제2투,1651,1168,377,705,73,3,1,1159,9,483,32.52804141501294,60.828300258843825,6.298533218291631,0.2588438308886971,0.08628127696289906
27,부산광역시,사상구,덕포제2동,덕포제2동제3투,2295,1628,542,976,92,11,3,1624,4,667,33.3743842364532,60.09852216748769,5.665024630541872,0.6773399014778325,0.18472906403940886
28,부산광역시,사상구,덕포제2동,덕포제2동제4투,2213,1621,585,905,97,18,5,1610,11,592,36.33540372670808,56.2111801242236,6.024844720496894,1.1180124223602486,0.3105590062111801
29,부산광역시,사상구,괘법동,관내사전투표,3576,3576,1985,1208,338,23,4,3558,18,0,55.78976953344576,33.95165823496346,9.499718943226531,0.6464305789769533,0.11242270938729623
30,부산광역시,사상구,괘법동,괘법동제1투,3897,2366,661,1370,291,19,2,2343,23,1531,28.21169440887751,58.472044387537345,12.419974391805377,0.810926163038839,0.08536064874093044
31,부산광역시,사상구,괘법동,괘법동제2투,2468,1523,486,875,132,15,4,1512,11,945,32.142857142857146,57.870370370370374,8.73015873015873,0.992063492063492,0.26455026455026454
32,부산광역시,사상구,괘법동,괘법동제3투,4227,2562,784,1505,225,20,3,2537,25,1665,30.902640914465906,59.32203389830508,8.868742609381158,0.7883326763894364,0.11824990145841545
33,부산광역시,사상구,괘법동,괘법동제4투,3842,2757,913,1606,196,24,0,2739,18,1085,33.33333333333333,58.63453815261044,7.155896312522819,0.8762322015334063,0.0
34,부산광역시,사상구,괘법동,괘법동제5투,2417,1740,580,1021,114,18,0,1733,7,677,33.46797461050202,58.91517599538373,6.578188113098673,1.03866128101558,0.0
35,부산광역시,사상구,감전동,관내사전투표,1894,1894,1025,701,140,17,3,1886,8,0,54.347826086956516,37.168610816542945,7.423117709437964,0.9013785790031814,0.15906680805938495
36,부산광역시,사상구,감전동,감전동제1투,2661,1632,464,1049,94,13,5,1625,7,1029,28.553846153846152,64.55384615384615,5.7846153846153845,0.8,0.3076923076923077
37,부산광역시,사상구,감전동,감전동제2투,2012,1312,362,864,64,8,1,1299,13,700,27.867590454195536,66.51270207852194,4.926866820631255,0.6158583525789069,0.07698229407236336
38,부산광역시,사상구,감전동,감전동제3투,1945,1276,427,780,53,6,0,1266,10,669,33.72827804107425,61.61137440758294,4.1864139020537126,0.47393364928909953,0.0
39,부산광역시,사상구,감전동,감전동제4투,1581,1078,314,691,52,10,0,1067,11,503,29.42830365510778,64.7610121836926,4.873477038425492,0.937207122774133,0.0
40,부산광역시,사상구,주례제1동,관내사전투표,2646,2646,1502,934,174,21,1,2632,14,0,57.06686930091185,35.48632218844985,6.6109422492401215,0.7978723404255319,0.037993920972644375
41,부산광역시,사상구,주례제1동,주례제1동제1투,2378,1594,519,903,149,10,3,1584,10,784,32.765151515151516,57.00757575757576,9.406565656565656,0.6313131313131313,0.1893939393939394
42,부산광역시,사상구,주례제1동,주례제1동제2투,2789,2037,701,1182,124,17,0,2024,13,752,34.634387351778656,58.399209486166,6.126482213438735,0.8399209486166008,0.0
43,부산광역시,사상구,주례제1동,주례제1동제3투,2588,1916,631,1138,119,11,3,1902,14,672,33.175604626708726,59.831756046267095,6.256572029442692,0.5783385909568874,0.15772870662460567
44,부산광역시,사상구,주례제1동,주례제1동제4투,2303,1608,503,971,109,15,0,1598,10,695,31.476846057571965,60.76345431789737,6.821026282853566,0.9386733416770965,0.0
45,부산광역시,사상구,주례제2동,관내사전투표,2501,2501,1369,847,237,27,1,2481,20,0,55.17936316001612,34.139459895203544,9.552599758162032,1.0882708585247884,0.04030632809351068
46,부산광역시,사상구,주례제2동,주례제2동제1투,1934,1106,316,644,118,16,1,1095,11,828,28.858447488584478,58.81278538812785,10.776255707762557,1.461187214611872,0.091324200913242
47,부산광역시,사상구,주례제2동,주례제2동제2투,2429,1406,354,861,168,14,3,1400,6,1023,25.285714285714285,61.5,12.0,1.0,0.2142857142857143
48,부산광역시,사상구,주례제2동,주례제2동제3투,1580,1020,261,652,89,7,2,1011,9,560,25.816023738872403,64.49060336300693,8.803165182987142,0.6923837784371909,0.19782393669634024
49,부산광역시,사상구,주례제2동,주례제2동제4투,939,584,171,372,31,6,0,580,4,355,29.48275862068965,64.13793103448275,5.344827586206897,1.0344827586206897,0.0
50,부산광역시,사상구,주례제2동,주례제2동제5투,2190,1709,627,935,123,14,1,1700,9,481,36.88235294117647,55.00000000000001,7.235294117647059,0.823529411764706,0.0588235294117647
51,부산광역시,사상구,주례제2동,주례제2동제6투,2390,1850,690,1018,116,11,1,1836,14,540,37.58169934640523,55.446623093681914,6.318082788671024,0.5991285403050108,0.054466230936819175
52,부산광역시,사상구,주례제2동,주례제2동제7투,2695,2150,818,1179,122,15,1,2135,15,545,38.313817330210775,55.222482435597186,5.714285714285714,0.702576112412178,0.046838407494145196
53,부산광역시,사상구,주례제3동,관내사전투표,2868,2868,1576,1102,153,22,5,2858,10,0,55.14345696291113,38.55843247025892,5.353393981805459,0.7697690692792162,0.17494751574527642
54,부산광역시,사상구,주례제3동,주례제3동제1투,1508,946,265,622,42,7,0,936,10,562,28.311965811965813,66.45299145299145,4.487179487179487,0.7478632478632479,0.0
55,부산광역시,사상구,주례제3동,주례제3동제2투,2365,1698,445,1094,128,19,1,1687,11,667,26.378186129223476,64.84884410195613,7.587433313574392,1.1262596324836989,0.05927682276229994
56,부산광역시,사상구,주례제3동,주례제3동제3투,1726,1244,383,760,83,10,1,1237,7,482,30.962004850444625,61.43896523848019,6.709781729991916,0.8084074373484237,0.08084074373484236
57,부산광역시,사상구,주례제3동,주례제3동제4투,1299,849,222,559,51,7,3,842,7,450,26.365795724465556,66.3895486935867,6.0570071258907365,0.831353919239905,0.35629453681710216
58,부산광역시,사상구,학장동,관내사전투표,3600,3600,2124,1242,194,20,7,3587,13,0,59.213827711179256,34.62503484806245,5.408419291887371,0.5575689991636464,0.1951491497072763
59,부산광역시,사상구,학장동,학장동제1투,1959,1394,472,815,84,7,2,1380,14,565,34.20289855072463,59.05797101449275,6.086956521739131,0.5072463768115941,0.14492753623188406
60,부산광역시,사상구,학장동,학장동제2투,1293,740,204,495,30,5,1,735,5,553,27.755102040816325,67.3469387755102,4.081632653061225,0.6802721088435374,0.13605442176870747
61,부산광역시,사상구,학장동,학장동제3투,3055,2280,874,1210,153,25,3,2265,15,775,38.58719646799117,53.42163355408388,6.754966887417218,1.1037527593818985,0.13245033112582782
62,부산광역시,사상구,학장동,학장동제4투,1857,1329,471,758,76,13,3,1321,8,528,35.65480696442089,57.38077214231643,5.753217259651779,0.984102952308857,0.22710068130204392
63,부산광역시,사상구,학장동,학장동제5투,2258,1587,476,973,109,14,0,1572,15,671,30.279898218829516,61.895674300254456,6.933842239185751,0.8905852417302799,0.0
64,부산광역시,사상구,학장동,학장동제6투,1636,992,302,619,56,6,0,983,9,644,30.722278738555442,62.970498474059,5.696846388606307,0.6103763987792472,0.0
65,부산광역시,사상구,학장동,학장동제7투,2216,1660,609,941,81,20,0,1651,9,556,36.88673531193216,56.99576014536645,4.906117504542702,1.2113870381586918,0.0
66,부산광역시,사상구,학장동,학장동제8투,2918,2238,878,1179,143,17,6,2223,15,680,39.4961763382816,53.036437246963565,6.432748538011696,0.7647323436797121,0.2699055330634278
67,부산광역시,사상구,엄궁동,관내사전투표,4456,4456,2596,1555,240,26,10,4427,29,0,58.64016263835554,35.125367065733,5.421278518183872,0.5873051728032528,0.225886604924328
68,부산광역시,사상구,엄궁동,엄궁동제1투,1976,1342,479,750,87,11,5,1332,10,634,35.96096096096096,56.30630630630631,6.531531531531531,0.8258258258258258,0.37537537537537535
69,부산광역시,사상구,엄궁동,엄궁동제2투,1088,661,171,443,37,4,1,656,5,427,26.067073170731707,67.53048780487805,5.640243902439025,0.6097560975609756,0.1524390243902439
70,부산광역시,사상구,엄궁동,엄궁동제3투,2134,1450,403,923,98,13,0,1437,13,684,28.04453723034099,64.23103688239388,6.819763395963814,0.9046624913013221,0.0
71,부산광역시,사상구,엄궁동,엄궁동제4투,1103,740,235,435,59,4,0,733,7,363,32.06002728512961,59.34515688949522,8.049113233287859,0.5457025920873124,0.0
72,부산광역시,사상구,엄궁동,엄궁동제5투,2978,2305,948,1148,157,30,3,2286,19,673,41.46981627296588,50.218722659667534,6.867891513560805,1.3123359580052494,0.13123359580052493
73,부산광역시,사상구,엄궁동,엄궁동제6투,2135,1624,630,838,118,23,3,1612,12,511,39.08188585607941,51.98511166253101,7.320099255583126,1.4267990074441688,0.18610421836228289
74,부산광역시,사상구,엄궁동,엄궁동제7투,2846,2218,752,1278,149,26,3,2208,10,628,34.05797101449276,57.88043478260869,6.748188405797101,1.177536231884058,0.1358695652173913
75,부산광역시,사상구,잘못 투입·구분된 투표지,,0,0,0,0,0,0,0,0,0,0,0.0,0.0,0.0,0.0,0.0
0,대구광역시,중구,거소·선상투표,,127,121,34,67,16,1,0,118,3,6,28.8135593220339,56.779661016949156,13.559322033898304,0.847457627118644,0.0
1,대구광역시,중구,관외사전투표,,8229,8225,2921,3811,1311,90,11,8144,81,4,35.866895874263264,46.79518664047151,16.097740667976424,1.1051080550098231,0.13506876227897838
2,대구광역시,중구,재외투표,,455,330,172,106,44,6,0,328,2,125,52.4390243902439,32.31707317073171,13.414634146341465,1.8292682926829267,0.0
3,대구광역시,중구,동인동,관내사전투표,1355,1355,495,683,158,6,2,1344,11,0,36.830357142857146,50.81845238095239,11.755952380952381,0.4464285714285714,0.1488095238095238
4,대구광역시,중구,동인동,동인동제1투,1857,1190,146,946,78,6,1,1177,13,667,12.404418011894647,80.37383177570094,6.627017841971113,0.5097706032285472,0.08496176720475786
5,대구광역시,중구,동인동,동인동제2투,2304,1603,224,1227,129,16,1,1597,6,701,14.026299311208515,76.83155917345022,8.077645585472762,1.0018785222291797,0.06261740763932373
6,대구광역시,중구,동인동,동인동제3투,2465,1810,291,1274,212,17,1,1795,15,655,16.211699164345404,70.974930362117,11.81058495821727,0.947075208913649,0.05571030640668524
7,대구광역시,중구,삼덕동,관내사전투표,1148,1148,469,499,155,16,0,1139,9,0,41.17647058823529,43.81035996488147,13.608428446005268,1.404741000877963,0.0
8,대구광역시,중구,삼덕동,삼덕동제1투,2197,1578,238,1148,170,11,2,1569,9,619,15.16889738687062,73.16762268961122,10.834926704907584,0.7010834926704907,0.12746972594008923
9,대구광역시,중구,삼덕동,삼덕동제2투,2289,1454,224,1056,147,16,1,1444,10,835,15.512465373961218,73.13019390581718,10.18005540166205,1.10803324099723,0.06925207756232687
10,대구광역시,중구,성내1동,관내사전투표,737,737,285,332,110,4,1,732,5,0,38.9344262295082,45.3551912568306,15.027322404371585,0.546448087431694,0.1366120218579235
11,대구광역시,중구,성내1동,성내1동제1투,2277,1331,165,1009,134,12,1,1321,10,946,12.490537471612415,76.38152914458743,10.143830431491295,0.9084027252081757,0.0757002271006813
12,대구광역시,중구,성내1동,성내1동제2투,1303,869,104,670,79,7,1,861,8,434,12.07897793263647,77.81649245063879,9.175377468060395,0.8130081300813009,0.11614401858304298
13,대구광역시,중구,성내2동,관내사전투표,1484,1484,559,701,180,19,2,1461,23,0,38.261464750171115,47.98083504449008,12.320328542094455,1.3004791238877482,0.13689253935660506
14,대구광역시,중구,성내2동,성내2동제1투,2014,1343,198,997,134,10,0,1339,4,671,14.787154592979837,74.45855115758029,10.007468259895443,0.7468259895444361,0.0
15,대구광역시,중구,성내2동,성내2동제2투,3102,2250,419,1542,250,18,2,2231,19,852,18.78081577767817,69.11698789780367,11.20573733751681,0.8068130883012102,0.08964589870013448
16,대구광역시,중구,성내3동,관내사전투표,1874,1874,754,884,218,8,1,1865,9,0,40.428954423592494,47.39946380697051,11.689008042895441,0.42895442359249336,0.05361930294906167
17,대구광역시,중구,성내3동,성내3동제1투,3208,2488,432,1786,237,15,1,2471,17,720,17.482800485633344,72.27842978551195,9.591258599757184,0.6070416835289356,0.04046944556859571
18,대구광역시,중구,성내3동,성내3동제2투,2024,1584,253,1152,161,9,3,1578,6,440,16.03295310519645,73.00380228136882,10.202788339670468,0.5703422053231939,0.19011406844106463
19,대구광역시,중구,성내3동,성내3동제3투,2329,1790,387,1171,215,11,0,1784,6,539,21.692825112107624,65.6390134529148,12.051569506726457,0.6165919282511211,0.0
20,대구광역시,중구,대신동,관내사전투표,1611,1611,583,860,142,14,0,1599,12,0,36.460287679799876,53.78361475922452,8.880550343964979,0.8755472170106317,0.0
21,대구광역시,중구,대신동,대신동제1투,2794,2174,334,1645,151,19,1,2150,24,620,15.534883720930232,76.51162790697674,7.023255813953488,0.8837209302325582,0.046511627906976744
22,대구광역시,중구,대신동,대신동제2투,1560,1150,130,952,53,7,0,1142,8,410,11.38353765323993,83.36252189141857,4.640980735551663,0.6129597197898424,0.0
23,대구광역시,중구,남산1동,관내사전투표,731,731,297,365,52,10,1,725,6,0,40.96551724137931,50.3448275862069,7.1724137931034475,1.3793103448275863,0.13793103448275862
24,대구광역시,중구,남산1동,남산1동제1투,1595,1094,162,821,90,16,0,1089,5,501,14.87603305785124,75.39026629935721,8.264462809917356,1.4692378328741964,0.0
25,대구광역시,중구,남산1동,남산1동제2투,1673,1202,194,877,103,13,1,1188,14,471,16.329966329966332,73.82154882154882,8.67003367003367,1.0942760942760943,0.08417508417508417
26,대구광역시,중구,남산2동,관내사전투표,1117,1117,445,530,130,5,1,1111,6,0,40.054005400540056,47.7047704770477,11.701170117011701,0.45004500450045004,0.09000900090009001
27,대구광역시,중구,남산2동,남산2동제1투,2020,1488,211,1149,108,11,1,1480,8,532,14.256756756756756,77.63513513513513,7.297297297297297,0.7432432432432433,0.06756756756756757
28,대구광역시,중구,남산2동,남산2동제2투,2194,1703,336,1153,184,18,4,1695,8,491,19.82300884955752,68.023598820059,10.855457227138643,1.0619469026548671,0.2359882005899705
29,대구광역시,중구,남산3동,관내사전투표,1006,1006,424,494,74,7,0,999,7,0,42.44244244244244,49.44944944944945,7.4074074074074066,0.7007007007007007,0.0
30,대구광역시,중구,남산3동,남산3동제1투,2162,1651,288,1213,133,13,0,1647,4,511,17.48633879781421,73.64905889496055,8.075288403157256,0.7893139040680024,0.0
31,대구광역시,중구,남산3동,남산3동제2투,1422,963,121,774,49,10,1,955,8,459,12.670157068062826,81.04712041884817,5.130890052356021,1.0471204188481675,0.10471204188481677
32,대구광역시,중구,남산4동,관내사전투표,2200,2200,859,1098,199,27,2,2185,15,0,39.31350114416476,50.25171624713959,9.107551487414188,1.2356979405034325,0.09153318077803205
33,대구광역시,중구,남산4동,남산4동제1투,3315,2383,393,1795,172,15,0,2375,8,932,16.54736842105263,75.57894736842105,7.242105263157894,0.631578947368421,0.0
34,대구광역시,중구,남산4동,남산4동제2투,3364,2673,463,1975,203,13,1,2655,18,691,17.438794726930322,74.3879472693032,7.645951035781544,0.4896421845574388,0.03766478342749529
35,대구광역시,중구,남산4동,남산4동제3투,3123,2463,443,1789,187,22,0,2441,22,660,18.14829987709955,73.28963539532978,7.66079475624744,0.9012699713232282,0.0
36,대구광역시,중구,대봉1동,관내사전투표,1136,1136,432,533,144,15,5,1129,7,0,38.26395039858282,47.20992028343667,12.75465013286094,1.328609388839681,0.44286979627989376
37,대구광역시,중구,대봉1동,대봉1동제1투,2281,1685,197,1330,136,13,0,1676,9,596,11.75417661097852,79.35560859188544,8.1145584725537,0.7756563245823389,0.0
38,대구광역시,중구,대봉1동,대봉1동제2투,2452,1831,255,1429,128,13,0,1825,6,621,13.972602739726028,78.3013698630137,7.013698630136986,0.7123287671232876,0.0
39,대구광역시,중구,대봉2동,관내사전투표,1204,1203,521,549,117,8,0,1195,8,1,43.59832635983263,45.94142259414226,9.790794979079498,0.6694560669456067,0.0
40,대구광역시,중구,대봉2동,대봉2동제1투,2409,1837,315,1359,148,7,1,1830,7,572,17.21311475409836,74.26229508196721,8.087431693989071,0.3825136612021858,0.0546448087431694
41,대구광역시,중구,대봉2동,대봉2동제2투,1034,821,143,572,93,6,2,816,5,213,17.524509803921568,70.09803921568627,11.397058823529411,0.7352941176470588,0.24509803921568626
42,대구광역시,중구,잘못 투입·구분된 투표지,,0,1,1,0,0,0,0,1,0,-1,100.0,0.0,0.0,0.0,0.0
0,대구광역시,동구,거소·선상투표,,544,504,121,251,81,7,4,464,40,40,26.07758620689655,54.0948275862069,17.45689655172414,1.5086206896551724,0.8620689655172413
1,대구광역시,동구,관외사전투표,,24102,24098,8689,11363,3528,257,28,23865,233,4,36.408967106641526,47.6136601717997,14.783155248271527,1.0768908443327048,0.11732662895453594
2,대구광역시,동구,재외투표,,1151,912,533,248,111,14,0,906,6,239,58.83002207505519,27.373068432671083,12.251655629139073,1.545253863134658,0.0
3,대구광역시,동구,신암1동,관내사전투표,1909,1909,629,1095,154,15,1,1894,15,0,33.21013727560718,57.814149947201685,8.130939809926083,0.791974656810982,0.05279831045406547
4,대구광역시,동구,신암1동,신암1동제1투,2240,1547,238,1152,141,6,2,1539,8,693,15.464587394411955,74.85380116959064,9.161793372319687,0.3898635477582846,0.1299545159194282
5,대구광역시,동구,신암1동,신암1동제2투,1928,1441,185,1172,65,7,0,1429,12,487,12.946116165150453,82.01539538138559,4.548635409377187,0.489853044086774,0.0
6,대구광역시,동구,신암1동,신암1동제3투,2693,2069,396,1454,184,23,2,2059,10,624,19.2326372025255,70.61680427391937,8.936376881981545,1.117047110247693,0.09713453132588634
7,대구광역시,동구,신암2동,관내사전투표,2306,2306,823,1232,205,27,0,2287,19,0,35.9860078705728,53.869698294709224,8.963707914298208,1.1805859204197637,0.0
8,대구광역시,동구,신암2동,신암2동제1투,2043,1530,216,1204,82,19,2,1523,7,513,14.182534471437952,79.05449770190414,5.384110308601445,1.247537754432042,0.13131976362442546
9,대구광역시,동구,신암2동,신암2동제2투,2912,2228,454,1523,226,11,3,2217,11,684,20.478123590437527,68.69643662607126,10.193955796120884,0.49616599007668016,0.13531799729364005
10,대구광역시,동구,신암2동,신암2동제3투,2067,1616,259,1237,97,9,0,1602,14,451,16.16729088639201,77.21598002496879,6.054931335830212,0.5617977528089888,0.0
11,대구광역시,동구,신암3동,관내사전투표,2057,2057,726,1078,221,13,0,2038,19,0,35.62315996074583,52.89499509322866,10.84396467124632,0.6378802747791953,0.0
12,대구광역시,동구,신암3동,신암3동제1투,2662,1944,363,1373,182,10,1,1929,15,718,18.818040435458787,71.1767755313634,9.434940383618455,0.5184033177812338,0.05184033177812338
13,대구광역시,동구,신암3동,신암3동제2투,3683,2724,445,2013,234,13,3,2708,16,959,16.432791728212703,74.33530280649926,8.6410635155096,0.48005908419497784,0.11078286558345643
14,대구광역시,동구,신암4동,관내사전투표,2566,2566,900,1392,244,16,1,2553,13,0,35.25264394829612,54.524089306697995,9.557383470426949,0.626713670191931,0.03916960438699569
15,대구광역시,동구,신암4동,신암4동제1투,2491,1470,194,1169,89,10,3,1465,5,1021,13.242320819112626,79.79522184300342,6.075085324232082,0.6825938566552902,0.20477815699658702
16,대구광역시,동구,신암4동,신암4동제2투,3266,2443,423,1788,198,15,4,2428,15,823,17.42174629324547,73.64085667215815,8.15485996705107,0.6177924217462932,0.16474464579901155
17,대구광역시,동구,신암4동,신암4동제3투,3926,2760,462,2021,229,19,2,2733,27,1166,16.90450054884742,73.94804244420051,8.379070618368093,0.6952067325283571,0.07317965605561653
18,대구광역시,동구,신암4동,신암4동제4투,2242,1778,357,1217,175,17,2,1768,10,464,20.192307692307693,68.83484162895928,9.89819004524887,0.9615384615384616,0.11312217194570137
19,대구광역시,동구,신암5동,관내사전투표,2351,2351,824,1310,178,19,2,2333,18,0,35.31933133304758,56.15087869695671,7.629661380197171,0.8144020574367767,0.08572653236176596
20,대구광역시,동구,신암5동,신암5동제1투,2703,2078,360,1527,156,17,1,2061,17,625,17.46724890829694,74.09024745269286,7.5691411935953425,0.8248423095584668,0.048520135856380396
21,대구광역시,동구,신암5동,신암5동제2투,2244,1553,194,1277,69,8,0,1548,5,691,12.532299741602069,82.49354005167959,4.457364341085271,0.516795865633075,0.0
22,대구광역시,동구,신천1·2동,관내사전투표,1682,1682,604,964,95,11,0,1674,8,0,36.081242532855434,57.58661887694145,5.675029868578255,0.6571087216248507,0.0
23,대구광역시,동구,신천1·2동,신천1·2동제1투,1862,1427,243,1084,78,10,3,1418,9,435,17.136812411847675,76.4456981664316,5.500705218617771,0.7052186177715092,0.21156558533145275
24,대구광역시,동구,신천1·2동,신천1·2동제2투,1808,1338,196,1034,87,9,3,1329,9,470,14.74793077501881,77.80285929270127,6.5462753950338595,0.6772009029345373,0.2257336343115124
25,대구광역시,동구,신천1·2동,신천1·2동제3투,1544,1085,128,884,55,9,1,1077,8,459,11.884865366759517,82.07985143918292,5.10677808727948,0.8356545961002786,0.09285051067780872
26,대구광역시,동구,신천1·2동,신천1·2동제4투,2565,2071,373,1510,150,22,1,2056,15,494,18.1420233463035,73.44357976653697,7.295719844357977,1.0700389105058365,0.048638132295719845
27,대구광역시,동구,신천3동,관내사전투표,2598,2598,1031,1234,290,28,2,2585,13,0,39.883945841392645,47.73694390715667,11.218568665377177,1.0831721470019342,0.07736943907156672
28,대구광역시,동구,신천3동,신천3동제1투,3167,2355,428,1670,225,16,1,2340,15,812,18.29059829059829,71.36752136752136,9.615384615384617,0.6837606837606838,0.042735042735042736
29,대구광역시,동구,신천3동,신천3동제2투,3042,2330,489,1625,184,17,3,2318,12,712,21.095772217428816,70.10353753235547,7.937877480586712,0.7333908541846419,0.12942191544434856
30,대구광역시,동구,신천3동,신천3동제3투,2361,1782,233,1419,106,15,0,1773,9,579,13.14156796390299,80.03384094754654,5.978567399887197,0.8460236886632826,0.0
31,대구광역시,동구,신천4동,관내사전투표,1906,1906,730,886,249,22,4,1891,15,0,38.60391327340032,46.85351665785299,13.167636171337914,1.1634056054997355,0.21152829190904282
32,대구광역시,동구,신천4동,신천4동제1투,2749,2109,323,1555,202,14,1,2095,14,640,15.417661097852028,74.22434367541766,9.64200477326969,0.6682577565632458,0.0477326968973747
33,대구광역시,동구,신천4동,신천4동제2투,2100,1360,229,987,125,7,2,1350,10,740,16.962962962962962,73.11111111111111,9.25925925925926,0.5185185185185185,0.14814814814814814
34,대구광역시,동구,신천4동,신천4동제3투,1832,1290,182,1027,65,6,1,1281,9,542,14.207650273224044,80.17174082747853,5.07416081186573,0.468384074941452,0.078064012490242
35,대구광역시,동구,효목1동,관내사전투표,1370,1370,439,850,72,4,1,1366,4,0,32.13762811127379,62.225475841874086,5.27086383601757,0.29282576866764276,0.07320644216691069
36,대구광역시,동구,효목1동,효목1동제1투,1432,1003,150,787,45,11,0,993,10,429,15.105740181268882,79.25478348439073,4.531722054380665,1.1077542799597182,0.0
37,대구광역시,동구,효목1동,효목1동제2투,1518,1124,143,927,39,6,0,1115,9,394,12.825112107623319,83.1390134529148,3.497757847533632,0.5381165919282511,0.0
38,대구광역시,동구,효목1동,효목1동제3투,1482,985,131,803,42,4,0,980,5,497,13.36734693877551,81.93877551020408,4.285714285714286,0.40816326530612246,0.0
39,대구광역시,동구,효목1동,효목1동제4투,2330,1785,242,1402,119,9,0,1772,13,545,13.656884875846501,79.1196388261851,6.715575620767495,0.5079006772009029,0.0
40,대구광역시,동구,효목1동,효목1동제5투,1649,1092,132,893,51,3,2,1081,11,557,12.210915818686402,82.6086956521739,4.717853839037928,0.27752081406105455,0.18501387604070307
41,대구광역시,동구,효목2동,관내사전투표,2241,2241,828,1224,160,11,1,2224,17,0,37.23021582733813,55.03597122302158,7.194244604316546,0.49460431654676257,0.04496402877697842
42,대구광역시,동구,효목2동,효목2동제1투,1658,1194,188,908,84,8,0,1188,6,464,15.824915824915825,76.43097643097643,7.07070707070707,0.6734006734006733,0.0
43,대구광역시,동구,효목2동,효목2동제2투,2045,1339,163,1078,86,5,0,1332,7,706,12.237237237237238,80.93093093093093,6.456456456456457,0.37537537537537535,0.0
44,대구광역시,동구,효목2동,효목2동제3투,1129,786,89,660,31,3,1,784,2,343,11.35204081632653,84.18367346938776,3.9540816326530615,0.3826530612244898,0.12755102040816327
45,대구광역시,동구,효목2동,효목2동제4투,1796,1396,244,1005,126,11,1,1387,9,400,17.59192501802451,72.45854361932228,9.084354722422495,0.7930785868781542,0.07209805335255948
46,대구광역시,동구,효목2동,효목2동제5투,2736,2154,398,1589,143,11,1,2142,12,582,18.58076563958917,74.18300653594771,6.6760037348272645,0.5135387488328664,0.04668534080298786
47,대구광역시,동구,도평동,관내사전투표,848,848,305,463,67,8,0,843,5,0,36.1803084223013,54.922894424673785,7.947805456702254,0.9489916963226572,0.0
48,대구광역시,동구,도평동,도평동제1투,1516,1063,123,893,40,1,0,1057,6,453,11.636707663197729,84.48438978240303,3.7842951750236518,0.0946073793755913,0.0
49,대구광역시,동구,도평동,도평동제2투,749,523,53,431,34,3,0,521,2,226,10.17274472168906,82.72552783109404,6.525911708253358,0.5758157389635317,0.0
50,대구광역시,동구,불로·봉무동,관내사전투표,2254,2254,831,1236,161,10,1,2239,15,0,37.11478338543993,55.203215721304154,7.190710138454667,0.4466279589102278,0.044662795891022775
51,대구광역시,동구,불로·봉무동,불로·봉무동제1투,1871,1300,165,1054,62,7,1,1289,11,571,12.800620636152054,81.7688130333592,4.809930178432894,0.5430566330488751,0.07757951900698215
52,대구광역시,동구,불로·봉무동,불로·봉무동제2투,3492,2656,468,1988,165,17,1,2639,17,836,17.733990147783253,75.3315649867374,6.252368321333838,0.6441834028040925,0.037893141341417205
53,대구광역시,동구,불로·봉무동,불로·봉무동제3투,1759,1165,126,977,52,6,0,1161,4,594,10.852713178294573,84.15159345391903,4.478897502153316,0.516795865633075,0.0
54,대구광역시,동구,불로·봉무동,불로·봉무동제4투,2899,2384,613,1550,187,22,3,2375,9,515,25.810526315789474,65.26315789473685,7.873684210526316,0.9263157894736843,0.12631578947368421
55,대구광역시,동구,불로·봉무동,불로·봉무동제5투,2550,2098,443,1461,167,18,0,2089,9,452,21.206318812829107,69.93776926759216,7.994255624700814,0.861656294877932,0.0
56,대구광역시,동구,지저동,관내사전투표,2250,2250,743,1343,143,10,2,2241,9,0,33.15484158857653,59.92860330209729,6.381079875055779,0.4462293618920125,0.0892458723784025
57,대구광역시,동구,지저동,지저동제1투,2417,1727,198,1413,87,14,2,1714,13,690,11.551925320886815,82.438739789965,5.075845974329055,0.8168028004667445,0.11668611435239205
58,대구광역시,동구,지저동,지저동제2투,2246,1509,152,1270,70,12,0,1504,5,737,10.106382978723403,84.44148936170212,4.654255319148936,0.7978723404255319,0.0
59,대구광역시,동구,지저동,지저동제3투,2150,1562,193,1272,75,9,2,1551,11,588,12.443584784010316,82.01160541586073,4.835589941972921,0.5802707930367506,0.1289490651192779
60,대구광역시,동구,지저동,지저동제4투,2006,1496,239,1152,88,9,1,1489,7,510,16.05104096709201,77.367360644728,5.910006715916722,0.6044325050369375,0.0671591672263264
61,대구광역시,동구,동촌동,관내사전투표,2608,2608,890,1487,195,12,1,2585,23,0,34.4294003868472,57.524177949709866,7.543520309477756,0.46421663442940037,0.03868471953578336
62,대구광역시,동구,동촌동,동촌동제1투,2324,1518,185,1247,76,7,0,1515,3,806,12.211221122112212,82.3102310231023,5.016501650165017,0.46204620462046203,0.0
63,대구광역시,동구,동촌동,동촌동제2투,2315,1521,197,1221,90,4,1,1513,8,794,13.02048909451421,80.70059484467944,5.948446794448117,0.2643754130865829,0.06609385327164573
64,대구광역시,동구,동촌동,동촌동제3투,2597,1967,314,1516,113,9,3,1955,12,630,16.0613810741688,77.54475703324808,5.780051150895141,0.46035805626598464,0.1534526854219949
65,대구광역시,동구,동촌동,동촌동제4투,2336,1549,237,1208,89,8,0,1542,7,787,15.369649805447471,78.33981841763944,5.7717250324254215,0.5188067444876783,0.0
66,대구광역시,동구,방촌동,관내사전투표,2874,2874,939,1674,227,20,4,2864,10,0,32.786312849162016,58.44972067039106,7.925977653631285,0.6983240223463687,0.13966480446927373
67,대구광역시,동구,방촌동,방촌동제1투,1968,1514,201,1201,82,12,0,1496,18,454,13.43582887700535,80.2807486631016,5.481283422459892,0.8021390374331552,0.0
68,대구광역시,동구,방촌동,방촌동제2투,2216,1537,185,1244,81,10,2,1522,15,679,12.155059132720107,81.73455978975032,5.321944809461235,0.657030223390276,0.1314060446780552
69,대구광역시,동구,방촌동,방촌동제3투,1753,1213,156,951,91,7,2,1207,6,540,12.924606462303231,78.7903893951947,7.539353769676885,0.579950289975145,0.16570008285004142
70,대구광역시,동구,방촌동,방촌동제4투,2355,1933,297,1522,100,4,1,1924,9,422,15.436590436590436,79.10602910602911,5.197505197505198,0.2079002079002079,0.05197505197505198
71,대구광역시,동구,방촌동,방촌동제5투,1814,1462,239,1107,87,18,2,1453,9,352,16.448726772195457,76.18719889883,5.987611837577425,1.2388162422573985,0.13764624913971094
72,대구광역시,동구,방촌동,방촌동제6투,1595,1198,165,966,52,0,0,1183,15,397,13.947590870667796,81.65680473372781,4.395604395604396,0.0,0.0
73,대구광역시,동구,해안동,관내사전투표,2663,2663,789,1602,243,11,4,2649,14,0,29.784824462061156,60.47565118912798,9.173272933182334,0.41525103812759534,0.15100037750094375
74,대구광역시,동구,해안동,해안동제1투,2376,1557,217,1248,72,11,2,1550,7,819,14.000000000000002,80.51612903225806,4.645161290322581,0.7096774193548387,0.12903225806451613
75,대구광역시,동구,해안동,해안동제2투,2135,1491,214,1188,76,7,1,1486,5,644,14.401076716016151,79.94616419919247,5.114401076716016,0.47106325706594887,0.06729475100942127
76,대구광역시,동구,해안동,해안동제3투,1774,1183,144,961,64,6,2,1177,6,591,12.234494477485132,81.64825828377231,5.437553101104503,0.5097706032285472,0.16992353440951571
77,대구광역시,동구,해안동,해안동제4투,1119,799,110,615,72,1,0,798,1,320,13.784461152882205,77.06766917293233,9.022556390977442,0.12531328320802004,0.0
78,대구광역시,동구,해안동,해안동제5투,1710,1211,126,993,77,9,0,1205,6,499,10.45643153526971,82.40663900414937,6.390041493775933,0.7468879668049793,0.0
79,대구광역시,동구,안심1동,관내사전투표,4956,4956,1879,2637,366,31,4,4917,39,0,38.214358348586536,53.63026235509457,7.443563148261134,0.6304657311368721,0.08135041692088672
80,대구광역시,동구,안심1동,안심1동제1투,2351,1531,200,1236,72,9,1,1518,13,820,13.175230566534916,81.42292490118577,4.743083003952568,0.592885375494071,0.06587615283267458
81,대구광역시,동구,안심1동,안심1동제2투,1662,1088,183,809,79,4,2,1077,11,574,16.991643454038996,75.11606313834726,7.3351903435468895,0.3714020427112349,0.18570102135561745
82,대구광역시,동구,안심1동,안심1동제3투,2619,1650,266,1241,117,13,1,1638,12,969,16.23931623931624,75.76312576312576,7.142857142857142,0.7936507936507936,0.06105006105006105
83,대구광역시,동구,안심1동,안심1동제4투,2429,1682,269,1290,91,12,1,1663,19,747,16.175586289837643,77.57065544197233,5.472038484666266,0.7215874924834637,0.06013229104028864
84,대구광역시,동구,안심1동,안심1동제5투,2245,1547,314,1118,84,11,2,1529,18,698,20.53629823413996,73.11968606932636,5.493786788750818,0.7194244604316548,0.13080444735120994
85,대구광역시,동구,안심1동,안심1동제6투,1918,1360,241,1028,72,7,4,1352,8,558,17.825443786982248,76.03550295857988,5.325443786982249,0.5177514792899409,0.2958579881656805
86,대구광역시,동구,안심1동,안심1동제7투,2599,1989,403,1459,103,14,1,1980,9,610,20.353535353535353,73.68686868686869,5.202020202020202,0.7070707070707071,0.050505050505050504
87,대구광역시,동구,안심1동,안심1동제8투,3106,2335,572,1573,148,26,2,2321,14,771,24.644549763033176,67.77251184834124,6.376561826798794,1.1202068074105989,0.08616975441619991
88,대구광역시,동구,안심1동,안심1동제9투,3020,2424,596,1590,193,30,2,2411,13,596,24.720033181252592,65.94773952716714,8.004977187888842,1.244296972210701,0.08295313148071339
89,대구광역시,동구,안심1동,안심1동제10투,3163,2480,569,1648,230,17,1,2465,15,683,23.083164300202842,66.85598377281947,9.330628803245435,0.6896551724137931,0.04056795131845842
90,대구광역시,동구,안심2동,관내사전투표,2150,2150,835,1112,175,15,2,2139,11,0,39.036933146330064,51.98690977092099,8.18139317438055,0.7012622720897616,0.09350163627863488
91,대구광역시,동구,안심2동,안심2동제1투,2798,1995,335,1475,164,13,3,1990,5,803,16.834170854271356,74.12060301507537,8.241206030150753,0.6532663316582915,0.1507537688442211
92,대구광역시,동구,안심2동,안심2동제2투,2276,1750,231,1396,107,11,0,1745,5,526,13.2378223495702,80.0,6.131805157593123,0.6303724928366762,0.0
93,대구광역시,동구,안심2동,안심2동제3투,2837,2012,324,1546,124,6,3,2003,9,825,16.17573639540689,77.18422366450325,6.19071392910634,0.29955067398901647,0.14977533699450823
94,대구광역시,동구,안심2동,안심2동제4투,2873,2200,468,1478,212,24,3,2185,15,673,21.418764302059497,67.64302059496568,9.702517162471395,1.0983981693363845,0.13729977116704806
95,대구광역시,동구,안심3동,관내사전투표,4275,4275,1856,1903,430,56,4,4249,26,0,43.68086608613792,44.78700870793128,10.12002824193928,1.3179571663920924,0.09413979759943517
96,대구광역시,동구,안심3동,안심3동제1투,2166,1594,329,1054,179,19,2,1583,11,572,20.78332280480101,66.5824384080859,11.307643714466204,1.2002526847757422,0.12634238787113075
97,대구광역시,동구,안심3동,안심3동제2투,2973,2254,503,1517,190,23,4,2237,17,719,22.48547161376844,67.81403665623603,8.49351810460438,1.0281627179257935,0.17881090746535538
98,대구광역시,동구,안심3동,안심3동제3투,2329,1771,446,1144,152,20,1,1763,8,558,25.297787861599545,64.88939307997731,8.621667612024957,1.1344299489506522,0.05672149744753262
99,대구광역시,동구,안심3동,안심3동제4투,2393,1831,509,1161,138,12,2,1822,9,562,27.936333699231614,63.7211855104281,7.574094401756312,0.6586169045005488,0.10976948408342481
100,대구광역시,동구,안심3동,안심3동제5투,1760,1301,220,948,114,8,0,1290,11,459,17.05426356589147,73.48837209302326,8.837209302325581,0.6201550387596899,0.0
101,대구광역시,동구,안심4동,관내사전투표,2378,2378,918,1221,193,17,3,2352,26,0,39.03061224489796,51.91326530612245,8.20578231292517,0.7227891156462585,0.12755102040816327
102,대구광역시,동구,안심4동,안심4동제1투,2121,1439,259,1080,86,7,1,1433,6,682,18.07397069085834,75.36636427076064,6.001395673412421,0.48848569434752265,0.06978367062107467
103,대구광역시,동구,안심4동,안심4동제2투,2353,1535,218,1170,118,16,2,1524,11,818,14.304461942257218,76.77165354330708,7.742782152230972,1.0498687664041995,0.13123359580052493
104,대구광역시,동구,안심4동,안심4동제3투,2068,1506,250,1121,105,12,1,1489,17,562,16.789791806581597,75.28542646071189,7.0517125587642715,0.8059100067159166,0.0671591672263264
105,대구광역시,동구,안심4동,안심4동제4투,2230,1723,349,1240,117,7,0,1713,10,507,20.37361354349095,72.38762405137186,6.830122591943957,0.4086398131932283,0.0
106,대구광역시,동구,안심4동,안심4동제5투,2898,2159,497,1464,170,18,0,2149,10,739,23.12703583061889,68.12470916705445,7.910656119125174,0.837598883201489,0.0
107,대구광역시,동구,안심4동,안심4동제6투,2715,1925,285,1514,104,8,1,1912,13,790,14.905857740585773,79.18410041841004,5.439330543933055,0.41841004184100417,0.05230125523012552
108,대구광역시,동구,안심4동,안심4동제7투,2742,2209,417,1568,193,13,1,2192,17,533,19.02372262773723,71.53284671532847,8.804744525547445,0.5930656934306568,0.04562043795620438
109,대구광역시,동구,혁신동,관내사전투표,3701,3701,1864,1317,410,48,5,3644,57,0,51.15257958287596,36.14160263446762,11.251372118551043,1.3172338090010975,0.13721185510428102
110,대구광역시,동구,혁신동,혁신동제1투,2392,1832,607,1024,169,20,3,1823,9,560,33.29676357652222,56.171146461876035,9.27043335161821,1.0970927043335161,0.16456390565002743
111,대구광역시,동구,혁신동,혁신동제2투,2475,1698,375,1129,170,7,2,1683,15,777,22.281639928698752,67.08259061200238,10.1010101010101,0.41592394533571003,0.11883541295306002
112,대구광역시,동구,혁신동,혁신동제3투,2114,1663,448,994,185,17,2,1646,17,451,27.217496962332927,60.388821385176186,11.23936816524909,1.0328068043742407,0.12150668286755771
113,대구광역시,동구,혁신동,혁신동제4투,2422,1809,500,1127,146,26,3,1802,7,613,27.746947835738066,62.541620421753606,8.102108768035517,1.4428412874583796,0.1664816870144284
114,대구광역시,동구,공산동,관내사전투표,2932,2932,1144,1544,202,19,3,2912,20,0,39.285714285714285,53.02197802197802,6.936813186813187,0.6524725274725275,0.10302197802197803
115,대구광역시,동구,공산동,공산동제1투,1998,1361,134,1171,45,3,2,1355,6,637,9.889298892988931,86.42066420664206,3.3210332103321036,0.22140221402214022,0.14760147601476015
116,대구광역시,동구,공산동,공산동제2투,2539,1833,224,1505,84,11,3,1827,6,706,12.260536398467432,82.37547892720306,4.597701149425287,0.60207991242474,0.16420361247947454
117,대구광역시,동구,공산동,공산동제3투,2648,1975,317,1522,111,13,0,1963,12,673,16.148751910341314,77.53438614365766,5.654610290371879,0.6622516556291391,0.0
118,대구광역시,동구,공산동,공산동제4투,1314,840,63,747,24,3,1,838,2,474,7.517899761336516,89.14081145584726,2.863961813842482,0.35799522673031026,0.11933174224343676
119,대구광역시,동구,공산동,공산동제5투,2307,1797,378,1264,128,18,1,1789,8,510,21.12912241475685,70.65399664617105,7.154835103409726,1.0061486864169928,0.05589714924538849
120,대구광역시,동구,공산동,공산동제6투,2647,2069,515,1360,166,22,1,2064,5,578,24.9515503875969,65.89147286821705,8.04263565891473,1.065891472868217,0.04844961240310078
121,대구광역시,동구,잘못 투입·구분된 투표지,,0,0,0,0,0,0,0,0,0,0,0.0,0.0,0.0,0.0,0.0
0,대구광역시,서구,거소·선상투표,,193,178,34,106,31,0,0,171,7,15,19.883040935672515,61.98830409356725,18.128654970760234,0.0,0.0
1,대구광역시,서구,관외사전투표,,10676,10675,3404,5720,1326,109,16,10575,100,1,32.189125295508276,54.089834515366434,12.539007092198581,1.0307328605200945,0.15130023640661938
2,대구광역시,서구,재외투표,,426,323,194,83,40,4,0,321,2,103,60.43613707165109,25.85669781931464,12.461059190031152,1.2461059190031152,0.0
3,대구광역시,서구,내당1동,관내사전투표,1778,1778,561,1045,144,15,3,1768,10,0,31.73076923076923,59.10633484162896,8.144796380090497,0.8484162895927602,0.16968325791855204
4,대구광역시,서구,내당1동,내당1동제1투,2849,1999,231,1632,107,12,4,1986,13,850,11.63141993957704,82.17522658610272,5.387713997985901,0.6042296072507553,0.2014098690835851
5,대구광역시,서구,내당1동,내당1동제2투,2992,2019,334,1481,176,14,3,2008,11,973,16.633466135458168,73.75498007968127,8.764940239043826,0.697211155378486,0.14940239043824702
6,대구광역시,서구,내당2·3동,관내사전투표,1219,1219,315,811,72,6,5,1209,10,0,26.054590570719604,67.08023159636063,5.955334987593052,0.49627791563275436,0.41356492969396197
7,대구광역시,서구,내당2·3동,내당2·3동제1투,2067,1422,165,1169,73,6,2,1415,7,645,11.66077738515901,82.6148409893993,5.159010600706713,0.4240282685512367,0.1413427561837456
8,대구광역시,서구,내당2·3동,내당2·3동제2투,1828,1259,139,1048,50,12,0,1249,10,569,11.128903122497999,83.90712570056044,4.00320256204964,0.9607686148919135,0.0
9,대구광역시,서구,내당2·3동,내당2·3동제3투,1883,1322,167,1069,68,7,3,1314,8,561,12.709284627092845,81.35464231354642,5.175038051750381,0.532724505327245,0.228310502283105
10,대구광역시,서구,내당4동,관내사전투표,2441,2441,665,1558,184,11,0,2418,23,0,27.502067824648467,64.43341604631927,7.6095947063689,0.45492142266335817,0.0
11,대구광역시,서구,내당4동,내당4동제1투,1677,1093,159,843,76,7,0,1085,8,584,14.654377880184333,77.69585253456222,7.0046082949308754,0.6451612903225806,0.0
12,대구광역시,서구,내당4동,내당4동제2투,2129,1568,220,1234,93,9,2,1558,10,561,14.120667522464696,79.20410783055199,5.969191270860077,0.5776636713735559,0.12836970474967907
13,대구광역시,서구,내당4동,내당4동제3투,2378,1782,269,1396,98,9,0,1772,10,596,15.180586907449209,78.78103837471784,5.530474040632054,0.5079006772009029,0.0
14,대구광역시,서구,내당4동,내당4동제4투,1762,1247,162,1001,67,6,2,1238,9,515,13.08562197092084,80.8562197092084,5.4119547657512115,0.48465266558966075,0.16155088852988692
15,대구광역시,서구,내당4동,내당4동제5투,1954,1331,179,1061,81,4,1,1326,5,623,13.499245852187029,80.01508295625943,6.108597285067873,0.301659125188537,0.07541478129713425
16,대구광역시,서구,비산1동,관내사전투표,1586,1586,364,1126,81,3,2,1576,10,0,23.096446700507613,71.44670050761421,5.1395939086294415,0.1903553299492386,0.12690355329949238
17,대구광역시,서구,비산1동,비산1동제1투,1581,1051,111,879,50,4,0,1044,7,530,10.632183908045976,84.19540229885058,4.789272030651341,0.38314176245210724,0.0
18,대구광역시,서구,비산1동,비산1동제2투,1440,901,111,743,40,3,0,897,4,539,12.37458193979933,82.83166109253067,4.459308807134894,0.33444816053511706,0.0
19,대구광역시,서구,비산1동,비산1동제3투,1338,913,137,729,36,5,0,907,6,425,15.104740904079383,80.37486218302095,3.9691289966923926,0.5512679162072767,0.0
20,대구광역시,서구,비산1동,비산1동제4투,1289,875,115,723,28,5,0,871,4,414,13.203214695752008,83.00803673938002,3.214695752009185,0.5740528128587831,0.0
21,대구광역시,서구,비산2·3동,관내사전투표,1160,1160,266,807,65,9,2,1149,11,0,23.150565709312446,70.23498694516971,5.657093124456049,0.7832898172323759,0.17406440382941687
22,대구광역시,서구,비산2·3동,비산2·3동제1투,1931,1384,174,1128,72,5,0,1379,5,547,12.6178390137781,81.79840464104423,5.221174764321972,0.36258158085569253,0.0
23,대구광역시,서구,비산2·3동,비산2·3동제2투,1958,1307,131,1110,47,8,2,1298,9,651,10.092449922958398,85.51617873651772,3.62095531587057,0.6163328197226503,0.15408320493066258
24,대구광역시,서구,비산2·3동,비산2·3동제3투,1788,1119,126,932,47,6,2,1113,6,669,11.320754716981133,83.73764600179695,4.22282120395328,0.5390835579514826,0.17969451931716085
25,대구광역시,서구,비산4동,관내사전투표,1278,1278,383,800,75,4,4,1266,12,0,30.252764612954188,63.191153238546605,5.924170616113744,0.315955766192733,0.315955766192733
26,대구광역시,서구,비산4동,비산4동제1투,2057,1401,179,1148,59,5,1,1392,9,656,12.859195402298852,82.47126436781609,4.238505747126436,0.35919540229885055,0.07183908045977011
27,대구광역시,서구,비산4동,비산4동제2투,1926,1292,148,1056,62,7,1,1274,18,634,11.616954474097332,82.88854003139717,4.866562009419153,0.5494505494505495,0.07849293563579278
28,대구광역시,서구,비산4동,비산4동제3투,2265,1689,215,1378,78,6,0,1677,12,576,12.82051282051282,82.17054263565892,4.651162790697675,0.35778175313059035,0.0
29,대구광역시,서구,비산5동,관내사전투표,1259,1259,287,908,50,7,0,1252,7,0,22.923322683706072,72.52396166134186,3.993610223642172,0.5591054313099041,0.0
30,대구광역시,서구,비산5동,비산5동제1투,1508,1002,102,845,43,6,1,997,5,506,10.230692076228685,84.7542627883651,4.312938816449348,0.6018054162487462,0.10030090270812438
31,대구광역시,서구,비산5동,비산5동제2투,1756,1142,141,940,45,9,2,1137,5,614,12.401055408970976,82.67370272647318,3.95778364116095,0.79155672823219,0.1759014951627089
32,대구광역시,서구,비산6동,관내사전투표,1430,1429,363,968,75,9,0,1415,14,1,25.653710247349824,68.40989399293285,5.30035335689046,0.6360424028268552,0.0
33,대구광역시,서구,비산6동,비산6동제1투,2295,1571,194,1275,77,8,5,1559,12,724,12.443874278383579,81.78319435535599,4.939063502245029,0.5131494547787042,0.3207184092366902
34,대구광역시,서구,비산6동,비산6동제2투,2268,1601,191,1322,64,8,1,1586,15,667,12.042875157629256,83.35435056746532,4.03530895334174,0.5044136191677175,0.06305170239596469
35,대구광역시,서구,비산7동,관내사전투표,1082,1082,266,756,46,4,2,1074,8,0,24.767225325884542,70.39106145251397,4.283054003724395,0.37243947858473,0.186219739292365
36,대구광역시,서구,비산7동,비산7동제1투,1493,888,97,741,42,5,0,885,3,605,10.96045197740113,83.72881355932203,4.745762711864407,0.5649717514124294,0.0
37,대구광역시,서구,비산7동,비산7동제2투,1559,1132,136,941,46,4,0,1127,5,427,12.067435669920142,83.49600709849157,4.081632653061225,0.354924578527063,0.0
38,대구광역시,서구,비산7동,비산7동제3투,1736,1106,143,890,59,7,4,1103,3,630,12.964641885766092,80.68902991840436,5.349048050770626,0.6346328195829556,0.3626473254759746
39,대구광역시,서구,비산7동,비산7동제4투,1376,998,125,828,30,6,1,990,8,378,12.626262626262626,83.63636363636363,3.0303030303030303,0.6060606060606061,0.10101010101010101
40,대구광역시,서구,평리1동,관내사전투표,1244,1244,316,851,65,7,0,1239,5,0,25.504439063761097,68.68442292171105,5.246166263115415,0.5649717514124294,0.0
41,대구광역시,서구,평리1동,평리1동제1투,2872,1900,263,1529,83,7,1,1883,17,972,13.967073818374933,81.20021242697823,4.40785979819437,0.37174721189591076,0.05310674455655868
42,대구광역시,서구,평리1동,평리1동제2투,1644,1112,142,900,53,3,1,1099,13,532,12.92083712465878,81.8926296633303,4.822565969062785,0.27297543221110104,0.09099181073703368
43,대구광역시,서구,평리2동,관내사전투표,1685,1685,562,988,121,7,0,1678,7,0,33.49225268176401,58.87961859356376,7.210965435041716,0.4171632896305125,0.0
44,대구광역시,서구,평리2동,평리2동제1투,2743,2014,309,1571,114,7,1,2002,12,729,15.434565434565434,78.47152847152847,5.694305694305695,0.34965034965034963,0.04995004995004995
45,대구광역시,서구,평리2동,평리2동제2투,1791,1203,162,983,44,7,1,1197,6,588,13.533834586466165,82.12197159565581,3.6758563074352546,0.5847953216374269,0.0835421888053467
46,대구광역시,서구,평리3동,관내사전투표,1810,1810,540,1101,133,19,3,1796,14,0,30.066815144766146,61.30289532293987,7.405345211581292,1.0579064587973273,0.16703786191536749
47,대구광역시,서구,평리3동,평리3동제1투,1306,894,122,726,36,4,1,889,5,412,13.72328458942632,81.66479190101236,4.049493813273341,0.44994375703037126,0.11248593925759282
48,대구광역시,서구,평리3동,평리3동제2투,1854,1209,140,997,58,4,0,1199,10,645,11.676396997497914,83.15262718932443,4.837364470391994,0.3336113427856547,0.0
49,대구광역시,서구,평리3동,평리3동제3투,1684,1174,121,995,45,3,1,1165,9,510,10.386266094420602,85.40772532188842,3.862660944206009,0.2575107296137339,0.08583690987124463
50,대구광역시,서구,평리3동,평리3동제4투,3279,2481,444,1777,221,16,3,2461,20,798,18.04144656643641,72.20642015440878,8.980089394555058,0.650142218610321,0.12190166598943519
51,대구광역시,서구,평리4동,관내사전투표,2374,2374,761,1431,156,13,1,2362,12,0,32.218458933107534,60.584250635055035,6.604572396274344,0.550381033022862,0.04233700254022015
52,대구광역시,서구,평리4동,평리4동제1투,3018,2220,343,1693,155,16,1,2208,12,798,15.534420289855072,76.67572463768117,7.019927536231885,0.7246376811594203,0.04528985507246377
53,대구광역시,서구,평리4동,평리4동제2투,2278,1481,172,1214,78,6,0,1470,11,797,11.700680272108844,82.58503401360544,5.3061224489795915,0.40816326530612246,0.0
54,대구광역시,서구,평리4동,평리4동제3투,2554,1840,218,1486,112,11,1,1828,12,714,11.925601750547047,81.2910284463895,6.12691466083151,0.6017505470459519,0.05470459518599562
55,대구광역시,서구,평리4동,평리4동제4투,2783,1945,245,1568,102,14,1,1930,15,838,12.694300518134716,81.24352331606217,5.284974093264249,0.7253886010362695,0.05181347150259067
56,대구광역시,서구,평리5동,관내사전투표,1633,1633,621,786,192,16,2,1617,16,0,38.40445269016698,48.608534322820034,11.873840445269018,0.9894867037724181,0.12368583797155226
57,대구광역시,서구,평리5동,평리5동제1투,3059,2308,419,1652,206,11,5,2293,15,751,18.2730047972089,72.04535542956825,8.983863933711294,0.4797208896641954,0.2180549498473615
58,대구광역시,서구,평리5동,평리5동제2투,2804,2169,411,1482,247,11,4,2155,14,635,19.071925754060327,68.77030162412993,11.46171693735499,0.5104408352668214,0.18561484918793503
59,대구광역시,서구,평리6동,관내사전투표,936,936,296,568,70,0,1,935,1,0,31.65775401069519,60.748663101604286,7.4866310160427805,0.0,0.10695187165775401
60,대구광역시,서구,평리6동,평리6동투표소,3508,2477,355,1927,159,16,4,2461,16,1031,14.425030475416497,78.30150345388054,6.4607882974400646,0.650142218610321,0.16253555465258024
61,대구광역시,서구,상중이동,관내사전투표,2682,2682,853,1616,174,18,3,2664,18,0,32.01951951951952,60.66066066066066,6.531531531531531,0.6756756756756757,0.11261261261261261
62,대구광역시,서구,상중이동,상중이동제1투,1034,566,51,485,26,2,0,564,2,468,9.042553191489363,85.99290780141844,4.609929078014184,0.3546099290780142,0.0
63,대구광역시,서구,상중이동,상중이동제2투,2328,1617,231,1288,76,10,1,1606,11,711,14.383561643835616,80.19925280199253,4.732254047322541,0.62266500622665,0.062266500622665005
64,대구광역시,서구,상중이동,상중이동제3투,2194,1592,203,1275,96,7,3,1584,8,602,12.815656565656566,80.49242424242425,6.0606060606060606,0.4419191919191919,0.1893939393939394
65,대구광역시,서구,상중이동,상중이동제4투,1987,1465,176,1183,89,9,0,1457,8,522,12.079615648592998,81.19423472889498,6.108442004118051,0.6177076183939602,0.0
66,대구광역시,서구,상중이동,상중이동제5투,3123,2526,439,1892,164,14,1,2510,16,597,17.49003984063745,75.37848605577689,6.53386454183267,0.5577689243027889,0.0398406374501992
67,대구광역시,서구,상중이동,상중이동제6투,445,287,28,246,8,1,1,284,3,158,9.859154929577464,86.61971830985915,2.8169014084507045,0.35211267605633806,0.35211267605633806
68,대구광역시,서구,상중이동,상중이동제7투,558,362,29,311,14,0,0,354,8,196,8.192090395480225,87.85310734463276,3.954802259887006,0.0,0.0
69,대구광역시,서구,원대동,관내사전투표,1742,1742,516,1052,146,13,1,1728,14,0,29.86111111111111,60.879629629629626,8.449074074074074,0.7523148148148148,0.057870370370370364
70,대구광역시,서구,원대동,원대동제1투,3168,2275,365,1701,177,17,1,2261,14,893,16.143299425033174,75.23219814241486,7.828394515701017,0.7518796992481203,0.044228217602830605
71,대구광역시,서구,원대동,원대동제2투,1914,1394,163,1137,81,7,0,1388,6,520,11.743515850144092,81.9164265129683,5.835734870317003,0.5043227665706052,0.0
72,대구광역시,서구,원대동,원대동제3투,1736,1128,121,947,50,4,1,1123,5,608,10.774710596616206,84.32769367764915,4.452359750667854,0.3561887800534283,0.08904719501335707
73,대구광역시,서구,잘못 투입·구분된 투표지,,0,0,0,0,0,0,0,0,0,0,0.0,0.0,0.0,0.0,0.0
0,대구광역시,남구,거소·선상투표,,157,147,36,78,23,3,2,142,5,10,25.352112676056336,54.929577464788736,16.19718309859155,2.112676056338028,1.4084507042253522
1,대구광역시,남구,관외사전투표,,10730,10729,3781,5304,1398,107,13,10603,126,1,35.6597189474677,50.02357823257568,13.184947656323681,1.0091483542393662,0.12260680939356786
2,대구광역시,남구,재외투표,,520,384,236,96,45,4,0,381,3,136,61.942257217847775,25.196850393700785,11.811023622047244,1.0498687664041995,0.0
3,대구광역시,남구,이천동,관내사전투표,1808,1808,761,840,176,16,1,1794,14,0,42.41917502787068,46.82274247491639,9.810479375696767,0.8918617614269788,0.055741360089186176
4,대구광역시,남구,이천동,이천동제1투,2006,1399,210,1049,115,13,0,1387,12,607,15.14059120403749,75.6308579668349,8.29127613554434,0.9372746935832732,0.0
5,대구광역시,남구,이천동,이천동제2투,1901,1417,232,1082,81,8,2,1405,12,484,16.512455516014235,77.01067615658363,5.765124555160142,0.5693950177935944,0.1423487544483986
6,대구광역시,남구,이천동,이천동제3투,3313,2543,514,1787,193,24,3,2521,22,770,20.38873462911543,70.88456961523205,7.655692185640619,0.9520031733439112,0.1190003966679889
7,대구광역시,남구,이천동,이천동제4투,2196,1636,237,1279,98,11,2,1627,9,560,14.566687154271666,78.61094038106945,6.0233558696988325,0.6760909649661955,0.1229256299938537
8,대구광역시,남구,봉덕1동,관내사전투표,1335,1335,467,762,79,17,2,1327,8,0,35.19216277317257,57.42275810097966,5.953278070836474,1.281085154483798,0.15071590052750566
9,대구광역시,남구,봉덕1동,봉덕1동제1투,1436,922,129,743,44,4,0,920,2,514,14.021739130434781,80.76086956521739,4.782608695652174,0.43478260869565216,0.0
10,대구광역시,남구,봉덕1동,봉덕1동제2투,2096,1502,179,1228,72,16,2,1497,5,594,11.957247828991315,82.03072812291249,4.809619238476954,1.068804275217101,0.13360053440213762
11,대구광역시,남구,봉덕1동,봉덕1동제3투,2002,1199,179,935,65,8,0,1187,12,803,15.080033698399326,78.77000842459984,5.475989890480202,0.6739679865206403,0.0
12,대구광역시,남구,봉덕2동,관내사전투표,1766,1766,626,974,137,21,0,1758,8,0,35.60864618885097,55.40386803185437,7.792946530147896,1.1945392491467577,0.0
13,대구광역시,남구,봉덕2동,봉덕2동제1투,2413,1735,272,1323,119,13,1,1728,7,678,15.74074074074074,76.5625,6.886574074074074,0.7523148148148148,0.057870370370370364
14,대구광역시,남구,봉덕2동,봉덕2동제2투,1918,1462,238,1076,117,23,1,1455,7,456,16.3573883161512,73.95189003436427,8.041237113402062,1.5807560137457044,0.06872852233676977
15,대구광역시,남구,봉덕2동,봉덕2동제3투,2047,1476,219,1187,58,4,2,1470,6,571,14.897959183673471,80.74829931972789,3.9455782312925165,0.27210884353741494,0.13605442176870747
16,대구광역시,남구,봉덕2동,봉덕2동제4투,2219,1747,249,1371,106,11,1,1738,9,472,14.32681242807825,78.88377445339471,6.098964326812428,0.6329113924050633,0.05753739930955121
17,대구광역시,남구,봉덕3동,관내사전투표,1943,1943,625,1171,121,10,1,1928,15,0,32.41701244813278,60.73651452282157,6.275933609958506,0.5186721991701244,0.05186721991701245
18,대구광역시,남구,봉덕3동,봉덕3동제1투,2692,1571,176,1289,79,10,4,1558,13,1121,11.296534017971759,82.73427471116817,5.070603337612323,0.6418485237483954,0.25673940949935814
19,대구광역시,남구,봉덕3동,봉덕3동제2투,2418,1525,192,1245,74,7,0,1518,7,893,12.648221343873518,82.01581027667984,4.874835309617918,0.461133069828722,0.0
20,대구광역시,남구,봉덕3동,봉덕3동제3투,2297,1626,230,1291,91,5,0,1617,9,671,14.22387136672851,79.83920841063699,5.627705627705628,0.30921459492888065,0.0
21,대구광역시,남구,봉덕3동,봉덕3동제4투,2319,1791,268,1411,88,14,0,1781,10,528,15.047725996631106,79.22515440763615,4.941044357102752,0.7860752386299831,0.0
22,대구광역시,남구,대명1동,관내사전투표,1618,1618,598,910,87,10,3,1608,10,0,37.18905472636816,56.59203980099502,5.410447761194029,0.6218905472636816,0.18656716417910446
23,대구광역시,남구,대명1동,대명1동제1투,2344,1583,201,1258,101,9,2,1571,12,761,12.79439847231063,80.0763844684914,6.429026098026734,0.5728835136855506,0.1273074474856779
24,대구광역시,남구,대명1동,대명1동제2투,1626,1063,138,846,61,5,0,1050,13,563,13.142857142857142,80.57142857142857,5.809523809523809,0.4761904761904762,0.0
25,대구광역시,남구,대명1동,대명1동제3투,2606,1837,260,1436,126,8,0,1830,7,769,14.207650273224044,78.46994535519126,6.885245901639345,0.4371584699453552,0.0
26,대구광역시,남구,대명2동,관내사전투표,1723,1723,710,751,229,15,2,1707,16,0,41.59343878148799,43.99531341534856,13.415348564733451,0.8787346221441126,0.11716461628588166
27,대구광역시,남구,대명2동,대명2동제1투,2100,1450,232,1028,160,17,0,1437,13,650,16.14474599860821,71.53792623521224,11.134307585247043,1.1830201809324983,0.0
28,대구광역시,남구,대명2동,대명2동제2투,2747,2058,374,1487,166,20,1,2048,10,689,18.26171875,72.607421875,8.10546875,0.9765625,0.048828125
29,대구광역시,남구,대명2동,대명2동제3투,1563,1118,173,861,68,9,2,1113,5,445,15.54357592093441,77.35849056603774,6.109613656783468,0.8086253369272237,0.17969451931716085
30,대구광역시,남구,대명2동,대명2동제4투,1532,1093,165,852,61,5,0,1083,10,439,15.23545706371191,78.67036011080333,5.632502308402586,0.46168051708217916,0.0
31,대구광역시,남구,대명3동,관내사전투표,1520,1520,538,848,101,20,3,1510,10,0,35.62913907284768,56.158940397350996,6.688741721854305,1.3245033112582782,0.1986754966887417
32,대구광역시,남구,대명3동,대명3동제1투,1453,912,117,714,62,8,1,902,10,541,12.971175166297117,79.15742793791574,6.873614190687362,0.8869179600886918,0.11086474501108648
33,대구광역시,남구,대명3동,대명3동제2투,1877,1162,172,897,73,9,0,1151,11,715,14.943527367506515,77.93223284100782,6.34231103388358,0.7819287576020852,0.0
34,대구광역시,남구,대명3동,대명3동제3투,1240,892,109,729,43,5,1,887,5,348,12.288613303269448,82.18714768883878,4.8478015783540025,0.5636978579481398,0.11273957158962795
35,대구광역시,남구,대명3동,대명3동제4투,1901,1209,164,975,56,6,2,1203,6,692,13.632585203657523,81.04738154613467,4.655029093931837,0.4987531172069825,0.1662510390689942
36,대구광역시,남구,대명4동,관내사전투표,1538,1538,488,915,109,17,0,1529,9,0,31.916285153695224,59.84303466317855,7.128842380640942,1.1118378024852846,0.0
37,대구광역시,남구,대명4동,대명4동제1투,2167,1440,168,1184,67,5,0,1424,16,727,11.797752808988763,83.14606741573034,4.705056179775281,0.35112359550561795,0.0
38,대구광역시,남구,대명4동,대명4동제2투,1820,1254,185,981,67,10,1,1244,10,566,14.87138263665595,78.85852090032154,5.385852090032155,0.8038585209003215,0.08038585209003216
39,대구광역시,남구,대명4동,대명4동제3투,1590,1135,118,962,42,6,0,1128,7,455,10.460992907801419,85.28368794326241,3.723404255319149,0.5319148936170213,0.0
40,대구광역시,남구,대명4동,대명4동제4투,1002,643,85,492,62,0,1,640,3,359,13.28125,76.875,9.6875,0.0,0.15625
41,대구광역시,남구,대명5동,관내사전투표,1106,1106,425,497,161,14,0,1097,9,0,38.742023701002736,45.30537830446673,14.676390154968095,1.276207839562443,0.0
42,대구광역시,남구,대명5동,대명5동제1투,1468,1040,197,715,113,6,2,1033,7,428,19.070667957405615,69.21587608906098,10.939012584704743,0.5808325266214909,0.1936108422071636
43,대구광역시,남구,대명5동,대명5동제2투,2007,1379,219,1061,76,12,0,1368,11,628,16.00877192982456,77.55847953216374,5.555555555555555,0.8771929824561403,0.0
44,대구광역시,남구,대명5동,대명5동제3투,1343,887,108,679,81,6,0,874,13,456,12.356979405034325,77.68878718535468,9.267734553775744,0.6864988558352403,0.0
45,대구광역시,남구,대명6동,관내사전투표,1812,1812,636,1016,134,14,4,1804,8,0,35.254988913525494,56.31929046563193,7.427937915742794,0.7760532150776054,0.22172949002217296
46,대구광역시,남구,대명6동,대명6동제1투,2827,1832,307,1364,128,18,1,1818,14,995,16.886688668866885,75.02750275027503,7.04070407040704,0.9900990099009901,0.055005500550055
47,대구광역시,남구,대명6동,대명6동제2투,2282,1760,294,1331,114,7,0,1746,14,522,16.83848797250859,76.23138602520045,6.529209621993128,0.40091638029782356,0.0
48,대구광역시,남구,대명6동,대명6동제3투,1821,1182,158,927,79,5,1,1170,12,639,13.504273504273504,79.23076923076923,6.752136752136752,0.4273504273504274,0.08547008547008547
49,대구광역시,남구,대명9동,관내사전투표,2411,2411,942,1260,170,20,1,2393,18,0,39.36481404095278,52.653572921019645,7.1040534893439204,0.8357709987463435,0.041788549937317176
50,대구광역시,남구,대명9동,대명9동제1투,2356,1512,208,1188,90,12,1,1499,13,844,13.875917278185456,79.25283522348232,6.004002668445631,0.8005336891260841,0.06671114076050699
51,대구광역시,남구,대명9동,대명9동제2투,2248,1551,214,1231,89,10,2,1546,5,697,13.842173350582149,79.6248382923674,5.75679172056921,0.646830530401035,0.129366106080207
52,대구광역시,남구,대명9동,대명9동제3투,1943,1228,179,957,78,9,1,1224,4,715,14.624183006535949,78.18627450980392,6.372549019607843,0.7352941176470588,0.08169934640522876
53,대구광역시,남구,대명9동,대명9동제4투,2280,1463,240,1115,87,14,1,1457,6,817,16.47220315717227,76.52711050102951,5.971173644474949,0.9608785175017158,0.06863417982155114
54,대구광역시,남구,대명10동,관내사전투표,1401,1401,446,840,90,9,2,1387,14,0,32.15573179524153,60.56236481614996,6.4888248017303525,0.6488824801730353,0.14419610670511895
55,대구광역시,남구,대명10동,대명10동제1투,2132,1430,181,1144,92,5,0,1422,8,702,12.728551336146273,80.45007032348805,6.469760900140647,0.35161744022503516,0.0
56,대구광역시,남구,대명10동,대명10동제2투,1623,1118,131,924,51,9,1,1116,2,505,11.738351254480287,82.79569892473118,4.56989247311828,0.8064516129032258,0.08960573476702509
57,대구광역시,남구,대명10동,대명10동제3투,1932,1318,164,1069,72,4,1,1310,8,614,12.51908396946565,81.6030534351145,5.4961832061068705,0.3053435114503817,0.07633587786259542
58,대구광역시,남구,대명11동,관내사전투표,1474,1474,428,940,82,8,6,1464,10,0,29.23497267759563,64.20765027322405,5.601092896174864,0.546448087431694,0.4098360655737705
59,대구광역시,남구,대명11동,대명11동제1투,1917,1262,165,1003,77,7,1,1253,9,655,13.168395849960095,80.04788507581804,6.145251396648044,0.5586592178770949,0.07980845969672785
60,대구광역시,남구,대명11동,대명11동제2투,1540,1047,110,882,46,3,0,1041,6,493,10.566762728146013,84.72622478386167,4.418828049951969,0.2881844380403458,0.0
61,대구광역시,남구,대명11동,대명11동제3투,1657,1116,137,897,66,5,1,1106,10,541,12.386980108499095,81.10307414104882,5.967450271247739,0.45207956600361665,0.09041591320072333
62,대구광역시,남구,잘못 투입·구분된 투표지,,0,0,0,0,0,0,0,0,0,0,0.0,0.0,0.0,0.0,0.0
0,대구광역시,북구,거소·선상투표,,567,530,130,259,109,3,6,507,23,37,25.64102564102564,51.08481262327417,21.499013806706113,0.591715976331361,1.183431952662722
1,대구광역시,북구,관외사전투표,,27377,27375,9413,13110,4201,323,34,27081,294,2,34.758686902256194,48.41032458181013,15.512721095971346,1.1927181418706843,0.12554927809165098
2,대구광역시,북구,재외투표,,1130,888,492,232,143,13,5,885,3,242,55.59322033898305,26.214689265536723,16.158192090395477,1.4689265536723164,0.5649717514124294
3,대구광역시,북구,고성동,관내사전투표,2886,2886,1258,1235,339,30,1,2863,23,0,43.93992315752707,43.136570031435554,11.84072651065316,1.0478519035976248,0.0349283967865875
4,대구광역시,북구,고성동,고성동제1투,2293,1758,305,1280,148,12,5,1750,8,535,17.42857142857143,73.14285714285714,8.457142857142857,0.6857142857142857,0.2857142857142857
5,대구광역시,북구,고성동,고성동제2투,2423,1738,317,1268,132,10,1,1728,10,685,18.34490740740741,73.37962962962963,7.638888888888889,0.5787037037037037,0.057870370370370364
6,대구광역시,북구,고성동,고성동제3투,2839,2366,564,1488,286,18,2,2358,8,473,23.918575063613233,63.104325699745544,12.128922815945717,0.7633587786259541,0.08481764206955046
7,대구광역시,북구,칠성동,관내사전투표,2154,2154,807,1136,177,20,2,2142,12,0,37.675070028011206,53.034547152194214,8.26330532212885,0.9337068160597572,0.09337068160597572
8,대구광역시,북구,칠성동,칠성동제1투,1778,1141,132,941,57,4,0,1134,7,637,11.64021164021164,82.98059964726632,5.026455026455026,0.3527336860670194,0.0
9,대구광역시,북구,칠성동,칠성동제2투,3277,2506,527,1729,216,24,1,2497,9,771,21.105326391670005,69.24309171005206,8.650380456547857,0.961153384060873,0.040048057669203045
10,대구광역시,북구,칠성동,칠성동제3투,1764,1281,187,995,86,6,1,1275,6,483,14.666666666666666,78.03921568627452,6.745098039215685,0.4705882352941176,0.0784313725490196
11,대구광역시,북구,칠성동,칠성동제4투,3281,2443,342,1890,176,23,2,2433,10,838,14.056720098643648,77.68187422934648,7.233867653103165,0.9453349773941636,0.08220304151253596
12,대구광역시,북구,칠성동,칠성동제5투,3824,2940,613,2042,245,25,1,2926,14,884,20.950102529049897,69.78810663021189,8.373205741626794,0.8544087491455913,0.03417634996582365
13,대구광역시,북구,침산1동,관내사전투표,589,589,161,388,32,6,1,588,1,0,27.380952380952383,65.98639455782312,5.442176870748299,1.0204081632653061,0.17006802721088435
14,대구광역시,북구,침산1동,침산1동제1투,1329,966,112,793,42,8,3,958,8,363,11.691022964509393,82.77661795407099,4.3841336116910234,0.8350730688935281,0.31315240083507306
15,대구광역시,북구,침산1동,침산1동제2투,1175,811,102,675,29,2,0,808,3,364,12.623762376237623,83.53960396039604,3.5891089108910887,0.24752475247524752,0.0
16,대구광역시,북구,침산2동,관내사전투표,2510,2510,994,1244,232,21,0,2491,19,0,39.90365315134484,49.93978321959053,9.313528703331995,0.8430349257326376,0.0
17,대구광역시,북구,침산2동,침산2동제1투,2090,1639,233,1261,110,23,0,1627,12,451,14.32083589428396,77.50460971112477,6.760909649661954,1.4136447449293177,0.0
18,대구광역시,북구,침산2동,침산2동제2투,2396,1701,297,1285,93,14,1,1690,11,695,17.57396449704142,76.03550295857988,5.502958579881657,0.8284023668639053,0.0591715976331361
19,대구광역시,북구,침산2동,침산2동제3투,3408,2705,539,1906,223,20,1,2689,16,703,20.044626255113425,70.88136853849014,8.293045741911492,0.7437709185570844,0.03718854592785422
20,대구광역시,북구,침산2동,침산2동제4투,2603,2097,413,1421,233,14,3,2084,13,506,19.817658349328216,68.18618042226487,11.18042226487524,0.6717850287907869,0.14395393474088292
21,대구광역시,북구,침산3동,관내사전투표,3314,3314,1169,1821,261,34,3,3288,26,0,35.55352798053528,55.38321167883211,7.937956204379562,1.0340632603406326,0.09124087591240876
22,대구광역시,북구,침산3동,침산3동제1투,2432,1769,300,1344,102,13,2,1761,8,663,17.035775127768314,76.32027257240205,5.792163543441227,0.7382169222032936,0.1135718341851221
23,대구광역시,북구,침산3동,침산3동제2투,2659,1944,324,1483,107,13,1,1928,16,715,16.804979253112034,76.91908713692946,5.549792531120332,0.6742738589211619,0.05186721991701245
24,대구광역시,북구,침산3동,침산3동제3투,2867,2166,357,1635,147,11,2,2152,14,701,16.589219330855016,75.97583643122677,6.830855018587361,0.5111524163568774,0.09293680297397769
25,대구광역시,북구,침산3동,침산3동제4투,3245,2618,533,1870,182,23,2,2610,8,627,20.42145593869732,71.64750957854406,6.973180076628352,0.8812260536398467,0.07662835249042146
26,대구광역시,북구,노원동,관내사전투표,2262,2262,697,1399,139,12,0,2247,15,0,31.019136626613264,62.26079216733422,6.186025812194036,0.5340453938584779,0.0
27,대구광역시,북구,노원동,노원동제1투,1903,1384,203,1075,94,4,2,1378,6,519,14.731494920174166,78.01161103047896,6.821480406386067,0.29027576197387517,0.14513788098693758
28,대구광역시,북구,노원동,노원동제2투,1117,795,84,676,29,3,1,793,2,322,10.592686002522068,85.24590163934425,3.6569987389659517,0.37831021437578816,0.12610340479192939
29,대구광역시,북구,노원동,노원동제3투,1474,1081,111,924,36,3,1,1075,6,393,10.325581395348838,85.95348837209302,3.3488372093023258,0.27906976744186046,0.09302325581395349
30,대구광역시,북구,노원동,노원동제4투,953,586,68,492,20,1,0,581,5,367,11.703958691910499,84.6815834767642,3.4423407917383817,0.17211703958691912,0.0
31,대구광역시,북구,노원동,노원동제5투,2338,1883,363,1374,121,11,4,1873,10,455,19.380672717565403,73.35824879871863,6.460224239188468,0.587293112653497,0.21356113187399892
32,대구광역시,북구,산격1동,관내사전투표,1518,1518,405,1005,84,5,1,1500,18,0,27.0,67.0,5.6000000000000005,0.33333333333333337,0.06666666666666667
33,대구광역시,북구,산격1동,산격1동제1투,1908,1344,174,1100,50,10,1,1335,9,564,13.03370786516854,82.39700374531836,3.7453183520599254,0.7490636704119851,0.0749063670411985
34,대구광역시,북구,산격1동,산격1동제2투,1924,1310,150,1080,59,5,2,1296,14,614,11.574074074074074,83.33333333333334,4.552469135802469,0.38580246913580246,0.15432098765432098
35,대구광역시,북구,산격1동,산격1동제3투,1630,1037,104,878,35,12,3,1032,5,593,10.077519379844961,85.07751937984496,3.391472868217054,1.1627906976744187,0.29069767441860467
36,대구광역시,북구,산격2동,관내사전투표,2435,2435,822,1384,197,12,0,2415,20,0,34.037267080745345,57.30848861283644,8.157349896480332,0.4968944099378882,0.0
37,대구광역시,북구,산격2동,산격2동제1투,1879,1357,199,1063,77,5,3,1347,10,522,14.773570898292501,78.91610987379362,5.716406829992576,0.3711952487008166,0.22271714922048996
38,대구광역시,북구,산격2동,산격2동제2투,1844,1279,162,1018,76,7,1,1264,15,565,12.81645569620253,80.5379746835443,6.012658227848101,0.5537974683544303,0.07911392405063292
39,대구광역시,북구,산격2동,산격2동제3투,2516,1939,267,1513,139,10,0,1929,10,577,13.841368584758943,78.43442198030067,7.20580611715915,0.5184033177812338,0.0
40,대구광역시,북구,산격3동,관내사전투표,1767,1767,679,689,356,21,3,1748,19,0,38.84439359267734,39.41647597254004,20.36613272311213,1.2013729977116705,0.17162471395881007
41,대구광역시,북구,산격3동,산격3동제1투,2859,1901,309,1295,259,17,2,1882,19,958,16.418703506907544,68.80977683315622,13.761955366631243,0.9032943676939427,0.10626992561105207
42,대구광역시,북구,산격3동,산격3동제2투,2817,1902,242,1506,124,14,3,1889,13,915,12.811011116993118,79.72472207517205,6.5643197458973,0.7411328745367919,0.15881418740074113
43,대구광역시,북구,산격4동,관내사전투표,1513,1513,495,846,148,11,0,1500,13,0,33.0,56.39999999999999,9.866666666666667,0.7333333333333333,0.0
44,대구광역시,북구,산격4동,산격4동제1투,1714,1174,143,934,75,10,1,1163,11,540,12.29578675838349,80.30954428202924,6.44883920894239,0.8598452278589854,0.08598452278589853
45,대구광역시,북구,산격4동,산격4동제2투,1712,1171,138,955,66,8,0,1167,4,541,11.825192802056556,81.8337617823479,5.655526992287918,0.6855184233076265,0.0
46,대구광역시,북구,산격4동,산격4동제3투,1663,1175,149,943,67,9,1,1169,6,488,12.745936698032507,80.6672369546621,5.731394354148845,0.7698887938408896,0.0855431993156544
47,대구광역시,북구,복현1동,관내사전투표,1556,1556,549,619,344,23,2,1537,19,0,35.71893298633702,40.27325959661678,22.381262199089136,1.4964216005204944,0.13012361743656475
48,대구광역시,북구,복현1동,복현1동제1투,2238,1429,198,1057,154,12,1,1422,7,809,13.924050632911392,74.33192686357243,10.829817158931084,0.8438818565400843,0.07032348804500703
49,대구광역시,북구,복현1동,복현1동제2투,2569,1665,249,1177,202,23,3,1654,11,904,15.05441354292624,71.1608222490931,12.212817412333736,1.3905683192261185,0.18137847642079807
50,대구광역시,북구,복현2동,관내사전투표,3293,3293,1306,1611,314,36,1,3268,25,0,39.963280293757656,49.296205630354955,9.608323133414933,1.101591187270502,0.03059975520195838
51,대구광역시,북구,복현2동,복현2동제1투,3159,2127,332,1602,159,10,2,2105,22,1032,15.771971496437054,76.10451306413302,7.553444180522566,0.4750593824228029,0.09501187648456057
52,대구광역시,북구,복현2동,복현2동제2투,3114,2277,415,1612,218,19,1,2265,12,837,18.322295805739515,71.16997792494482,9.624724061810154,0.8388520971302429,0.04415011037527594
53,대구광역시,북구,복현2동,복현2동제3투,3360,2579,534,1762,236,27,2,2561,18,781,20.851229988285827,68.80124951190942,9.2151503319016,1.0542756735650136,0.07809449433814916
54,대구광역시,북구,복현2동,복현2동제4투,3076,2409,394,1843,136,17,4,2394,15,667,16.4578111946533,76.98412698412699,5.680868838763575,0.7101086048454469,0.1670843776106934
55,대구광역시,북구,복현2동,복현2동제5투,3232,2463,470,1746,200,28,2,2446,17,769,19.215044971381847,71.3818479149632,8.176614881439084,1.1447260834014716,0.08176614881439084
56,대구광역시,북구,복현2동,복현2동제6투,2526,1819,325,1322,145,12,0,1804,15,707,18.015521064301552,73.28159645232816,8.03769401330377,0.6651884700665188,0.0
57,대구광역시,북구,대현동,관내사전투표,3010,3010,978,1670,313,19,2,2982,28,0,32.796780684104625,56.00268276324615,10.496311200536553,0.6371562709590879,0.0670690811535882
58,대구광역시,북구,대현동,대현동제1투,2113,1344,173,1019,134,4,0,1330,14,769,13.007518796992482,76.61654135338345,10.075187969924812,0.30075187969924816,0.0
59,대구광역시,북구,대현동,대현동제2투,2275,1553,203,1144,179,13,1,1540,13,722,13.18181818181818,74.28571428571429,11.623376623376624,0.8441558441558441,0.06493506493506493
60,대구광역시,북구,대현동,대현동제3투,1513,1073,177,805,77,11,0,1070,3,440,16.542056074766357,75.23364485981308,7.196261682242991,1.0280373831775702,0.0
61,대구광역시,북구,대현동,대현동제4투,2337,1763,233,1403,98,13,2,1749,14,574,13.321898227558604,80.21726700971983,5.603201829616924,0.7432818753573471,0.11435105774728416
62,대구광역시,북구,대현동,대현동제5투,1774,1394,279,987,111,8,2,1387,7,380,20.115356885364093,71.16077865897621,8.002883922134101,0.5767844268204758,0.14419610670511895
63,대구광역시,북구,검단동,관내사전투표,1055,1055,383,600,62,7,0,1052,3,0,36.40684410646388,57.03422053231939,5.893536121673003,0.6653992395437262,0.0
64,대구광역시,북구,검단동,검단동제1투,1864,1308,163,1056,78,3,0,1300,8,556,12.538461538461537,81.23076923076923,6.0,0.23076923076923078,0.0
65,대구광역시,북구,검단동,검단동제2투,2239,1635,263,1280,66,16,0,1625,10,604,16.184615384615384,78.76923076923077,4.061538461538461,0.9846153846153847,0.0
66,대구광역시,북구,무태조야동,관내사전투표,4588,4588,1862,2311,357,33,3,4566,22,0,40.77967586508979,50.613228208497596,7.818659658344283,0.7227332457293035,0.0657030223390276
67,대구광역시,북구,무태조야동,무태조야동제1투,2991,2049,372,1508,137,17,2,2036,13,942,18.271119842829076,74.06679764243614,6.728880157170923,0.8349705304518664,0.09823182711198428
68,대구광역시,북구,무태조야동,무태조야동제2투,2069,1466,240,1118,88,12,0,1458,8,603,16.46090534979424,76.6803840877915,6.035665294924554,0.823045267489712,0.0
69,대구광역시,북구,무태조야동,무태조야동제3투,2611,1896,346,1404,119,14,3,1886,10,715,18.345705196182397,74.44326617179216,6.30965005302227,0.7423117709437964,0.15906680805938495
70,대구광역시,북구,무태조야동,무태조야동제4투,1640,933,187,673,60,10,0,930,3,707,20.107526881720432,72.36559139784946,6.451612903225806,1.0752688172043012,0.0
71,대구광역시,북구,무태조야동,무태조야동제5투,1946,1500,293,1079,100,16,1,1489,11,446,19.677635997313633,72.46474143720619,6.715916722632639,1.0745466756212223,0.0671591672263264
72,대구광역시,북구,무태조야동,무태조야동제6투,3068,2416,502,1713,167,24,1,2407,9,652,20.85583714167013,71.16742833402576,6.9380972164520145,0.9970918155380142,0.04154549231408392
73,대구광역시,북구,무태조야동,무태조야동제7투,967,742,73,623,33,5,0,734,8,225,9.945504087193461,84.87738419618529,4.4959128065395095,0.6811989100817438,0.0
74,대구광역시,북구,무태조야동,무태조야동제8투,3205,2558,659,1629,227,24,5,2544,14,647,25.904088050314467,64.03301886792453,8.922955974842766,0.9433962264150944,0.19654088050314467
75,대구광역시,북구,무태조야동,무태조야동제9투,2724,2120,461,1457,175,12,5,2110,10,604,21.84834123222749,69.0521327014218,8.293838862559241,0.5687203791469194,0.23696682464454977
76,대구광역시,북구,관문동,관내사전투표,2851,2851,1055,1526,236,21,4,2842,9,0,37.121745249824066,53.69458128078818,8.304011259676285,0.7389162561576355,0.14074595355383532
77,대구광역시,북구,관문동,관문동제1투,1207,777,104,627,36,4,2,773,4,430,13.454075032341525,81.11254851228978,4.657179818887451,0.517464424320828,0.258732212160414
78,대구광역시,북구,관문동,관문동제2투,2659,2098,445,1462,151,27,2,2087,11,561,21.322472448490657,70.05270723526593,7.235265931959751,1.2937230474365118,0.09583133684714902
79,대구광역시,북구,관문동,관문동제3투,2207,1677,268,1272,115,9,1,1665,12,530,16.096096096096097,76.3963963963964,6.906906906906906,0.5405405405405406,0.06006006006006006
80,대구광역시,북구,관문동,관문동제4투,1988,1588,271,1199,99,13,0,1582,6,400,17.130214917825537,75.79013906447535,6.257901390644753,0.8217446270543615,0.0
81,대구광역시,북구,관문동,관문동제5투,597,436,70,339,20,0,0,429,7,161,16.317016317016318,79.02097902097903,4.662004662004662,0.0,0.0
82,대구광역시,북구,관문동,관문동제6투,2511,1837,463,1233,122,10,1,1829,8,674,25.31437944231821,67.41388737014762,6.670311645708036,0.5467468562055768,0.054674685620557675
83,대구광역시,북구,관문동,관문동제7투,2087,1546,306,1132,95,8,0,1541,5,541,19.857235561323815,73.45879299156391,6.164828033744322,0.5191434133679429,0.0
84,대구광역시,북구,관문동,관문동제8투,3466,2678,697,1787,156,17,6,2663,15,788,26.173488546751784,67.10476905745399,5.8580548253849045,0.6383777694329703,0.22530980097634246
85,대구광역시,북구,관문동,관문동제9투,2314,1801,481,1105,188,16,2,1792,9,513,26.841517857142854,61.66294642857143,10.491071428571429,0.8928571428571428,0.11160714285714285
86,대구광역시,북구,관문동,관문동제10투,2526,1972,363,1415,161,22,1,1962,10,554,18.501529051987767,72.12028542303773,8.205912334352702,1.1213047910295617,0.05096839959225281
87,대구광역시,북구,태전1동,관내사전투표,1841,1841,671,931,199,19,4,1824,17,0,36.78728070175439,51.041666666666664,10.910087719298247,1.0416666666666665,0.21929824561403508
88,대구광역시,북구,태전1동,태전1동제1투,3348,2397,372,1838,150,13,3,2376,21,951,15.656565656565657,77.35690235690235,6.313131313131313,0.5471380471380471,0.12626262626262627
89,대구광역시,북구,태전1동,태전1동제2투,2326,1781,298,1336,125,8,2,1769,12,545,16.84567552289429,75.52289429055963,7.066139061616733,0.4522328999434709,0.11305822498586772
90,대구광역시,북구,태전1동,태전1동제3투,2179,1402,202,1069,117,9,0,1397,5,777,14.459556191839656,76.521116678597,8.375089477451683,0.644237652111668,0.0
91,대구광역시,북구,태전1동,태전1동제4투,2830,1885,267,1432,145,21,1,1866,19,945,14.308681672025724,76.7416934619507,7.770632368703108,1.1254019292604502,0.05359056806002144
92,대구광역시,북구,태전1동,태전1동제5투,2414,1816,292,1394,112,9,0,1807,9,598,16.159380188157165,77.14443829551743,6.198118428334256,0.4980630879911455,0.0
93,대구광역시,북구,태전1동,태전1동제6투,2104,1653,286,1235,112,14,3,1650,3,451,17.333333333333336,74.84848484848486,6.787878787878789,0.8484848484848486,0.18181818181818182
94,대구광역시,북구,태전2동,관내사전투표,4096,4096,1515,2230,291,25,4,4065,31,0,37.269372693726936,54.858548585485856,7.158671586715867,0.6150061500615006,0.09840098400984008
95,대구광역시,북구,태전2동,태전2동제1투,2607,1906,256,1524,105,10,1,1896,10,701,13.502109704641349,80.37974683544303,5.537974683544303,0.5274261603375527,0.05274261603375527
96,대구광역시,북구,태전2동,태전2동제2투,2907,1956,312,1513,104,11,4,1944,12,951,16.049382716049383,77.8292181069959,5.349794238683128,0.565843621399177,0.205761316872428
97,대구광역시,북구,태전2동,태전2동제3투,3059,2243,371,1659,187,16,1,2234,9,816,16.606982990152193,74.2614145031334,8.37063563115488,0.7162041181736795,0.044762757385854966
98,대구광역시,북구,태전2동,태전2동제4투,3117,2287,400,1684,160,19,2,2265,22,830,17.660044150110377,74.34878587196468,7.06401766004415,0.8388520971302429,0.08830022075055188
99,대구광역시,북구,태전2동,태전2동제5투,3054,2258,468,1637,117,17,3,2242,16,796,20.87421944692239,73.01516503122212,5.218554861730597,0.7582515611061552,0.13380909901873325
100,대구광역시,북구,구암동,관내사전투표,4398,4398,1937,2002,383,42,3,4367,31,0,44.35539271811312,45.843828715365234,8.770322876116326,0.9617586443782917,0.06869704602702084
101,대구광역시,북구,구암동,구암동제1투,1770,1258,194,960,87,7,4,1252,6,512,15.495207667731629,76.6773162939297,6.94888178913738,0.5591054313099041,0.3194888178913738
102,대구광역시,북구,구암동,구암동제2투,2675,2118,356,1606,133,14,0,2109,9,557,16.880037932669513,76.14983404457088,6.306306306306306,0.6638217164532955,0.0
103,대구광역시,북구,구암동,구암동제3투,2375,1774,351,1299,101,14,1,1766,8,601,19.875424688561722,73.55605889014723,5.719139297848245,0.7927519818799547,0.05662514156285391
104,대구광역시,북구,구암동,구암동제4투,2358,1883,365,1371,121,14,2,1873,10,475,19.487453283502404,73.19807794981314,6.460224239188468,0.7474639615589963,0.10678056593699946
105,대구광역시,북구,구암동,구암동제5투,2770,2069,430,1409,201,11,5,2056,13,701,20.914396887159533,68.53112840466926,9.77626459143969,0.5350194552529183,0.24319066147859922
106,대구광역시,북구,구암동,구암동제6투,2714,1949,403,1344,161,22,3,1933,16,765,20.848422141748575,69.52922917744438,8.329022245214693,1.1381272633212622,0.1551991722710812
107,대구광역시,북구,구암동,구암동제7투,2502,1863,382,1278,173,13,3,1849,14,639,20.6598161168199,69.118442401298,9.356408869659276,0.7030827474310438,0.16224986479177933
108,대구광역시,북구,구암동,구암동제8투,2827,2143,488,1435,190,12,2,2127,16,684,22.943112364833098,67.46591443347437,8.932769158439116,0.5641748942172073,0.09402914903620122
109,대구광역시,북구,관음동,관내사전투표,3151,3149,1097,1759,248,29,3,3136,13,2,34.98086734693878,56.0905612244898,7.908163265306123,0.9247448979591837,0.09566326530612244
110,대구광역시,북구,관음동,관음동제1투,2504,1680,235,1308,101,12,2,1658,22,824,14.173703256936069,78.89022919179735,6.09167671893848,0.7237635705669482,0.12062726176115801
111,대구광역시,북구,관음동,관음동제2투,2318,1633,274,1247,92,8,0,1621,12,685,16.90314620604565,76.92782233189389,5.67550894509562,0.4935225169648365,0.0
112,대구광역시,북구,관음동,관음동제3투,2158,1522,242,1169,87,12,2,1512,10,636,16.005291005291006,77.31481481481481,5.753968253968254,0.7936507936507936,0.13227513227513227
113,대구광역시,북구,관음동,관음동제4투,2770,2033,279,1592,130,15,3,2019,14,737,13.818722139673106,78.85091629519565,6.438831104507181,0.7429420505200593,0.1485884101040119
114,대구광역시,북구,읍내동,관내사전투표,3457,3457,1173,1979,247,22,3,3424,33,0,34.25817757009346,57.79789719626168,7.213785046728972,0.6425233644859812,0.08761682242990654
115,대구광역시,북구,읍내동,읍내동제1투,2521,1685,263,1305,93,11,0,1672,13,836,15.729665071770334,78.05023923444976,5.562200956937799,0.6578947368421052,0.0
116,대구광역시,북구,읍내동,읍내동제2투,2497,1809,253,1401,127,15,1,1797,12,688,14.07902058987201,77.96327212020033,7.0673344462993875,0.8347245409015025,0.05564830272676684
117,대구광역시,북구,읍내동,읍내동제3투,2738,1876,328,1394,121,14,0,1857,19,862,17.662897145934302,75.06731287022077,6.515885837372106,0.7539041464728056,0.0
118,대구광역시,북구,읍내동,읍내동제4투,3185,2277,402,1649,190,22,1,2264,13,908,17.75618374558304,72.83568904593639,8.392226148409893,0.9717314487632509,0.044169611307420496
119,대구광역시,북구,읍내동,읍내동제5투,3000,2246,361,1727,126,13,1,2228,18,754,16.202872531418315,77.51346499102334,5.655296229802514,0.5834829443447037,0.04488330341113106
120,대구광역시,북구,읍내동,읍내동제6투,2549,1966,306,1510,132,9,2,1959,7,583,15.620214395099541,77.08014293006636,6.738131699846861,0.45941807044410415,0.10209290454313426
121,대구광역시,북구,동천동,관내사전투표,4980,4980,2118,2302,478,43,1,4942,38,0,42.857142857142854,46.58033184945366,9.672197490894375,0.8700930797248078,0.020234722784297856
122,대구광역시,북구,동천동,동천동제1투,2388,1702,318,1240,123,9,1,1691,11,686,18.80544056771141,73.32939089296275,7.273802483737433,0.5322294500295683,0.05913660555884093
123,대구광역시,북구,동천동,동천동제2투,2026,1514,288,1110,99,6,2,1505,9,512,19.13621262458472,73.75415282392026,6.578073089700996,0.3986710963455149,0.132890365448505
124,대구광역시,북구,동천동,동천동제3투,2445,2001,426,1367,166,29,1,1989,12,444,21.417797888386122,68.72800402212167,8.345902463549521,1.4580191050779285,0.050276520864756154
125,대구광역시,북구,동천동,동천동제4투,2467,1839,403,1224,177,15,4,1823,16,628,22.106417992320353,67.14207350521119,9.70927043335162,0.8228195282501372,0.21941854086670326
126,대구광역시,북구,동천동,동천동제5투,3334,2658,645,1725,241,28,1,2640,18,676,24.431818181818183,65.3409090909091,9.128787878787879,1.0606060606060608,0.03787878787878788
127,대구광역시,북구,동천동,동천동제6투,3124,2351,411,1694,200,26,1,2332,19,773,17.62435677530017,72.64150943396226,8.576329331046312,1.1149228130360207,0.04288164665523156
128,대구광역시,북구,국우동,관내사전투표,3534,3534,1530,1579,366,33,1,3509,25,0,43.60216585921915,44.99857509261898,10.43032202906811,0.9404388714733543,0.028498147620404674
129,대구광역시,북구,국우동,국우동제1투,2925,2072,398,1498,148,17,2,2063,9,853,19.292292777508482,72.6126999515269,7.174018419777024,0.8240426563257393,0.09694619486185167
130,대구광역시,북구,국우동,국우동제2투,2123,1477,283,1099,71,13,3,1469,8,646,19.264805990469707,74.81279782164738,4.8332198774676645,0.8849557522123894,0.2042205582028591
131,대구광역시,북구,국우동,국우동제3투,2845,2230,443,1562,187,28,2,2222,8,615,19.936993699369935,70.29702970297029,8.415841584158416,1.2601260126012601,0.09000900090009001
132,대구광역시,북구,국우동,국우동제4투,2450,1845,432,1214,166,17,0,1829,16,605,23.61946418808092,66.37506834335703,9.075997813012576,0.9294696555494806,0.0
133,대구광역시,북구,국우동,국우동제5투,2932,2151,520,1396,193,23,3,2135,16,781,24.355971896955502,65.3864168618267,9.039812646370024,1.0772833723653397,0.1405152224824356
134,대구광역시,북구,국우동,국우동제6투,3614,2860,682,1847,294,25,2,2850,10,754,23.92982456140351,64.80701754385964,10.31578947368421,0.8771929824561403,0.07017543859649122
135,대구광역시,북구,국우동,국우동제7투,1837,1219,217,884,99,7,0,1207,12,618,17.978458989229495,73.23943661971832,8.20215410107705,0.579950289975145,0.0
136,대구광역시,북구,잘못 투입·구분된 투표지,,0,2,0,2,0,0,0,2,0,-2,0.0,100.0,0.0,0.0,0.0
0,대구광역시,수성구,거소·선상투표,,483,468,85,287,71,4,5,452,16,15,18.805309734513273,63.495575221238944,15.70796460176991,0.8849557522123894,1.1061946902654867
1,대구광역시,수성구,관외사전투표,,32327,32324,10888,15693,5065,353,33,32032,292,3,33.99100899100899,48.991633366633366,15.812312687312687,1.102022977022977,0.10302197802197803
2,대구광역시,수성구,재외투표,,1966,1525,779,499,216,22,0,1516,9,441,51.385224274406326,32.9155672823219,14.24802110817942,1.4511873350923483,0.0
3,대구광역시,수성구,범어1동,관내사전투표,2893,2893,1058,1421,369,25,0,2873,20,0,36.82561782109293,49.46049425687435,12.843717368604246,0.8701705534284719,0.0
4,대구광역시,수성구,범어1동,범어1동제1투,2189,1659,283,1177,175,16,1,1652,7,530,17.130750605326877,71.24697336561744,10.59322033898305,0.9685230024213075,0.06053268765133172
5,대구광역시,수성구,범어1동,범어1동제2투,2427,1921,185,1531,179,15,0,1910,11,506,9.68586387434555,80.15706806282724,9.3717277486911,0.7853403141361256,0.0
6,대구광역시,수성구,범어1동,범어1동제3투,2987,2424,348,1877,178,14,1,2418,6,563,14.392059553349876,77.62613730355666,7.3614557485525225,0.5789909015715468,0.0413564929693962
7,대구광역시,수성구,범어1동,범어1동제4투,2116,1660,290,1192,157,12,0,1651,9,456,17.56511205330103,72.19866747425803,9.509388249545731,0.7268322228952151,0.0
8,대구광역시,수성구,범어1동,범어1동제5투,2612,2160,376,1518,236,17,3,2150,10,452,17.488372093023255,70.6046511627907,10.976744186046512,0.7906976744186046,0.13953488372093023
9,대구광역시,수성구,범어2동,관내사전투표,1121,1121,423,567,118,9,0,1117,4,0,37.8692927484333,50.76096687555953,10.564010743061774,0.8057296329453895,0.0
10,대구광역시,수성구,범어2동,범어2동제1투,2071,1404,222,1055,110,10,1,1398,6,667,15.879828326180256,75.46494992846924,7.868383404864092,0.7153075822603719,0.07153075822603719
11,대구광역시,수성구,범어2동,범어2동제2투,1514,1167,207,845,100,9,0,1161,6,347,17.829457364341085,72.78208440999138,8.613264427217917,0.7751937984496124,0.0
12,대구광역시,수성구,범어2동,범어2동제3투,2398,1622,221,1244,133,14,1,1613,9,776,13.70117792932424,77.12337259764415,8.245505269683818,0.8679479231246126,0.06199628022318661
13,대구광역시,수성구,범어2동,범어2동제4투,2858,2425,204,1955,249,12,0,2420,5,433,8.429752066115702,80.78512396694215,10.289256198347108,0.49586776859504134,0.0
14,대구광역시,수성구,범어3동,관내사전투표,2730,2730,1088,1277,323,27,1,2716,14,0,40.058910162002945,47.017673048600884,11.892488954344623,0.9941089837997054,0.036818851251840944
15,대구광역시,수성구,범어3동,범어3동제1투,2998,2464,485,1721,225,18,0,2449,15,534,19.80400163331972,70.27358105349121,9.187423438138016,0.7349938750510413,0.0
16,대구광역시,수성구,범어3동,범어3동제2투,3424,2549,374,1882,259,15,0,2530,19,875,14.782608695652174,74.38735177865613,10.237154150197629,0.592885375494071,0.0
17,대구광역시,수성구,범어3동,범어3동제3투,3307,2559,425,1871,235,20,1,2552,7,748,16.653605015673982,73.31504702194357,9.20846394984326,0.7836990595611284,0.03918495297805642
18,대구광역시,수성구,범어4동,관내사전투표,2388,2388,997,1067,270,33,4,2371,17,0,42.049768030366934,45.00210881484606,11.387600168705188,1.3918177983973008,0.1687051876845213
19,대구광역시,수성구,범어4동,범어4동제1투,1819,1365,185,1073,93,9,1,1361,4,454,13.592946362968405,78.83908890521674,6.83321087435709,0.6612784717119765,0.07347538574577515
20,대구광역시,수성구,범어4동,범어4동제2투,2782,2181,455,1461,229,23,3,2171,10,601,20.958083832335326,67.2961768770152,10.54813450023031,1.0594196222938737,0.1381851681252879
21,대구광역시,수성구,범어4동,범어4동제3투,2395,1815,322,1276,185,15,4,1802,13,580,17.869034406215317,70.81021087680355,10.266370699223087,0.8324084350721421,0.22197558268590456
22,대구광역시,수성구,범어4동,범어4동제4투,2555,1992,304,1472,190,17,0,1983,9,563,15.330307614725164,74.23096318709027,9.581442259203229,0.8572869389813415,0.0
23,대구광역시,수성구,만촌1동,관내사전투표,3351,3351,1307,1715,279,26,0,3327,24,0,39.28464081755335,51.547941088067326,8.385933273219116,0.7814848211602045,0.0
24,대구광역시,수성구,만촌1동,만촌1동제1투,2210,1707,225,1355,112,10,2,1704,3,503,13.204225352112676,79.51877934272301,6.572769953051644,0.5868544600938966,0.11737089201877934
25,대구광역시,수성구,만촌1동,만촌1동제2투,2700,2175,460,1510,182,14,1,2167,8,525,21.227503461006002,69.68158744808491,8.398707891093677,0.6460544531610521,0.046146746654360866
26,대구광역시,수성구,만촌1동,만촌1동제3투,2107,1637,252,1271,98,10,0,1631,6,470,15.450643776824036,77.92765174739424,6.008583690987124,0.6131207847946045,0.0
27,대구광역시,수성구,만촌1동,만촌1동제4투,2614,1855,296,1409,127,7,1,1840,15,759,16.08695652173913,76.57608695652173,6.9021739130434785,0.3804347826086957,0.05434782608695652
28,대구광역시,수성구,만촌1동,만촌1동제5투,3172,2437,305,1961,147,14,1,2428,9,735,12.561779242174628,80.7660626029654,6.0543657331136735,0.5766062602965404,0.04118616144975289
29,대구광역시,수성구,만촌2동,관내사전투표,2010,2010,830,938,212,18,1,1999,11,0,41.5207603801901,46.923461730865434,10.605302651325662,0.9004502251125562,0.05002501250625312
30,대구광역시,수성구,만촌2동,만촌2동제1투,2923,2151,384,1504,228,19,2,2137,14,772,17.96911558259242,70.3790360318203,10.669162377164248,0.8890968647636874,0.09358914365933552
31,대구광역시,수성구,만촌2동,만촌2동제2투,2230,1567,189,1252,106,8,0,1555,12,663,12.154340836012862,80.51446945337621,6.816720257234726,0.5144694533762058,0.0
32,대구광역시,수성구,만촌2동,만촌2동제3투,2426,1850,267,1424,135,13,0,1839,11,576,14.518760195758565,77.43338771071234,7.3409461663947795,0.7069059271343121,0.0
33,대구광역시,수성구,만촌3동,관내사전투표,2431,2431,956,1176,261,24,2,2419,12,0,39.52046300124018,48.6151302190988,10.789582472095907,0.9921455146754857,0.0826787928896238
34,대구광역시,수성구,만촌3동,만촌3동제1투,3576,2627,426,1919,243,21,1,2610,17,949,16.32183908045977,73.52490421455938,9.310344827586208,0.8045977011494253,0.03831417624521073
35,대구광역시,수성구,만촌3동,만촌3동제2투,2924,2306,485,1559,235,16,4,2299,7,618,21.096128751631145,67.81209221400609,10.221835580687255,0.6959547629404089,0.17398869073510223
36,대구광역시,수성구,만촌3동,만촌3동제3투,2087,1644,271,1201,146,18,0,1636,8,443,16.56479217603912,73.41075794621027,8.924205378973104,1.1002444987775062,0.0
37,대구광역시,수성구,만촌3동,만촌3동제4투,3037,2416,416,1743,226,18,2,2405,11,621,17.2972972972973,72.47401247401247,9.397089397089397,0.7484407484407485,0.08316008316008316
38,대구광역시,수성구,수성1가동,관내사전투표,2742,2742,1020,1455,219,25,6,2725,17,0,37.43119266055046,53.39449541284404,8.036697247706421,0.9174311926605505,0.22018348623853212
39,대구광역시,수성구,수성1가동,수성1가동제1투,2512,1965,363,1448,131,13,0,1955,10,547,18.567774936061383,74.06649616368286,6.70076726342711,0.6649616368286445,0.0
40,대구광역시,수성구,수성1가동,수성1가동제2투,2958,2286,335,1778,150,15,3,2281,5,672,14.686540990793512,77.94826830337571,6.57606313020605,0.657606313020605,0.131521262604121
41,대구광역시,수성구,수성1가동,수성1가동제3투,2653,2020,225,1637,138,11,1,2012,8,633,11.182902584493041,81.36182902584494,6.858846918489066,0.5467196819085487,0.049701789264413515
42,대구광역시,수성구,수성1가동,수성1가동제4투,2234,1609,207,1297,82,12,1,1599,10,625,12.94559099437148,81.11319574734209,5.128205128205128,0.7504690431519699,0.06253908692933083
43,대구광역시,수성구,수성2·3가동,관내사전투표,2415,2415,811,1342,230,16,0,2399,16,0,33.80575239683201,55.939974989578985,9.587328053355565,0.6669445602334306,0.0
44,대구광역시,수성구,수성2·3가동,수성2·3가동제1투,2346,1863,231,1437,184,6,2,1860,3,483,12.419354838709678,77.25806451612904,9.89247311827957,0.3225806451612903,0.10752688172043011
45,대구광역시,수성구,수성2·3가동,수성2·3가동제2투,1982,1529,191,1202,123,10,2,1528,1,453,12.5,78.66492146596859,8.049738219895287,0.6544502617801047,0.13089005235602094
46,대구광역시,수성구,수성2·3가동,수성2·3가동제3투,1756,1247,124,1042,64,8,2,1240,7,509,10.0,84.03225806451613,5.161290322580645,0.6451612903225806,0.16129032258064516
47,대구광역시,수성구,수성4가동,관내사전투표,2549,2549,863,1376,267,24,2,2532,17,0,34.08372827804108,54.34439178515008,10.545023696682465,0.9478672985781991,0.07898894154818326
48,대구광역시,수성구,수성4가동,수성4가동제1투,2347,1767,249,1386,110,12,2,1759,8,580,14.155770324047753,78.79476975554293,6.253553155201819,0.6822057987492893,0.11370096645821488
49,대구광역시,수성구,수성4가동,수성4가동제2투,2412,1771,219,1439,95,8,2,1763,8,641,12.422007941009642,81.62223482699943,5.388542257515598,0.45377197958026094,0.11344299489506524
50,대구광역시,수성구,수성4가동,수성4가동제3투,1821,1386,153,1130,86,11,0,1380,6,435,11.08695652173913,81.88405797101449,6.231884057971015,0.7971014492753623,0.0
51,대구광역시,수성구,수성4가동,수성4가동제4투,1712,1288,161,1012,103,9,2,1287,1,424,12.509712509712509,78.63247863247864,8.003108003108004,0.6993006993006993,0.1554001554001554
52,대구광역시,수성구,황금1동,관내사전투표,2815,2814,1177,1294,298,30,1,2800,14,1,42.035714285714285,46.214285714285715,10.642857142857142,1.0714285714285714,0.03571428571428571
53,대구광역시,수성구,황금1동,황금1동제1투,2785,2146,219,1746,156,12,1,2134,12,639,10.262417994376758,81.81818181818183,7.310215557638237,0.5623242736644799,0.046860356138706656
54,대구광역시,수성구,황금1동,황금1동제2투,1372,1025,165,786,55,12,0,1018,7,347,16.208251473477407,77.21021611001964,5.402750491159136,1.1787819253438114,0.0
55,대구광역시,수성구,황금1동,황금1동제3투,3371,2673,434,1959,245,18,3,2659,14,698,16.321925535915756,73.67431365174878,9.213990221887927,0.6769462203836029,0.11282437006393381
56,대구광역시,수성구,황금1동,황금1동제4투,2878,2314,461,1570,249,25,1,2306,8,564,19.991326973113615,68.08326105810927,10.797918473547268,1.0841283607979184,0.04336513443191674
57,대구광역시,수성구,황금1동,황금1동제5투,2140,1707,267,1254,161,17,1,1700,7,433,15.705882352941178,73.76470588235294,9.470588235294118,1.0,0.0588235294117647
58,대구광역시,수성구,황금2동,관내사전투표,2111,2111,810,1084,193,15,0,2102,9,0,38.53472882968602,51.56993339676499,9.181731684110371,0.7136060894386299,0.0
59,대구광역시,수성구,황금2동,황금2동제1투,2705,1956,291,1486,160,9,0,1946,10,749,14.953751284686536,76.3617677286742,8.221993833504625,0.4624871531346352,0.0
60,대구광역시,수성구,황금2동,황금2동제2투,2397,1596,253,1230,94,6,2,1585,11,801,15.962145110410095,77.60252365930599,5.930599369085174,0.3785488958990536,0.12618296529968456
61,대구광역시,수성구,황금2동,황금2동제3투,1962,1271,158,1033,70,5,0,1266,5,691,12.480252764612953,81.5955766192733,5.529225908372828,0.3949447077409162,0.0
62,대구광역시,수성구,중동,관내사전투표,1925,1925,727,992,177,16,2,1914,11,0,37.98328108672936,51.828631138975965,9.247648902821316,0.8359456635318705,0.10449320794148381
63,대구광역시,수성구,중동,중동제1투,1614,994,112,808,59,9,0,988,6,620,11.336032388663968,81.78137651821862,5.97165991902834,0.9109311740890688,0.0
64,대구광역시,수성구,중동,중동제2투,2458,1907,303,1425,166,8,0,1902,5,551,15.930599369085174,74.9211356466877,8.727655099894847,0.4206098843322818,0.0
65,대구광역시,수성구,중동,중동제3투,2185,1466,179,1173,92,9,0,1453,13,719,12.31933929800413,80.72952512044047,6.331727460426703,0.6194081211286993,0.0
66,대구광역시,수성구,중동,중동제4투,3036,2398,405,1729,241,14,3,2392,6,638,16.9314381270903,72.28260869565217,10.075250836120402,0.5852842809364548,0.1254180602006689
67,대구광역시,수성구,상동,관내사전투표,1677,1677,615,914,121,19,0,1669,8,0,36.84841222288796,54.76333133612942,7.249850209706412,1.1384062312762133,0.0
68,대구광역시,수성구,상동,상동제1투,2370,1475,194,1161,88,16,2,1461,14,895,13.27857631759069,79.46611909650923,6.023271731690623,1.0951403148528405,0.13689253935660506
69,대구광역시,수성구,상동,상동제2투,3501,2628,304,2111,191,9,2,2617,11,873,11.61635460450898,80.66488345433702,7.298433320596103,0.3439052350019106,0.07642338555598013
70,대구광역시,수성구,상동,상동제3투,2166,1678,214,1351,101,5,0,1671,7,488,12.806702573309394,80.84979054458408,6.044284859365649,0.2992220227408737,0.0
71,대구광역시,수성구,상동,상동제4투,2049,1416,214,1119,60,12,1,1406,10,633,15.220483641536273,79.58748221906117,4.267425320056899,0.8534850640113799,0.07112375533428165
72,대구광역시,수성구,파동,관내사전투표,2565,2565,933,1397,206,17,1,2554,11,0,36.530931871574005,54.698512137823016,8.065779169929522,0.6656225528582616,0.03915426781519186
73,대구광역시,수성구,파동,파동제1투,2936,2120,276,1654,163,14,1,2108,12,816,13.092979127134724,78.4629981024668,7.732447817836813,0.6641366223908919,0.04743833017077799
74,대구광역시,수성구,파동,파동제2투,3298,2517,433,1887,166,18,1,2505,12,781,17.285429141716566,75.32934131736528,6.626746506986028,0.718562874251497,0.03992015968063872
75,대구광역시,수성구,파동,파동제3투,3410,2511,361,1968,160,10,0,2499,12,899,14.445778311324531,78.75150060024009,6.402561024409764,0.4001600640256103,0.0
76,대구광역시,수성구,두산동,관내사전투표,2054,2054,786,1047,190,12,4,2039,15,0,38.54830799411476,51.348700343305545,9.31829328102011,0.588523786169691,0.196174595389897
77,대구광역시,수성구,두산동,두산동제1투,2158,1382,186,1067,120,5,0,1378,4,776,13.497822931785198,77.43105950653121,8.708272859216255,0.36284470246734396,0.0
78,대구광역시,수성구,두산동,두산동제2투,2271,1492,230,1120,124,9,0,1483,9,779,15.509103169251517,75.52258934592044,8.361429534726906,0.6068779501011463,0.0
79,대구광역시,수성구,두산동,두산동제3투,3112,2550,282,2040,199,9,7,2537,13,562,11.115490737091053,80.40993299172251,7.843910130074892,0.35474970437524633,0.27591643673630273
80,대구광역시,수성구,두산동,두산동제4투,2258,1470,177,1174,102,9,1,1463,7,788,12.098427887901572,80.24606971975393,6.971975393028025,0.6151742993848257,0.0683526999316473
81,대구광역시,수성구,지산1동,관내사전투표,3405,3405,1256,1862,247,16,4,3385,20,0,37.104874446085674,55.00738552437223,7.296898079763663,0.4726735598227474,0.11816838995568685
82,대구광역시,수성구,지산1동,지산1동제1투,1998,1482,168,1221,84,4,2,1479,3,516,11.359026369168356,82.55578093306288,5.679513184584178,0.2704530087897228,0.1352265043948614
83,대구광역시,수성구,지산1동,지산1동제2투,1447,1012,137,800,64,4,0,1005,7,435,13.631840796019901,79.60199004975125,6.368159203980099,0.3980099502487562,0.0
84,대구광역시,수성구,지산1동,지산1동제3투,1708,1175,170,935,57,6,0,1168,7,533,14.554794520547945,80.0513698630137,4.88013698630137,0.5136986301369862,0.0
85,대구광역시,수성구,지산1동,지산1동제4투,2456,1823,224,1456,121,11,2,1814,9,633,12.348401323042998,80.26460859977949,6.6703417861080485,0.6063947078280044,0.11025358324145534
86,대구광역시,수성구,지산1동,지산1동제5투,2708,1937,299,1466,144,12,3,1924,13,771,15.54054054054054,76.1954261954262,7.484407484407485,0.6237006237006237,0.15592515592515593
87,대구광역시,수성구,지산1동,지산1동제6투,2781,1919,272,1523,106,12,1,1914,5,862,14.211076280041798,79.57157784743991,5.538140020898641,0.6269592476489028,0.052246603970741906
88,대구광역시,수성구,지산2동,관내사전투표,2806,2806,1013,1512,232,32,2,2791,15,0,36.29523468290935,54.17413113579362,8.312432819777857,1.146542457900394,0.07165890361877462
89,대구광역시,수성구,지산2동,지산2동제1투,2326,1541,202,1251,70,9,1,1533,8,785,13.176777560339204,81.60469667318982,4.5662100456621,0.5870841487279843,0.06523157208088715
90,대구광역시,수성구,지산2동,지산2동제2투,3364,2579,357,2029,163,17,0,2566,13,785,13.91270459859704,79.07248636009354,6.352299298519096,0.6625097427903351,0.0
91,대구광역시,수성구,지산2동,지산2동제3투,3280,2392,367,1867,129,17,4,2384,8,888,15.394295302013422,78.31375838926175,5.4110738255033555,0.7130872483221476,0.16778523489932887
92,대구광역시,수성구,지산2동,지산2동제4투,2832,2132,326,1620,169,6,3,2124,8,700,15.34839924670433,76.27118644067797,7.956685499058381,0.2824858757062147,0.14124293785310735
93,대구광역시,수성구,범물1동,관내사전투표,2211,2211,602,1442,145,7,0,2196,15,0,27.413479052823313,65.6648451730419,6.602914389799635,0.31876138433515483,0.0
94,대구광역시,수성구,범물1동,범물1동제1투,1577,1032,125,856,38,4,0,1023,9,545,12.218963831867057,83.67546432062561,3.714565004887586,0.39100684261974583,0.0
95,대구광역시,수성구,범물1동,범물1동제2투,1172,737,81,631,19,2,0,733,4,435,11.050477489768076,86.08458390177354,2.592087312414734,0.2728512960436562,0.0
96,대구광역시,수성구,범물1동,범물1동제3투,2033,1584,234,1275,61,5,2,1577,7,449,14.838300570703868,80.84971464806596,3.868103994927077,0.31705770450221943,0.12682308180088775
97,대구광역시,수성구,범물1동,범물1동제4투,1995,1484,206,1199,64,4,0,1473,11,511,13.985064494229462,81.39850644942295,4.344874405974202,0.2715546503733876,0.0
98,대구광역시,수성구,범물2동,관내사전투표,2561,2561,998,1318,202,26,1,2545,16,0,39.214145383104125,51.787819253438116,7.937131630648329,1.0216110019646365,0.03929273084479371
99,대구광역시,수성구,범물2동,범물2동제1투,3101,2382,384,1793,175,17,1,2370,12,719,16.20253164556962,75.65400843881856,7.383966244725738,0.7172995780590717,0.04219409282700422
100,대구광역시,수성구,범물2동,범물2동제2투,1759,1265,215,943,87,12,0,1257,8,494,17.104216388225936,75.01988862370725,6.921241050119331,0.9546539379474941,0.0
101,대구광역시,수성구,범물2동,범물2동제3투,2321,1793,288,1340,144,9,3,1784,9,528,16.143497757847534,75.11210762331838,8.071748878923767,0.5044843049327354,0.1681614349775785
102,대구광역시,수성구,범물2동,범물2동제4투,2451,1898,325,1440,101,22,0,1888,10,553,17.21398305084746,76.27118644067797,5.349576271186441,1.1652542372881356,0.0
103,대구광역시,수성구,고산1동,관내사전투표,5196,5196,2267,2328,507,60,4,5166,30,0,43.88308168795974,45.063879210220676,9.814169570267131,1.1614401858304297,0.07742934572202864
104,대구광역시,수성구,고산1동,고산1동제1투,3138,2420,572,1576,228,31,4,2411,9,718,23.72459560348403,65.36706760680215,9.456656988801328,1.2857735379510575,0.16590626296142677
105,대구광역시,수성구,고산1동,고산1동제2투,2078,1552,242,1201,98,6,0,1547,5,526,15.643180349062701,77.63413057530705,6.334841628959276,0.3878474466709761,0.0
106,대구광역시,수성구,고산1동,고산1동제3투,2954,2205,352,1642,176,20,1,2191,14,749,16.065723413966225,74.94294842537654,8.032861706983113,0.9128251939753538,0.045641259698767686
107,대구광역시,수성구,고산1동,고산1동제4투,1953,1470,228,1114,106,13,1,1462,8,483,15.595075239398085,76.1969904240766,7.250341997264022,0.8891928864569083,0.06839945280437756
108,대구광역시,수성구,고산1동,고산1동제5투,2351,1904,327,1415,139,12,2,1895,9,447,17.25593667546174,74.67018469656992,7.33509234828496,0.6332453825857519,0.10554089709762532
109,대구광역시,수성구,고산1동,고산1동제6투,3343,2663,591,1817,211,32,3,2654,9,680,22.26827430293896,68.46269781461945,7.950263752825923,1.2057272042200453,0.11303692539562923
110,대구광역시,수성구,고산1동,고산1동제7투,2630,2075,517,1322,207,20,0,2066,9,555,25.024201355275892,63.98838334946757,10.019361084220717,0.9680542110358179,0.0
111,대구광역시,수성구,고산2동,관내사전투표,3967,3967,1659,1879,358,42,5,3943,24,0,42.07456251585088,47.65407050469186,9.079381181841239,1.0651787978696423,0.12680699974638598
112,대구광역시,수성구,고산2동,고산2동제1투,2405,1822,268,1380,146,16,1,1811,11,583,14.798453892876864,76.20099392600773,8.061844284925455,0.8834897846493651,0.05521811154058532
113,대구광역시,수성구,고산2동,고산2동제2투,2449,2003,399,1395,169,30,1,1994,9,446,20.01003009027081,69.95987963891676,8.47542627883651,1.5045135406218655,0.05015045135406219
114,대구광역시,수성구,고산2동,고산2동제3투,2354,1646,256,1250,118,15,0,1639,7,708,15.61928004881025,76.2660158633313,7.199511897498474,0.9151921903599756,0.0
115,대구광역시,수성구,고산2동,고산2동제4투,2747,2158,427,1546,157,20,1,2151,7,589,19.8512319851232,71.87354718735472,7.2989307298930735,0.9298000929800093,0.046490004649000466
116,대구광역시,수성구,고산2동,고산2동제5투,2960,2375,498,1659,193,13,0,2363,12,585,21.07490478205671,70.20736352094795,8.167583580194668,0.5501481168006771,0.0
117,대구광역시,수성구,고산2동,고산2동제6투,2710,2117,465,1453,165,24,0,2107,10,593,22.069292833412433,68.96060749881347,7.831039392501187,1.1390602752728998,0.0
118,대구광역시,수성구,고산3동,관내사전투표,4730,4730,1919,2295,455,34,4,4707,23,0,40.7690673465052,48.75717017208413,9.666454217123434,0.7223284469938389,0.08497981729339282
119,대구광역시,수성구,고산3동,고산3동제1투,2398,1735,248,1345,116,12,1,1722,13,663,14.40185830429733,78.1068524970964,6.736353077816492,0.6968641114982579,0.05807200929152149
120,대구광역시,수성구,고산3동,고산3동제2투,2052,1519,211,1194,90,10,4,1509,10,533,13.982770046388337,79.12524850894633,5.964214711729622,0.6626905235255135,0.26507620941020543
121,대구광역시,수성구,고산3동,고산3동제3투,2266,1667,300,1212,124,23,2,1661,6,599,18.06140878988561,72.96809151113787,7.465382299819385,1.3847080072245637,0.12040939193257075
122,대구광역시,수성구,고산3동,고산3동제4투,1952,1512,271,1109,117,12,1,1510,2,440,17.947019867549667,73.44370860927152,7.748344370860927,0.7947019867549668,0.06622516556291391
123,대구광역시,수성구,고산3동,고산3동제5투,2744,2226,421,1611,161,21,3,2217,9,518,18.989625620207487,72.66576454668471,7.262065854758683,0.9472259810554804,0.13531799729364005
124,대구광역시,수성구,고산3동,고산3동제6투,3019,2366,439,1693,204,21,0,2357,9,653,18.62537123462028,71.828595672465,8.655070004242681,0.8909630886720408,0.0
125,대구광역시,수성구,고산3동,고산3동제7투,3574,2843,607,1949,246,30,1,2833,10,731,21.426050123543945,68.79632897987999,8.683374514648783,1.0589481115425343,0.03529827038475115
126,대구광역시,수성구,잘못 투입·구분된 투표지,,0,0,0,0,0,0,0,0,0,0,0.0,0.0,0.0,0.0,0.0
0,대구광역시,달서구,거소·선상투표,,685,642,146,351,120,4,1,622,20,43,23.47266881028939,56.430868167202576,19.292604501607716,0.6430868167202572,0.1607717041800643
1,대구광역시,달서구,관외사전투표,,34789,34779,11574,17221,5257,357,38,34447,332,10,33.59944262199902,49.99274247394548,15.261125787441577,1.036374720585247,0.11031439602868175
2,대구광역시,달서구,재외투표,,1558,1259,723,325,171,26,3,1248,11,299,57.932692307692314,26.041666666666668,13.701923076923078,2.083333333333333,0.2403846153846154
3,대구광역시,달서구,성당동,관내사전투표,2512,2512,756,1563,158,17,2,2496,16,0,30.288461538461537,62.620192307692314,6.330128205128204,0.6810897435897436,0.08012820512820512
4,대구광역시,달서구,성당동,성당동제1투,2319,1573,178,1294,83,6,1,1562,11,746,11.395646606914212,82.84250960307298,5.313700384122919,0.3841229193341869,0.06402048655569782
5,대구광역시,달서구,성당동,성당동제2투,1912,1346,158,1108,63,8,0,1337,9,566,11.81750186985789,82.87210172026927,4.712041884816754,0.5983545250560958,0.0
6,대구광역시,달서구,성당동,성당동제3투,3035,2009,257,1608,124,10,0,1999,10,1026,12.856428214107055,80.44022011005502,6.203101550775387,0.5002501250625313,0.0
7,대구광역시,달서구,성당동,성당동제4투,3240,2431,467,1749,182,18,1,2417,14,809,19.321472900289617,72.36243276789408,7.529995862639637,0.7447248655357882,0.04137360364087712
8,대구광역시,달서구,성당동,성당동제5투,2965,2127,327,1646,127,16,1,2117,10,838,15.446386395843174,77.75153519130845,5.999055266887105,0.7557864903164856,0.04723665564478035
9,대구광역시,달서구,두류1·2동,관내사전투표,2312,2312,705,1404,162,19,2,2292,20,0,30.759162303664922,61.25654450261781,7.068062827225131,0.8289703315881327,0.08726003490401396
10,대구광역시,달서구,두류1·2동,두류1·2동제1투,1777,1261,171,1007,70,3,2,1253,8,516,13.647246608140462,80.36711891460496,5.58659217877095,0.23942537909018355,0.1596169193934557
11,대구광역시,달서구,두류1·2동,두류1·2동제2투,1766,1222,144,1000,57,6,2,1209,13,544,11.910669975186105,82.7129859387924,4.714640198511166,0.49627791563275436,0.1654259718775848
12,대구광역시,달서구,두류1·2동,두류1·2동제3투,2741,1898,304,1409,161,14,0,1888,10,843,16.101694915254235,74.6292372881356,8.527542372881355,0.7415254237288136,0.0
13,대구광역시,달서구,두류1·2동,두류1·2동제4투,1878,1199,168,947,68,6,0,1189,10,679,14.129520605550884,79.64676198486123,5.719091673675358,0.5046257359125316,0.0
14,대구광역시,달서구,두류1·2동,두류1·2동제5투,2247,1452,218,1092,125,8,0,1443,9,795,15.107415107415106,75.67567567567568,8.662508662508662,0.5544005544005544,0.0
15,대구광역시,달서구,두류3동,관내사전투표,1993,1993,627,1193,139,20,2,1981,12,0,31.65068147400303,60.2221100454316,7.016658253407371,1.0095911155981827,0.10095911155981827
16,대구광역시,달서구,두류3동,두류3동제1투,2434,1797,233,1431,102,11,7,1784,13,637,13.060538116591927,80.21300448430493,5.7174887892376685,0.6165919282511211,0.3923766816143498
17,대구광역시,달서구,두류3동,두류3동제2투,1505,1015,122,821,64,2,0,1009,6,490,12.091179385530229,81.36769078295342,6.342913776015857,0.19821605550049554,0.0
18,대구광역시,달서구,두류3동,두류3동제3투,1822,1306,231,964,92,13,1,1301,5,516,17.755572636433513,74.0968485780169,7.071483474250577,0.9992313604919293,0.07686395080707148
19,대구광역시,달서구,본리동,관내사전투표,4865,4865,1915,2483,380,40,6,4824,41,0,39.69734660033167,51.47180762852405,7.877280265339967,0.8291873963515755,0.12437810945273632
20,대구광역시,달서구,본리동,본리동제1투,2329,1817,314,1334,147,7,1,1803,14,512,17.415418746533557,73.98779811425402,8.153078202995008,0.3882418191902385,0.055463117027176934
21,대구광역시,달서구,본리동,본리동제2투,4099,2746,461,2030,206,25,5,2727,19,1353,16.905023835716907,74.44077741107445,7.554088742207554,0.9167583425009167,0.18335166850018336
22,대구광역시,달서구,본리동,본리동제3투,2840,2062,328,1551,160,12,3,2054,8,778,15.96884128529698,75.5111976630964,7.789678675754626,0.5842259006815969,0.1460564751703992
23,대구광역시,달서구,본리동,본리동제4투,1852,1450,245,1094,95,5,1,1440,10,402,17.01388888888889,75.97222222222221,6.597222222222222,0.3472222222222222,0.06944444444444445
24,대구광역시,달서구,본리동,본리동제5투,2290,1703,302,1279,114,3,2,1700,3,587,17.764705882352942,75.23529411764706,6.705882352941177,0.17647058823529413,0.1176470588235294
25,대구광역시,달서구,감삼동,관내사전투표,2395,2395,826,1327,215,15,3,2386,9,0,34.61860854987427,55.616093880972336,9.010896898575021,0.6286672254819782,0.12573344509639564
26,대구광역시,달서구,감삼동,감삼동제1투,2296,1601,209,1256,111,13,3,1592,9,695,13.128140703517587,78.89447236180904,6.972361809045226,0.8165829145728644,0.18844221105527637
27,대구광역시,달서구,감삼동,감삼동제2투,2273,1600,213,1279,90,12,1,1595,5,673,13.35423197492163,80.18808777429467,5.6426332288401255,0.7523510971786834,0.06269592476489029
28,대구광역시,달서구,감삼동,감삼동제3투,2302,1575,223,1237,96,8,2,1566,9,727,14.240102171136654,78.99106002554278,6.130268199233716,0.5108556832694764,0.1277139208173691
29,대구광역시,달서구,감삼동,감삼동제4투,2539,1855,285,1429,118,9,1,1842,13,684,15.472312703583063,77.57871878393051,6.406080347448426,0.4885993485342019,0.05428881650380022
30,대구광역시,달서구,감삼동,감삼동제5투,2271,1811,362,1268,162,7,3,1802,9,460,20.08879023307436,70.36625971143174,8.990011098779133,0.388457269700333,0.1664816870144284
31,대구광역시,달서구,감삼동,감삼동제6투,2823,2273,269,1838,156,5,0,2268,5,550,11.860670194003527,81.04056437389771,6.878306878306878,0.2204585537918871,0.0
32,대구광역시,달서구,감삼동,감삼동제7투,2416,2014,307,1508,170,17,3,2005,9,402,15.311720698254364,75.21197007481297,8.478802992518704,0.8478802992518704,0.14962593516209477
33,대구광역시,달서구,감삼동,감삼동제8투,2950,2335,485,1584,232,18,1,2320,15,615,20.905172413793103,68.27586206896552,10.0,0.7758620689655172,0.04310344827586207
34,대구광역시,달서구,죽전동,관내사전투표,2051,2051,708,1113,189,20,3,2033,18,0,34.825381210034436,54.746679783571075,9.296606000983768,0.9837678307919331,0.14756517461878996
35,대구광역시,달서구,죽전동,죽전동제1투,2213,1640,270,1188,157,14,1,1630,10,573,16.56441717791411,72.88343558282209,9.631901840490798,0.8588957055214724,0.06134969325153375
36,대구광역시,달서구,죽전동,죽전동제2투,1824,1188,161,944,69,8,0,1182,6,636,13.620981387478851,79.86463620981388,5.83756345177665,0.676818950930626,0.0
37,대구광역시,달서구,죽전동,죽전동제3투,2822,2018,307,1524,153,13,0,1997,21,804,15.373059589384075,76.31447170756134,7.661492238357537,0.6509764646970456,0.0
38,대구광역시,달서구,죽전동,죽전동제4투,2991,2131,293,1677,135,9,1,2115,16,860,13.853427895981088,79.29078014184398,6.382978723404255,0.425531914893617,0.04728132387706856
39,대구광역시,달서구,장기동,관내사전투표,4049,4049,1540,2083,382,21,1,4027,22,0,38.24186739508319,51.72585050906382,9.48596970449466,0.5214800099329526,0.024832381425378695
40,대구광역시,달서구,장기동,장기동제1투,2620,1907,296,1436,154,15,1,1902,5,713,15.562565720294428,75.49947423764458,8.096740273396424,0.7886435331230284,0.052576235541535225
41,대구광역시,달서구,장기동,장기동제2투,1548,1051,138,834,61,8,1,1042,9,497,13.24376199616123,80.03838771593091,5.854126679462572,0.7677543186180422,0.09596928982725528
42,대구광역시,달서구,장기동,장기동제3투,2971,2310,352,1753,173,20,0,2298,12,661,15.317667536988685,76.28372497824195,7.528285465622281,0.8703220191470844,0.0
43,대구광역시,달서구,장기동,장기동제4투,2940,2115,345,1552,186,16,3,2102,13,825,16.412940057088488,73.83444338725023,8.84871550903901,0.7611798287345386,0.142721217887726
44,대구광역시,달서구,용산1동,관내사전투표,4521,4521,1586,2511,364,35,5,4501,20,0,35.236614085758724,55.78760275494334,8.087091757387247,0.7776049766718507,0.1110864252388358
45,대구광역시,달서구,용산1동,용산1동제1투,2289,1559,199,1228,113,10,0,1550,9,730,12.838709677419354,79.2258064516129,7.290322580645162,0.6451612903225806,0.0
46,대구광역시,달서구,용산1동,용산1동제2투,2934,2269,456,1624,163,14,2,2259,10,665,20.185922974767596,71.89021691013723,7.215582115980522,0.619743249225321,0.08853474988933156
47,대구광역시,달서구,용산1동,용산1동제3투,2248,1656,250,1248,130,12,2,1642,14,592,15.225334957369064,76.00487210718636,7.917174177831912,0.730816077953715,0.12180267965895249
48,대구광역시,달서구,용산1동,용산1동제4투,2531,1984,337,1496,125,12,1,1971,13,547,17.097919837645865,75.90055809233891,6.341958396752917,0.60882800608828,0.050735667174023336
49,대구광역시,달서구,용산1동,용산1동제5투,2467,1778,297,1332,120,20,0,1769,9,689,16.789146410401358,75.29677784058791,6.783493499152063,1.1305822498586773,0.0
50,대구광역시,달서구,용산1동,용산1동제6투,2990,2254,335,1740,158,10,0,2243,11,736,14.935354436023182,77.57467677218011,7.044137316094516,0.4458314757021846,0.0
51,대구광역시,달서구,용산1동,용산1동제7투,3138,2493,320,1973,176,17,1,2487,6,645,12.866907921190188,79.33252915158826,7.076799356654603,0.6835544833132288,0.04020908725371934
52,대구광역시,달서구,용산2동,관내사전투표,3060,3060,1091,1637,273,34,1,3036,24,0,35.935441370223984,53.91963109354414,8.992094861660078,1.1198945981554678,0.03293807641633729
53,대구광역시,달서구,용산2동,용산2동제1투,2174,1481,246,1088,129,11,1,1475,6,693,16.677966101694917,73.76271186440678,8.745762711864407,0.7457627118644068,0.06779661016949153
54,대구광역시,달서구,용산2동,용산2동제2투,2817,1824,305,1364,127,10,3,1809,15,993,16.86014372581537,75.4007739082366,7.020453289110005,0.552791597567717,0.16583747927031509
55,대구광역시,달서구,용산2동,용산2동제3투,1776,1453,264,1067,109,7,1,1448,5,323,18.23204419889503,73.6878453038674,7.527624309392265,0.48342541436464087,0.06906077348066297
56,대구광역시,달서구,용산2동,용산2동제4투,2876,2406,398,1764,202,31,1,2396,10,470,16.6110183639399,73.62270450751252,8.430717863105174,1.2938230383973288,0.041736227045075125
57,대구광역시,달서구,용산2동,용산2동제5투,3177,2488,473,1800,181,18,2,2474,14,689,19.118835893290218,72.75666936135814,7.316087308003234,0.7275666936135812,0.08084074373484236
58,대구광역시,달서구,용산2동,용산2동제6투,2211,1725,310,1293,107,9,1,1720,5,486,18.023255813953487,75.17441860465117,6.22093023255814,0.5232558139534884,0.05813953488372093
59,대구광역시,달서구,용산2동,용산2동제7투,2517,2003,312,1543,113,17,5,1990,13,514,15.678391959798995,77.53768844221105,5.678391959798995,0.8542713567839196,0.25125628140703515
60,대구광역시,달서구,이곡1동,관내사전투표,3245,3245,1245,1625,322,26,2,3220,25,0,38.66459627329192,50.465838509316775,10.0,0.8074534161490683,0.062111801242236024
61,대구광역시,달서구,이곡1동,이곡1동제1투,1980,1309,216,963,104,10,0,1293,16,671,16.70533642691415,74.47795823665894,8.043310131477185,0.7733952049497294,0.0
62,대구광역시,달서구,이곡1동,이곡1동제2투,1534,1176,189,894,75,12,1,1171,5,358,16.1400512382579,76.34500426985483,6.404782237403928,1.0247651579846286,0.08539709649871904
63,대구광역시,달서구,이곡1동,이곡1동제3투,2742,2145,459,1482,171,15,2,2129,16,597,21.559417566932833,69.61014560826679,8.031939877876937,0.7045561296383279,0.09394081728511039
64,대구광역시,달서구,이곡1동,이곡1동제4투,2170,1659,279,1227,124,13,2,1645,14,511,16.96048632218845,74.58966565349544,7.537993920972644,0.7902735562310031,0.12158054711246201
65,대구광역시,달서구,이곡1동,이곡1동제5투,2425,1901,393,1338,147,16,0,1894,7,524,20.74973600844773,70.6441393875396,7.761351636747624,0.8447729672650475,0.0
66,대구광역시,달서구,이곡1동,이곡1동제6투,3112,2387,421,1780,153,17,2,2373,14,725,17.74125579435314,75.01053518752634,6.447534766118837,0.7163927517909818,0.08428150021070376
67,대구광역시,달서구,이곡2동,관내사전투표,4063,4063,1333,2330,322,41,3,4029,34,0,33.08513278729213,57.8307272275999,7.992057582526682,1.0176222387689253,0.07446016381236038
68,대구광역시,달서구,이곡2동,이곡2동제1투,2334,1585,287,1173,110,8,0,1578,7,749,18.187579214195186,74.33460076045627,6.970849176172369,0.5069708491761723,0.0
69,대구광역시,달서구,이곡2동,이곡2동제2투,2501,1647,289,1230,112,8,0,1639,8,854,17.632702867602195,75.045759609518,6.833435021354485,0.4881025015253203,0.0
70,대구광역시,달서구,이곡2동,이곡2동제3투,2519,2034,279,1598,132,18,1,2028,6,485,13.757396449704142,78.79684418145956,6.508875739644971,0.8875739644970414,0.04930966469428008
71,대구광역시,달서구,이곡2동,이곡2동제4투,2437,1917,253,1523,112,10,3,1901,16,520,13.308784850078906,80.11572856391373,5.891635981062598,0.5260389268805892,0.15781167806417673
72,대구광역시,달서구,신당동,관내사전투표,2247,2247,792,1184,238,14,2,2230,17,0,35.51569506726457,53.09417040358745,10.672645739910314,0.6278026905829596,0.08968609865470852
73,대구광역시,달서구,신당동,신당동제1투,2081,1277,222,929,109,5,2,1267,10,804,17.521704814522494,73.32280978689818,8.602999210734017,0.3946329913180742,0.15785319652722968
74,대구광역시,달서구,신당동,신당동제2투,1932,1222,178,873,148,8,3,1210,12,710,14.710743801652892,72.14876033057851,12.231404958677686,0.6611570247933884,0.24793388429752067
75,대구광역시,달서구,신당동,신당동제3투,1680,1119,175,775,139,18,0,1107,12,561,15.808491418247517,70.00903342366756,12.556458897922312,1.6260162601626018,0.0
76,대구광역시,달서구,신당동,신당동제4투,1811,1233,164,1005,45,6,2,1222,11,578,13.420621931260229,82.24222585924713,3.6824877250409163,0.4909983633387889,0.16366612111292964
77,대구광역시,달서구,신당동,신당동제5투,2002,1344,208,1035,79,11,1,1334,10,658,15.592203898050974,77.58620689655173,5.922038980509745,0.8245877061469266,0.07496251874062969
78,대구광역시,달서구,신당동,신당동제6투,2972,2472,515,1737,183,26,2,2463,9,500,20.909460008120178,70.5237515225335,7.429963459196102,1.0556232237109215,0.08120178643930166
79,대구광역시,달서구,신당동,신당동제7투,3469,2211,391,1508,280,16,3,2198,13,1258,17.788898999090083,68.60782529572339,12.738853503184714,0.7279344858962694,0.13648771610555052
80,대구광역시,달서구,신당동,신당동제8투,3771,3092,639,2168,239,24,1,3071,21,679,20.8075545424943,70.5958971019212,7.7824812764571805,0.7815043959622273,0.0325626831650928
81,대구광역시,달서구,신당동,신당동제9투,1607,1340,263,965,93,14,0,1335,5,267,19.700374531835205,72.28464419475655,6.96629213483146,1.0486891385767791,0.0
82,대구광역시,달서구,월성1동,관내사전투표,4648,4648,2152,1861,569,48,2,4632,16,0,46.45941278065631,40.17702936096719,12.284110535405873,1.0362694300518136,0.04317789291882556
83,대구광역시,달서구,월성1동,월성1동제1투,2726,2095,443,1444,185,12,2,2086,9,631,21.236816874400766,69.22339405560882,8.868648130393098,0.5752636625119847,0.09587727708533077
84,대구광역시,달서구,월성1동,월성1동제2투,2554,2046,477,1373,174,14,1,2039,7,508,23.39382050024522,67.33692986758216,8.53359489946052,0.6866110838646395,0.04904364884747425
85,대구광역시,달서구,월성1동,월성1동제3투,2514,2027,449,1348,195,18,1,2011,16,487,22.32720039781203,67.03132769766286,9.696668324216807,0.8950770760815515,0.04972650422675286
86,대구광역시,달서구,월성1동,월성1동제4투,2750,2157,376,1627,128,15,3,2149,8,593,17.496510004653327,75.70963238715682,5.956258724988367,0.6979990693345742,0.13959981386691486
87,대구광역시,달서구,월성1동,월성1동제5투,1927,1561,288,1139,99,23,0,1549,12,366,18.592640413169786,73.53131052291802,6.391220142027114,1.4848289218850872,0.0
88,대구광역시,달서구,월성1동,월성1동제6투,3014,2352,522,1586,216,15,0,2339,13,662,22.31722958529286,67.80675502351431,9.234715690466011,0.6412997007268063,0.0
89,대구광역시,달서구,월성1동,월성1동제7투,2984,2339,540,1573,206,13,1,2333,6,645,23.14616373767681,67.42391770252894,8.829832833261895,0.5572224603514788,0.04286326618088298
90,대구광역시,달서구,월성1동,월성1동제8투,3572,2884,745,1792,313,24,1,2875,9,688,25.91304347826087,62.33043478260869,10.88695652173913,0.8347826086956521,0.034782608695652174
91,대구광역시,달서구,월성2동,관내사전투표,3302,3302,1189,1819,230,24,7,3269,33,0,36.37197919853166,55.6439278066687,7.035790761700826,0.7341694707861731,0.21413276231263384
92,대구광역시,달서구,월성2동,월성2동제1투,1110,670,72,567,21,6,1,667,3,440,10.794602698650674,85.00749625187406,3.1484257871064467,0.8995502248875562,0.14992503748125938
93,대구광역시,달서구,월성2동,월성2동제2투,1696,1176,186,911,58,10,2,1167,9,520,15.938303341902312,78.06341045415596,4.970008568980291,0.8568980291345331,0.17137960582690662
94,대구광역시,달서구,월성2동,월성2동제3투,1597,1118,169,876,56,6,1,1108,10,479,15.252707581227437,79.06137184115524,5.054151624548736,0.5415162454873645,0.09025270758122744
95,대구광역시,달서구,월성2동,월성2동제4투,2226,1741,283,1345,103,5,2,1738,3,485,16.28308400460299,77.38780207134639,5.926352128883774,0.28768699654775604,0.11507479861910241
96,대구광역시,달서구,월성2동,월성2동제5투,1325,941,161,746,19,2,1,929,12,384,17.330462863293864,80.30139935414424,2.045209903121636,0.2152852529601722,0.1076426264800861
97,대구광역시,달서구,월성2동,월성2동제6투,1786,1303,215,1007,54,12,0,1288,15,483,16.69254658385093,78.1832298136646,4.192546583850932,0.9316770186335404,0.0
98,대구광역시,달서구,진천동,관내사전투표,5534,5534,1994,2940,508,53,2,5497,37,0,36.274331453520105,53.4837183918501,9.24140440240131,0.9641622703292705,0.03638348189921776
99,대구광역시,달서구,진천동,진천동제1투,3090,2234,355,1710,142,12,0,2219,15,856,15.998197386210006,77.06173952230735,6.399278954484002,0.540784136998648,0.0
100,대구광역시,달서구,진천동,진천동제2투,3242,2322,318,1838,145,15,0,2316,6,920,13.730569948186528,79.36096718480138,6.260794473229707,0.6476683937823834,0.0
101,대구광역시,달서구,진천동,진천동제3투,2414,1697,254,1341,74,12,0,1681,16,717,15.110053539559786,79.77394408090423,4.402141582391433,0.7138607971445567,0.0
102,대구광역시,달서구,진천동,진천동제4투,2753,1990,339,1485,140,13,1,1978,12,763,17.138523761375126,75.07583417593528,7.077856420626897,0.6572295247724975,0.05055611729019212
103,대구광역시,달서구,진천동,진천동제5투,2770,2233,431,1627,142,22,1,2223,10,537,19.38821412505623,73.1893837156995,6.387764282501125,0.9896536212325686,0.0449842555105713
104,대구광역시,달서구,진천동,진천동제6투,2250,1756,247,1387,97,9,2,1742,14,494,14.17910447761194,79.62112514351321,5.568312284730196,0.5166475315729048,0.1148105625717566
105,대구광역시,달서구,진천동,진천동제7투,3938,3001,636,2077,245,24,2,2984,17,937,21.31367292225201,69.60455764075067,8.210455764075068,0.8042895442359249,0.06702412868632708
106,대구광역시,달서구,진천동,진천동제8투,2492,1938,378,1409,127,9,3,1926,12,554,19.626168224299064,73.15680166147456,6.5939771547248185,0.46728971962616817,0.1557632398753894
107,대구광역시,달서구,진천동,진천동제9투,3208,2469,476,1737,216,17,3,2449,20,739,19.436504695794202,70.92690894242548,8.819926500612494,0.6941608819926501,0.12249897917517355
108,대구광역시,달서구,진천동,진천동제10투,3336,2677,588,1869,189,19,2,2667,10,659,22.04724409448819,70.07874015748031,7.086614173228346,0.7124109486314211,0.07499062617172854
109,대구광역시,달서구,진천동,진천동제11투,2863,2173,492,1485,159,21,1,2158,15,690,22.798887859128822,68.81371640407785,7.367933271547729,0.9731232622798889,0.04633920296570899
110,대구광역시,달서구,유천동,관내사전투표,4055,4055,1941,1617,421,40,2,4021,34,0,48.27157423526486,40.21387714498881,10.470032330266104,0.9947774185525988,0.04973887092762994
111,대구광역시,달서구,유천동,유천동제1투,2849,2202,458,1519,199,16,2,2194,8,647,20.875113947128533,69.23427529626254,9.070191431175935,0.7292616226071102,0.09115770282588878
112,대구광역시,달서구,유천동,유천동제2투,2520,2080,515,1290,247,22,1,2075,5,440,24.819277108433734,62.16867469879518,11.903614457831326,1.0602409638554215,0.048192771084337345
113,대구광역시,달서구,유천동,유천동제3투,3005,2336,587,1450,257,19,1,2314,22,669,25.36732929991357,62.66205704407951,11.106309420916162,0.8210890233362144,0.043215211754537596
114,대구광역시,달서구,유천동,유천동제4투,2869,2193,493,1452,214,19,1,2179,14,676,22.62505736576411,66.63607159247361,9.82101881597063,0.8719596145020652,0.04589261128958238
115,대구광역시,달서구,유천동,유천동제5투,3315,2581,624,1668,254,17,2,2565,16,734,24.327485380116958,65.02923976608187,9.90253411306043,0.6627680311890838,0.07797270955165692
116,대구광역시,달서구,유천동,유천동제6투,2879,2353,543,1592,186,18,3,2342,11,526,23.18531169940222,67.97608881298036,7.941929974380871,0.7685738684884714,0.12809564474807858
117,대구광역시,달서구,상인1동,관내사전투표,3453,3453,1337,1726,345,29,3,3440,13,0,38.86627906976744,50.17441860465116,10.029069767441861,0.8430232558139535,0.0872093023255814
118,대구광역시,달서구,상인1동,상인1동제1투,2971,2380,348,1862,144,14,3,2371,9,591,14.677351328553353,78.53226486714466,6.073386756642766,0.5904681568958245,0.12652889076339097
119,대구광역시,달서구,상인1동,상인1동제2투,1782,1434,211,1126,82,10,1,1430,4,348,14.755244755244757,78.74125874125875,5.734265734265734,0.6993006993006993,0.06993006993006994
120,대구광역시,달서구,상인1동,상인1동제3투,2505,1947,306,1494,125,11,1,1937,10,558,15.797625193598346,77.1295818275684,6.453278265358803,0.5678884873515746,0.05162622612287042
121,대구광역시,달서구,상인1동,상인1동제4투,1651,1277,194,1013,56,9,0,1272,5,374,15.251572327044025,79.63836477987421,4.40251572327044,0.7075471698113208,0.0
122,대구광역시,달서구,상인1동,상인1동제5투,2103,1731,287,1280,146,11,0,1724,7,372,16.647331786542924,74.24593967517401,8.468677494199536,0.6380510440835266,0.0
123,대구광역시,달서구,상인1동,상인1동제6투,2555,1977,271,1560,126,8,1,1966,11,578,13.784333672431332,79.34893184130215,6.408952187182096,0.40691759918616477,0.050864699898270596
124,대구광역시,달서구,상인1동,상인1동제7투,2957,2430,497,1668,236,19,2,2422,8,527,20.520231213872833,68.86870355078447,9.744013212221304,0.7844756399669695,0.08257638315441783
125,대구광역시,달서구,상인1동,상인1동제8투,2773,2179,390,1560,193,20,1,2164,15,594,18.02218114602588,72.08872458410352,8.918669131238447,0.9242144177449169,0.04621072088724584
126,대구광역시,달서구,상인1동,상인1동제9투,2199,1883,356,1307,190,16,1,1870,13,316,19.037433155080212,69.89304812834224,10.16042780748663,0.8556149732620321,0.053475935828877004
127,대구광역시,달서구,상인2동,관내사전투표,2944,2944,980,1723,205,13,3,2924,20,0,33.515731874145004,58.926128590971274,7.0109439124487,0.44459644322845415,0.10259917920656635
128,대구광역시,달서구,상인2동,상인2동제1투,1910,1247,152,996,86,4,1,1239,8,663,12.267958030669895,80.38740920096852,6.941081517352704,0.3228410008071025,0.08071025020177562
129,대구광역시,달서구,상인2동,상인2동제2투,2179,1503,198,1172,104,13,0,1487,16,676,13.315400134498992,78.81640887693342,6.99394754539341,0.8742434431741762,0.0
130,대구광역시,달서구,상인2동,상인2동제3투,1914,1278,186,980,94,5,1,1266,12,636,14.691943127962084,77.40916271721959,7.424960505529225,0.3949447077409162,0.07898894154818326
131,대구광역시,달서구,상인2동,상인2동제4투,2843,2036,328,1556,127,11,2,2024,12,807,16.205533596837945,76.87747035573122,6.274703557312253,0.5434782608695652,0.09881422924901186
132,대구광역시,달서구,상인2동,상인2동제5투,2936,2222,356,1702,133,16,1,2208,14,714,16.1231884057971,77.08333333333334,6.023550724637681,0.7246376811594203,0.04528985507246377
133,대구광역시,달서구,상인3동,관내사전투표,2522,2522,788,1578,122,21,2,2511,11,0,31.381919553962568,62.84348864994026,4.858622062923138,0.8363201911589008,0.07964954201513341
134,대구광역시,달서구,상인3동,상인3동제1투,1609,1103,112,931,52,4,1,1100,3,506,10.181818181818182,84.63636363636363,4.7272727272727275,0.36363636363636365,0.09090909090909091
135,대구광역시,달서구,상인3동,상인3동제2투,1945,1393,174,1140,65,6,0,1385,8,552,12.56317689530686,82.31046931407943,4.693140794223827,0.4332129963898917,0.0
136,대구광역시,달서구,상인3동,상인3동제3투,1820,1245,173,1019,29,8,0,1229,16,575,14.076484947111473,82.91293734743694,2.3596419853539463,0.6509357200976403,0.0
137,대구광역시,달서구,상인3동,상인3동제4투,1445,977,125,810,27,4,0,966,11,468,12.939958592132506,83.85093167701864,2.7950310559006213,0.4140786749482402,0.0
138,대구광역시,달서구,도원동,관내사전투표,5302,5302,1996,2850,367,57,3,5273,29,0,37.85321448890574,54.04892850369808,6.9599848283709465,1.0809785700739616,0.056893608951261145
139,대구광역시,달서구,도원동,도원동제1투,1995,1448,214,1148,70,7,3,1442,6,547,14.840499306518723,79.6116504854369,4.854368932038835,0.48543689320388345,0.20804438280166435
140,대구광역시,달서구,도원동,도원동제2투,1985,1458,248,1118,70,12,0,1448,10,527,17.12707182320442,77.20994475138122,4.834254143646409,0.8287292817679558,0.0
141,대구광역시,달서구,도원동,도원동제3투,2044,1499,258,1130,88,13,0,1489,10,545,17.327065144392208,75.88985896574883,5.910006715916722,0.8730691739422431,0.0
142,대구광역시,달서구,도원동,도원동제4투,1785,1370,224,1042,85,9,2,1362,8,415,16.44640234948605,76.5051395007342,6.240822320117474,0.6607929515418502,0.14684287812041116
143,대구광역시,달서구,도원동,도원동제5투,1772,1387,255,1007,107,14,1,1384,3,385,18.42485549132948,72.76011560693641,7.731213872832369,1.0115606936416186,0.0722543352601156
144,대구광역시,달서구,도원동,도원동제6투,1918,1436,254,1060,92,17,2,1425,11,482,17.82456140350877,74.3859649122807,6.4561403508771935,1.1929824561403508,0.14035087719298245
145,대구광역시,달서구,도원동,도원동제7투,2232,1802,296,1359,121,13,2,1791,11,430,16.527079843662758,75.87939698492463,6.756002233389167,0.7258514796203238,0.11166945840312675
146,대구광역시,달서구,도원동,도원동제8투,2770,2328,429,1713,161,15,0,2318,10,442,18.507333908541845,73.89991371872304,6.945642795513374,0.6471095772217429,0.0
147,대구광역시,달서구,도원동,도원동제9투,2852,2255,391,1723,125,9,2,2250,5,597,17.377777777777776,76.57777777777778,5.555555555555555,0.4,0.08888888888888889
148,대구광역시,달서구,도원동,도원동제10투,1907,1565,301,1109,130,11,2,1553,12,342,19.381841596909208,71.41017385705088,8.370895041854476,0.7083065035415326,0.128783000643915
149,대구광역시,달서구,송현1동,관내사전투표,2606,2606,898,1513,156,14,1,2582,24,0,34.77924089852827,58.59798605731991,6.041828040278854,0.5422153369481022,0.03872966692486445
150,대구광역시,달서구,송현1동,송현1동제1투,2262,1406,180,1129,81,8,2,1400,6,856,12.857142857142856,80.64285714285714,5.785714285714286,0.5714285714285714,0.14285714285714285
151,대구광역시,달서구,송현1동,송현1동제2투,1781,1187,134,977,62,6,2,1181,6,594,11.346316680779001,82.72650296359018,5.249788314987299,0.5080440304826418,0.1693480101608806
152,대구광역시,달서구,송현1동,송현1동제3투,2272,1468,186,1183,78,13,3,1463,5,804,12.7136021872864,80.86124401913875,5.331510594668489,0.888585099111415,0.2050580997949419
153,대구광역시,달서구,송현1동,송현1동제4투,3064,2020,275,1600,112,19,1,2007,13,1044,13.702042850024911,79.72097658196313,5.580468360737419,0.9466865969108121,0.04982561036372695
154,대구광역시,달서구,송현1동,송현1동제5투,2329,1585,263,1221,84,4,1,1573,12,744,16.719643992371267,77.62237762237763,5.340114431023522,0.25429116338207247,0.06357279084551812
155,대구광역시,달서구,송현2동,관내사전투표,2238,2238,693,1377,142,12,0,2224,14,0,31.160071942446045,61.91546762589928,6.384892086330936,0.539568345323741,0.0
156,대구광역시,달서구,송현2동,송현2동제1투,2875,1900,240,1530,105,14,0,1889,11,975,12.70513499205929,80.99523557437797,5.55849655902594,0.7411328745367919,0.0
157,대구광역시,달서구,송현2동,송현2동제2투,1336,881,103,724,44,3,1,875,6,455,11.771428571428572,82.74285714285713,5.0285714285714285,0.34285714285714286,0.1142857142857143
158,대구광역시,달서구,송현2동,송현2동제3투,2527,1635,207,1325,87,9,1,1629,6,892,12.70718232044199,81.33824432166973,5.3406998158379375,0.5524861878453038,0.06138735420503376
159,대구광역시,달서구,송현2동,송현2동제4투,2015,1461,183,1185,71,14,0,1453,8,554,12.59463179628355,81.55540261527874,4.886441844459739,0.9635237439779766,0.0
160,대구광역시,달서구,송현2동,송현2동제5투,4017,3131,553,2302,234,22,4,3115,16,886,17.752808988764045,73.90048154093098,7.512038523274478,0.7062600321027288,0.12841091492776885
161,대구광역시,달서구,본동,관내사전투표,1699,1699,550,1029,97,12,0,1688,11,0,32.58293838862559,60.95971563981043,5.746445497630331,0.7109004739336493,0.0
162,대구광역시,달서구,본동,본동제1투,1797,1151,193,870,79,5,0,1147,4,646,16.826503923278118,75.85004359197907,6.887532693984307,0.4359197907585004,0.0
163,대구광역시,달서구,본동,본동제2투,2322,1810,251,1418,117,13,0,1799,11,512,13.952195664257921,78.82156753752085,6.5036131183991115,0.7226236798221234,0.0
164,대구광역시,달서구,본동,본동제3투,1921,1381,233,1050,83,9,2,1377,4,540,16.92084241103849,76.25272331154684,6.027596223674655,0.6535947712418301,0.14524328249818447
165,대구광역시,달서구,본동,본동제4투,2493,1639,256,1260,101,13,0,1630,9,854,15.70552147239264,77.30061349693251,6.196319018404909,0.7975460122699387,0.0
166,대구광역시,달서구,잘못 투입·구분된 투표지,,0,0,0,0,0,0,0,0,0,0,0.0,0.0,0.0,0.0,0.0
0,대구광역시,달성군,거소·선상투표,,374,358,104,174,54,4,4,340,18,16,30.58823529411765,51.17647058823529,15.88235294117647,1.1764705882352942,1.1764705882352942
1,대구광역시,달성군,관외사전투표,,18118,18115,6396,8956,2407,170,18,17947,168,3,35.63826823424528,49.90249066696384,13.411712263888115,0.9472335209227168,0.10029531398005238
2,대구광역시,달성군,재외투표,,739,523,285,150,78,6,1,520,3,216,54.807692307692314,28.846153846153843,15.0,1.153846153846154,0.19230769230769232
3,대구광역시,달성군,화원읍,관내사전투표,4992,4992,1795,2713,395,50,3,4956,36,0,36.21872477804681,54.741727199354315,7.970137207425343,1.0088781275221952,0.06053268765133172
4,대구광역시,달성군,화원읍,화원읍제1투,2751,1998,262,1589,123,13,3,1990,8,753,13.165829145728644,79.84924623115577,6.180904522613066,0.6532663316582915,0.1507537688442211
5,대구광역시,달성군,화원읍,화원읍제2투,2733,2043,287,1624,97,18,3,2029,14,690,14.144898965007394,80.03942828979793,4.780680137999014,0.8871365204534253,0.14785608674223755
6,대구광역시,달성군,화원읍,화원읍제3투,1989,1457,193,1184,62,2,2,1443,14,532,13.374913374913374,82.05128205128204,4.296604296604296,0.1386001386001386,0.1386001386001386
7,대구광역시,달성군,화원읍,화원읍제4투,2302,1302,190,1035,61,9,1,1296,6,1000,14.660493827160495,79.86111111111111,4.70679012345679,0.6944444444444444,0.07716049382716049
8,대구광역시,달성군,화원읍,화원읍제5투,2586,1989,354,1504,103,13,0,1974,15,597,17.933130699088146,76.19047619047619,5.2178318135764945,0.6585612968591692,0.0
9,대구광역시,달성군,화원읍,화원읍제6투,2929,2236,343,1730,141,12,1,2227,9,693,15.401885945217783,77.6829815895824,6.331387516838796,0.5388414907947913,0.044903457566232596
10,대구광역시,달성군,화원읍,화원읍제7투,987,789,129,610,42,6,0,787,2,198,16.39135959339263,77.50952986022872,5.336721728081321,0.7623888182973316,0.0
11,대구광역시,달성군,화원읍,화원읍제8투,2912,2132,287,1675,137,18,4,2121,11,780,13.531353135313532,78.97218293257897,6.459217350306459,0.8486562942008486,0.1885902876001886
12,대구광역시,달성군,화원읍,화원읍제9투,3193,2494,368,1955,142,16,1,2482,12,699,14.826752618855762,78.76712328767124,5.72119258662369,0.6446414182111201,0.040290088638195005
13,대구광역시,달성군,화원읍,화원읍제10투,2341,1790,328,1304,132,15,1,1780,10,551,18.426966292134832,73.25842696629213,7.415730337078652,0.8426966292134831,0.05617977528089888
14,대구광역시,달성군,화원읍,화원읍제11투,1556,1219,217,911,73,8,0,1209,10,337,17.94871794871795,75.35153019023987,6.038047973531844,0.6617038875103392,0.0
15,대구광역시,달성군,화원읍,화원읍제12투,2656,2312,511,1596,176,20,1,2304,8,344,22.178819444444446,69.27083333333334,7.638888888888889,0.8680555555555556,0.043402777777777776
16,대구광역시,달성군,화원읍,화원읍제13투,2951,2429,467,1743,181,23,4,2418,11,522,19.31348221670802,72.08436724565756,7.485525227460712,0.9511993382961125,0.1654259718775848
17,대구광역시,달성군,논공읍,관내사전투표,1599,1599,545,919,119,4,2,1589,10,0,34.2983008181246,57.83511642542479,7.488986784140969,0.25173064820641916,0.12586532410320958
18,대구광역시,달성군,논공읍,논공읍제1투,2103,1402,181,1143,68,5,1,1398,4,701,12.947067238912732,81.75965665236052,4.86409155937053,0.35765379113018597,0.07153075822603719
19,대구광역시,달성군,논공읍,논공읍제2투,672,475,41,416,12,2,1,472,3,197,8.686440677966102,88.13559322033898,2.5423728813559325,0.423728813559322,0.211864406779661
20,대구광역시,달성군,논공읍,논공읍제3투,1548,1001,229,727,32,5,0,993,8,547,23.061430010070495,73.21248741188319,3.2225579053373616,0.5035246727089627,0.0
21,대구광역시,달성군,논공읍,논공읍제4투,1297,900,197,636,53,9,1,896,4,397,21.986607142857142,70.98214285714286,5.915178571428571,1.0044642857142858,0.11160714285714285
22,대구광역시,달성군,논공읍,논공읍제5투,2312,1593,347,1112,109,11,3,1582,11,719,21.93426042983565,70.29077117572693,6.890012642225031,0.695322376738306,0.18963337547408343
23,대구광역시,달성군,논공읍,논공읍제6투,1809,1151,211,885,42,8,1,1147,4,658,18.39581517000872,77.15780296425457,3.661726242371403,0.6974716652136007,0.08718395815170009
24,대구광역시,달성군,논공읍,논공읍제7투,1570,1161,257,823,63,10,2,1155,6,409,22.251082251082252,71.25541125541126,5.454545454545454,0.8658008658008658,0.17316017316017315
25,대구광역시,달성군,다사읍,관내사전투표,6508,6506,2739,3136,533,59,4,6471,35,2,42.327306444135374,48.46237057641786,8.23674857054551,0.9117601607170452,0.061814248184206465
26,대구광역시,달성군,다사읍,다사읍제1투,1862,1369,306,917,127,9,1,1360,9,493,22.5,67.4264705882353,9.338235294117647,0.6617647058823529,0.07352941176470588
27,대구광역시,달성군,다사읍,다사읍제2투,3729,2866,612,1963,236,31,4,2846,20,863,21.50386507378777,68.97399859451863,8.292340126493324,1.089248067463106,0.14054813773717498
28,대구광역시,달성군,다사읍,다사읍제3투,1984,1457,295,1072,73,6,2,1448,9,527,20.37292817679558,74.03314917127072,5.041436464088398,0.4143646408839779,0.13812154696132595
29,대구광역시,달성군,다사읍,다사읍제4투,557,412,36,361,11,2,1,411,1,145,8.75912408759124,87.8345498783455,2.67639902676399,0.48661800486618007,0.24330900243309003
30,대구광역시,달성군,다사읍,다사읍제5투,3713,2767,462,2040,222,20,3,2747,20,946,16.81834728795049,74.26283218056061,8.081543502002184,0.728066982162359,0.10921004732435385
31,대구광역시,달성군,다사읍,다사읍제6투,2337,1813,388,1287,105,16,1,1797,16,524,21.59154145798553,71.61936560934892,5.843071786310518,0.8903728436282694,0.05564830272676684
32,대구광역시,달성군,다사읍,다사읍제7투,2512,1927,415,1370,116,20,1,1922,5,585,21.592091571279916,71.27991675338188,6.035379812695109,1.040582726326743,0.052029136316337155
33,대구광역시,달성군,다사읍,다사읍제8투,2864,2136,410,1511,178,22,2,2123,13,728,19.312293923692888,71.17286858219501,8.3843617522374,1.0362694300518136,0.09420631182289213
34,대구광역시,달성군,다사읍,다사읍제9투,2395,1859,400,1294,137,17,2,1850,9,536,21.62162162162162,69.94594594594594,7.405405405405406,0.9189189189189189,0.10810810810810811
35,대구광역시,달성군,다사읍,다사읍제10투,2920,2305,516,1580,183,17,2,2298,7,615,22.45430809399478,68.75543951261966,7.963446475195822,0.7397737162750218,0.08703220191470844
36,대구광역시,달성군,다사읍,다사읍제11투,3443,2770,656,1820,252,21,5,2754,16,673,23.81989832970225,66.08569353667393,9.15032679738562,0.7625272331154684,0.18155410312273057
37,대구광역시,달성군,다사읍,다사읍제12투,2797,2150,484,1498,143,16,1,2142,8,647,22.595704948646127,69.93464052287581,6.6760037348272645,0.7469654528478058,0.04668534080298786
38,대구광역시,달성군,다사읍,다사읍제13투,3081,2402,605,1582,190,17,2,2396,6,679,25.25041736227045,66.02671118530886,7.929883138564274,0.7095158597662772,0.08347245409015025
39,대구광역시,달성군,다사읍,다사읍제14투,1781,1217,231,880,91,6,0,1208,9,564,19.12251655629139,72.84768211920529,7.533112582781457,0.49668874172185434,0.0
40,대구광역시,달성군,다사읍,다사읍제15투,3156,2209,607,1391,179,20,0,2197,12,947,27.62858443331816,63.31360946745562,8.1474738279472,0.9103322712790167,0.0
41,대구광역시,달성군,다사읍,다사읍제16투,4146,3072,785,1944,292,21,3,3045,27,1074,25.779967159277504,63.8423645320197,9.589490968801313,0.6896551724137931,0.09852216748768472
42,대구광역시,달성군,다사읍,다사읍제17투,2815,2298,612,1447,208,17,1,2285,13,517,26.783369803063454,63.32603938730853,9.102844638949671,0.7439824945295405,0.0437636761487965
43,대구광역시,달성군,다사읍,다사읍제18투,2799,2141,554,1371,186,21,0,2132,9,658,25.984990619136962,64.30581613508443,8.72420262664165,0.9849906191369606,0.0
44,대구광역시,달성군,다사읍,다사읍제19투,2653,2059,564,1277,187,15,4,2047,12,594,27.552515876893015,62.38397655105031,9.135319980459208,0.7327796775769418,0.19540791402051783
45,대구광역시,달성군,다사읍,다사읍제20투,2752,2263,603,1383,243,20,1,2250,13,489,26.8,61.46666666666667,10.8,0.8888888888888888,0.044444444444444446
46,대구광역시,달성군,다사읍,다사읍제21투,3040,2295,470,1614,182,19,2,2287,8,745,20.55094009619589,70.57280279842588,7.958023611718408,0.8307826847398339,0.08745080891998251
47,대구광역시,달성군,유가읍,관내사전투표,6273,6273,2929,2436,794,64,7,6230,43,0,47.014446227929376,39.10112359550561,12.74478330658106,1.0272873194221508,0.11235955056179776
48,대구광역시,달성군,유가읍,유가읍제1투,2832,1801,345,1284,148,5,0,1782,19,1031,19.36026936026936,72.05387205387206,8.305274971941639,0.28058361391694725,0.0
49,대구광역시,달성군,유가읍,유가읍제2투,986,635,72,523,32,1,0,628,7,351,11.464968152866243,83.28025477707006,5.095541401273886,0.15923566878980894,0.0
50,대구광역시,달성군,유가읍,유가읍제3투,2617,1906,448,1267,159,18,0,1892,14,711,23.678646934460886,66.9661733615222,8.403805496828753,0.9513742071881607,0.0
51,대구광역시,달성군,유가읍,유가읍제4투,2719,1940,491,1280,140,16,3,1930,10,779,25.44041450777202,66.32124352331607,7.253886010362693,0.8290155440414507,0.15544041450777202
52,대구광역시,달성군,유가읍,유가읍제5투,3029,2200,598,1361,212,16,0,2187,13,829,27.343392775491544,62.23136716963877,9.693644261545495,0.7315957933241883,0.0
53,대구광역시,달성군,유가읍,유가읍제6투,3826,2819,804,1707,255,35,1,2802,17,1007,28.693790149892934,60.92077087794433,9.100642398286936,1.2491077801570307,0.03568879371877231
54,대구광역시,달성군,옥포읍,관내사전투표,2752,2751,986,1542,182,16,4,2730,21,1,36.11721611721612,56.48351648351648,6.666666666666667,0.5860805860805861,0.14652014652014653
55,대구광역시,달성군,옥포읍,옥포읍제1투,1721,1187,117,996,57,8,1,1179,8,534,9.923664122137405,84.47837150127226,4.8346055979643765,0.6785411365564037,0.08481764206955046
56,대구광역시,달성군,옥포읍,옥포읍제2투,1224,919,81,802,32,0,0,915,4,305,8.852459016393443,87.65027322404372,3.4972677595628414,0.0,0.0
57,대구광역시,달성군,옥포읍,옥포읍제3투,2070,1512,229,1206,55,9,2,1501,11,558,15.25649566955363,80.34643570952699,3.664223850766156,0.5996002664890073,0.13324450366422386
58,대구광역시,달성군,옥포읍,옥포읍제4투,3046,2184,355,1686,106,14,2,2163,21,862,16.412390198797965,77.94729542302358,4.900601017105871,0.6472491909385114,0.09246417013407304
59,대구광역시,달성군,옥포읍,옥포읍제5투,2719,2066,451,1443,145,17,0,2056,10,653,21.93579766536965,70.18482490272373,7.052529182879377,0.8268482490272374,0.0
60,대구광역시,달성군,옥포읍,옥포읍제6투,1858,1469,276,1095,78,11,1,1461,8,389,18.8911704312115,74.94866529774127,5.338809034907597,0.7529089664613279,0.06844626967830253
61,대구광역시,달성군,옥포읍,옥포읍제7투,2296,1729,333,1276,103,9,1,1722,7,567,19.337979094076655,74.09988385598142,5.981416957026713,0.5226480836236934,0.05807200929152149
62,대구광역시,달성군,현풍읍,관내사전투표,2769,2769,1046,1445,231,25,2,2749,20,0,38.050200072753725,52.564568934157876,8.403055656602401,0.9094216078574027,0.07275372862859221
63,대구광역시,달성군,현풍읍,현풍읍제1투,1776,1098,143,860,79,7,0,1089,9,678,13.131313131313133,78.97153351698806,7.254361799816346,0.642791551882461,0.0
64,대구광역시,달성군,현풍읍,현풍읍제2투,2380,1402,201,1055,123,9,2,1390,12,978,14.46043165467626,75.89928057553958,8.848920863309353,0.6474820143884892,0.14388489208633093
65,대구광역시,달성군,현풍읍,현풍읍제3투,1004,612,67,514,20,4,0,605,7,392,11.074380165289256,84.9586776859504,3.3057851239669422,0.6611570247933884,0.0
66,대구광역시,달성군,현풍읍,현풍읍제4투,1951,1334,277,940,85,9,1,1312,22,617,21.11280487804878,71.64634146341463,6.478658536585366,0.6859756097560976,0.07621951219512195
67,대구광역시,달성군,현풍읍,현풍읍제5투,3046,2195,521,1406,228,21,1,2177,18,851,23.932016536518145,64.58429030776298,10.473128158015617,0.964630225080386,0.045934772622875514
68,대구광역시,달성군,현풍읍,현풍읍제6투,3256,2282,492,1598,163,17,1,2271,11,974,21.66446499339498,70.36547776309996,7.17745486569793,0.7485689123734038,0.044033465433729636
69,대구광역시,달성군,가창면,관내사전투표,1080,1080,330,693,45,10,0,1078,2,0,30.612244897959183,64.28571428571429,4.174397031539889,0.927643784786642,0.0
70,대구광역시,달성군,가창면,가창면제1투,1465,1068,91,924,42,5,0,1062,6,397,8.56873822975518,87.00564971751412,3.954802259887006,0.4708097928436911,0.0
71,대구광역시,달성군,가창면,가창면제2투,795,555,85,430,36,0,1,552,3,240,15.39855072463768,77.89855072463769,6.521739130434782,0.0,0.18115942028985507
72,대구광역시,달성군,가창면,가창면제3투,1462,1085,152,885,40,1,2,1080,5,377,14.074074074074074,81.94444444444444,3.7037037037037033,0.0925925925925926,0.1851851851851852
73,대구광역시,달성군,가창면,가창면제4투,870,582,60,502,13,2,0,577,5,288,10.398613518197573,87.00173310225303,2.2530329289428077,0.34662045060658575,0.0
74,대구광역시,달성군,하빈면,관내사전투표,906,906,308,505,66,8,1,888,18,0,34.68468468468468,56.86936936936937,7.4324324324324325,0.9009009009009009,0.11261261261261261
75,대구광역시,달성군,하빈면,하빈면제1투,1190,848,71,749,21,2,0,843,5,342,8.422301304863582,88.84934756820878,2.491103202846975,0.2372479240806643,0.0
76,대구광역시,달성군,하빈면,하빈면제2투,1090,762,81,651,21,1,1,755,7,328,10.728476821192052,86.2251655629139,2.781456953642384,0.13245033112582782,0.13245033112582782
77,대구광역시,달성군,구지면,관내사전투표,2979,2979,1399,1245,296,16,1,2957,22,0,47.31146432194792,42.10348326006087,10.010145417653026,0.5410889414947582,0.033818058843422386
78,대구광역시,달성군,구지면,구지면제1투,2983,1877,335,1385,126,11,0,1857,20,1106,18.039849219170705,74.58266020463113,6.78513731825525,0.5923532579429186,0.0
79,대구광역시,달성군,구지면,구지면제2투,427,300,33,252,12,1,0,298,2,127,11.073825503355705,84.56375838926175,4.026845637583892,0.33557046979865773,0.0
80,대구광역시,달성군,구지면,구지면제3투,2567,1566,417,1004,126,8,2,1557,9,1001,26.78227360308285,64.48298008991651,8.092485549132949,0.5138086062941554,0.12845215157353884
81,대구광역시,달성군,구지면,구지면제4투,1821,1245,228,917,84,6,4,1239,6,576,18.401937046004843,74.01129943502825,6.779661016949152,0.48426150121065376,0.3228410008071025
82,대구광역시,달성군,구지면,구지면제5투,3542,2327,601,1509,183,16,1,2310,17,1215,26.017316017316016,65.32467532467533,7.922077922077922,0.6926406926406926,0.04329004329004329
83,대구광역시,달성군,잘못 투입·구분된 투표지,,0,2,1,0,1,0,0,2,0,-2,50.0,0.0,50.0,0.0,0.0
0,대구광역시,군위군,거소·선상투표,,51,46,11,32,2,1,0,46,0,5,23.91304347826087,69.56521739130434,4.3478260869565215,2.1739130434782608,0.0
1,대구광역시,군위군,관외사전투표,,2828,2828,626,1971,197,17,2,2813,15,0,22.25382154283683,70.06754354781373,7.003199431212229,0.6043370067543549,0.07109847138286526
2,대구광역시,군위군,재외투표,,199,86,50,31,1,1,0,83,3,113,60.24096385542169,37.34939759036144,1.2048192771084338,1.2048192771084338,0.0
3,대구광역시,군위군,군위읍,관내사전투표,2161,2161,478,1554,96,13,3,2144,17,0,22.294776119402986,72.48134328358209,4.477611940298507,0.6063432835820896,0.13992537313432835
4,대구광역시,군위군,군위읍,군위읍제1투,1468,994,113,832,33,8,1,987,7,474,11.448834853090172,84.29584599797366,3.343465045592705,0.8105369807497468,0.10131712259371835
5,대구광역시,군위군,군위읍,군위읍제2투,1373,938,115,761,47,8,1,932,6,435,12.339055793991417,81.65236051502146,5.042918454935622,0.8583690987124464,0.1072961373390558
6,대구광역시,군위군,군위읍,군위읍제3투,629,463,18,430,10,0,1,459,4,166,3.9215686274509802,93.68191721132898,2.178649237472767,0.0,0.2178649237472767
7,대구광역시,군위군,군위읍,군위읍제4투,693,473,36,412,20,0,0,468,5,220,7.6923076923076925,88.03418803418803,4.273504273504273,0.0,0.0
8,대구광역시,군위군,소보면,관내사전투표,552,552,92,431,23,0,1,547,5,0,16.819012797074954,78.79341864716636,4.204753199268739,0.0,0.18281535648994515
9,대구광역시,군위군,소보면,소보면제1투,801,562,49,498,7,1,1,556,6,239,8.81294964028777,89.568345323741,1.2589928057553956,0.1798561151079137,0.1798561151079137
10,대구광역시,군위군,소보면,소보면제2투,449,314,31,271,9,3,0,314,0,135,9.872611464968154,86.30573248407643,2.8662420382165608,0.9554140127388535,0.0
11,대구광역시,군위군,효령면,관내사전투표,896,896,164,692,26,4,1,887,9,0,18.489289740698986,78.01578354002254,2.931228861330327,0.4509582863585118,0.11273957158962795
12,대구광역시,군위군,효령면,효령면제1투,1220,880,71,783,20,2,1,877,3,340,8.095781071835804,89.28164196123147,2.280501710376283,0.22805017103762829,0.11402508551881414
13,대구광역시,군위군,효령면,효령면제2투,855,625,55,547,17,1,1,621,4,230,8.856682769726248,88.08373590982286,2.737520128824477,0.1610305958132045,0.1610305958132045
14,대구광역시,군위군,부계면,관내사전투표,405,405,101,274,29,0,0,404,1,0,25.0,67.82178217821783,7.1782178217821775,0.0,0.0
15,대구광역시,군위군,부계면,부계면제1투,534,413,34,368,8,1,0,411,2,121,8.27250608272506,89.53771289537713,1.9464720194647203,0.24330900243309003,0.0
16,대구광역시,군위군,부계면,부계면제2투,723,544,42,485,12,1,0,540,4,179,7.777777777777778,89.81481481481481,2.2222222222222223,0.1851851851851852,0.0
17,대구광역시,군위군,우보면,관내사전투표,561,561,84,452,16,3,0,555,6,0,15.135135135135137,81.44144144144144,2.8828828828828827,0.5405405405405406,0.0
18,대구광역시,군위군,우보면,우보면제1투,693,485,37,436,11,0,0,484,1,208,7.644628099173553,90.08264462809917,2.272727272727273,0.0,0.0
19,대구광역시,군위군,우보면,우보면제2투,351,259,17,231,7,0,0,255,4,92,6.666666666666667,90.58823529411765,2.7450980392156863,0.0,0.0
20,대구광역시,군위군,의흥면,관내사전투표,732,732,123,581,24,0,0,728,4,0,16.895604395604398,79.8076923076923,3.296703296703297,0.0,0.0
21,대구광역시,군위군,의흥면,의흥면제1투,891,631,55,554,15,3,0,627,4,260,8.771929824561402,88.3572567783094,2.3923444976076556,0.4784688995215311,0.0
22,대구광역시,군위군,의흥면,의흥면제2투,300,204,8,191,3,1,0,203,1,96,3.9408866995073892,94.08866995073892,1.477832512315271,0.49261083743842365,0.0
23,대구광역시,군위군,산성면,관내사전투표,307,307,43,253,9,1,0,306,1,0,14.052287581699346,82.6797385620915,2.941176470588235,0.32679738562091504,0.0
24,대구광역시,군위군,산성면,산성면제1투,328,255,26,217,8,1,0,252,3,73,10.317460317460316,86.11111111111111,3.1746031746031744,0.3968253968253968,0.0
25,대구광역시,군위군,산성면,산성면제2투,373,275,24,236,11,2,0,273,2,98,8.791208791208792,86.44688644688645,4.029304029304029,0.7326007326007326,0.0
26,대구광역시,군위군,삼국유사면,관내사전투표,310,310,54,248,7,1,0,310,0,0,17.419354838709676,80.0,2.258064516129032,0.3225806451612903,0.0
27,대구광역시,군위군,삼국유사면,삼국유사면제1투,348,274,34,234,3,0,0,271,3,74,12.546125461254611,86.34686346863468,1.107011070110701,0.0,0.0
28,대구광역시,군위군,삼국유사면,삼국유사면제2투,371,272,25,241,3,1,1,271,1,99,9.22509225092251,88.92988929889299,1.107011070110701,0.36900369003690037,0.36900369003690037
29,대구광역시,군위군,잘못 투입·구분된 투표지,,0,0,0,0,0,0,0,0,0,0,0.0,0.0,0.0,0.0,0.0
0,인천광역시,중구,거소·선상투표,,221,215,90,68,51,1,0,210,5,6,42.857142857142854,32.38095238095238,24.285714285714285,0.4761904761904762,0.0
1,인천광역시,중구,관외사전투표,,13141,13140,7671,3497,1690,145,13,13016,124,1,58.93515673017824,26.866933005531653,12.9840196681008,1.1140135218192995,0.09987707437000616
2,인천광역시,중구,재외투표,,984,814,567,163,72,6,0,808,6,170,70.17326732673267,20.173267326732674,8.91089108910891,0.7425742574257426,0.0
3,인천광역시,중구,신포동,관내사전투표,1298,1298,808,381,80,16,1,1286,12,0,62.83048211508554,29.62674961119751,6.2208398133748055,1.244167962674961,0.07776049766718507
4,인천광역시,중구,신포동,신포동제1투,1512,986,422,466,76,9,1,974,12,526,43.3264887063655,47.84394250513347,7.802874743326489,0.9240246406570842,0.10266940451745381
5,인천광역시,중구,신포동,신포동제2투,1255,688,232,413,35,1,1,682,6,567,34.01759530791789,60.55718475073314,5.131964809384164,0.1466275659824047,0.1466275659824047
6,인천광역시,중구,연안동,관내사전투표,1430,1430,850,509,56,7,1,1423,7,0,59.732958538299364,35.76950105411103,3.9353478566408993,0.4919184820801124,0.07027406886858749
7,인천광역시,중구,연안동,연안동투표소,2940,1630,508,1027,73,12,1,1621,9,1310,31.338679827267118,63.35595311536088,4.5033929673041335,0.7402837754472548,0.061690314620604564
8,인천광역시,중구,신흥동,관내사전투표,2181,2181,1309,729,124,8,3,2173,8,0,60.239300506212615,33.54809019788311,5.706396686608375,0.36815462494247586,0.13805798435342845
9,인천광역시,중구,신흥동,신흥동제1투,1874,1088,456,530,79,14,0,1079,9,786,42.2613531047266,49.119555143651525,7.32159406858202,1.2974976830398517,0.0
10,인천광역시,중구,신흥동,신흥동제2투,2193,1399,508,759,104,14,1,1386,13,794,36.65223665223665,54.761904761904766,7.503607503607504,1.0101010101010102,0.07215007215007214
11,인천광역시,중구,신흥동,신흥동제3투,80,43,13,27,3,0,0,43,0,37,30.23255813953488,62.7906976744186,6.976744186046512,0.0,0.0
12,인천광역시,중구,신흥동,신흥동제4투,2878,1953,830,928,159,16,3,1936,17,925,42.87190082644628,47.93388429752066,8.212809917355372,0.8264462809917356,0.15495867768595042
13,인천광역시,중구,신흥동,신흥동제5투,1468,861,326,460,51,9,2,848,13,607,38.443396226415096,54.24528301886793,6.014150943396227,1.0613207547169812,0.2358490566037736
14,인천광역시,중구,도원동,관내사전투표,1139,1139,697,383,43,7,3,1133,6,0,61.51809355692851,33.80406001765225,3.795233892321271,0.617828773168579,0.264783759929391
15,인천광역시,중구,도원동,도원동제1투,1218,755,273,434,28,12,3,750,5,463,36.4,57.86666666666667,3.733333333333334,1.6,0.4
16,인천광역시,중구,도원동,도원동제2투,981,632,200,390,35,2,1,628,4,349,31.84713375796178,62.101910828025474,5.573248407643312,0.3184713375796179,0.15923566878980894
17,인천광역시,중구,율목동,관내사전투표,600,600,367,193,31,5,0,596,4,0,61.57718120805369,32.38255033557047,5.201342281879195,0.8389261744966443,0.0
18,인천광역시,중구,율목동,율목동투표소,1819,1012,337,605,52,10,0,1004,8,807,33.56573705179283,60.2589641434263,5.179282868525896,0.9960159362549801,0.0
19,인천광역시,중구,동인천동,관내사전투표,1253,1253,774,384,69,15,2,1244,9,0,62.21864951768489,30.86816720257235,5.546623794212219,1.2057877813504823,0.1607717041800643
20,인천광역시,중구,동인천동,동인천동제1투,1367,675,220,391,52,1,0,664,11,692,33.13253012048193,58.8855421686747,7.83132530120482,0.15060240963855423,0.0
21,인천광역시,중구,동인천동,동인천동제2투,2028,1154,321,732,71,11,5,1140,14,874,28.157894736842103,64.21052631578948,6.228070175438597,0.9649122807017544,0.43859649122807015
22,인천광역시,중구,개항동,관내사전투표,1034,1034,661,323,40,5,0,1029,5,0,64.23712342079689,31.389698736637513,3.8872691933916426,0.4859086491739553,0.0
23,인천광역시,중구,개항동,개항동제1투,1383,819,286,453,69,5,1,814,5,564,35.13513513513514,55.651105651105645,8.476658476658477,0.6142506142506142,0.12285012285012285
24,인천광역시,중구,개항동,개항동제2투,510,353,122,208,19,2,0,351,2,157,34.75783475783476,59.25925925925925,5.413105413105413,0.5698005698005698,0.0
25,인천광역시,중구,개항동,개항동제3투,1367,827,280,469,63,6,1,819,8,540,34.18803418803419,57.26495726495726,7.6923076923076925,0.7326007326007326,0.1221001221001221
26,인천광역시,중구,개항동,개항동제4투,724,373,126,225,16,4,0,371,2,351,33.9622641509434,60.64690026954178,4.31266846361186,1.078167115902965,0.0
27,인천광역시,중구,영종동,관내사전투표,4284,4284,2803,1068,358,34,2,4265,19,0,65.72098475967175,25.04103165298945,8.39390386869871,0.7971864009378663,0.04689331770222743
28,인천광역시,중구,영종동,영종동제1투,3348,1589,513,887,162,14,3,1579,10,1759,32.4889170360988,56.17479417352755,10.259658011399619,0.8866371120962635,0.18999366687777072
29,인천광역시,중구,영종동,영종동제2투,4203,2725,1180,1262,236,34,1,2713,12,1478,43.49428676741615,46.516771102100996,8.698857353483229,1.2532252119424991,0.036859565057132324
30,인천광역시,중구,영종동,영종동제3투,1274,804,247,516,33,3,0,799,5,470,30.91364205256571,64.58072590738423,4.130162703379224,0.37546933667083854,0.0
31,인천광역시,중구,영종동,영종동제4투,2150,1223,389,737,82,8,2,1218,5,927,31.9376026272578,60.50903119868637,6.732348111658457,0.6568144499178982,0.16420361247947454
32,인천광역시,중구,영종동,영종동제5투,3748,2682,1318,1045,270,28,1,2662,20,1066,49.51164537941398,39.25619834710744,10.1427498121713,1.051840721262209,0.03756574004507889
33,인천광역시,중구,영종1동,관내사전투표,6633,6633,4710,1235,594,48,9,6596,37,0,71.40691328077622,18.72346876895088,9.00545785324439,0.7277137659187386,0.13644633110976348
34,인천광역시,중구,영종1동,영종1동제1투,2715,1922,963,723,205,19,0,1910,12,793,50.41884816753927,37.853403141361255,10.732984293193718,0.9947643979057591,0.0
35,인천광역시,중구,영종1동,영종1동제2투,3232,1906,778,843,247,21,1,1890,16,1326,41.164021164021165,44.60317460317461,13.068783068783068,1.1111111111111112,0.052910052910052914
36,인천광역시,중구,영종1동,영종1동제3투,2609,1768,802,776,158,22,0,1758,10,841,45.62002275312855,44.141069397042095,8.987485779294653,1.2514220705346986,0.0
37,인천광역시,중구,영종1동,영종1동제4투,2612,1851,931,722,164,23,0,1840,11,761,50.59782608695652,39.23913043478261,8.91304347826087,1.25,0.0
38,인천광역시,중구,영종1동,영종1동제5투,2506,1686,775,731,147,20,3,1676,10,820,46.241050119331746,43.61575178997613,8.770883054892602,1.1933174224343674,0.17899761336515513
39,인천광역시,중구,영종1동,영종1동제6투,1535,1103,505,487,90,15,2,1099,4,432,45.950864422202,44.313011828935394,8.18926296633303,1.364877161055505,0.18198362147406735
40,인천광역시,중구,영종1동,영종1동제7투,2303,1614,781,656,147,20,0,1604,10,689,48.69077306733167,40.89775561097257,9.164588528678303,1.2468827930174564,0.0
41,인천광역시,중구,영종2동,관내사전투표,3981,3981,2813,762,352,30,3,3960,21,0,71.03535353535354,19.242424242424242,8.88888888888889,0.7575757575757576,0.07575757575757576
42,인천광역시,중구,영종2동,영종2동제1투,3499,2444,1169,1035,209,20,3,2436,8,1055,47.98850574712644,42.48768472906404,8.579638752052546,0.8210180623973727,0.12315270935960591
43,인천광역시,중구,영종2동,영종2동제2투,2942,2043,930,890,193,14,0,2027,16,899,45.880611741489886,43.90725209669462,9.521460286137149,0.6906758756783424,0.0
44,인천광역시,중구,영종2동,영종2동제3투,3104,2165,1069,862,200,18,2,2151,14,939,49.6978149697815,40.074384007438404,9.298000929800093,0.8368200836820083,0.09298000929800093
45,인천광역시,중구,영종2동,영종2동제4투,3814,2472,1105,1027,299,27,0,2458,14,1342,44.95524816924329,41.781936533767286,12.164361269324655,1.098454027664768,0.0
46,인천광역시,중구,운서동,관내사전투표,12696,12696,8372,2378,1693,116,19,12578,118,0,66.56066147241215,18.906026395293367,13.460009540467482,0.9222451900143107,0.1510574018126888
47,인천광역시,중구,운서동,운서동제1투,2035,1303,495,624,158,15,2,1294,9,732,38.25347758887172,48.222565687789796,12.210200927357032,1.1591962905718702,0.1545595054095827
48,인천광역시,중구,운서동,운서동제2투,2225,1188,466,583,114,15,1,1179,9,1037,39.525021204410514,49.44868532654792,9.669211195928753,1.2722646310432568,0.08481764206955046
49,인천광역시,중구,운서동,운서동제3투,2271,1504,690,644,131,28,1,1494,10,767,46.1847389558233,43.1057563587684,8.768406961178044,1.8741633199464525,0.06693440428380187
50,인천광역시,중구,운서동,운서동제4투,3533,1889,710,877,266,21,1,1875,14,1644,37.86666666666667,46.77333333333333,14.186666666666667,1.1199999999999999,0.05333333333333334
51,인천광역시,중구,운서동,운서동제5투,2413,1497,670,666,125,23,0,1484,13,916,45.14824797843666,44.878706199460915,8.423180592991914,1.5498652291105122,0.0
52,인천광역시,중구,운서동,운서동제6투,5329,2921,1076,1325,455,36,5,2897,24,2408,37.141870900932,45.73696927856403,15.705902657921989,1.2426648256817396,0.17259233690024164
53,인천광역시,중구,운서동,운서동제7투,3527,2437,1018,1148,229,22,3,2420,17,1090,42.06611570247934,47.43801652892562,9.462809917355372,0.9090909090909091,0.12396694214876033
54,인천광역시,중구,용유동,관내사전투표,1045,1045,554,414,63,4,0,1035,10,0,53.526570048309175,40.0,6.086956521739131,0.3864734299516908,0.0
55,인천광역시,중구,용유동,용유동제1투,821,448,97,336,14,0,0,447,1,373,21.700223713646533,75.16778523489933,3.131991051454139,0.0,0.0
56,인천광역시,중구,용유동,용유동제2투,709,409,87,300,16,3,0,406,3,300,21.428571428571427,73.89162561576354,3.9408866995073892,0.7389162561576355,0.0
57,인천광역시,중구,용유동,용유동제3투,392,274,60,206,4,3,0,273,1,118,21.978021978021978,75.45787545787546,1.465201465201465,1.098901098901099,0.0
58,인천광역시,중구,용유동,용유동제4투,48,39,10,29,0,0,0,39,0,9,25.64102564102564,74.35897435897436,0.0,0.0,0.0
59,인천광역시,중구,잘못 투입·구분된 투표지,,0,0,0,0,0,0,0,0,0,0,0.0,0.0,0.0,0.0,0.0
0,인천광역시,동구,거소·선상투표,,64,58,25,23,9,0,0,57,1,6,43.859649122807014,40.35087719298245,15.789473684210526,0.0,0.0
1,인천광역시,동구,관외사전투표,,4250,4249,2547,1110,472,69,10,4208,41,1,60.52756653992395,26.37832699619772,11.216730038022813,1.6397338403041826,0.2376425855513308
2,인천광역시,동구,재외투표,,289,215,149,39,23,1,0,212,3,74,70.28301886792453,18.39622641509434,10.849056603773585,0.4716981132075472,0.0
3,인천광역시,동구,만석동,관내사전투표,1619,1619,1005,472,104,19,2,1602,17,0,62.734082397003746,29.463171036204745,6.491885143570538,1.1860174781523096,0.12484394506866417
4,인천광역시,동구,만석동,만석동제1투,1624,1017,381,560,56,10,1,1008,9,607,37.797619047619044,55.55555555555556,5.555555555555555,0.992063492063492,0.0992063492063492
5,인천광역시,동구,만석동,만석동제2투,2170,1542,662,743,102,28,0,1535,7,628,43.127035830618894,48.40390879478827,6.644951140065146,1.8241042345276872,0.0
6,인천광역시,동구,화수1·화평동,관내사전투표,1072,1072,637,357,51,19,1,1065,7,0,59.81220657276995,33.52112676056338,4.788732394366197,1.784037558685446,0.09389671361502347
7,인천광역시,동구,화수1·화평동,화수1·화평동제1투,1490,895,310,509,62,8,2,891,4,595,34.792368125701465,57.12682379349046,6.958473625140292,0.8978675645342313,0.22446689113355783
8,인천광역시,동구,화수1·화평동,화수1·화평동제2투,1764,1236,453,679,71,17,1,1221,15,528,37.1007371007371,55.61015561015561,5.814905814905815,1.3923013923013923,0.08190008190008191
9,인천광역시,동구,화수2동,관내사전투표,1134,1134,668,378,62,14,1,1123,11,0,59.483526268922525,33.659839715048975,5.520926090828139,1.2466607301869992,0.08904719501335707
10,인천광역시,동구,화수2동,화수2동제1투,1125,676,242,387,39,3,1,672,4,449,36.01190476190476,57.58928571428571,5.803571428571429,0.4464285714285714,0.1488095238095238
11,인천광역시,동구,화수2동,화수2동제2투,1573,1071,386,610,51,12,4,1063,8,502,36.312323612417686,57.38476011288805,4.797742238946378,1.1288805268109126,0.37629350893697083
12,인천광역시,동구,화수2동,화수2동제3투,1680,1269,484,672,79,17,3,1255,14,411,38.56573705179283,53.54581673306773,6.294820717131475,1.3545816733067728,0.2390438247011952
13,인천광역시,동구,송현1·2동,관내사전투표,3420,3420,2181,925,246,36,4,3392,28,0,64.29834905660378,27.270047169811324,7.2523584905660385,1.0613207547169812,0.1179245283018868
14,인천광역시,동구,송현1·2동,송현1·2동제1투,1368,970,325,566,55,12,2,960,10,398,33.85416666666667,58.958333333333336,5.729166666666666,1.25,0.20833333333333334
15,인천광역시,동구,송현1·2동,송현1·2동제2투,1997,1440,592,729,94,12,2,1429,11,557,41.42757172848145,51.0146955913226,6.578026592022393,0.8397480755773268,0.13995801259622112
16,인천광역시,동구,송현1·2동,송현1·2동제3투,1941,1306,539,652,84,23,3,1301,5,635,41.42966948501153,50.115295926210614,6.456571867794005,1.7678708685626443,0.23059185242121444
17,인천광역시,동구,송현3동,관내사전투표,645,645,396,212,29,4,0,641,4,0,61.77847113884556,33.073322932917314,4.5241809672386895,0.62402496099844,0.0
18,인천광역시,동구,송현3동,송현3동투표소,1630,1055,347,626,64,8,4,1049,6,575,33.079122974261196,59.67588179218303,6.1010486177311725,0.7626310772163966,0.3813155386081983
19,인천광역시,동구,송림1동,관내사전투표,571,571,366,169,26,6,1,568,3,0,64.43661971830986,29.753521126760564,4.577464788732395,1.056338028169014,0.17605633802816903
20,인천광역시,동구,송림1동,송림1동제1투,619,417,124,265,23,3,1,416,1,202,29.807692307692307,63.70192307692307,5.528846153846153,0.7211538461538461,0.2403846153846154
21,인천광역시,동구,송림1동,송림1동제2투,3093,2190,903,1006,228,31,6,2174,16,903,41.53633854645814,46.274149034038636,10.48758049678013,1.4259429622815087,0.27598896044158233
22,인천광역시,동구,송림2동,관내사전투표,514,514,262,208,33,9,0,512,2,0,51.171875,40.625,6.4453125,1.7578125,0.0
23,인천광역시,동구,송림2동,송림2동투표소,682,406,114,254,26,3,1,398,8,276,28.643216080402013,63.81909547738693,6.532663316582915,0.7537688442211055,0.25125628140703515
24,인천광역시,동구,송림3·5동,관내사전투표,1351,1351,853,385,89,18,2,1347,4,0,63.32590942835932,28.582034149962883,6.607275426874535,1.3363028953229399,0.14847809948032664
25,인천광역시,동구,송림3·5동,송림3·5동제1투,1104,673,234,381,45,6,0,666,7,431,35.13513513513514,57.20720720720721,6.756756756756757,0.9009009009009009,0.0
26,인천광역시,동구,송림3·5동,송림3·5동제2투,1924,1348,571,645,110,14,1,1341,7,576,42.58016405667412,48.09843400447427,8.202833706189411,1.0439970171513795,0.07457121551081282
27,인천광역시,동구,송림4동,관내사전투표,1080,1080,780,206,74,15,0,1075,5,0,72.55813953488372,19.162790697674417,6.883720930232558,1.3953488372093024,0.0
28,인천광역시,동구,송림4동,송림4동제1투,1486,1027,413,457,126,16,0,1012,15,459,40.81027667984189,45.15810276679842,12.450592885375494,1.5810276679841897,0.0
29,인천광역시,동구,송림4동,송림4동제2투,1849,1360,641,605,93,12,3,1354,6,489,47.34121122599705,44.68242245199409,6.868537666174299,0.8862629246676514,0.22156573116691286
30,인천광역시,동구,송림6동,관내사전투표,1499,1499,1000,392,72,23,4,1491,8,0,67.0690811535882,26.291079812206576,4.82897384305835,1.5425888665325285,0.2682763246143528
31,인천광역시,동구,송림6동,송림6동제1투,681,409,144,238,23,3,0,408,1,272,35.294117647058826,58.333333333333336,5.637254901960785,0.7352941176470588,0.0
32,인천광역시,동구,송림6동,송림6동제2투,2495,1698,719,845,102,20,2,1688,10,797,42.59478672985782,50.05924170616114,6.042654028436019,1.1848341232227488,0.11848341232227488
33,인천광역시,동구,금창동,관내사전투표,450,450,250,170,25,5,0,450,0,0,55.55555555555556,37.77777777777778,5.555555555555555,1.1111111111111112,0.0
34,인천광역시,동구,금창동,금창동투표소,1410,917,311,543,43,13,1,911,6,493,34.13830954994512,59.60482985729967,4.720087815587267,1.4270032930845227,0.10976948408342481
35,인천광역시,동구,잘못 투입·구분된 투표지,,0,0,0,0,0,0,0,0,0,0,0.0,0.0,0.0,0.0,0.0
0,인천광역시,미추홀구,거소·선상투표,,617,581,262,163,127,8,2,562,19,36,46.619217081850536,29.00355871886121,22.597864768683273,1.4234875444839856,0.3558718861209964
1,인천광역시,미추홀구,관외사전투표,,32422,32414,19513,7937,4193,402,44,32089,325,8,60.80899996883667,24.734332637352363,13.06678300975412,1.2527657452709653,0.1371186387858768
2,인천광역시,미추홀구,재외투표,,1493,1212,851,232,113,8,0,1204,8,281,70.68106312292359,19.269102990033225,9.385382059800666,0.6644518272425249,0.0
3,인천광역시,미추홀구,숭의1·3동,관내사전투표,2516,2516,1661,666,155,18,0,2500,16,0,66.44,26.640000000000004,6.2,0.72,0.0
4,인천광역시,미추홀구,숭의1·3동,숭의1·3동제1투,3821,2297,1036,1007,210,23,2,2278,19,1524,45.478489903424055,44.2054433713784,9.218612818261633,1.009657594381036,0.08779631255487269
5,인천광역시,미추홀구,숭의1·3동,숭의1·3동제2투,3742,2356,931,1155,215,25,3,2329,27,1386,39.97423787033061,49.59209961356805,9.23142979819665,1.07342206955775,0.12881064834693
6,인천광역시,미추홀구,숭의1·3동,숭의1·3동제3투,2663,1465,628,676,127,14,1,1446,19,1198,43.43015214384509,46.749654218533884,8.782849239280774,0.9681881051175657,0.06915629322268327
7,인천광역시,미추홀구,숭의2동,관내사전투표,3331,3331,2128,915,235,29,3,3310,21,0,64.29003021148037,27.64350453172205,7.099697885196375,0.8761329305135951,0.09063444108761329
8,인천광역시,미추홀구,숭의2동,숭의2동제1투,2677,1475,591,731,135,8,0,1465,10,1202,40.341296928327644,49.89761092150171,9.215017064846416,0.5460750853242321,0.0
9,인천광역시,미추홀구,숭의2동,숭의2동제2투,2700,1491,652,704,104,9,2,1471,20,1209,44.32358939496941,47.85859959211421,7.070020394289599,0.6118286879673691,0.13596193065941536
10,인천광역시,미추홀구,숭의2동,숭의2동제3투,2806,1556,628,789,108,16,3,1544,12,1250,40.67357512953368,51.101036269430054,6.994818652849741,1.0362694300518136,0.19430051813471502
11,인천광역시,미추홀구,숭의4동,관내사전투표,3356,3356,2036,1063,200,35,3,3337,19,0,61.012885825591844,31.85495954450105,5.993407252022775,1.0488462691039857,0.08990110878034162
12,인천광역시,미추홀구,숭의4동,숭의4동제1투,2976,1617,594,865,127,16,0,1602,15,1359,37.07865168539326,53.99500624219725,7.927590511860175,0.9987515605493134,0.0
13,인천광역시,미추홀구,숭의4동,숭의4동제2투,2594,1549,665,764,93,10,2,1534,15,1045,43.35071707953064,49.80443285528031,6.0625814863103,0.651890482398957,0.1303780964797914
14,인천광역시,미추홀구,숭의4동,숭의4동제3투,2866,1735,750,833,108,19,4,1714,21,1131,43.75729288214703,48.599766627771295,6.301050175029172,1.1085180863477246,0.2333722287047841
15,인천광역시,미추홀구,용현1·4동,관내사전투표,3793,3793,1992,1074,656,31,3,3756,37,0,53.03514376996805,28.594249201277954,17.465388711395104,0.825346112886049,0.07987220447284345
16,인천광역시,미추홀구,용현1·4동,용현1·4동제1투,1808,931,341,521,56,4,1,923,8,877,36.944745395449615,56.44637053087757,6.067172264355363,0.43336944745395445,0.10834236186348861
17,인천광역시,미추홀구,용현1·4동,용현1·4동제2투,1504,859,314,491,41,8,1,855,4,645,36.72514619883041,57.42690058479533,4.7953216374269,0.9356725146198831,0.11695906432748539
18,인천광역시,미추홀구,용현1·4동,용현1·4동제3투,2866,1782,638,924,181,16,3,1762,20,1084,36.20885357548241,52.44040862656073,10.272417707150964,0.9080590238365494,0.170261066969353
19,인천광역시,미추홀구,용현1·4동,용현1·4동제4투,2490,1645,407,851,353,18,2,1631,14,845,24.954015941140405,52.17657878602084,21.64316370324954,1.1036174126302882,0.1226241569589209
20,인천광역시,미추홀구,용현1·4동,용현1·4동제5투,2381,1525,487,850,163,14,2,1516,9,856,32.12401055408971,56.068601583113455,10.751978891820581,0.9234828496042217,0.13192612137203166
21,인천광역시,미추홀구,용현2동,관내사전투표,5030,5030,3326,1237,367,65,3,4998,32,0,66.54661864745898,24.749899959983992,7.342937174869949,1.3005202080832332,0.060024009603841535
22,인천광역시,미추홀구,용현2동,용현2동제1투,3312,2251,994,960,251,25,2,2232,19,1061,44.53405017921147,43.01075268817204,11.245519713261649,1.1200716845878136,0.08960573476702509
23,인천광역시,미추홀구,용현2동,용현2동제2투,3775,2413,953,1235,196,19,1,2404,9,1362,39.64226289517471,51.37271214642263,8.153078202995008,0.7903494176372712,0.04159733777038269
24,인천광역시,미추홀구,용현2동,용현2동제3투,3103,2185,826,1162,158,22,3,2171,14,918,38.0469829571626,53.523721787194845,7.277752187931828,1.0133578995854444,0.1381851681252879
25,인천광역시,미추홀구,용현2동,용현2동제4투,2363,1588,632,711,201,28,4,1576,12,775,40.10152284263959,45.11421319796954,12.753807106598986,1.7766497461928936,0.25380710659898476
26,인천광역시,미추홀구,용현3동,관내사전투표,1876,1876,1077,637,130,14,0,1858,18,0,57.96555435952637,34.28417653390743,6.996770721205597,0.7534983853606028,0.0
27,인천광역시,미추홀구,용현3동,용현3동제1투,2164,1157,400,675,63,6,3,1147,10,1007,34.873583260680036,58.84917175239755,5.492589363557106,0.5231037489102005,0.26155187445510025
28,인천광역시,미추홀구,용현3동,용현3동제2투,2055,1159,372,669,97,8,3,1149,10,896,32.375979112271544,58.22454308093995,8.44212358572672,0.6962576153176675,0.26109660574412535
29,인천광역시,미추홀구,용현5동,관내사전투표,8396,8396,5399,2262,594,80,6,8341,55,0,64.72844982615993,27.11905047356432,7.121448267593814,0.9591176117971466,0.07193382088478599
30,인천광역시,미추홀구,용현5동,용현5동제1투,2392,1459,582,740,97,21,3,1443,16,933,40.33264033264034,51.28205128205128,6.722106722106721,1.4553014553014554,0.2079002079002079
31,인천광역시,미추홀구,용현5동,용현5동제2투,3096,1674,662,856,129,16,0,1663,11,1422,39.807576668671075,51.47324113048707,7.757065544197234,0.9621166566446182,0.0
32,인천광역시,미추홀구,용현5동,용현5동제3투,2139,1195,477,595,102,11,1,1186,9,944,40.21922428330523,50.16863406408094,8.600337268128163,0.927487352445194,0.08431703204047217
33,인천광역시,미추홀구,용현5동,용현5동제4투,2411,1293,522,659,93,10,2,1286,7,1118,40.59097978227061,51.24416796267496,7.2317262830482125,0.7776049766718507,0.15552099533437014
34,인천광역시,미추홀구,용현5동,용현5동제5투,2826,1936,821,954,133,18,5,1931,5,890,42.51683065769031,49.404453650958054,6.887622993267736,0.9321595028482652,0.25893319523562924
35,인천광역시,미추홀구,용현5동,용현5동제6투,2836,2026,801,1031,149,25,8,2014,12,810,39.77159880834161,51.19165839126117,7.3982125124131075,1.2413108242303872,0.3972194637537239
36,인천광역시,미추홀구,용현5동,용현5동제7투,2906,1995,858,876,230,21,1,1986,9,911,43.202416918429,44.10876132930513,11.581067472306144,1.0574018126888218,0.050352467270896276
37,인천광역시,미추홀구,용현5동,용현5동제8투,3353,2485,1139,1056,242,37,1,2475,10,868,46.02020202020202,42.66666666666667,9.777777777777779,1.494949494949495,0.0404040404040404
38,인천광역시,미추홀구,용현5동,용현5동제9투,3529,2686,1218,1175,240,34,1,2668,18,843,45.65217391304348,44.040479760119936,8.995502248875562,1.2743628185907045,0.037481259370314844
39,인천광역시,미추홀구,학익1동,관내사전투표,6471,6471,4267,1615,497,50,6,6435,36,0,66.3092463092463,25.097125097125094,7.723387723387723,0.777000777000777,0.09324009324009325
40,인천광역시,미추홀구,학익1동,학익1동제1투,2165,1531,562,838,103,17,3,1523,8,634,36.90085357846356,55.02298095863427,6.762967826657912,1.1162179908076166,0.1969796454366382
41,인천광역시,미추홀구,학익1동,학익1동제2투,3278,2088,855,985,212,17,2,2071,17,1190,41.284403669724774,47.56156446161275,10.236600676001933,0.8208594881699662,0.09657170449058425
42,인천광역시,미추홀구,학익1동,학익1동제3투,2443,1845,681,952,167,26,2,1828,17,598,37.25382932166302,52.078774617067836,9.135667396061269,1.4223194748358863,0.10940919037199125
43,인천광역시,미추홀구,학익1동,학익1동제4투,2987,1986,784,973,191,26,5,1979,7,1001,39.61596766043456,49.16624557857504,9.651339060131379,1.3137948458817585,0.25265285497726125
44,인천광역시,미추홀구,학익1동,학익1동제5투,2011,1292,566,605,92,21,0,1284,8,719,44.0809968847352,47.1183800623053,7.165109034267912,1.6355140186915886,0.0
45,인천광역시,미추홀구,학익1동,학익1동제6투,1546,1057,425,551,58,14,2,1050,7,489,40.476190476190474,52.476190476190474,5.523809523809524,1.3333333333333335,0.19047619047619047
46,인천광역시,미추홀구,학익1동,학익1동제7투,3340,2604,1123,1231,202,29,5,2590,14,736,43.359073359073356,47.52895752895753,7.7992277992278,1.1196911196911197,0.19305019305019305
47,인천광역시,미추홀구,학익1동,학익1동제8투,2384,1803,912,658,204,18,3,1795,8,581,50.807799442896936,36.65738161559889,11.364902506963787,1.0027855153203342,0.1671309192200557
48,인천광역시,미추홀구,학익1동,학익1동제9투,2865,2278,1185,837,218,21,2,2263,15,587,52.36411842686699,36.986301369863014,9.63323022536456,0.9279717189571366,0.08837825894829872
49,인천광역시,미추홀구,학익2동,관내사전투표,3941,3941,2369,1215,291,41,3,3919,22,0,60.44909415667262,31.002806838479202,7.425363613166624,1.0461852513396275,0.07655014034192395
50,인천광역시,미추홀구,학익2동,학익2동제1투,1938,1094,408,593,80,6,2,1089,5,844,37.46556473829201,54.45362718089991,7.3461891643709825,0.5509641873278237,0.18365472910927455
51,인천광역시,미추홀구,학익2동,학익2동제2투,1580,784,303,404,63,3,0,773,11,796,39.19793014230272,52.26390685640362,8.15006468305304,0.38809831824062097,0.0
52,인천광역시,미추홀구,학익2동,학익2동제3투,1997,1334,526,683,98,19,2,1328,6,663,39.60843373493976,51.43072289156626,7.379518072289157,1.430722891566265,0.15060240963855423
53,인천광역시,미추홀구,학익2동,학익2동제4투,2448,1869,739,974,121,23,1,1858,11,579,39.77395048439182,52.42195909580194,6.51237890204521,1.2378902045209903,0.05382131324004305
54,인천광역시,미추홀구,학익2동,학익2동제5투,2446,1804,742,904,123,22,3,1794,10,642,41.36008918617614,50.390189520624304,6.856187290969899,1.2263099219620959,0.16722408026755853
55,인천광역시,미추홀구,도화1동,관내사전투표,3387,3387,2174,966,188,25,5,3358,29,0,64.74091721262656,28.767123287671232,5.598570577724836,0.7444907683144729,0.14889815366289458
56,인천광역시,미추홀구,도화1동,도화1동제1투,3413,1849,728,915,167,24,2,1836,13,1564,39.651416122004356,49.83660130718954,9.095860566448803,1.3071895424836601,0.10893246187363835
57,인천광역시,미추홀구,도화1동,도화1동제2투,3218,1711,694,868,115,16,2,1695,16,1507,40.94395280235988,51.2094395280236,6.784660766961652,0.943952802359882,0.11799410029498525
58,인천광역시,미추홀구,도화1동,도화1동제3투,2577,1666,685,859,101,13,0,1658,8,911,41.31483715319662,51.80940892641737,6.09167671893848,0.7840772014475271,0.0
59,인천광역시,미추홀구,도화1동,도화1동제4투,3430,1872,789,910,139,21,2,1861,11,1558,42.39656098871574,48.89844169801182,7.469102632993015,1.1284255776464267,0.10746910263299302
60,인천광역시,미추홀구,도화2·3동,관내사전투표,5920,5920,4017,1375,420,53,4,5869,51,0,68.44436871698755,23.42818197307889,7.1562446754131885,0.9030499233259499,0.06815471119441131
61,인천광역시,미추홀구,도화2·3동,도화2·3동제1투,1641,971,339,565,56,3,2,965,6,670,35.129533678756474,58.549222797927456,5.803108808290156,0.31088082901554404,0.20725388601036268
62,인천광역시,미추홀구,도화2·3동,도화2·3동제2투,2549,1550,576,820,110,21,2,1529,21,999,37.671680837148465,53.62982341399608,7.194244604316546,1.3734466971877044,0.13080444735120994
63,인천광역시,미추홀구,도화2·3동,도화2·3동제3투,2475,1539,627,767,125,7,1,1527,12,936,41.06090373280943,50.22920759659463,8.185985592665357,0.45841519318926005,0.06548788474132286
64,인천광역시,미추홀구,도화2·3동,도화2·3동제4투,2307,1616,709,741,144,15,2,1611,5,691,44.00993171942893,45.99627560521415,8.938547486033519,0.931098696461825,0.12414649286157665
65,인천광역시,미추홀구,도화2·3동,도화2·3동제5투,2675,1887,864,794,192,20,4,1874,13,788,46.10458911419424,42.3692636072572,10.245464247598719,1.0672358591248665,0.21344717182497333
66,인천광역시,미추홀구,도화2·3동,도화2·3동제6투,3182,1918,814,923,133,24,2,1896,22,1264,42.93248945147679,48.68143459915612,7.014767932489452,1.2658227848101267,0.10548523206751054
67,인천광역시,미추홀구,도화2·3동,도화2·3동제7투,2631,1929,876,807,202,32,2,1919,10,702,45.64877540385617,42.05315268368942,10.526315789473683,1.6675351745700884,0.10422094841063052
68,인천광역시,미추홀구,주안1동,관내사전투표,3169,3169,2114,704,291,35,1,3145,24,0,67.21780604133545,22.384737678855327,9.252782193958664,1.1128775834658187,0.03179650238473768
69,인천광역시,미추홀구,주안1동,주안1동제1투,3626,1758,724,817,181,22,0,1744,14,1868,41.51376146788991,46.846330275229356,10.378440366972477,1.261467889908257,0.0
70,인천광역시,미추홀구,주안1동,주안1동제2투,2750,1389,622,583,142,22,2,1371,18,1361,45.36834427425237,42.5237053245806,10.35740335521517,1.604668125455872,0.14587892049598833
71,인천광역시,미추홀구,주안1동,주안1동제3투,4041,1970,851,874,206,19,3,1953,17,2071,43.57398873527906,44.751664106502815,10.547875064004096,0.9728622631848439,0.15360983102918588
72,인천광역시,미추홀구,주안1동,주안1동제4투,2815,1511,622,713,141,14,4,1494,17,1304,41.633199464524765,47.724230254350736,9.437751004016064,0.9370816599732262,0.2677376171352075
73,인천광역시,미추홀구,주안2동,관내사전투표,3593,3593,2220,1083,244,24,4,3575,18,0,62.0979020979021,30.293706293706297,6.825174825174825,0.6713286713286714,0.11188811188811189
74,인천광역시,미추홀구,주안2동,주안2동제1투,1807,1034,376,591,56,3,3,1029,5,773,36.54033041788144,57.434402332361515,5.442176870748299,0.2915451895043732,0.2915451895043732
75,인천광역시,미추홀구,주안2동,주안2동제2투,3177,1866,642,1049,144,10,5,1850,16,1311,34.7027027027027,56.7027027027027,7.783783783783783,0.5405405405405406,0.2702702702702703
76,인천광역시,미추홀구,주안2동,주안2동제3투,1813,1035,372,572,68,15,1,1028,7,778,36.18677042801556,55.6420233463035,6.614785992217899,1.4591439688715953,0.09727626459143969
77,인천광역시,미추홀구,주안2동,주안2동제4투,2666,1572,645,800,100,18,2,1565,7,1094,41.21405750798722,51.118210862619804,6.3897763578274756,1.1501597444089458,0.12779552715654952
78,인천광역시,미추홀구,주안2동,주안2동제5투,4023,2988,1275,1352,289,40,3,2959,29,1035,43.0888813788442,45.69111186211558,9.76681311253802,1.3518080432578574,0.1013856032443393
79,인천광역시,미추홀구,주안3동,관내사전투표,2688,2688,1668,809,158,20,7,2662,26,0,62.65965439519159,30.390683696468823,5.935386927122464,0.7513148009015778,0.26296018031555224
80,인천광역시,미추홀구,주안3동,주안3동제1투,3309,2105,844,1019,205,20,0,2088,17,1204,40.42145593869732,48.80268199233716,9.81800766283525,0.9578544061302682,0.0
81,인천광역시,미추홀구,주안3동,주안3동제2투,1929,1177,443,644,70,10,1,1168,9,752,37.928082191780824,55.13698630136986,5.993150684931506,0.8561643835616438,0.08561643835616438
82,인천광역시,미추홀구,주안3동,주안3동제3투,1832,1134,442,599,76,7,3,1127,7,698,39.21916592724046,53.149955634427684,6.7435669920141965,0.6211180124223602,0.26619343389529726
83,인천광역시,미추홀구,주안4동,관내사전투표,3494,3494,2028,1150,259,28,5,3470,24,0,58.443804034582136,33.14121037463977,7.463976945244958,0.8069164265129682,0.1440922190201729
84,인천광역시,미추홀구,주안4동,주안4동제1투,3407,2365,953,1166,198,28,3,2348,17,1042,40.58773424190801,49.65928449744463,8.432708688245315,1.192504258943782,0.12776831345826234
85,인천광역시,미추홀구,주안4동,주안4동제2투,2872,1705,583,963,126,15,4,1691,14,1167,34.47664104080425,56.948551153163805,7.451212300413957,0.8870490833826138,0.2365464222353637
86,인천광역시,미추홀구,주안4동,주안4동제3투,2397,1502,512,885,82,9,0,1488,14,895,34.40860215053764,59.4758064516129,5.510752688172043,0.6048387096774194,0.0
87,인천광역시,미추홀구,주안4동,주안4동제4투,3009,1885,711,962,169,19,3,1864,21,1124,38.14377682403433,51.60944206008584,9.066523605150214,1.01931330472103,0.1609442060085837
88,인천광역시,미추홀구,주안5동,관내사전투표,4148,4148,2731,1090,267,31,3,4122,26,0,66.25424551188743,26.443474041727317,6.477438136826782,0.7520621057738962,0.0727802037845706
89,인천광역시,미추홀구,주안5동,주안5동제1투,2296,1456,608,717,109,12,0,1446,10,840,42.047026279391424,49.5850622406639,7.538035961272476,0.8298755186721992,0.0
90,인천광역시,미추홀구,주안5동,주안5동제2투,2172,1316,525,653,110,20,1,1309,7,856,40.106951871657756,49.88540870893812,8.403361344537815,1.5278838808250574,0.07639419404125286
91,인천광역시,미추홀구,주안5동,주안5동제3투,2167,1517,630,714,150,11,0,1505,12,650,41.86046511627907,47.44186046511628,9.966777408637874,0.7308970099667774,0.0
92,인천광역시,미추홀구,주안5동,주안5동제4투,2637,1632,697,781,119,24,2,1623,9,1005,42.94516327788047,48.12076401725201,7.3321010474430075,1.478743068391867,0.12322858903265559
93,인천광역시,미추홀구,주안5동,주안5동제5투,2877,1761,770,813,144,20,1,1748,13,1116,44.05034324942792,46.51029748283753,8.237986270022883,1.1441647597254003,0.057208237986270026
94,인천광역시,미추홀구,주안6동,관내사전투표,4113,4113,2613,1174,250,45,2,4084,29,0,63.98139079333986,28.746327130264447,6.121449559255632,1.1018609206660137,0.04897159647404505
95,인천광역시,미추홀구,주안6동,주안6동제1투,2451,1297,588,575,109,15,2,1289,8,1154,45.61675717610551,44.60822342901474,8.456167571761055,1.1636927851047323,0.1551590380139643
96,인천광역시,미추홀구,주안6동,주안6동제2투,3620,1913,861,856,152,20,7,1896,17,1707,45.41139240506329,45.14767932489451,8.016877637130802,1.0548523206751055,0.3691983122362869
97,인천광역시,미추홀구,주안6동,주안6동제3투,1735,1022,338,613,59,5,1,1016,6,713,33.267716535433074,60.33464566929134,5.807086614173229,0.4921259842519685,0.09842519685039369
98,인천광역시,미추홀구,주안6동,주안6동제4투,1984,1474,583,761,107,12,0,1463,11,510,39.849624060150376,52.01640464798359,7.313738892686262,0.8202323991797676,0.0
99,인천광역시,미추홀구,주안6동,주안6동제5투,2467,1775,711,902,122,26,5,1766,9,692,40.260475651189125,51.075877689694224,6.908267270668176,1.4722536806342015,0.28312570781426954
100,인천광역시,미추홀구,주안7동,관내사전투표,4415,4415,2692,1412,261,28,5,4398,17,0,61.20964074579355,32.105502501136876,5.9345156889495225,0.6366530241018644,0.11368804001819009
101,인천광역시,미추홀구,주안7동,주안7동제1투,1797,1241,464,691,70,12,0,1237,4,556,37.51010509296685,55.86095392077607,5.6588520614389655,0.9700889248181084,0.0
102,인천광역시,미추홀구,주안7동,주안7동제2투,2257,1388,607,663,97,11,2,1380,8,869,43.98550724637681,48.04347826086956,7.028985507246377,0.7971014492753623,0.14492753623188406
103,인천광역시,미추홀구,주안7동,주안7동제3투,1906,1057,414,533,91,7,1,1046,11,849,39.5793499043977,50.956022944550675,8.69980879541109,0.6692160611854685,0.09560229445506692
104,인천광역시,미추홀구,주안7동,주안7동제4투,1568,919,326,516,61,6,2,911,8,649,35.78485181119649,56.6410537870472,6.695938529088913,0.6586169045005488,0.21953896816684962
105,인천광역시,미추홀구,주안8동,관내사전투표,2900,2898,1879,788,183,30,2,2882,16,2,65.19777931991672,27.342123525329633,6.349757113115892,1.040943789035392,0.06939625260235947
106,인천광역시,미추홀구,주안8동,주안8동제1투,1907,1085,465,529,65,16,1,1076,9,822,43.215613382899626,49.1635687732342,6.04089219330855,1.486988847583643,0.09293680297397769
107,인천광역시,미추홀구,주안8동,주안8동제2투,1604,988,388,500,69,15,2,974,14,616,39.83572895277207,51.33470225872689,7.084188911704311,1.5400410677618068,0.20533880903490762
108,인천광역시,미추홀구,주안8동,주안8동제3투,2406,1587,639,809,109,21,1,1579,8,819,40.46865104496517,51.234958834705516,6.903103229892336,1.3299556681443951,0.06333122229259025
109,인천광역시,미추홀구,주안8동,주안8동제4투,2715,1980,903,891,151,18,1,1964,16,735,45.97759674134419,45.366598778004075,7.688391038696538,0.9164969450101833,0.05091649694501018
110,인천광역시,미추홀구,주안8동,주안8동제5투,3223,2223,846,1189,160,13,5,2213,10,1000,38.22864889290556,53.72797107998193,7.230004518752824,0.587437867148667,0.22593764121102575
111,인천광역시,미추홀구,관교동,관내사전투표,3053,3053,1854,927,214,34,2,3031,22,0,61.16793137578357,30.583965687891784,7.060376113493897,1.1217419993401518,0.06598482349059716
112,인천광역시,미추홀구,관교동,관교동제1투,2197,1625,448,1052,98,15,1,1614,11,572,27.757125154894673,65.17967781908303,6.071871127633209,0.929368029739777,0.061957868649318466
113,인천광역시,미추홀구,관교동,관교동제2투,1791,1150,420,607,99,14,1,1141,9,641,36.809815950920246,53.19894829097284,8.676599474145487,1.2269938650306749,0.0876424189307625
114,인천광역시,미추홀구,관교동,관교동제3투,1818,1342,455,766,90,20,0,1331,11,476,34.18482344102179,57.550713749060854,6.7618332081142,1.5026296018031555,0.0
115,인천광역시,미추홀구,관교동,관교동제4투,2405,1643,719,771,126,15,0,1631,12,762,44.08338442673207,47.27161250766401,7.725321888412018,0.9196811771919068,0.0
116,인천광역시,미추홀구,문학동,관내사전투표,3263,3263,2214,805,204,13,4,3240,23,0,68.33333333333333,24.845679012345677,6.296296296296296,0.4012345679012346,0.12345679012345678
117,인천광역시,미추홀구,문학동,문학동제1투,2849,1366,605,629,101,14,2,1351,15,1483,44.78164322723908,46.558105107327904,7.475943745373797,1.0362694300518136,0.1480384900074019
118,인천광역시,미추홀구,문학동,문학동제2투,2430,1285,523,640,102,9,1,1275,10,1145,41.01960784313726,50.19607843137255,8.0,0.7058823529411765,0.0784313725490196
119,인천광역시,미추홀구,문학동,문학동제3투,3013,1529,675,710,118,13,4,1520,9,1484,44.40789473684211,46.71052631578947,7.7631578947368425,0.855263157894737,0.2631578947368421
120,인천광역시,미추홀구,잘못 투입·구분된 투표지,,0,2,1,1,0,0,0,2,0,-2,50.0,50.0,0.0,0.0,0.0
0,인천광역시,연수구,거소·선상투표,,487,459,192,143,102,0,1,438,21,28,43.83561643835616,32.64840182648402,23.28767123287671,0.0,0.228310502283105
1,인천광역시,연수구,관외사전투표,,30913,30907,17644,8107,4477,365,36,30629,278,6,57.60553723595285,26.46837964021026,14.616866368474321,1.1916810865519605,0.11753566881060433
2,인천광역시,연수구,재외투표,,2337,1906,1232,407,236,25,0,1900,6,431,64.84210526315789,21.421052631578945,12.421052631578949,1.3157894736842104,0.0
3,인천광역시,연수구,옥련1동,관내사전투표,2651,2651,1637,806,184,16,2,2645,6,0,61.89035916824197,30.47258979206049,6.956521739130435,0.6049149338374291,0.07561436672967864
4,인천광역시,연수구,옥련1동,옥련1동제1투,2565,1698,579,933,149,18,2,1681,17,867,34.443783462224864,55.502676977989296,8.863771564544914,1.0707911957168352,0.1189767995240928
5,인천광역시,연수구,옥련1동,옥련1동제2투,2412,1487,519,854,91,15,3,1482,5,925,35.020242914979754,57.62483130904184,6.140350877192982,1.0121457489878543,0.20242914979757085
6,인천광역시,연수구,옥련1동,옥련1동제3투,2755,1838,694,971,138,19,6,1828,10,917,37.96498905908096,53.11816192560175,7.549234135667396,1.0393873085339167,0.3282275711159737
7,인천광역시,연수구,옥련1동,옥련1동제4투,2480,1704,716,838,116,19,4,1693,11,776,42.2917897223863,49.49793266391022,6.851742468989959,1.1222681630242175,0.23626698168930893
8,인천광역시,연수구,옥련2동,관내사전투표,5579,5579,3600,1577,329,45,4,5555,24,0,64.8064806480648,28.38883888388839,5.922592259225922,0.8100810081008101,0.07200720072007201
9,인천광역시,연수구,옥련2동,옥련2동제1투,2039,1266,469,676,102,6,1,1254,12,773,37.40031897926635,53.90749601275917,8.133971291866029,0.4784688995215311,0.07974481658692185
10,인천광역시,연수구,옥련2동,옥련2동제2투,1782,1166,473,580,96,9,1,1159,7,616,40.81104400345125,50.043140638481454,8.283002588438308,0.7765314926660914,0.08628127696289906
11,인천광역시,연수구,옥련2동,옥련2동제3투,2777,1951,736,1036,145,23,1,1941,10,826,37.918598660484285,53.374549201442555,7.470376094796497,1.184956208140134,0.05151983513652757
12,인천광역시,연수구,옥련2동,옥련2동제4투,2128,1439,593,705,121,10,2,1431,8,689,41.43955276030748,49.266247379454924,8.455625436757511,0.6988120195667366,0.1397624039133473
13,인천광역시,연수구,옥련2동,옥련2동제5투,2259,1655,693,807,124,14,1,1639,16,604,42.281879194630875,49.23733984136669,7.565588773642465,0.8541793776693106,0.06101281269066504
14,인천광역시,연수구,선학동,관내사전투표,3505,3504,2258,956,237,25,4,3480,24,1,64.88505747126436,27.47126436781609,6.810344827586206,0.7183908045977011,0.11494252873563218
15,인천광역시,연수구,선학동,선학동제1투,1677,1138,461,571,83,11,0,1126,12,539,40.94138543516873,50.710479573712256,7.371225577264654,0.9769094138543518,0.0
16,인천광역시,연수구,선학동,선학동제2투,3686,2430,888,1283,212,24,6,2413,17,1256,36.80066307501036,53.170327393286364,8.785743887277249,0.9946125155408205,0.24865312888520513
17,인천광역시,연수구,선학동,선학동제3투,3762,2628,1073,1288,216,33,2,2612,16,1134,41.079632465543646,49.31087289433385,8.269525267993874,1.2633996937212864,0.0765696784073507
18,인천광역시,연수구,선학동,선학동제4투,1700,1091,397,604,70,9,0,1080,11,609,36.75925925925926,55.925925925925924,6.481481481481481,0.8333333333333334,0.0
19,인천광역시,연수구,연수1동,관내사전투표,3590,3590,2277,1006,237,46,3,3569,21,0,63.79938358083497,28.187167273746148,6.640515550574391,1.288876435976464,0.08405715886803025
20,인천광역시,연수구,연수1동,연수1동제1투,2315,1565,551,840,149,15,1,1556,9,750,35.411311053984576,53.98457583547558,9.575835475578407,0.9640102827763496,0.06426735218508997
21,인천광역시,연수구,연수1동,연수1동제2투,3241,1966,691,1061,182,19,3,1956,10,1275,35.327198364008176,54.243353783231086,9.304703476482617,0.9713701431492843,0.15337423312883436
22,인천광역시,연수구,연수1동,연수1동제3투,3121,1891,698,1038,122,18,3,1879,12,1230,37.14741883980841,55.2421500798297,6.492815327301757,0.9579563597658328,0.15965939329430548
23,인천광역시,연수구,연수1동,연수1동제4투,1639,762,276,418,57,5,0,756,6,877,36.507936507936506,55.29100529100529,7.5396825396825395,0.6613756613756614,0.0
24,인천광역시,연수구,연수2동,관내사전투표,4353,4353,2738,1152,378,58,1,4327,26,0,63.27709729604807,26.623526692858796,8.735844696094292,1.3404206147446267,0.023110700254217704
25,인천광역시,연수구,연수2동,연수2동제1투,2227,1612,552,885,141,16,3,1597,15,615,34.5648090169067,55.4164057608015,8.829054477144647,1.0018785222291797,0.18785222291797118
26,인천광역시,연수구,연수2동,연수2동제2투,2166,1633,644,805,159,14,0,1622,11,533,39.70406905055487,49.63008631319359,9.802712700369915,0.8631319358816275,0.0
27,인천광역시,연수구,연수2동,연수2동제3투,2095,1427,517,743,124,11,4,1399,28,668,36.95496783416726,53.10936383130807,8.863473909935667,0.7862759113652609,0.28591851322373124
28,인천광역시,연수구,연수2동,연수2동제4투,1597,1220,532,518,141,14,0,1205,15,377,44.149377593360995,42.98755186721992,11.701244813278008,1.161825726141079,0.0
29,인천광역시,연수구,연수2동,연수2동제5투,2364,1525,559,776,158,10,5,1508,17,839,37.06896551724138,51.45888594164456,10.477453580901857,0.6631299734748011,0.33156498673740054
30,인천광역시,연수구,연수2동,연수2동제6투,1276,732,227,435,60,3,0,725,7,544,31.310344827586206,60.0,8.275862068965518,0.41379310344827586,0.0
31,인천광역시,연수구,연수3동,관내사전투표,3612,3612,2261,1025,268,28,1,3583,29,0,63.1035445157689,28.607312308121685,7.479765559586939,0.7814680435389338,0.027909572983533353
32,인천광역시,연수구,연수3동,연수3동제1투,2800,1937,718,1047,135,16,6,1922,15,863,37.356919875130075,54.47450572320499,7.023933402705515,0.8324661810613945,0.31217481789802287
33,인천광역시,연수구,연수3동,연수3동제2투,2238,1533,547,814,137,24,0,1522,11,705,35.939553219448094,53.482260183968464,9.00131406044678,1.5768725361366622,0.0
34,인천광역시,연수구,연수3동,연수3동제3투,1947,1326,540,631,127,18,1,1317,9,621,41.00227790432802,47.911921032649964,9.643128321943811,1.366742596810934,0.07593014426727411
35,인천광역시,연수구,연수3동,연수3동제4투,1772,1278,521,595,134,10,1,1261,17,494,41.31641554321966,47.184773988897696,10.626486915146709,0.7930214115781126,0.07930214115781126
36,인천광역시,연수구,청학동,관내사전투표,4200,4200,2682,1231,217,42,4,4176,24,0,64.22413793103449,29.477969348659006,5.196360153256705,1.0057471264367817,0.09578544061302681
37,인천광역시,연수구,청학동,청학동제1투,1997,1107,422,573,91,10,0,1096,11,890,38.503649635036496,52.28102189781022,8.302919708029197,0.9124087591240875,0.0
38,인천광역시,연수구,청학동,청학동제2투,1638,1014,311,620,67,8,1,1007,7,624,30.883813306852037,61.56901688182721,6.653426017874876,0.7944389275074478,0.09930486593843098
39,인천광역시,연수구,청학동,청학동제3투,2646,1934,797,967,139,20,2,1925,9,712,41.4025974025974,50.23376623376623,7.220779220779221,1.0389610389610389,0.1038961038961039
40,인천광역시,연수구,청학동,청학동제4투,2721,1588,622,791,143,21,1,1578,10,1133,39.4169835234474,50.126742712294046,9.062103929024081,1.3307984790874523,0.06337135614702154
41,인천광역시,연수구,청학동,청학동제5투,2057,1254,443,686,106,11,0,1246,8,803,35.553772070626,55.0561797752809,8.507223113964688,0.8828250401284109,0.0
42,인천광역시,연수구,청학동,청학동제6투,2992,1939,672,1090,143,17,3,1925,14,1053,34.909090909090914,56.62337662337662,7.428571428571429,0.8831168831168832,0.15584415584415584
43,인천광역시,연수구,동춘1동,관내사전투표,5085,5085,3450,1189,342,65,5,5051,34,0,68.30330627598495,23.539893090477133,6.770936448228074,1.2868738863591367,0.09899029895070284
44,인천광역시,연수구,동춘1동,동춘1동제1투,2947,2026,875,929,188,24,1,2017,9,921,43.38125929598414,46.05850272682201,9.32077342588002,1.189885969261279,0.04957858205255329
45,인천광역시,연수구,동춘1동,동춘1동제2투,2368,1763,752,832,144,21,1,1750,13,605,42.971428571428575,47.542857142857144,8.228571428571428,1.2,0.05714285714285715
46,인천광역시,연수구,동춘1동,동춘1동제3투,1768,1243,433,687,100,19,1,1240,3,525,34.91935483870968,55.403225806451616,8.064516129032258,1.532258064516129,0.08064516129032258
47,인천광역시,연수구,동춘1동,동춘1동제4투,2353,1709,672,862,142,27,0,1703,6,644,39.45977686435702,50.61655901350558,8.338226658837346,1.5854374633000587,0.0
48,인천광역시,연수구,동춘1동,동춘1동제5투,1022,730,319,323,76,7,0,725,5,292,44.0,44.55172413793104,10.482758620689655,0.9655172413793104,0.0
49,인천광역시,연수구,동춘1동,동춘1동제6투,3597,2810,1293,1237,230,30,4,2794,16,787,46.27773801002147,44.27344309234073,8.231925554760199,1.0737294201861132,0.14316392269148173
50,인천광역시,연수구,동춘2동,관내사전투표,3902,3902,2576,956,304,33,4,3873,29,0,66.51174799896721,24.683707720113606,7.849212496772527,0.8520526723470179,0.10327911179963851
51,인천광역시,연수구,동춘2동,동춘2동제1투,1958,1281,443,690,128,12,2,1275,6,677,34.74509803921569,54.11764705882353,10.03921568627451,0.9411764705882352,0.1568627450980392
52,인천광역시,연수구,동춘2동,동춘2동제2투,2431,1835,742,907,149,21,4,1823,12,596,40.70213933077345,49.75315414152496,8.173340647284695,1.151947339550192,0.21941854086670326
53,인천광역시,연수구,동춘2동,동춘2동제3투,2272,1686,730,745,180,17,1,1673,13,586,43.63419007770472,44.530783024506874,10.759115361625822,1.0161386730424387,0.059772863120143446
54,인천광역시,연수구,동춘2동,동춘2동제4투,2642,1972,769,979,182,24,1,1955,17,670,39.33503836317136,50.076726342711,9.309462915601022,1.227621483375959,0.051150895140664954
55,인천광역시,연수구,동춘3동,관내사전투표,4273,4273,2740,1132,333,45,3,4253,20,0,64.4251116858688,26.616505995767692,7.829767223136609,1.0580766517752174,0.07053844345168116
56,인천광역시,연수구,동춘3동,동춘3동제1투,2191,1673,600,908,131,20,1,1660,13,518,36.144578313253014,54.69879518072289,7.8915662650602405,1.2048192771084338,0.06024096385542169
57,인천광역시,연수구,동춘3동,동춘3동제2투,2331,1775,791,803,143,22,1,1760,15,556,44.94318181818181,45.625,8.125,1.25,0.056818181818181816
58,인천광역시,연수구,동춘3동,동춘3동제3투,2494,1866,661,996,178,18,0,1853,13,628,35.67188343227199,53.750674581759306,9.60604425256341,0.9713977334052887,0.0
59,인천광역시,연수구,동춘3동,동춘3동제4투,2003,1504,608,736,129,23,1,1497,7,499,40.61456245824983,49.164996659986635,8.617234468937877,1.5364061456245823,0.06680026720106881
60,인천광역시,연수구,송도1동,관내사전투표,6797,6797,4247,1718,734,67,3,6769,28,0,62.74191165607918,25.38041069581918,10.843551484709705,0.9898064706751367,0.044319692716797164
61,인천광역시,연수구,송도1동,송도1동제1투,2385,1862,770,889,170,18,2,1849,13,523,41.644131963223366,48.08004326663061,9.194159004867496,0.9734991887506761,0.1081665765278529
62,인천광역시,연수구,송도1동,송도1동제2투,2330,1763,540,1054,143,11,0,1748,15,567,30.892448512585812,60.297482837528605,8.180778032036613,0.6292906178489702,0.0
63,인천광역시,연수구,송도1동,송도1동제3투,2358,1706,681,811,179,22,1,1694,12,652,40.200708382526564,47.874852420306965,10.566706021251477,1.2987012987012987,0.05903187721369539
64,인천광역시,연수구,송도1동,송도1동제4투,2216,1706,641,886,150,20,3,1700,6,510,37.70588235294118,52.11764705882352,8.823529411764707,1.1764705882352942,0.17647058823529413
65,인천광역시,연수구,송도1동,송도1동제5투,2324,1812,625,1041,116,17,2,1801,11,512,34.70294280955025,57.8012215435869,6.440866185452526,0.9439200444197668,0.11104941699056081
66,인천광역시,연수구,송도1동,송도1동제6투,3597,2642,918,1334,331,41,2,2626,16,955,34.95811119573496,50.7996953541508,12.604722010662606,1.5613099771515613,0.07616146230007616
67,인천광역시,연수구,송도1동,송도1동제7투,3208,2441,684,1490,220,27,3,2424,17,767,28.217821782178216,61.46864686468647,9.075907590759076,1.1138613861386137,0.12376237623762376
68,인천광역시,연수구,송도1동,송도1동제8투,2254,1630,515,733,337,20,1,1606,24,624,32.06724782067248,45.64134495641345,20.983810709838107,1.2453300124533,0.062266500622665005
69,인천광역시,연수구,송도2동,관내사전투표,6590,6590,4223,1703,599,45,1,6571,19,0,64.26723481966215,25.91690762441029,9.115811900776137,0.6848272713437833,0.015218383807639627
70,인천광역시,연수구,송도2동,송도2동제1투,1910,1468,545,759,145,13,0,1462,6,442,37.277701778385776,51.91518467852257,9.917920656634747,0.8891928864569083,0.0
71,인천광역시,연수구,송도2동,송도2동제2투,3045,2220,793,1174,221,18,1,2207,13,825,35.931128228364294,53.194381513366565,10.013593112822837,0.8155867693701857,0.045310376076121435
72,인천광역시,연수구,송도2동,송도2동제3투,3298,2322,694,1400,201,10,2,2307,15,976,30.082358040745554,60.68487212830516,8.712613784135241,0.43346337234503685,0.08669267446900737
73,인천광역시,연수구,송도2동,송도2동제4투,2075,1398,516,715,144,14,1,1390,8,677,37.12230215827338,51.438848920863315,10.359712230215827,1.0071942446043165,0.07194244604316546
74,인천광역시,연수구,송도2동,송도2동제5투,2454,1871,688,980,168,26,2,1864,7,583,36.9098712446352,52.57510729613733,9.012875536480687,1.3948497854077253,0.1072961373390558
75,인천광역시,연수구,송도2동,송도2동제6투,2688,2015,686,1120,189,13,1,2009,6,673,34.146341463414636,55.749128919860624,9.40766550522648,0.6470881035340966,0.049776007964161276
76,인천광역시,연수구,송도2동,송도2동제7투,2703,1959,586,1159,191,15,0,1951,8,744,30.035879036391595,59.405433111225015,9.789851358277806,0.768836494105587,0.0
77,인천광역시,연수구,송도3동,관내사전투표,9151,9151,5664,2162,1156,114,3,9099,52,0,62.24859874711507,23.760852840971538,12.704692823387184,1.252884932410155,0.03297065611605671
78,인천광역시,연수구,송도3동,송도3동제1투,2820,2073,708,1017,312,17,4,2058,15,747,34.40233236151604,49.416909620991255,15.160349854227405,0.8260447035957239,0.1943634596695821
79,인천광역시,연수구,송도3동,송도3동제2투,2519,1970,829,920,187,27,0,1963,7,549,42.231278655119716,46.867040244523686,9.526235354049923,1.3754457463066736,0.0
80,인천광역시,연수구,송도3동,송도3동제3투,3119,2164,729,1183,227,19,0,2158,6,955,33.781278962001856,54.81927710843374,10.51899907321594,0.8804448563484708,0.0
81,인천광역시,연수구,송도3동,송도3동제4투,2358,1837,716,943,153,17,0,1829,8,521,39.147074904319304,51.558228540185894,8.365226899945325,0.9294696555494806,0.0
82,인천광역시,연수구,송도3동,송도3동제5투,3774,2716,1028,1372,275,24,2,2701,15,1058,38.059977786005184,50.796001480932986,10.181414291003332,0.8885597926693818,0.07404664938911515
83,인천광역시,연수구,송도3동,송도3동제6투,1855,1300,513,632,135,11,1,1292,8,555,39.705882352941174,48.91640866873065,10.448916408668731,0.8513931888544891,0.07739938080495357
84,인천광역시,연수구,송도3동,송도3동제7투,2737,2026,829,890,275,16,0,2010,16,711,41.243781094527364,44.27860696517413,13.681592039800993,0.7960199004975124,0.0
85,인천광역시,연수구,송도3동,송도3동제8투,1599,1244,565,494,158,19,1,1237,7,355,45.675020210185934,39.935327405012124,12.772837510105091,1.5359741309620047,0.08084074373484236
86,인천광역시,연수구,송도3동,송도3동제9투,4074,3242,1330,1459,391,45,1,3226,16,832,41.2275263484191,45.22628642281463,12.120272783632982,1.3949163050216988,0.030998140111593304
87,인천광역시,연수구,송도4동,관내사전투표,7667,7667,4904,1821,832,64,3,7624,43,0,64.32318992654774,23.885099685204615,10.912906610703043,0.8394543546694648,0.039349422875131164
88,인천광역시,연수구,송도4동,송도4동제1투,2524,1711,565,906,210,16,1,1698,13,813,33.27444051825677,53.35689045936396,12.36749116607774,0.9422850412249705,0.058892815076560655
89,인천광역시,연수구,송도4동,송도4동제2투,2943,2192,779,1165,218,19,1,2182,10,751,35.701191567369385,53.39138405132906,9.99083409715857,0.8707607699358386,0.045829514207149404
90,인천광역시,연수구,송도4동,송도4동제3투,3388,2552,985,1239,284,27,2,2537,15,836,38.825384312179736,48.837209302325576,11.194324004729996,1.064249113125739,0.07883326763894363
91,인천광역시,연수구,송도4동,송도4동제4투,3259,2497,945,1310,217,19,1,2492,5,762,37.92134831460674,52.56821829855538,8.707865168539326,0.7624398073836276,0.04012841091492777
92,인천광역시,연수구,송도4동,송도4동제5투,2661,1985,769,1010,177,16,1,1973,12,676,38.97617840851495,51.191079574252406,8.971109984794728,0.8109477952356817,0.05068423720223011
93,인천광역시,연수구,송도4동,송도4동제6투,2165,1621,672,737,192,13,1,1615,6,544,41.60990712074303,45.634674922600624,11.888544891640866,0.804953560371517,0.061919504643962855
94,인천광역시,연수구,송도4동,송도4동제7투,3671,2804,1170,1284,313,24,1,2792,12,867,41.9054441260745,45.98853868194843,11.210601719197708,0.8595988538681949,0.03581661891117478
95,인천광역시,연수구,송도4동,송도4동제8투,3456,2546,933,1298,275,24,1,2531,15,910,36.86290003951008,51.284077439747136,10.865270644014222,0.9482418016594232,0.03951007506914263
96,인천광역시,연수구,송도5동,관내사전투표,6096,6096,4045,1409,566,45,4,6069,27,0,66.65018948755973,23.216345361674083,9.32608337452628,0.7414730598121602,0.06590871642774757
97,인천광역시,연수구,송도5동,송도5동제1투,3996,3157,1463,1315,335,30,0,3143,14,839,46.5478841870824,41.83900731784919,10.658606426980592,0.9545020680878141,0.0
98,인천광역시,연수구,송도5동,송도5동제2투,3371,2551,1132,1190,203,17,2,2544,7,820,44.49685534591195,46.776729559748425,7.979559748427673,0.6682389937106918,0.07861635220125787
99,인천광역시,연수구,송도5동,송도5동제3투,3028,2350,943,1145,231,21,2,2342,8,678,40.26473099914603,48.88983774551665,9.863364645602049,0.8966695132365499,0.08539709649871904
100,인천광역시,연수구,송도5동,송도5동제4투,3353,2574,1177,1142,215,29,4,2567,7,779,45.851188157382154,44.48772886638099,8.375535644721465,1.1297234125438256,0.15582391897156214
101,인천광역시,연수구,송도5동,송도5동제5투,2425,1909,798,898,189,17,1,1903,6,516,41.933788754598005,47.18864950078823,9.931686810299526,0.8933263268523385,0.05254860746190226
102,인천광역시,연수구,송도5동,송도5동제6투,2854,1871,638,1025,177,16,0,1856,15,983,34.375,55.22629310344828,9.536637931034484,0.8620689655172413,0.0
103,인천광역시,연수구,송도5동,송도5동제7투,2251,1609,649,762,162,27,0,1600,9,642,40.5625,47.625,10.125,1.6875,0.0
104,인천광역시,연수구,송도5동,송도5동제8투,3515,2491,1053,1146,260,23,2,2484,7,1024,42.391304347826086,46.13526570048309,10.466988727858293,0.9259259259259258,0.08051529790660225
105,인천광역시,연수구,잘못 투입·구분된 투표지,,0,1,0,1,0,0,0,1,0,-1,0.0,100.0,0.0,0.0,0.0
0,인천광역시,남동구,거소·선상투표,,801,749,355,238,123,7,4,727,22,52,48.830811554332875,32.737276478679505,16.91884456671252,0.9628610729023385,0.5502063273727648
1,인천광역시,남동구,관외사전투표,,39107,39085,23493,9619,5032,476,58,38678,407,22,60.739955530275616,24.869434820828378,13.009979833497079,1.2306737680335074,0.1499560473654274
2,인천광역시,남동구,재외투표,,1966,1637,1180,309,120,19,0,1628,9,329,72.48157248157248,18.98034398034398,7.371007371007371,1.167076167076167,0.0
3,인천광역시,남동구,구월1동,관내사전투표,6796,6796,4524,1625,535,69,5,6758,38,0,66.94288250961823,24.04557561408701,7.916543356022491,1.021012133767387,0.0739863865048831
4,인천광역시,남동구,구월1동,구월1동제1투,2072,1399,516,743,110,19,0,1388,11,673,37.17579250720461,53.53025936599424,7.92507204610951,1.3688760806916427,0.0
5,인천광역시,남동구,구월1동,구월1동제2투,2021,1293,538,632,88,14,1,1273,20,728,42.2623723487824,49.64650432050275,6.912804399057344,1.0997643362136684,0.07855459544383347
6,인천광역시,남동구,구월1동,구월1동제3투,2225,1282,540,595,116,18,0,1269,13,943,42.5531914893617,46.887312844759656,9.141055949566587,1.4184397163120568,0.0
7,인천광역시,남동구,구월1동,구월1동제4투,2281,1502,604,746,130,12,1,1493,9,779,40.45545880776959,49.966510381781646,8.7073007367716,0.8037508372404554,0.06697923643670461
8,인천광역시,남동구,구월1동,구월1동제5투,3092,2067,843,1012,164,33,2,2054,13,1025,41.04186952288218,49.269717624148,7.98442064264849,1.6066212268743916,0.09737098344693282
9,인천광역시,남동구,구월1동,구월1동제6투,3029,2310,1078,961,226,26,1,2292,18,719,47.033158813263526,41.92844677137871,9.860383944153577,1.1343804537521813,0.04363001745200698
10,인천광역시,남동구,구월1동,구월1동제7투,2590,2102,982,915,155,31,2,2085,17,488,47.09832134292566,43.884892086330936,7.434052757793765,1.486810551558753,0.09592326139088729
11,인천광역시,남동구,구월2동,관내사전투표,7970,7970,5267,1924,653,79,3,7926,44,0,66.4521826898814,24.27453949028514,8.23870804945748,0.9967196568256372,0.03785011355034065
12,인천광역시,남동구,구월2동,구월2동제1투,2084,1508,663,672,143,14,3,1495,13,576,44.34782608695652,44.94983277591974,9.565217391304348,0.9364548494983277,0.2006688963210702
13,인천광역시,남동구,구월2동,구월2동제2투,2884,2178,966,1001,176,25,0,2168,10,706,44.557195571955724,46.17158671586716,8.118081180811808,1.1531365313653137,0.0
14,인천광역시,남동구,구월2동,구월2동제3투,2485,1837,712,936,158,18,1,1825,12,648,39.013698630136986,51.28767123287671,8.657534246575342,0.9863013698630136,0.0547945205479452
15,인천광역시,남동구,구월2동,구월2동제4투,2509,1923,779,947,162,23,2,1913,10,586,40.721380031364355,49.503397804495556,8.468374281233665,1.2023000522739153,0.10454783063251437
16,인천광역시,남동구,구월2동,구월2동제5투,2724,1997,796,1006,159,21,1,1983,14,727,40.141200201714575,50.73121533030761,8.018154311649017,1.059001512859304,0.05042864346949068
17,인천광역시,남동구,구월2동,구월2동제6투,2635,1693,666,887,111,10,6,1680,13,942,39.64285714285714,52.79761904761905,6.607142857142858,0.5952380952380952,0.35714285714285715
18,인천광역시,남동구,구월2동,구월2동제7투,2081,1389,543,739,89,10,1,1382,7,692,39.29088277858177,53.47322720694645,6.439942112879884,0.723589001447178,0.0723589001447178
19,인천광역시,남동구,구월2동,구월2동제8투,2250,1723,740,758,198,15,0,1711,12,527,43.24956165984804,44.30157802454705,11.57218001168907,0.8766803039158386,0.0
20,인천광역시,남동구,구월3동,관내사전투표,3807,3807,2531,868,342,35,3,3779,28,0,66.97539031489812,22.969039428420217,9.050013231013496,0.9261709446943637,0.07938608097380259
21,인천광역시,남동구,구월3동,구월3동제1투,2238,1263,522,591,127,12,1,1253,10,975,41.66001596169194,47.16679968076616,10.135674381484437,0.9577015163607342,0.07980845969672785
22,인천광역시,남동구,구월3동,구월3동제2투,2363,1381,516,724,124,10,1,1375,6,982,37.527272727272724,52.654545454545456,9.018181818181818,0.7272727272727273,0.07272727272727272
23,인천광역시,남동구,구월3동,구월3동제3투,2858,1748,587,1003,126,18,4,1738,10,1110,33.77445339470656,57.71001150747986,7.249712313003452,1.0356731875719216,0.23014959723820483
24,인천광역시,남동구,구월3동,구월3동제4투,3893,2323,1052,909,305,32,3,2301,22,1570,45.71925249891351,39.50456323337679,13.255106475445459,1.3906996957844415,0.1303780964797914
25,인천광역시,남동구,구월3동,구월3동제5투,3704,2045,906,814,284,20,1,2025,20,1659,44.74074074074074,40.19753086419753,14.024691358024691,0.9876543209876543,0.04938271604938272
26,인천광역시,남동구,구월3동,구월3동제6투,3364,1835,740,861,192,28,1,1822,13,1529,40.61470911086718,47.25576289791438,10.53787047200878,1.5367727771679474,0.054884742041712405
27,인천광역시,남동구,구월4동,관내사전투표,2638,2638,1748,697,149,23,4,2621,17,0,66.69210225104922,26.592903471957268,5.684853109500191,0.877527661198016,0.15261350629530715
28,인천광역시,남동구,구월4동,구월4동제1투,1804,951,379,484,70,9,2,944,7,853,40.14830508474576,51.271186440677965,7.415254237288135,0.9533898305084746,0.211864406779661
29,인천광역시,남동구,구월4동,구월4동제2투,1718,994,396,525,60,10,1,992,2,724,39.91935483870967,52.923387096774185,6.048387096774194,1.0080645161290323,0.10080645161290322
30,인천광역시,남동구,구월4동,구월4동제3투,1786,1041,433,518,66,13,3,1033,8,745,41.91674733785092,50.14520813165537,6.389157792836399,1.2584704743465636,0.29041626331074544
31,인천광역시,남동구,구월4동,구월4동제4투,1707,986,366,526,77,11,1,981,5,721,37.308868501529055,53.61875637104995,7.8491335372069315,1.1213047910295617,0.10193679918450561
32,인천광역시,남동구,구월4동,구월4동제5투,1575,900,370,459,48,8,0,885,15,675,41.80790960451977,51.864406779661024,5.423728813559322,0.903954802259887,0.0
33,인천광역시,남동구,간석1동,관내사전투표,3558,3558,2306,923,265,34,2,3530,28,0,65.32577903682719,26.14730878186969,7.507082152974505,0.9631728045325779,0.05665722379603399
34,인천광역시,남동구,간석1동,간석1동제1투,2269,1388,512,732,114,13,2,1373,15,881,37.29060451565914,53.31391114348143,8.30298616168973,0.9468317552804079,0.14566642388929352
35,인천광역시,남동구,간석1동,간석1동제2투,1698,822,328,405,74,9,2,818,4,876,40.09779951100245,49.511002444987774,9.04645476772616,1.1002444987775062,0.24449877750611246
36,인천광역시,남동구,간석1동,간석1동제3투,2599,1745,699,883,132,17,2,1733,12,854,40.33467974610502,50.95210617426428,7.6168493941142525,0.9809578765147143,0.1154068090017311
37,인천광역시,남동구,간석1동,간석1동제4투,2243,1797,690,922,147,23,0,1782,15,446,38.72053872053872,51.73961840628507,8.24915824915825,1.2906846240179575,0.0
38,인천광역시,남동구,간석1동,간석1동제5투,2417,1711,696,846,145,15,2,1704,7,706,40.845070422535215,49.647887323943664,8.509389671361504,0.8802816901408451,0.11737089201877934
39,인천광역시,남동구,간석2동,관내사전투표,3015,3015,1936,804,212,27,5,2984,31,0,64.87935656836461,26.943699731903486,7.104557640750671,0.9048257372654156,0.1675603217158177
40,인천광역시,남동구,간석2동,간석2동제1투,2962,1543,559,836,123,15,3,1536,7,1419,36.39322916666667,54.427083333333336,8.0078125,0.9765625,0.1953125
41,인천광역시,남동구,간석2동,간석2동제2투,2457,1413,570,722,97,11,1,1401,12,1044,40.68522483940043,51.53461812990721,6.923625981441828,0.7851534618129907,0.07137758743754462
42,인천광역시,남동구,간석2동,간석2동제3투,2809,2117,803,1113,164,21,4,2105,12,692,38.14726840855107,52.87410926365796,7.790973871733967,0.9976247030878859,0.19002375296912113
43,인천광역시,남동구,간석2동,간석2동제4투,2101,1666,685,825,130,18,0,1658,8,435,41.31483715319662,49.758745476477685,7.840772014475271,1.0856453558504222,0.0
44,인천광역시,남동구,간석2동,간석2동제5투,2034,1604,673,775,127,19,1,1595,9,430,42.194357366771165,48.589341692789965,7.962382445141065,1.1912225705329154,0.06269592476489029
45,인천광역시,남동구,간석3동,관내사전투표,3898,3898,2630,1010,191,35,3,3869,29,0,67.97622124579995,26.10493667614371,4.936676143706384,0.9046265184802273,0.07753941586973379
46,인천광역시,남동구,간석3동,간석3동제1투,3693,1977,908,861,163,22,2,1956,21,1716,46.421267893660534,44.01840490797546,8.333333333333332,1.1247443762781186,0.10224948875255625
47,인천광역시,남동구,간석3동,간석3동제2투,3053,2192,971,996,177,25,1,2170,22,861,44.74654377880184,45.89861751152074,8.15668202764977,1.1520737327188941,0.04608294930875576
48,인천광역시,남동구,간석3동,간석3동제3투,2281,1235,489,613,99,22,2,1225,10,1046,39.91836734693878,50.04081632653061,8.081632653061224,1.7959183673469388,0.163265306122449
49,인천광역시,남동구,간석3동,간석3동제4투,2211,1516,669,709,106,19,4,1507,9,695,44.39283344392834,47.04711347047114,7.033842070338421,1.26078301260783,0.26542800265428
50,인천광역시,남동구,간석3동,간석3동제5투,3515,2159,944,1019,156,21,4,2144,15,1356,44.02985074626866,47.52798507462687,7.276119402985075,0.9794776119402986,0.18656716417910446
51,인천광역시,남동구,간석3동,간석3동제6투,1131,774,311,412,37,6,1,767,7,357,40.547588005215125,53.71577574967405,4.823989569752282,0.7822685788787485,0.1303780964797914
52,인천광역시,남동구,간석4동,관내사전투표,3353,3353,2245,857,207,24,3,3336,17,0,67.29616306954436,25.689448441247002,6.205035971223022,0.7194244604316548,0.08992805755395684
53,인천광역시,남동구,간석4동,간석4동제1투,2151,1218,412,686,98,7,1,1204,14,933,34.21926910299003,56.97674418604651,8.13953488372093,0.5813953488372093,0.08305647840531562
54,인천광역시,남동구,간석4동,간석4동제2투,4778,2665,1150,1222,242,22,3,2639,26,2113,43.577112542629784,46.30541871921182,9.170140204622964,0.8336491095111784,0.11367942402425162
55,인천광역시,남동구,간석4동,간석4동제3투,2793,1996,742,1078,136,22,2,1980,16,797,37.474747474747474,54.44444444444444,6.8686868686868685,1.1111111111111112,0.10101010101010101
56,인천광역시,남동구,간석4동,간석4동제4투,2408,1857,753,928,143,18,4,1846,11,551,40.79089924160347,50.27085590465872,7.746478873239436,0.9750812567713976,0.21668472372697722
57,인천광역시,남동구,간석4동,간석4동제5투,2693,1703,819,725,124,19,3,1690,13,990,48.46153846153846,42.89940828402367,7.337278106508875,1.1242603550295858,0.17751479289940827
58,인천광역시,남동구,간석4동,간석4동제6투,2628,1943,882,879,152,20,1,1934,9,685,45.60496380558428,45.44984488107549,7.859358841778697,1.0341261633919339,0.0517063081695967
59,인천광역시,남동구,만수1동,관내사전투표,3610,3610,2269,1027,236,43,7,3582,28,0,63.344500279173644,28.671133445002795,6.588498045784479,1.2004466778336125,0.1954215522054718
60,인천광역시,남동구,만수1동,만수1동제1투,2171,1449,572,723,120,14,4,1433,16,722,39.91625959525471,50.453593859036985,8.37404047452896,0.9769713886950453,0.2791346824842987
61,인천광역시,남동구,만수1동,만수1동제2투,2699,1801,788,849,130,11,2,1780,21,898,44.26966292134831,47.69662921348314,7.303370786516854,0.6179775280898876,0.11235955056179776
62,인천광역시,남동구,만수1동,만수1동제3투,2073,1237,477,658,76,11,2,1224,13,836,38.970588235294116,53.75816993464052,6.209150326797386,0.8986928104575163,0.16339869281045752
63,인천광역시,남동구,만수1동,만수1동제4투,1398,814,315,444,35,3,2,799,15,584,39.424280350438046,55.56946182728411,4.380475594493117,0.37546933667083854,0.2503128911138924
64,인천광역시,남동구,만수1동,만수1동제5투,1508,1037,442,495,80,12,1,1030,7,471,42.9126213592233,48.05825242718447,7.766990291262135,1.1650485436893203,0.0970873786407767
65,인천광역시,남동구,만수2동,관내사전투표,4917,4917,3371,1165,295,41,6,4878,39,0,69.10619106191062,23.882738827388277,6.047560475604756,0.8405084050840509,0.12300123001230012
66,인천광역시,남동구,만수2동,만수2동제1투,1842,1175,536,539,73,14,4,1166,9,667,45.96912521440824,46.22641509433962,6.260720411663807,1.2006861063464835,0.34305317324185247
67,인천광역시,남동구,만수2동,만수2동제2투,2144,1296,585,597,87,15,1,1285,11,848,45.525291828793776,46.459143968871594,6.770428015564202,1.1673151750972763,0.07782101167315175
68,인천광역시,남동구,만수2동,만수2동제3투,2401,1627,707,791,100,18,3,1619,8,774,43.66893143915998,48.857319332921556,6.176652254478073,1.1117974058060531,0.1852995676343422
69,인천광역시,남동구,만수2동,만수2동제4투,1594,1014,416,494,86,9,1,1006,8,580,41.35188866799205,49.10536779324055,8.548707753479125,0.8946322067594433,0.09940357852882703
70,인천광역시,남동구,만수2동,만수2동제5투,2182,1629,718,734,144,17,3,1616,13,553,44.43069306930693,45.42079207920792,8.91089108910891,1.051980198019802,0.18564356435643564
71,인천광역시,남동구,만수2동,만수2동제6투,2593,2006,898,921,152,19,1,1991,15,587,45.10296333500754,46.25816172777499,7.634354595680562,0.9542943244600702,0.05022601707684581
72,인천광역시,남동구,만수3동,관내사전투표,3995,3994,2677,998,263,35,2,3975,19,1,67.34591194968553,25.106918238993707,6.616352201257862,0.8805031446540881,0.05031446540880503
73,인천광역시,남동구,만수3동,만수3동제1투,2467,1600,648,792,122,20,4,1586,14,867,40.85750315258512,49.93694829760403,7.6923076923076925,1.2610340479192939,0.25220680958385877
74,인천광역시,남동구,만수3동,만수3동제2투,1400,801,335,391,62,6,0,794,7,599,42.19143576826197,49.24433249370277,7.8085642317380355,0.7556675062972292,0.0
75,인천광역시,남동구,만수3동,만수3동제3투,2196,1259,533,613,91,11,3,1251,8,937,42.60591526778577,49.00079936051159,7.274180655475619,0.8792965627498002,0.2398081534772182
76,인천광역시,남동구,만수3동,만수3동제4투,3302,2474,1075,1143,209,25,6,2458,16,828,43.734743694060214,46.501220504475185,8.502847843775427,1.017087062652563,0.24410089503661514
77,인천광역시,남동구,만수4동,관내사전투표,4649,4649,2938,1363,277,43,3,4624,25,0,63.53806228373703,29.476643598615915,5.990484429065744,0.9299307958477508,0.06487889273356401
78,인천광역시,남동구,만수4동,만수4동제1투,1578,954,350,511,70,8,1,940,14,624,37.234042553191486,54.36170212765957,7.446808510638298,0.851063829787234,0.10638297872340426
79,인천광역시,남동구,만수4동,만수4동제2투,1840,1330,507,685,113,12,1,1318,12,510,38.46737481031867,51.97268588770865,8.573596358118362,0.9104704097116844,0.07587253414264036
80,인천광역시,남동구,만수4동,만수4동제3투,1832,1197,454,639,82,11,1,1187,10,635,38.24768323504634,53.833192923336135,6.908171861836562,0.9267059814658803,0.08424599831508003
81,인천광역시,남동구,만수4동,만수4동제4투,2053,1420,592,673,127,12,3,1407,13,633,42.07533759772566,47.83226723525231,9.026297085998578,0.8528784648187633,0.21321961620469082
82,인천광역시,남동구,만수4동,만수4동제5투,1467,949,372,497,68,7,3,947,2,518,39.281942977824706,52.48152059134108,7.1805702217529035,0.7391763463569165,0.31678986272439286
83,인천광역시,남동구,만수4동,만수4동제6투,1489,993,415,494,69,11,2,991,2,496,41.87689202825429,49.848637739656915,6.962663975782038,1.109989909182644,0.20181634712411706
84,인천광역시,남동구,만수5동,관내사전투표,2694,2694,1824,712,117,24,5,2682,12,0,68.0089485458613,26.547352721849364,4.3624161073825505,0.8948545861297539,0.18642803877703207
85,인천광역시,남동구,만수5동,만수5동제1투,2269,1345,523,697,100,15,1,1336,9,924,39.14670658682635,52.17065868263473,7.48502994011976,1.122754491017964,0.07485029940119761
86,인천광역시,남동구,만수5동,만수5동제2투,2745,1966,760,1038,136,20,0,1954,12,779,38.89457523029683,53.12180143295804,6.960081883316274,1.023541453428864,0.0
87,인천광역시,남동구,만수5동,만수5동제3투,2053,1135,472,564,82,7,3,1128,7,918,41.843971631205676,50.0,7.2695035460992905,0.6205673758865249,0.26595744680851063
88,인천광역시,남동구,만수5동,만수5동제4투,2275,1379,550,693,106,14,3,1366,13,896,40.26354319180088,50.73206442166911,7.759882869692533,1.0248901903367496,0.21961932650073207
89,인천광역시,남동구,만수6동,관내사전투표,5048,5048,3311,1273,353,68,3,5008,40,0,66.11421725239617,25.419329073482427,7.048722044728435,1.3578274760383386,0.05990415335463259
90,인천광역시,남동구,만수6동,만수6동제1투,2086,1321,487,708,98,14,3,1310,11,765,37.17557251908397,54.045801526717554,7.480916030534352,1.0687022900763359,0.22900763358778628
91,인천광역시,남동구,만수6동,만수6동제2투,2164,1559,672,757,104,13,0,1546,13,605,43.46701164294955,48.965071151358345,6.727037516170762,0.8408796895213453,0.0
92,인천광역시,남동구,만수6동,만수6동제3투,2321,1569,612,810,117,16,0,1555,14,752,39.356913183279744,52.09003215434084,7.52411575562701,1.0289389067524115,0.0
93,인천광역시,남동구,만수6동,만수6동제4투,2530,1929,800,930,163,24,1,1918,11,601,41.71011470281543,48.488008342022944,8.498435870698644,1.251303441084463,0.05213764337851929
94,인천광역시,남동구,만수6동,만수6동제5투,2495,1640,707,790,110,21,2,1630,10,855,43.374233128834355,48.466257668711656,6.748466257668712,1.2883435582822087,0.1226993865030675
95,인천광역시,남동구,만수6동,만수6동제6투,2253,1687,638,906,121,13,1,1679,8,566,37.9988088147707,53.960690887432996,7.206670637284097,0.7742703990470519,0.05955926146515784
96,인천광역시,남동구,장수서창동,관내사전투표,3736,3736,2518,946,219,33,5,3721,15,0,67.66998118785273,25.423273313625373,5.885514646600376,0.8868583714055361,0.13437248051599032
97,인천광역시,남동구,장수서창동,장수서창동제1투,3231,2181,780,1233,135,21,0,2169,12,1050,35.9612724757953,56.84647302904564,6.224066390041494,0.9681881051175657,0.0
98,인천광역시,남동구,장수서창동,장수서창동제2투,183,133,23,102,7,0,0,132,1,50,17.424242424242426,77.27272727272727,5.303030303030303,0.0,0.0
99,인천광역시,남동구,장수서창동,장수서창동제3투,3287,2233,831,1233,134,22,5,2225,8,1054,37.348314606741575,55.41573033707865,6.02247191011236,0.9887640449438202,0.22471910112359553
100,인천광역시,남동구,장수서창동,장수서창동제4투,1882,1440,602,726,93,14,2,1437,3,442,41.892832289492,50.52192066805845,6.471816283924843,0.9742519137091163,0.13917884481558804
101,인천광역시,남동구,장수서창동,장수서창동제5투,1863,1320,556,634,108,12,1,1311,9,543,42.41037376048818,48.36003051106026,8.237986270022883,0.9153318077803204,0.07627765064836003
102,인천광역시,남동구,서창2동,관내사전투표,6854,6854,4901,1424,441,54,2,6822,32,0,71.84110231603636,20.873644092641456,6.464379947229551,0.79155672823219,0.02931691586045148
103,인천광역시,남동구,서창2동,서창2동제1투,2821,2031,958,866,178,24,3,2029,2,790,47.21537703302119,42.681123706259235,8.772794480039428,1.1828486939379004,0.14785608674223755
104,인천광역시,남동구,서창2동,서창2동제2투,1971,1401,587,716,81,11,0,1395,6,570,42.078853046594986,51.32616487455197,5.806451612903226,0.7885304659498209,0.0
105,인천광역시,남동구,서창2동,서창2동제3투,3153,2323,1197,876,211,23,0,2307,16,830,51.88556566970091,37.971391417425224,9.146077156480278,0.9969657563935848,0.0
106,인천광역시,남동구,서창2동,서창2동제4투,3167,2427,1207,968,214,20,4,2413,14,740,50.02072109407377,40.116038126813095,8.868628263572315,0.8288437629506838,0.16576875259013676
107,인천광역시,남동구,서창2동,서창2동제5투,1779,1447,719,583,113,20,2,1437,10,332,50.0347947112039,40.57063326374391,7.8636047320807245,1.3917884481558804,0.13917884481558804
108,인천광역시,남동구,서창2동,서창2동제6투,2766,1961,880,929,129,14,1,1953,8,805,45.05888376856119,47.56784434203789,6.605222734254992,0.7168458781362007,0.051203277009728626
109,인천광역시,남동구,서창2동,서창2동제7투,1415,950,439,426,70,12,0,947,3,465,46.356916578669484,44.98416050686378,7.391763463569166,1.2671594508975714,0.0
110,인천광역시,남동구,서창2동,서창2동제8투,2607,1952,892,837,190,16,3,1938,14,655,46.02683178534572,43.188854489164086,9.803921568627452,0.8255933952528379,0.15479876160990713
111,인천광역시,남동구,남촌도림동,관내사전투표,3008,3008,1980,806,190,19,1,2996,12,0,66.08811748998666,26.90253671562083,6.341789052069426,0.6341789052069425,0.03337783711615487
112,인천광역시,남동구,남촌도림동,남촌도림동제1투,1545,829,290,463,63,5,2,823,6,716,35.236938031591734,56.25759416767922,7.654921020656136,0.6075334143377886,0.24301336573511542
113,인천광역시,남동구,남촌도림동,남촌도림동제2투,2036,1238,510,586,106,18,4,1224,14,798,41.66666666666667,47.875816993464056,8.660130718954248,1.4705882352941175,0.32679738562091504
114,인천광역시,남동구,남촌도림동,남촌도림동제3투,2523,1590,632,816,114,10,4,1576,14,933,40.10152284263959,51.776649746192895,7.233502538071066,0.6345177664974619,0.25380710659898476
115,인천광역시,남동구,남촌도림동,남촌도림동제4투,3349,2258,1039,990,181,34,2,2246,12,1091,46.260017809439006,44.078361531611755,8.058771148708816,1.5138023152270703,0.08904719501335707
116,인천광역시,남동구,남촌도림동,남촌도림동제5투,2316,1770,752,863,114,24,4,1757,13,546,42.80022766078543,49.117814456459875,6.488332384746727,1.3659647125782584,0.22766078542970974
117,인천광역시,남동구,남촌도림동,남촌도림동제6투,328,217,52,156,7,1,1,217,0,111,23.963133640552993,71.88940092165899,3.225806451612903,0.4608294930875576,0.4608294930875576
118,인천광역시,남동구,논현1동,관내사전투표,5895,5895,4107,1351,349,54,4,5865,30,0,70.02557544757033,23.034953111679453,5.950554134697357,0.9207161125319693,0.06820119352088662
119,인천광역시,남동구,논현1동,논현1동제1투,2042,1295,589,563,120,15,2,1289,6,747,45.69433669511249,43.67726920093095,9.309542280837858,1.1636927851047323,0.1551590380139643
120,인천광역시,남동구,논현1동,논현1동제2투,3466,2043,897,921,202,9,3,2032,11,1423,44.14370078740157,45.3248031496063,9.940944881889765,0.44291338582677164,0.14763779527559054
121,인천광역시,남동구,논현1동,논현1동제3투,3487,2557,1142,1169,205,29,1,2546,11,930,44.85467399842891,45.91516103692066,8.05184603299293,1.1390416339355853,0.03927729772191674
122,인천광역시,남동구,논현1동,논현1동제4투,2043,1267,474,680,88,12,0,1254,13,776,37.79904306220095,54.22647527910686,7.017543859649122,0.9569377990430622,0.0
123,인천광역시,남동구,논현1동,논현1동제5투,1861,1260,503,634,98,14,1,1250,10,601,40.239999999999995,50.72,7.84,1.1199999999999999,0.08
124,인천광역시,남동구,논현1동,논현1동제6투,2609,2019,921,895,170,19,0,2005,14,590,45.93516209476309,44.63840399002494,8.478802992518704,0.9476309226932668,0.0
125,인천광역시,남동구,논현1동,논현1동제7투,2102,1526,649,747,112,8,1,1517,9,576,42.78180619644034,49.24192485168095,7.382992748846408,0.5273566249176005,0.06591957811470006
126,인천광역시,남동구,논현2동,관내사전투표,5935,5935,4057,1366,428,49,0,5900,35,0,68.76271186440678,23.152542372881356,7.2542372881355925,0.8305084745762711,0.0
127,인천광역시,남동구,논현2동,논현2동제1투,2536,1423,542,727,118,15,2,1404,19,1113,38.603988603988604,51.78062678062678,8.404558404558404,1.0683760683760684,0.14245014245014245
128,인천광역시,남동구,논현2동,논현2동제2투,1906,1410,490,767,129,17,1,1404,6,496,34.9002849002849,54.629629629629626,9.18803418803419,1.2108262108262107,0.07122507122507123
129,인천광역시,남동구,논현2동,논현2동제3투,2124,1440,516,788,113,13,2,1432,8,684,36.03351955307262,55.02793296089386,7.8910614525139655,0.9078212290502794,0.13966480446927373
130,인천광역시,남동구,논현2동,논현2동제4투,3509,2322,1015,1063,201,19,4,2302,20,1187,44.09209383145091,46.17723718505648,8.731537793223284,0.8253692441355343,0.1737619461337967
131,인천광역시,남동구,논현2동,논현2동제5투,3712,2527,1149,1127,202,30,2,2510,17,1185,45.776892430278885,44.90039840637451,8.047808764940239,1.1952191235059761,0.0796812749003984
132,인천광역시,남동구,논현2동,논현2동제6투,1919,1424,684,617,96,15,3,1415,9,495,48.339222614840985,43.60424028268552,6.784452296819787,1.0600706713780919,0.21201413427561835
133,인천광역시,남동구,논현2동,논현2동제7투,2048,1528,716,662,115,26,1,1520,8,520,47.10526315789474,43.55263157894737,7.565789473684211,1.710526315789474,0.06578947368421052
134,인천광역시,남동구,논현2동,논현2동제8투,1244,781,324,374,70,5,0,773,8,463,41.91461836998706,48.38292367399741,9.055627425614489,0.646830530401035,0.0
135,인천광역시,남동구,논현고잔동,관내사전투표,8542,8542,5862,1900,641,90,7,8500,42,0,68.96470588235294,22.35294117647059,7.541176470588236,1.0588235294117647,0.08235294117647059
136,인천광역시,남동구,논현고잔동,논현고잔동제1투,2251,1603,694,750,135,14,1,1594,9,648,43.53826850690088,47.05144291091594,8.469259723964868,0.8782936010037641,0.06273525721455457
137,인천광역시,남동구,논현고잔동,논현고잔동제2투,3486,2050,833,1014,164,24,3,2038,12,1436,40.873405299313056,49.75466143277723,8.04710500490677,1.1776251226692835,0.14720314033366044
138,인천광역시,남동구,논현고잔동,논현고잔동제3투,3304,2373,1055,1028,247,35,1,2366,7,931,44.59002535925613,43.44885883347422,10.43956043956044,1.4792899408284024,0.042265426880811495
139,인천광역시,남동구,논현고잔동,논현고잔동제4투,2631,1991,960,801,194,24,4,1983,8,640,48.41149773071105,40.39334341906203,9.78315683308119,1.2102874432677762,0.2017145738779627
140,인천광역시,남동구,논현고잔동,논현고잔동제5투,3685,2670,971,1489,180,24,1,2665,5,1015,36.43527204502814,55.87242026266417,6.75422138836773,0.900562851782364,0.0375234521575985
141,인천광역시,남동구,논현고잔동,논현고잔동제6투,2737,2185,1014,938,192,28,1,2173,12,552,46.66359871145882,43.16612977450529,8.83571099861942,1.2885411872986654,0.04601932811780948
142,인천광역시,남동구,논현고잔동,논현고잔동제7투,2116,1660,768,751,127,6,0,1652,8,456,46.48910411622276,45.460048426150124,7.687651331719128,0.36319612590799033,0.0
143,인천광역시,남동구,논현고잔동,논현고잔동제8투,483,245,68,164,10,0,1,243,2,238,27.983539094650205,67.48971193415639,4.11522633744856,0.0,0.411522633744856
144,인천광역시,남동구,잘못 투입·구분된 투표지,,0,0,0,0,0,0,0,0,0,0,0.0,0.0,0.0,0.0,0.0
0,인천광역시,부평구,거소·선상투표,,668,628,285,196,128,4,1,614,14,40,46.416938110749186,31.921824104234524,20.846905537459286,0.6514657980456027,0.16286644951140067
1,인천광역시,부평구,관외사전투표,,40255,40241,24886,9198,5248,488,53,39873,368,14,62.41316178867906,23.068241667293655,13.161788679056002,1.223885837534171,0.13292202743711284
2,인천광역시,부평구,재외투표,,2040,1674,1188,307,143,23,2,1663,11,366,71.4371617558629,18.46061334936861,8.598917618761275,1.3830426939266387,0.12026458208057728
3,인천광역시,부평구,부평1동,관내사전투표,7382,7382,4676,1985,599,66,8,7334,48,0,63.75784019634578,27.06572129806381,8.167439323697847,0.8999181892555222,0.109080992637033
4,인천광역시,부평구,부평1동,부평1동제1투,2156,1367,479,738,125,15,1,1358,9,789,35.272459499263626,54.34462444771723,9.204712812960237,1.1045655375552283,0.07363770250368189
5,인천광역시,부평구,부평1동,부평1동제2투,3139,1480,601,634,207,16,4,1462,18,1659,41.10807113543092,43.365253077975375,14.158686730506156,1.094391244870041,0.27359781121751026
6,인천광역시,부평구,부평1동,부평1동제3투,2260,1721,595,988,115,13,0,1711,10,539,34.7749853886616,57.74400935125657,6.721215663354762,0.7597895967270601,0.0
7,인천광역시,부평구,부평1동,부평1동제4투,2413,1726,618,937,140,20,0,1715,11,687,36.034985422740526,54.63556851311954,8.16326530612245,1.1661807580174928,0.0
8,인천광역시,부평구,부평1동,부평1동제5투,2516,1872,857,854,124,17,5,1857,15,644,46.14970382337103,45.98815293484114,6.677436725901992,0.9154550350026925,0.2692514808831448
9,인천광역시,부평구,부평1동,부평1동제6투,2315,1782,717,875,149,29,4,1774,8,533,40.41713641488162,49.32356257046223,8.399098083427283,1.6347237880496055,0.2254791431792559
10,인천광역시,부평구,부평1동,부평1동제7투,2953,1729,737,796,174,11,2,1720,9,1224,42.848837209302324,46.27906976744186,10.116279069767442,0.6395348837209303,0.11627906976744186
11,인천광역시,부평구,부평1동,부평1동제8투,3188,1891,767,901,179,24,4,1875,16,1297,40.906666666666666,48.053333333333335,9.546666666666667,1.28,0.21333333333333335
12,인천광역시,부평구,부평2동,관내사전투표,3458,3458,2314,849,232,39,2,3436,22,0,67.34575087310827,24.70896391152503,6.752037252619325,1.1350407450523865,0.05820721769499418
13,인천광역시,부평구,부평2동,부평2동제1투,2315,1423,544,725,132,11,1,1413,10,892,38.49964614295824,51.30927105449399,9.341825902335456,0.778485491861288,0.07077140835102619
14,인천광역시,부평구,부평2동,부평2동제2투,2444,1551,688,719,112,19,3,1541,10,893,44.64633354964309,46.658014276443865,7.268007787151201,1.2329656067488644,0.1946787800129786
15,인천광역시,부평구,부평2동,부평2동제3투,1699,1017,430,474,90,10,0,1004,13,682,42.82868525896414,47.211155378486055,8.964143426294822,0.9960159362549801,0.0
16,인천광역시,부평구,부평2동,부평2동제4투,2074,1281,551,592,105,21,2,1271,10,793,43.35169158143194,46.57749803304485,8.261211644374509,1.6522423288749015,0.15735641227380015
17,인천광역시,부평구,부평2동,부평2동제5투,1419,1094,454,468,151,13,1,1087,7,325,41.766329346826126,43.054277828886846,13.891444342226311,1.1959521619135236,0.09199632014719411
18,인천광역시,부평구,부평3동,관내사전투표,3320,3320,2073,922,254,45,2,3296,24,0,62.89441747572816,27.973300970873787,7.70631067961165,1.3652912621359223,0.06067961165048543
19,인천광역시,부평구,부평3동,부평3동제1투,2423,1368,502,755,87,12,0,1356,12,1055,37.02064896755162,55.67846607669617,6.415929203539823,0.8849557522123894,0.0
20,인천광역시,부평구,부평3동,부평3동제2투,1917,1412,589,646,143,18,1,1397,15,505,42.161775232641375,46.24194702934861,10.236220472440944,1.288475304223336,0.07158196134574087
21,인천광역시,부평구,부평3동,부평3동제3투,2853,1778,779,833,123,29,0,1764,14,1075,44.1609977324263,47.22222222222222,6.972789115646258,1.6439909297052153,0.0
22,인천광역시,부평구,부평3동,부평3동제4투,1647,1025,395,540,66,10,0,1011,14,622,39.0702274975272,53.41246290801187,6.528189910979229,0.9891196834817012,0.0
23,인천광역시,부평구,부평4동,관내사전투표,6842,6841,4725,1369,614,80,5,6793,48,1,69.5568968055351,20.153098778153982,9.038716325629323,1.177682908876785,0.07360518180479907
24,인천광역시,부평구,부평4동,부평4동제1투,4283,2401,1096,1032,227,21,4,2380,21,1882,46.05042016806723,43.36134453781513,9.53781512605042,0.8823529411764706,0.16806722689075632
25,인천광역시,부평구,부평4동,부평4동제2투,2678,1628,807,681,111,12,0,1611,17,1050,50.09310986964618,42.27188081936685,6.890130353817504,0.74487895716946,0.0
26,인천광역시,부평구,부평4동,부평4동제3투,2430,1641,660,803,149,16,2,1630,11,789,40.49079754601227,49.263803680981596,9.141104294478527,0.98159509202454,0.1226993865030675
27,인천광역시,부평구,부평4동,부평4동제4투,2094,1317,587,599,110,10,3,1309,8,777,44.84339190221543,45.760122230710465,8.403361344537815,0.7639419404125287,0.2291825821237586
28,인천광역시,부평구,부평4동,부평4동제5투,2508,1549,633,774,120,11,0,1538,11,959,41.15734720416125,50.32509752925878,7.802340702210664,0.7152145643693107,0.0
29,인천광역시,부평구,부평4동,부평4동제6투,2486,1492,743,598,123,17,1,1482,10,994,50.13495276653172,40.35087719298245,8.299595141700406,1.1470985155195683,0.06747638326585695
30,인천광역시,부평구,부평4동,부평4동제7투,2695,1646,779,675,159,20,2,1635,11,1049,47.64525993883792,41.284403669724774,9.724770642201836,1.2232415902140672,0.12232415902140673
31,인천광역시,부평구,부평4동,부평4동제8투,2168,1217,570,503,118,12,2,1205,12,951,47.30290456431535,41.74273858921162,9.792531120331951,0.9958506224066389,0.16597510373443983
32,인천광역시,부평구,부평5동,관내사전투표,5297,5296,3727,1112,358,51,4,5252,44,1,70.96344249809596,21.172886519421173,6.816450875856816,0.971058644325971,0.07616146230007616
33,인천광역시,부평구,부평5동,부평5동제1투,4034,1956,894,842,183,23,3,1945,11,2078,45.96401028277635,43.290488431876604,9.408740359897172,1.1825192802056554,0.15424164524421594
34,인천광역시,부평구,부평5동,부평5동제2투,3983,2395,1225,937,199,20,1,2382,13,1588,51.42737195633921,39.336691855583545,8.354324097397145,0.8396305625524769,0.041981528127623846
35,인천광역시,부평구,부평5동,부평5동제3투,4605,2656,1239,1124,221,40,3,2627,29,1949,47.16406547392463,42.78644842025124,8.41263799010278,1.5226494099733536,0.11419870574800152
36,인천광역시,부평구,부평5동,부평5동제4투,3187,1763,789,779,159,22,1,1750,13,1424,45.08571428571428,44.51428571428571,9.085714285714285,1.2571428571428571,0.05714285714285715
37,인천광역시,부평구,부평5동,부평5동제5투,3893,2556,1223,1052,237,27,2,2541,15,1337,48.13065722156632,41.40102321920504,9.327036599763874,1.062573789846517,0.07870916961826052
38,인천광역시,부평구,부평6동,관내사전투표,4790,4790,3130,1179,390,53,2,4754,36,0,65.83929322675641,24.80016827934371,8.203618005889778,1.1148506520824568,0.04206983592763988
39,인천광역시,부평구,부평6동,부평6동제1투,2400,1657,698,726,196,22,5,1647,10,743,42.38008500303582,44.080145719489984,11.900425015179113,1.3357619914996965,0.3035822707953855
40,인천광역시,부평구,부평6동,부평6동제2투,2792,1752,761,803,140,20,6,1730,22,1040,43.98843930635838,46.41618497109827,8.092485549132949,1.1560693641618496,0.3468208092485549
41,인천광역시,부평구,부평6동,부평6동제3투,2761,1634,706,735,162,15,0,1618,16,1127,43.63411619283066,45.42645241038319,10.012360939431398,0.9270704573547589,0.0
42,인천광역시,부평구,부평6동,부평6동제4투,2544,1715,760,782,137,17,3,1699,16,829,44.732195409064154,46.02707474985285,8.063566804002354,1.0005885815185402,0.17657445556209533
43,인천광역시,부평구,산곡1동,관내사전투표,2101,2101,1391,495,185,16,2,2089,12,0,66.58688367640019,23.69554810914313,8.855911919578746,0.7659167065581618,0.09573958831977022
44,인천광역시,부평구,산곡1동,산곡1동제1투,2209,1455,632,634,156,17,3,1442,13,754,43.828016643550626,43.96671289875174,10.818307905686545,1.1789181692094313,0.20804438280166435
45,인천광역시,부평구,산곡1동,산곡1동제2투,2673,1982,848,929,166,22,4,1969,13,691,43.0675469781615,47.18131030980193,8.430675469781615,1.1173184357541899,0.20314880650076178
46,인천광역시,부평구,산곡1동,산곡1동제3투,1432,945,361,498,69,12,0,940,5,487,38.40425531914894,52.97872340425533,7.340425531914893,1.276595744680851,0.0
47,인천광역시,부평구,산곡1동,산곡1동제4투,2223,1532,666,681,152,17,0,1516,16,691,43.931398416886545,44.92084432717678,10.026385224274406,1.121372031662269,0.0
48,인천광역시,부평구,산곡2동,관내사전투표,4427,4426,2964,1068,317,45,5,4399,27,1,67.37894976130939,24.278245055694477,7.2061832234598775,1.0229597635826324,0.11366219595362581
49,인천광역시,부평구,산곡2동,산곡2동제1투,2325,1666,705,786,135,26,4,1656,10,659,42.572463768115945,47.46376811594203,8.152173913043478,1.570048309178744,0.24154589371980675
50,인천광역시,부평구,산곡2동,산곡2동제2투,1997,1482,644,681,121,20,0,1466,16,515,43.92905866302865,46.45293315143247,8.2537517053206,1.364256480218281,0.0
51,인천광역시,부평구,산곡2동,산곡2동제3투,3114,2233,957,1067,171,26,0,2221,12,881,43.08869878433138,48.04142278253039,7.69923457901846,1.170643854119766,0.0
52,인천광역시,부평구,산곡2동,산곡2동제4투,3015,2196,907,1079,167,19,3,2175,21,819,41.701149425287355,49.60919540229885,7.678160919540229,0.8735632183908045,0.13793103448275862
53,인천광역시,부평구,산곡2동,산곡2동제5투,2832,2074,919,950,169,25,3,2066,8,758,44.48209099709584,45.98257502420135,8.18005808325266,1.2100677637947725,0.14520813165537272
54,인천광역시,부평구,산곡2동,산곡2동제6투,2912,2133,1007,924,156,24,1,2112,21,779,47.67992424242424,43.75,7.386363636363637,1.1363636363636365,0.04734848484848485
55,인천광역시,부평구,산곡3동,관내사전투표,4477,4477,2837,1298,258,52,7,4452,25,0,63.72416891284816,29.155435759209343,5.795148247978436,1.1680143755615455,0.15723270440251574
56,인천광역시,부평구,산곡3동,산곡3동제1투,2393,1677,565,946,123,26,2,1662,15,716,33.99518652226233,56.919374247894105,7.400722021660649,1.5643802647412757,0.12033694344163659
57,인천광역시,부평구,산곡3동,산곡3동제2투,2891,2019,709,1125,148,21,4,2007,12,872,35.32635774788241,56.05381165919282,7.37419033383159,1.046337817638266,0.1993024414549078
58,인천광역시,부평구,산곡3동,산곡3동제3투,2614,1786,663,979,108,23,2,1775,11,828,37.352112676056336,55.154929577464785,6.084507042253521,1.295774647887324,0.11267605633802817
59,인천광역시,부평구,산곡3동,산곡3동제4투,2000,1499,444,943,87,15,1,1490,9,501,29.798657718120808,63.28859060402685,5.838926174496644,1.006711409395973,0.06711409395973154
60,인천광역시,부평구,산곡3동,산곡3동제5투,1787,1190,432,651,79,14,2,1178,12,597,36.6723259762309,55.26315789473685,6.706281833616298,1.1884550084889642,0.1697792869269949
61,인천광역시,부평구,산곡4동,관내사전투표,5843,5843,3944,1381,415,61,4,5805,38,0,67.94142980189491,23.789836347975882,7.14900947459087,1.0508182601205858,0.06890611541774332
62,인천광역시,부평구,산곡4동,산곡4동제1투,2632,1929,832,900,162,16,1,1911,18,703,43.53741496598639,47.09576138147567,8.47723704866562,0.837257980115123,0.052328623757195186
63,인천광역시,부평구,산곡4동,산곡4동제2투,2146,1524,610,775,114,10,1,1510,14,622,40.397350993377486,51.324503311258276,7.549668874172186,0.6622516556291391,0.06622516556291391
64,인천광역시,부평구,산곡4동,산곡4동제3투,2579,1917,777,965,147,18,2,1909,8,662,40.70193818753274,50.55002619172342,7.7003666841278156,0.9429020429544265,0.10476689366160294
65,인천광역시,부평구,산곡4동,산곡4동제4투,2282,1666,650,834,145,21,2,1652,14,616,39.346246973365616,50.48426150121066,8.7772397094431,1.2711864406779663,0.12106537530266344
66,인천광역시,부평구,청천1동,관내사전투표,4488,4488,3099,962,357,42,2,4462,26,0,69.45316001792918,21.559838637382338,8.000896458987002,0.9412819363514119,0.04482294935006724
67,인천광역시,부평구,청천1동,청천1동제1투,3142,2073,950,890,192,24,2,2058,15,1069,46.16132167152575,43.245869776482024,9.329446064139942,1.1661807580174928,0.09718172983479105
68,인천광역시,부평구,청천1동,청천1동제2투,2705,1541,724,681,105,16,1,1527,14,1164,47.41322855271775,44.59724950884086,6.8762278978389,1.0478061558611658,0.06548788474132286
69,인천광역시,부평구,청천1동,청천1동제3투,2777,2068,929,880,224,18,1,2052,16,709,45.2729044834308,42.8849902534113,10.916179337231968,0.8771929824561403,0.04873294346978557
70,인천광역시,부평구,청천1동,청천1동제4투,3494,2697,1213,1153,271,32,6,2675,22,797,45.345794392523366,43.10280373831776,10.130841121495326,1.1962616822429906,0.22429906542056074
71,인천광역시,부평구,청천2동,관내사전투표,4866,4866,3177,1274,326,45,4,4826,40,0,65.83091587235806,26.398673849979282,6.755076668048073,0.9324492333195192,0.08288437629506838
72,인천광역시,부평구,청천2동,청천2동제1투,3231,1731,751,775,169,13,2,1710,21,1500,43.918128654970765,45.32163742690059,9.883040935672515,0.7602339181286549,0.11695906432748539
73,인천광역시,부평구,청천2동,청천2동제2투,3106,2092,834,1010,203,26,4,2077,15,1014,40.15406836783823,48.62782859894078,9.773712084737603,1.2518054886856043,0.19258545979778527
74,인천광역시,부평구,청천2동,청천2동제3투,2102,1530,662,707,134,22,0,1525,5,572,43.40983606557377,46.36065573770492,8.786885245901638,1.4426229508196722,0.0
75,인천광역시,부평구,청천2동,청천2동제4투,2110,1548,753,613,141,26,2,1535,13,562,49.05537459283388,39.93485342019544,9.185667752442997,1.6938110749185669,0.13029315960912052
76,인천광역시,부평구,청천2동,청천2동제5투,2131,1626,724,687,173,31,1,1616,10,505,44.801980198019805,42.51237623762376,10.705445544554456,1.9183168316831682,0.06188118811881188
77,인천광역시,부평구,청천2동,청천2동제6투,2113,1531,693,655,150,21,2,1521,10,582,45.562130177514796,43.0637738330046,9.861932938856016,1.3806706114398422,0.13149243918474687
78,인천광역시,부평구,청천2동,청천2동제7투,2123,1511,651,714,107,21,1,1494,17,612,43.57429718875502,47.791164658634536,7.161981258366801,1.4056224899598393,0.06693440428380187
79,인천광역시,부평구,청천2동,청천2동제8투,2468,1586,689,747,117,15,6,1574,12,882,43.77382465057179,47.45870393900889,7.433290978398984,0.9529860228716646,0.3811944091486658
80,인천광역시,부평구,갈산1동,관내사전투표,3797,3797,2561,907,275,28,3,3774,23,0,67.85903550609433,24.03285638579756,7.286698463169052,0.7419183889772125,0.0794912559618442
81,인천광역시,부평구,갈산1동,갈산1동제1투,1060,575,224,294,51,3,0,572,3,485,39.16083916083916,51.39860139860139,8.916083916083917,0.5244755244755245,0.0
82,인천광역시,부평구,갈산1동,갈산1동제2투,2873,1776,756,818,156,18,1,1749,27,1097,43.22469982847341,46.76958261863922,8.919382504288166,1.0291595197255576,0.05717552887364208
83,인천광역시,부평구,갈산1동,갈산1동제3투,2590,1684,697,813,147,16,0,1673,11,906,41.661685594739986,48.59533771667663,8.786610878661087,0.9563658099222951,0.0
84,인천광역시,부평구,갈산1동,갈산1동제4투,2043,1365,605,606,124,18,1,1354,11,678,44.68242245199409,44.75627769571639,9.15805022156573,1.329394387001477,0.07385524372230429
85,인천광역시,부평구,갈산2동,관내사전투표,4670,4670,2927,1380,288,47,4,4646,24,0,63.00043047783039,29.7029702970297,6.198880757640982,1.0116229014205769,0.08609556607834697
86,인천광역시,부평구,갈산2동,갈산2동제1투,2850,1914,772,961,153,13,2,1901,13,936,40.61020515518148,50.55234087322462,8.048395581273015,0.6838506049447659,0.10520778537611783
87,인천광역시,부평구,갈산2동,갈산2동제2투,1970,1291,565,609,87,16,0,1277,14,679,44.244322631166796,47.68989819890368,6.812842599843383,1.2529365700861395,0.0
88,인천광역시,부평구,갈산2동,갈산2동제3투,1975,1335,534,667,113,11,2,1327,8,640,40.241145440844015,50.263752825923135,8.51544837980407,0.8289374529012812,0.15071590052750566
89,인천광역시,부평구,갈산2동,갈산2동제4투,2857,1957,710,1049,150,25,3,1937,20,900,36.654620547238,54.15591120289107,7.743933918430562,1.2906556530717606,0.15487867836861124
90,인천광역시,부평구,삼산1동,관내사전투표,6571,6570,4669,1408,382,74,4,6537,33,1,71.42420070368671,21.538932231910664,5.843659170873489,1.132017745143032,0.06119014838610984
91,인천광역시,부평구,삼산1동,삼산1동제1투,2246,1333,559,655,95,11,1,1321,12,913,42.31642694928085,49.58364875094625,7.1915215745647245,0.8327024981074944,0.0757002271006813
92,인천광역시,부평구,삼산1동,삼산1동제2투,3001,2231,1000,1011,174,29,4,2218,13,770,45.08566275924256,45.58160504959423,7.8449053201082055,1.3074842200180343,0.18034265103697023
93,인천광역시,부평구,삼산1동,삼산1동제3투,2631,1750,772,794,143,25,1,1735,15,881,44.49567723342939,45.763688760806915,8.24207492795389,1.440922190201729,0.05763688760806917
94,인천광역시,부평구,삼산1동,삼산1동제4투,1589,1020,470,449,89,9,0,1017,3,569,46.214355948869226,44.14945919370698,8.751229105211406,0.8849557522123894,0.0
95,인천광역시,부평구,삼산1동,삼산1동제5투,1573,936,370,500,38,12,3,923,13,637,40.08667388949079,54.17118093174431,4.117009750812568,1.3001083423618636,0.3250270855904659
96,인천광역시,부평구,삼산1동,삼산1동제6투,2767,2008,927,882,166,18,1,1994,14,759,46.489468405215646,44.232698094282846,8.324974924774322,0.9027081243731194,0.05015045135406219
97,인천광역시,부평구,삼산1동,삼산1동제7투,2049,1473,742,561,147,17,2,1469,4,576,50.51055139550715,38.18924438393465,10.006807351940095,1.1572498298162015,0.13614703880190604
98,인천광역시,부평구,삼산1동,삼산1동제8투,2235,1586,718,694,140,22,0,1574,12,649,45.61626429479034,44.09148665819568,8.89453621346887,1.3977128335451081,0.0
99,인천광역시,부평구,삼산2동,관내사전투표,5900,5899,4121,1265,428,60,2,5876,23,1,70.13274336283186,21.528250510551395,7.283866575901975,1.0211027910142956,0.03403675970047651
100,인천광역시,부평구,삼산2동,삼산2동제1투,2550,1875,830,836,171,21,2,1860,15,675,44.623655913978496,44.946236559139784,9.193548387096774,1.129032258064516,0.10752688172043011
101,인천광역시,부평구,삼산2동,삼산2동제2투,2597,2050,1032,748,232,26,2,2040,10,547,50.588235294117645,36.666666666666664,11.372549019607844,1.2745098039215685,0.09803921568627451
102,인천광역시,부평구,삼산2동,삼산2동제3투,2081,1521,628,748,118,12,5,1511,10,560,41.5618795499669,49.50363997352746,7.809397749834547,0.7941760423560555,0.3309066843150232
103,인천광역시,부평구,삼산2동,삼산2동제4투,2088,1431,558,762,85,15,1,1421,10,657,39.268121041520054,53.624208304011255,5.9817030260380015,1.0555946516537649,0.07037297677691766
104,인천광역시,부평구,삼산2동,삼산2동제5투,2463,1919,805,910,174,21,1,1911,8,544,42.124542124542124,47.61904761904761,9.105180533751962,1.098901098901099,0.052328623757195186
105,인천광역시,부평구,삼산2동,삼산2동제6투,2516,1796,816,794,152,22,0,1784,12,720,45.73991031390135,44.506726457399104,8.520179372197308,1.2331838565022422,0.0
106,인천광역시,부평구,부개1동,관내사전투표,3223,3223,2066,956,154,21,1,3198,25,0,64.60287679799876,29.893683552220136,4.815509693558474,0.6566604127579738,0.031269543464665414
107,인천광역시,부평구,부개1동,부개1동제1투,2249,1328,529,691,84,13,1,1318,10,921,40.13657056145675,52.42792109256449,6.373292867981791,0.9863429438543246,0.07587253414264036
108,인천광역시,부평구,부개1동,부개1동제2투,2997,2067,857,1033,143,20,0,2053,14,930,41.74378957622991,50.31660983925962,6.965416463711642,0.974184120798831,0.0
109,인천광역시,부평구,부개1동,부개1동제3투,2013,1221,492,633,78,8,1,1212,9,792,40.5940594059406,52.22772277227723,6.435643564356436,0.6600660066006601,0.08250825082508251
110,인천광역시,부평구,부개1동,부개1동제4투,1862,1145,448,609,63,15,4,1139,6,717,39.33274802458297,53.46795434591747,5.53116769095698,1.3169446883230904,0.35118525021949076
111,인천광역시,부평구,부개2동,관내사전투표,5990,5990,4049,1367,466,70,6,5958,32,0,67.959046659953,22.943940919771734,7.821416582745888,1.1748909029875798,0.10070493454179255
112,인천광역시,부평구,부개2동,부개2동제1투,2714,1747,714,846,154,20,2,1736,11,967,41.12903225806452,48.73271889400922,8.870967741935484,1.1520737327188941,0.1152073732718894
113,인천광역시,부평구,부개2동,부개2동제2투,2549,1782,767,821,154,25,1,1768,14,767,43.38235294117647,46.43665158371041,8.710407239819004,1.414027149321267,0.056561085972850686
114,인천광역시,부평구,부개2동,부개2동제3투,2737,1896,819,891,132,28,7,1877,19,841,43.633457645178474,47.46936600958977,7.032498668087374,1.4917421417155035,0.37293553542887586
115,인천광역시,부평구,부개2동,부개2동제4투,2500,1821,769,886,135,19,2,1811,10,679,42.46272777471011,48.92324682495859,7.454445057979017,1.0491441192711208,0.11043622308117064
116,인천광역시,부평구,부개3동,관내사전투표,5732,5732,3928,1291,412,56,3,5690,42,0,69.03339191564147,22.688927943760984,7.240773286467486,0.984182776801406,0.05272407732864675
117,인천광역시,부평구,부개3동,부개3동제1투,1885,1242,477,627,110,17,0,1231,11,643,38.74898456539399,50.93419983753046,8.935824532900082,1.380991064175467,0.0
118,인천광역시,부평구,부개3동,부개3동제2투,1687,1014,414,473,97,16,2,1002,12,673,41.31736526946108,47.20558882235529,9.68063872255489,1.5968063872255487,0.19960079840319359
119,인천광역시,부평구,부개3동,부개3동제3투,2107,1603,701,718,160,16,0,1595,8,504,43.94984326018809,45.01567398119122,10.031347962382444,1.0031347962382446,0.0
120,인천광역시,부평구,부개3동,부개3동제4투,2220,1547,678,652,180,20,3,1533,14,673,44.22700587084149,42.53098499673842,11.741682974559687,1.304631441617743,0.19569471624266144
121,인천광역시,부평구,부개3동,부개3동제5투,2906,2286,965,1106,171,34,0,2276,10,620,42.39894551845343,48.59402460456942,7.513181019332162,1.493848857644991,0.0
122,인천광역시,부평구,부개3동,부개3동제6투,2643,2088,944,935,168,26,1,2074,14,555,45.51591128254581,45.08196721311475,8.100289296046286,1.253616200578592,0.048216007714561235
123,인천광역시,부평구,부개3동,부개3동제7투,2568,1845,826,813,163,27,3,1832,13,723,45.08733624454149,44.377729257641924,8.897379912663755,1.4737991266375545,0.16375545851528384
124,인천광역시,부평구,일신동,관내사전투표,2926,2926,1864,779,235,24,0,2902,24,0,64.2315644383184,26.84355616815989,8.097863542384562,0.8270158511371467,0.0
125,인천광역시,부평구,일신동,일신동제1투,2308,1507,573,802,112,9,2,1498,9,801,38.251001335113486,53.538050734312414,7.476635514018691,0.6008010680907877,0.13351134846461948
126,인천광역시,부평구,일신동,일신동제2투,2172,1497,657,720,89,16,3,1485,12,675,44.24242424242424,48.484848484848484,5.993265993265993,1.0774410774410774,0.20202020202020202
127,인천광역시,부평구,일신동,일신동제3투,2030,1446,601,713,110,12,3,1439,7,584,41.76511466296039,49.54829742876998,7.644197359277276,0.8339124391938846,0.20847810979847115
128,인천광역시,부평구,십정1동,관내사전투표,5408,5408,3530,1392,393,55,7,5377,31,0,65.64999070113447,25.88804165891761,7.308908313185791,1.0228752092244746,0.1301841175376604
129,인천광역시,부평구,십정1동,십정1동제1투,3295,1976,766,1043,132,14,1,1956,20,1319,39.16155419222903,53.323108384458074,6.748466257668712,0.7157464212678937,0.051124744376278126
130,인천광역시,부평구,십정1동,십정1동제2투,2932,2081,944,923,158,36,4,2065,16,851,45.714285714285715,44.69733656174334,7.651331719128329,1.7433414043583535,0.1937046004842615
131,인천광역시,부평구,십정1동,십정1동제3투,3845,2758,1235,1194,277,29,6,2741,17,1087,45.05654870485225,43.560744253921925,10.105800802626778,1.0580080262677856,0.21889821233126594
132,인천광역시,부평구,십정1동,십정1동제4투,3843,2821,1232,1196,347,28,4,2807,14,1022,43.89027431421446,42.60776629853937,12.361952262201639,0.997506234413965,0.14250089063056642
133,인천광역시,부평구,십정2동,관내사전투표,2648,2648,1710,757,125,18,7,2617,31,0,65.341994650363,28.92625143293848,4.776461597248758,0.6878104700038212,0.26748184944593045
134,인천광역시,부평구,십정2동,십정2동제1투,2203,1326,514,705,82,11,2,1314,12,877,39.117199391171994,53.65296803652968,6.2404870624048705,0.837138508371385,0.15220700152207
135,인천광역시,부평구,십정2동,십정2동제2투,2554,1592,648,817,100,10,4,1579,13,962,41.038632045598476,51.74160861304623,6.3331222292590255,0.6333122229259025,0.253324889170361
136,인천광역시,부평구,십정2동,십정2동제3투,3178,1790,760,862,123,19,5,1769,21,1388,42.96212549462973,48.728094968908984,6.953080836630865,1.0740531373657434,0.2826455624646693
137,인천광역시,부평구,십정2동,십정2동제4투,2745,1603,653,827,95,13,3,1591,12,1142,41.043368950345695,51.979886863607796,5.971087366436204,0.8170961659333752,0.18856065367693275
138,인천광역시,부평구,십정2동,십정2동제5투,2649,2045,859,999,160,13,2,2033,12,604,42.25282833251352,49.13920314805706,7.870142646335465,0.6394490900147565,0.0983767830791933
139,인천광역시,부평구,잘못 투입·구분된 투표지,,0,16,7,6,3,0,0,16,0,-16,43.75,37.5,18.75,0.0,0.0
0,인천광역시,계양구,거소·선상투표,,401,379,179,108,75,2,2,366,13,22,48.90710382513661,29.508196721311474,20.491803278688526,0.546448087431694,0.546448087431694
1,인천광역시,계양구,관외사전투표,,22712,22701,14440,4948,2793,252,37,22470,231,11,64.26346239430352,22.020471740097907,12.429906542056075,1.1214953271028036,0.16466399643969737
2,인천광역시,계양구,재외투표,,1152,929,682,144,77,19,1,923,6,223,73.88949079089923,15.601300108342361,8.342361863488625,2.058504875406284,0.10834236186348861
3,인천광역시,계양구,효성1동,관내사전투표,6020,6020,4083,1457,385,47,3,5975,45,0,68.3347280334728,24.384937238493723,6.443514644351464,0.7866108786610879,0.05020920502092051
4,인천광역시,계양구,효성1동,효성1동제1투,2315,1479,586,768,99,15,3,1471,8,836,39.8368456832087,52.2093813732155,6.730115567641061,1.0197144799456153,0.20394289598912305
5,인천광역시,계양구,효성1동,효성1동제2투,1431,920,381,447,78,6,0,912,8,511,41.776315789473685,49.01315789473684,8.552631578947368,0.6578947368421052,0.0
6,인천광역시,계양구,효성1동,효성1동제3투,2476,1581,613,815,132,12,1,1573,8,895,38.97012078830261,51.81182453909726,8.391608391608392,0.7628734901462174,0.06357279084551812
7,인천광역시,계양구,효성1동,효성1동제4투,2056,1308,594,605,85,13,1,1298,10,748,45.76271186440678,46.61016949152542,6.548536209553159,1.0015408320493067,0.07704160246533129
8,인천광역시,계양구,효성1동,효성1동제5투,2535,1787,810,772,167,21,2,1772,15,748,45.71106094808127,43.566591422121896,9.424379232505643,1.1851015801354403,0.1128668171557562
9,인천광역시,계양구,효성1동,효성1동제6투,2258,1687,782,726,150,14,0,1672,15,571,46.770334928229666,43.42105263157895,8.971291866028707,0.8373205741626795,0.0
10,인천광역시,계양구,효성1동,효성1동제7투,2149,1591,817,629,118,16,0,1580,11,558,51.70886075949367,39.810126582278485,7.468354430379747,1.0126582278481013,0.0
11,인천광역시,계양구,효성2동,관내사전투표,4284,4284,2907,1086,236,29,2,4260,24,0,68.2394366197183,25.492957746478872,5.539906103286385,0.6807511737089201,0.046948356807511735
12,인천광역시,계양구,효성2동,효성2동제1투,2271,1359,557,699,85,13,0,1354,5,912,41.13737075332349,51.6248153618907,6.277695716395865,0.9601181683899557,0.0
13,인천광역시,계양구,효성2동,효성2동제2투,2718,1580,751,684,118,13,3,1569,11,1138,47.86488209050351,43.59464627151052,7.520713830465264,0.82855321861058,0.19120458891013384
14,인천광역시,계양구,효성2동,효성2동제3투,3059,2239,1005,1006,186,22,4,2223,16,820,45.209176788124154,45.254161043634724,8.367071524966262,0.9896536212325686,0.1799370220422852
15,인천광역시,계양구,효성2동,효성2동제4투,2946,2196,951,1028,173,26,1,2179,17,750,43.64387333639284,47.17760440569068,7.9394217530977516,1.1932078935291417,0.04589261128958238
16,인천광역시,계양구,효성2동,효성2동제5투,2350,1500,679,683,109,11,1,1483,17,850,45.78556979096426,46.05529332434255,7.349966284558327,0.7417397167902899,0.06743088334457181
17,인천광역시,계양구,효성2동,효성2동제6투,3080,2264,1076,1004,155,18,2,2255,9,816,47.71618625277162,44.52328159645233,6.873614190687362,0.7982261640798226,0.08869179600886917
18,인천광역시,계양구,계산1동,관내사전투표,2874,2873,1901,771,155,30,2,2859,14,1,66.49178034277719,26.967471143756562,5.421476040573627,1.049317943336831,0.06995452955578874
19,인천광역시,계양구,계산1동,계산1동제1투,2433,1497,571,792,105,13,2,1483,14,936,38.5030343897505,53.40525960890088,7.080242751180041,0.8766014834794336,0.13486176668914363
20,인천광역시,계양구,계산1동,계산1동제2투,2691,1644,730,774,105,15,4,1628,16,1047,44.840294840294845,47.54299754299755,6.44963144963145,0.9213759213759214,0.2457002457002457
21,인천광역시,계양구,계산1동,계산1동제3투,1934,1106,449,550,87,9,1,1096,10,828,40.96715328467153,50.18248175182482,7.937956204379562,0.8211678832116789,0.09124087591240876
22,인천광역시,계양구,계산1동,계산1동제4투,2442,1515,673,698,112,20,1,1504,11,927,44.74734042553192,46.409574468085104,7.446808510638298,1.3297872340425532,0.06648936170212766
23,인천광역시,계양구,계산1동,계산1동제5투,1606,1005,418,488,77,15,4,1002,3,601,41.71656686626746,48.70259481037924,7.684630738522954,1.4970059880239521,0.39920159680638717
24,인천광역시,계양구,계산2동,관내사전투표,4898,4898,3358,1109,350,41,2,4860,38,0,69.09465020576133,22.818930041152264,7.20164609053498,0.8436213991769548,0.0411522633744856
25,인천광역시,계양구,계산2동,계산2동제1투,1986,1190,458,611,99,12,1,1181,9,796,38.780694326841655,51.73581710414903,8.38272650296359,1.0160880609652836,0.0846740050804403
26,인천광역시,계양구,계산2동,계산2동제2투,2051,1238,508,638,63,13,3,1225,13,813,41.46938775510204,52.08163265306123,5.142857142857142,1.0612244897959184,0.24489795918367346
27,인천광역시,계양구,계산2동,계산2동제3투,2362,1702,751,784,128,18,3,1684,18,660,44.596199524940616,46.55581947743468,7.600950118764846,1.0688836104513064,0.17814726840855108
28,인천광역시,계양구,계산2동,계산2동제4투,2108,1221,497,605,93,11,2,1208,13,887,41.14238410596027,50.08278145695364,7.698675496688742,0.9105960264900662,0.16556291390728478
29,인천광역시,계양구,계산3동,관내사전투표,4917,4917,3397,1123,326,42,5,4893,24,0,69.42571019824238,22.951154710811362,6.6625791947680355,0.8583690987124464,0.10218679746576743
30,인천광역시,계양구,계산3동,계산3동제1투,2474,1755,769,833,133,15,1,1751,4,719,43.917761279268994,47.57281553398058,7.59565962307253,0.8566533409480296,0.05711022272986865
31,인천광역시,계양구,계산3동,계산3동제2투,1958,1309,586,565,121,19,1,1292,17,649,45.356037151702786,43.73065015479876,9.365325077399381,1.4705882352941175,0.07739938080495357
32,인천광역시,계양구,계산3동,계산3동제3투,1730,1176,498,542,103,19,1,1163,13,554,42.82029234737747,46.603611349957006,8.85640584694755,1.633705932932072,0.08598452278589853
33,인천광역시,계양구,계산3동,계산3동제4투,2125,1461,620,698,108,16,0,1442,19,664,42.995839112343965,48.40499306518724,7.489597780859916,1.1095700416088765,0.0
34,인천광역시,계양구,계산3동,계산3동제5투,2038,1256,515,596,110,20,0,1241,15,782,41.49879129734085,48.025785656728445,8.8638195004029,1.6116035455278,0.0
35,인천광역시,계양구,계산4동,관내사전투표,5946,5946,4298,1140,410,57,2,5907,39,0,72.76113086168951,19.299136617572373,6.940917555442695,0.9649568308786186,0.03385813441679363
36,인천광역시,계양구,계산4동,계산4동제1투,2805,1592,696,703,163,23,2,1587,5,1213,43.85633270321361,44.29741650913673,10.27095148078135,1.4492753623188406,0.1260239445494644
37,인천광역시,계양구,계산4동,계산4동제2투,1899,1371,618,613,112,17,3,1363,8,528,45.34115920763023,44.97432134996331,8.217168011738812,1.247248716067498,0.22010271460014674
38,인천광역시,계양구,계산4동,계산4동제3투,3300,2287,943,1121,179,26,1,2270,17,1013,41.541850220264315,49.38325991189427,7.885462555066079,1.145374449339207,0.04405286343612335
39,인천광역시,계양구,계산4동,계산4동제4투,2781,2076,996,860,184,23,1,2064,12,705,48.25581395348838,41.66666666666667,8.914728682170542,1.1143410852713178,0.04844961240310078
40,인천광역시,계양구,계산4동,계산4동제5투,1868,1521,725,647,121,20,1,1514,7,347,47.886393659180975,42.73447820343461,7.9920739762219295,1.321003963011889,0.06605019815059446
41,인천광역시,계양구,작전1동,관내사전투표,4688,4688,3299,1088,255,30,1,4673,15,0,70.59704686496897,23.282687780868823,5.45687994864113,0.6419858763107211,0.02139952921035737
42,인천광역시,계양구,작전1동,작전1동제1투,2945,2048,925,901,178,25,3,2032,16,897,45.52165354330709,44.34055118110236,8.759842519685039,1.2303149606299213,0.14763779527559054
43,인천광역시,계양구,작전1동,작전1동제2투,2642,1782,893,708,143,21,1,1766,16,860,50.566251415628535,40.09060022650057,8.097395243488108,1.189127972819932,0.05662514156285391
44,인천광역시,계양구,작전1동,작전1동제3투,2691,1897,824,895,152,15,1,1887,10,794,43.667196608373075,47.429782723900374,8.05511393746688,0.7949125596184419,0.052994170641229466
45,인천광역시,계양구,작전1동,작전1동제4투,1553,979,361,523,74,13,1,972,7,574,37.13991769547325,53.80658436213992,7.613168724279835,1.337448559670782,0.102880658436214
46,인천광역시,계양구,작전1동,작전1동제5투,2738,1847,844,814,145,23,6,1832,15,891,46.069868995633186,44.43231441048035,7.914847161572053,1.2554585152838427,0.32751091703056767
47,인천광역시,계양구,작전1동,작전1동제6투,2655,1910,958,743,184,14,1,1900,10,745,50.421052631578945,39.10526315789474,9.68421052631579,0.7368421052631579,0.05263157894736842
48,인천광역시,계양구,작전2동,관내사전투표,5164,5164,3485,1309,292,43,5,5134,30,0,67.88079470198676,25.496688741721858,5.6875730424620174,0.8375535644721466,0.09738994935722634
49,인천광역시,계양구,작전2동,작전2동제1투,1935,1131,447,599,70,7,1,1124,7,804,39.768683274021356,53.29181494661922,6.227758007117438,0.6227758007117438,0.0889679715302491
50,인천광역시,계양구,작전2동,작전2동제2투,2190,1490,645,693,116,21,1,1476,14,700,43.69918699186992,46.95121951219512,7.8590785907859075,1.4227642276422763,0.06775067750677506
51,인천광역시,계양구,작전2동,작전2동제3투,1834,1217,497,602,88,15,1,1203,14,617,41.31338320864506,50.041562759767245,7.315045719035744,1.2468827930174564,0.0831255195344971
52,인천광역시,계양구,작전2동,작전2동제4투,2886,1890,864,839,151,25,1,1880,10,996,45.95744680851064,44.62765957446809,8.031914893617023,1.3297872340425532,0.05319148936170213
53,인천광역시,계양구,작전2동,작전2동제5투,4973,3685,1652,1612,339,46,5,3654,31,1288,45.21072796934866,44.11603721948549,9.277504105090312,1.258894362342638,0.13683634373289547
54,인천광역시,계양구,작전서운동,관내사전투표,5266,5264,3627,1179,377,45,3,5231,33,2,69.3366469126362,22.538711527432614,7.207034983750717,0.8602561651691838,0.05735041101127892
55,인천광역시,계양구,작전서운동,작전서운동제1투,2217,1214,574,517,106,10,0,1207,7,1003,47.55592377796189,42.833471416735705,8.782104391052195,0.8285004142502072,0.0
56,인천광역시,계양구,작전서운동,작전서운동제2투,2603,1909,907,788,168,26,2,1891,18,694,47.964040190375464,41.67107350608144,8.8841882601798,1.3749338974087784,0.10576414595452141
57,인천광역시,계양구,작전서운동,작전서운동제3투,2205,1568,647,772,124,17,0,1560,8,637,41.47435897435898,49.48717948717949,7.948717948717948,1.0897435897435896,0.0
58,인천광역시,계양구,작전서운동,작전서운동제4투,3178,2375,1150,984,200,25,4,2363,12,803,48.66694879390605,41.64198053322048,8.463817181548878,1.0579771476936097,0.16927634363097757
59,인천광역시,계양구,작전서운동,작전서운동제5투,2520,1828,936,699,159,19,1,1814,14,692,51.598676957001096,38.53362734288864,8.7651598676957,1.0474090407938257,0.05512679162072767
60,인천광역시,계양구,작전서운동,작전서운동제6투,2445,1775,896,698,152,13,1,1760,15,670,50.90909090909091,39.659090909090914,8.636363636363637,0.7386363636363636,0.056818181818181816
61,인천광역시,계양구,작전서운동,작전서운동제7투,2216,1356,661,564,109,8,4,1346,10,860,49.108469539375925,41.90193164933135,8.098068350668647,0.5943536404160475,0.2971768202080238
62,인천광역시,계양구,작전서운동,작전서운동제8투,1219,893,481,341,51,9,3,885,8,326,54.35028248587571,38.53107344632768,5.762711864406779,1.0169491525423728,0.3389830508474576
63,인천광역시,계양구,계양1동,관내사전투표,2680,2680,1776,696,161,30,3,2666,14,0,66.61665416354089,26.106526631657918,6.03900975243811,1.1252813203300824,0.11252813203300824
64,인천광역시,계양구,계양1동,계양1동제1투,2713,1693,596,940,110,24,3,1673,20,1020,35.6246264196055,56.18649133293485,6.5750149432157805,1.434548714883443,0.17931858936043038
65,인천광역시,계양구,계양1동,계양1동제2투,3260,2215,1036,1024,122,14,2,2198,17,1045,47.13375796178344,46.58780709736124,5.550500454959054,0.6369426751592357,0.09099181073703368
66,인천광역시,계양구,계양1동,계양1동제3투,2985,2259,1081,955,181,21,2,2240,19,726,48.25892857142857,42.63392857142857,8.080357142857144,0.9375,0.08928571428571429
67,인천광역시,계양구,계양1동,계양1동제4투,2332,1706,732,811,119,30,0,1692,14,626,43.262411347517734,47.93144208037825,7.033096926713949,1.773049645390071,0.0
68,인천광역시,계양구,계양2동,관내사전투표,7462,7462,5220,1629,491,65,5,7410,52,0,70.44534412955466,21.983805668016192,6.626180836707153,0.8771929824561403,0.06747638326585695
69,인천광역시,계양구,계양2동,계양2동제1투,2569,1433,594,704,103,15,1,1417,16,1136,41.919548341566696,49.68242766407904,7.268877911079747,1.058574453069866,0.07057163020465773
70,인천광역시,계양구,계양2동,계양2동제2투,2041,1270,549,606,91,10,2,1258,12,771,43.64069952305246,48.171701112877585,7.233704292527822,0.7949125596184419,0.1589825119236884
71,인천광역시,계양구,계양2동,계양2동제3투,1589,1043,440,494,80,13,2,1029,14,546,42.75996112730807,48.00777453838678,7.774538386783285,1.2633624878522838,0.1943634596695821
72,인천광역시,계양구,계양2동,계양2동제4투,1673,1017,444,501,59,8,0,1012,5,656,43.873517786561266,49.50592885375494,5.8300395256917,0.7905138339920948,0.0
73,인천광역시,계양구,계양2동,계양2동제5투,2946,2024,885,927,168,23,3,2006,18,922,44.11764705882353,46.211365902293124,8.374875373878366,1.1465603190428715,0.14955134596211367
74,인천광역시,계양구,계양2동,계양2동제6투,3030,1854,889,809,131,16,0,1845,9,1176,48.18428184281843,43.84823848238482,7.100271002710028,0.8672086720867209,0.0
75,인천광역시,계양구,계양2동,계양2동제7투,2884,2171,1093,816,225,21,0,2155,16,713,50.719257540603245,37.86542923433875,10.440835266821345,0.974477958236659,0.0
76,인천광역시,계양구,계양2동,계양2동제8투,2496,1746,802,767,142,16,2,1729,17,750,46.38519375361481,44.3609022556391,8.212839791787161,0.9253903990746095,0.11567379988432619
77,인천광역시,계양구,계양3동,관내사전투표,4959,4959,3744,886,264,37,2,4933,26,0,75.89702006892357,17.960673018447192,5.351712953577945,0.7500506790999392,0.040543279951348064
78,인천광역시,계양구,계양3동,계양3동제1투,2042,1396,639,636,97,17,0,1389,7,646,46.00431965442765,45.78833693304535,6.983441324694025,1.2239020878329734,0.0
79,인천광역시,계양구,계양3동,계양3동제2투,270,188,61,120,5,2,0,188,0,82,32.4468085106383,63.829787234042556,2.6595744680851063,1.0638297872340425,0.0
80,인천광역시,계양구,계양3동,계양3동제3투,2815,1978,1035,763,141,21,6,1966,12,837,52.64496439471007,38.809766022380465,7.171922685656154,1.0681586978636826,0.3051881993896236
81,인천광역시,계양구,계양3동,계양3동제4투,2645,1818,915,753,120,19,3,1810,8,827,50.552486187845304,41.60220994475139,6.629834254143646,1.0497237569060773,0.16574585635359115
82,인천광역시,계양구,계양3동,계양3동제5투,2827,1688,866,671,128,15,2,1682,6,1139,51.48632580261593,39.89298454221165,7.609988109393578,0.89179548156956,0.11890606420927466
83,인천광역시,계양구,계양3동,계양3동제6투,2313,1858,909,781,133,22,1,1846,12,455,49.24160346695558,42.30769230769231,7.204767063921993,1.191765980498375,0.054171180931744306
84,인천광역시,계양구,잘못 투입·구분된 투표지,,0,0,0,0,0,0,0,0,0,0,0.0,0.0,0.0,0.0,0.0
0,인천광역시,서구,거소·선상투표,,798,750,329,224,169,4,1,727,23,48,45.2544704264099,30.81155433287483,23.24621733149931,0.5502063273727648,0.1375515818431912
1,인천광역시,서구,관외사전투표,,50306,50290,31013,11505,6665,572,60,49815,475,16,62.25634848941082,23.095453176753992,13.379504165412023,1.1482485195222323,0.12044564890093346
2,인천광역시,서구,재외투표,,2481,2059,1430,392,202,23,1,2048,11,422,69.82421875,19.140625,9.86328125,1.123046875,0.048828125
3,인천광역시,서구,검암경서동,관내사전투표,7662,7661,5384,1517,614,87,6,7608,53,1,70.76761303890642,19.939537329127237,8.070452155625658,1.1435331230283912,0.07886435331230283
4,인천광역시,서구,검암경서동,검암경서동제1투,2723,1909,766,900,201,18,2,1887,22,814,40.593534711181775,47.69475357710652,10.651828298887123,0.9538950715421303,0.10598834128245893
5,인천광역시,서구,검암경서동,검암경서동제2투,3915,2944,1384,1142,352,42,3,2923,21,971,47.34861443722203,39.06944919603148,12.042422169004448,1.4368799178925762,0.10263427984946973
6,인천광역시,서구,검암경서동,검암경서동제3투,3264,1819,905,751,135,9,2,1802,17,1445,50.22197558268591,41.67591564927858,7.491675915649279,0.4994450610432853,0.11098779134295228
7,인천광역시,서구,검암경서동,검암경서동제4투,2269,1649,693,741,185,10,1,1630,19,620,42.515337423312886,45.4601226993865,11.349693251533742,0.6134969325153374,0.06134969325153375
8,인천광역시,서구,검암경서동,검암경서동제5투,2395,1708,811,689,168,24,1,1693,15,687,47.90313053750738,40.696987595983465,9.923213230950974,1.4176018901358536,0.05906674542232723
9,인천광역시,서구,검암경서동,검암경서동제6투,1899,1455,674,612,135,22,2,1445,10,444,46.64359861591695,42.35294117647059,9.342560553633218,1.5224913494809689,0.13840830449826988
10,인천광역시,서구,검암경서동,검암경서동제7투,2098,1321,656,475,150,15,4,1300,21,777,50.46153846153846,36.53846153846153,11.538461538461538,1.153846153846154,0.3076923076923077
11,인천광역시,서구,검암경서동,검암경서동제8투,3077,2302,1141,957,163,26,1,2288,14,775,49.86888111888112,41.82692307692308,7.124125874125873,1.1363636363636365,0.043706293706293704
12,인천광역시,서구,검암경서동,검암경서동제9투,2181,1392,653,564,146,15,3,1381,11,789,47.28457639391745,40.83997103548154,10.57204923968139,1.0861694424330195,0.2172338884866039
13,인천광역시,서구,검암경서동,검암경서동제10투,2890,1781,925,675,144,23,2,1769,12,1109,52.28942905596382,38.15715093273035,8.140192198982476,1.3001695873374788,0.11305822498586772
14,인천광역시,서구,검암경서동,검암경서동제11투,1882,1414,724,528,130,18,2,1402,12,468,51.64051355206848,37.660485021398,9.272467902995722,1.2838801711840229,0.14265335235378032
15,인천광역시,서구,검암경서동,검암경서동제12투,3347,2612,1283,1013,276,29,1,2602,10,735,49.30822444273636,38.93159108378171,10.607225211375864,1.1145272867025366,0.03843197540353574
16,인천광역시,서구,연희동,관내사전투표,9262,9262,5984,2318,758,105,13,9178,84,0,65.1993898452822,25.25604706907823,8.258879930268032,1.1440400958814556,0.141643059490085
17,인천광역시,서구,연희동,연희동제1투,2451,1501,684,669,117,20,1,1491,10,950,45.87525150905433,44.8692152917505,7.847082494969819,1.341381623071764,0.0670690811535882
18,인천광역시,서구,연희동,연희동제2투,2781,1769,779,814,140,16,6,1755,14,1012,44.387464387464384,46.38176638176638,7.977207977207977,0.9116809116809116,0.3418803418803419
19,인천광역시,서구,연희동,연희동제3투,2896,1599,613,836,125,15,0,1589,10,1297,38.57772183763373,52.611705475141605,7.8665827564505975,0.9439899307740718,0.0
20,인천광역시,서구,연희동,연희동제4투,2563,1604,645,810,127,9,2,1593,11,959,40.48964218455744,50.847457627118644,7.9723791588198365,0.5649717514124294,0.12554927809165098
21,인천광역시,서구,연희동,연희동제5투,2551,1667,689,816,132,18,0,1655,12,884,41.63141993957704,49.30513595166163,7.975830815709969,1.0876132930513596,0.0
22,인천광역시,서구,연희동,연희동제6투,2294,1459,694,604,127,19,0,1444,15,835,48.06094182825485,41.82825484764543,8.795013850415513,1.3157894736842104,0.0
23,인천광역시,서구,연희동,연희동제7투,2501,1492,619,715,136,14,1,1485,7,1009,41.68350168350168,48.148148148148145,9.15824915824916,0.9427609427609427,0.06734006734006734
24,인천광역시,서구,연희동,연희동제8투,2089,1380,597,634,130,12,2,1375,5,709,43.418181818181814,46.10909090909091,9.454545454545455,0.8727272727272728,0.14545454545454545
25,인천광역시,서구,연희동,연희동제9투,2918,1620,664,780,148,18,4,1614,6,1298,41.14002478314746,48.3271375464684,9.169764560099132,1.1152416356877324,0.24783147459727387
26,인천광역시,서구,청라1동,관내사전투표,7289,7289,4966,1505,680,79,5,7235,54,0,68.63856254319282,20.801658604008296,9.39875604699378,1.0919143054595717,0.0691085003455425
27,인천광역시,서구,청라1동,청라1동제1투,2772,2116,1017,841,220,25,3,2106,10,656,48.29059829059829,39.933523266856604,10.446343779677113,1.1870845204178537,0.14245014245014245
28,인천광역시,서구,청라1동,청라1동제2투,2609,1951,915,821,174,29,4,1943,8,658,47.09212557900154,42.2542460113227,8.955223880597014,1.4925373134328357,0.2058672156459084
29,인천광역시,서구,청라1동,청라1동제3투,3320,2088,835,1016,208,21,3,2083,5,1232,40.086413826212194,48.77580412866059,9.985597695631302,1.0081613058089294,0.14402304368698993
30,인천광역시,서구,청라1동,청라1동제4투,3516,2269,925,1068,239,19,0,2251,18,1247,41.092847623278544,47.44557974233674,10.61750333185251,0.8440693025322079,0.0
31,인천광역시,서구,청라1동,청라1동제5투,3449,2501,1122,1070,262,25,3,2482,19,948,45.20547945205479,43.11039484286866,10.556003223207092,1.0072522159548751,0.12087026591458502
32,인천광역시,서구,청라2동,관내사전투표,8690,8690,5795,1950,814,79,4,8642,48,0,67.05623698218005,22.564221245082155,9.419115945383014,0.9141402453135848,0.04628558204119417
33,인천광역시,서구,청라2동,청라2동제1투,3455,2628,1089,1265,227,34,0,2615,13,827,41.64435946462715,48.37476099426386,8.680688336520076,1.3001912045889101,0.0
34,인천광역시,서구,청라2동,청라2동제2투,2106,1589,709,700,158,15,1,1583,6,517,44.788376500315856,44.21983575489577,9.98104864181933,0.9475679090334808,0.06317119393556538
35,인천광역시,서구,청라2동,청라2동제3투,2625,1758,658,911,161,13,2,1745,13,867,37.70773638968482,52.20630372492837,9.226361031518625,0.7449856733524355,0.1146131805157593
36,인천광역시,서구,청라2동,청라2동제4투,2622,1733,558,947,195,21,0,1721,12,889,32.42300987797792,55.02614758861127,11.330621731551425,1.220220801859384,0.0
37,인천광역시,서구,청라2동,청라2동제5투,3188,2456,1216,955,252,21,2,2446,10,732,49.71381847914963,39.043336058871624,10.302534750613246,0.8585445625511038,0.08176614881439084
38,인천광역시,서구,청라2동,청라2동제6투,2573,1737,762,829,113,19,3,1726,11,836,44.148319814600235,48.03012746234067,6.546929316338354,1.100811123986095,0.17381228273464658
39,인천광역시,서구,청라2동,청라2동제7투,1615,1103,374,613,100,10,0,1097,6,512,34.092980856882406,55.87967183226983,9.115770282588878,0.9115770282588878,0.0
40,인천광역시,서구,청라2동,청라2동제8투,2243,1786,947,633,178,14,1,1773,13,457,53.41229554427523,35.70219966159052,10.039481105470953,0.7896221094190639,0.05640157924421885
41,인천광역시,서구,청라2동,청라2동제9투,3548,2130,786,1088,221,11,2,2108,22,1418,37.2865275142315,51.61290322580645,10.483870967741936,0.5218216318785579,0.09487666034155598
42,인천광역시,서구,청라3동,관내사전투표,7206,7206,4912,1487,708,61,6,7174,32,0,68.46947309729579,20.727627543908557,9.868971285196542,0.8502927237245609,0.08363534987454697
43,인천광역시,서구,청라3동,청라3동제1투,2645,1939,801,951,150,24,0,1926,13,706,41.58878504672897,49.37694704049844,7.78816199376947,1.2461059190031152,0.0
44,인천광역시,서구,청라3동,청라3동제2투,3208,2460,1066,1162,194,21,1,2444,16,748,43.61702127659575,47.54500818330605,7.937806873977086,0.8592471358428805,0.04091653027823241
45,인천광역시,서구,청라3동,청라3동제3투,3149,2161,925,1013,181,26,1,2146,15,988,43.103448275862064,47.20410065237651,8.434296365330848,1.211556383970177,0.046598322460391424
46,인천광역시,서구,청라3동,청라3동제4투,2795,2140,943,929,240,21,0,2133,7,655,44.210032817627756,43.55368026254102,11.251758087201125,0.9845288326300985,0.0
47,인천광역시,서구,청라3동,청라3동제5투,2982,1758,689,776,264,19,1,1749,9,1224,39.39393939393939,44.36821040594626,15.09433962264151,1.0863350485991996,0.05717552887364208
48,인천광역시,서구,청라3동,청라3동제6투,3097,1957,792,916,223,17,2,1950,7,1140,40.61538461538461,46.97435897435898,11.435897435897434,0.8717948717948718,0.10256410256410256
49,인천광역시,서구,가정1동,관내사전투표,6803,6803,4628,1593,492,52,2,6767,36,0,68.39071966898183,23.540712280183243,7.270577804049061,0.76843505246047,0.029555194325402687
50,인천광역시,서구,가정1동,가정1동제1투,3114,1855,719,925,162,22,5,1833,22,1259,39.2253136933988,50.46372067648663,8.8379705400982,1.2002182214948172,0.27277686852154936
51,인천광역시,서구,가정1동,가정1동제2투,2200,1302,494,682,89,24,3,1292,10,898,38.23529411764706,52.78637770897833,6.888544891640867,1.8575851393188854,0.23219814241486067
52,인천광역시,서구,가정1동,가정1동제3투,4126,2953,1380,1257,268,24,3,2932,21,1173,47.0668485675307,42.87175989085949,9.140518417462483,0.8185538881309686,0.10231923601637108
53,인천광역시,서구,가정1동,가정1동제4투,3716,2827,1399,1078,304,30,1,2812,15,889,49.75106685633001,38.33570412517781,10.81081081081081,1.0668563300142246,0.03556187766714083
54,인천광역시,서구,가정1동,가정1동제5투,3663,2752,1357,1098,246,28,1,2730,22,911,49.70695970695971,40.21978021978022,9.010989010989011,1.0256410256410255,0.03663003663003663
55,인천광역시,서구,가정1동,가정1동제6투,3995,3089,1520,1192,317,42,0,3071,18,906,49.49527841094106,38.81471833279062,10.322370563334418,1.3676326929338978,0.0
56,인천광역시,서구,가정1동,가정1동제7투,2225,1756,889,648,183,27,2,1749,7,469,50.82904516866781,37.04974271012007,10.4631217838765,1.5437392795883362,0.11435105774728416
57,인천광역시,서구,가정2동,관내사전투표,3766,3766,2604,776,328,28,3,3739,27,0,69.64428991709013,20.754212356244985,8.772399037175715,0.7488633324418295,0.08023535704733886
58,인천광역시,서구,가정2동,가정2동제1투,2432,1548,613,767,144,11,2,1537,11,884,39.882888744307095,49.90240728692258,9.36890045543266,0.715679895901106,0.13012361743656475
59,인천광역시,서구,가정2동,가정2동제2투,2275,1453,564,727,128,24,2,1445,8,822,39.03114186851211,50.31141868512111,8.858131487889272,1.6608996539792389,0.13840830449826988
60,인천광역시,서구,가정2동,가정2동제3투,4475,3400,1627,1338,370,39,4,3378,22,1075,48.16459443457667,39.60923623445826,10.953226761397277,1.1545293072824157,0.11841326228537595
61,인천광역시,서구,가정3동,관내사전투표,1990,1990,1292,565,103,14,4,1978,12,0,65.31850353892821,28.564206268958543,5.207280080889787,0.7077856420626896,0.20222446916076847
62,인천광역시,서구,가정3동,가정3동제1투,2568,1592,639,803,125,13,3,1583,9,976,40.36639292482628,50.726468730259,7.896399241945673,0.82122552116235,0.18951358180669614
63,인천광역시,서구,가정3동,가정3동제2투,2435,1597,638,786,138,20,4,1586,11,838,40.22698612862548,49.558638083228246,8.701134930643127,1.2610340479192939,0.25220680958385877
64,인천광역시,서구,신현원창동,관내사전투표,4264,4264,2739,1210,260,36,3,4248,16,0,64.4774011299435,28.48399246704331,6.120527306967985,0.847457627118644,0.07062146892655367
65,인천광역시,서구,신현원창동,신현원창동제1투,1885,1118,450,584,64,10,0,1108,10,767,40.61371841155235,52.707581227436826,5.776173285198556,0.9025270758122743,0.0
66,인천광역시,서구,신현원창동,신현원창동제2투,1952,1162,495,569,80,9,2,1155,7,790,42.857142857142854,49.26406926406926,6.926406926406926,0.7792207792207793,0.17316017316017315
67,인천광역시,서구,신현원창동,신현원창동제3투,1751,938,403,440,76,13,2,934,4,813,43.147751605995715,47.109207708779444,8.137044967880087,1.3918629550321198,0.21413276231263384
68,인천광역시,서구,신현원창동,신현원창동제4투,2811,1859,846,832,155,14,2,1849,10,952,45.75446187128178,44.997295835586804,8.3829096809086,0.7571660356949702,0.1081665765278529
69,인천광역시,서구,신현원창동,신현원창동제5투,14,14,4,10,0,0,0,14,0,0,28.57142857142857,71.42857142857143,0.0,0.0,0.0
70,인천광역시,서구,신현원창동,신현원창동제6투,3099,2357,976,1165,172,25,2,2340,17,742,41.70940170940171,49.78632478632478,7.350427350427351,1.0683760683760684,0.08547008547008547
71,인천광역시,서구,신현원창동,신현원창동제7투,2548,1936,797,961,140,23,2,1923,13,612,41.44565782631305,49.9739989599584,7.280291211648465,1.1960478419136766,0.10400416016640666
72,인천광역시,서구,신현원창동,신현원창동제8투,2956,2278,1170,862,205,19,3,2259,19,678,51.79282868525896,38.1584772023019,9.074811863656485,0.84108012394865,0.13280212483399734
73,인천광역시,서구,석남1동,관내사전투표,3751,3751,2424,1060,216,29,3,3732,19,0,64.95176848874597,28.403001071811364,5.787781350482315,0.7770632368703109,0.08038585209003216
74,인천광역시,서구,석남1동,석남1동제1투,2796,1799,801,833,120,22,5,1781,18,997,44.97473329590118,46.771476698484,6.7377877596855695,1.235261089275688,0.2807411566535654
75,인천광역시,서구,석남1동,석남1동제2투,2594,1819,751,905,123,26,0,1805,14,775,41.606648199445985,50.13850415512465,6.814404432132965,1.440443213296399,0.0
76,인천광역시,서구,석남1동,석남1동제3투,2794,1620,691,756,146,14,4,1611,9,1174,42.892613283674734,46.927374301675975,9.062693978895096,0.8690254500310366,0.2482929857231533
77,인천광역시,서구,석남1동,석남1동제4투,1760,1027,389,569,51,12,1,1022,5,733,38.06262230919765,55.675146771037184,4.990215264187866,1.1741682974559686,0.09784735812133072
78,인천광역시,서구,석남1동,석남1동제5투,3142,1835,751,882,158,22,4,1817,18,1307,41.33186571271326,48.54155200880572,8.695652173913043,1.2107870115575123,0.2201430930104568
79,인천광역시,서구,석남2동,관내사전투표,3363,3363,2168,968,187,21,4,3348,15,0,64.75507765830346,28.912783751493432,5.585424133811231,0.6272401433691757,0.11947431302270012
80,인천광역시,서구,석남2동,석남2동제1투,2355,1332,422,791,104,8,1,1326,6,1023,31.825037707390646,59.653092006033184,7.8431372549019605,0.603318250377074,0.07541478129713425
81,인천광역시,서구,석남2동,석남2동제2투,2525,1810,800,845,130,16,0,1791,19,715,44.6677833612507,47.18034617532105,7.258514796203238,0.893355667225014,0.0
82,인천광역시,서구,석남2동,석남2동제3투,2470,1614,699,775,106,21,5,1606,8,856,43.52428393524284,48.256537982565376,6.60024906600249,1.3075965130759652,0.311332503113325
83,인천광역시,서구,석남3동,관내사전투표,2645,2645,1731,693,180,22,2,2628,17,0,65.8675799086758,26.36986301369863,6.8493150684931505,0.837138508371385,0.076103500761035
84,인천광역시,서구,석남3동,석남3동제1투,2678,1660,681,773,172,15,3,1644,16,1018,41.42335766423358,47.01946472019465,10.46228710462287,0.9124087591240875,0.18248175182481752
85,인천광역시,서구,석남3동,석남3동제2투,2594,1547,622,762,138,11,1,1534,13,1047,40.547588005215125,49.67405475880052,8.996088657105608,0.7170795306388527,0.0651890482398957
86,인천광역시,서구,석남3동,석남3동제3투,2625,1451,566,755,107,13,1,1442,9,1174,39.25104022191401,52.35783633841886,7.420249653259361,0.9015256588072121,0.06934812760055478
87,인천광역시,서구,가좌1동,관내사전투표,2765,2765,1881,659,165,32,5,2742,23,0,68.5995623632385,24.033552151714076,6.017505470459518,1.1670313639679066,0.18234865061998543
88,인천광역시,서구,가좌1동,가좌1동제1투,2452,1375,536,695,116,13,1,1361,14,1077,39.38280675973549,51.06539309331374,8.523144746509919,0.9551800146950772,0.07347538574577515
89,인천광역시,서구,가좌1동,가좌1동제2투,2236,1256,499,635,96,13,3,1246,10,980,40.048154093097914,50.96308186195827,7.704654895666131,1.043338683788122,0.2407704654895666
90,인천광역시,서구,가좌1동,가좌1동제3투,3157,1897,804,841,219,15,0,1879,18,1260,42.78871740287387,44.7578499201703,11.6551357104843,0.7982969664715274,0.0
91,인천광역시,서구,가좌2동,관내사전투표,4300,4300,2828,1130,280,35,9,4282,18,0,66.04390471742177,26.389537599252687,6.539000467071462,0.8173750583839328,0.21018215787015412
92,인천광역시,서구,가좌2동,가좌2동제1투,2341,1545,590,788,127,20,2,1527,18,796,38.63785199738049,51.604453176162416,8.316961362148003,1.309757694826457,0.13097576948264572
93,인천광역시,서구,가좌2동,가좌2동제2투,2277,1450,532,775,117,18,2,1444,6,827,36.84210526315789,53.67036011080333,8.102493074792244,1.2465373961218837,0.13850415512465375
94,인천광역시,서구,가좌2동,가좌2동제3투,2483,1779,657,959,125,18,3,1762,17,704,37.28717366628831,54.42678774120318,7.094211123723042,1.0215664018161181,0.170261066969353
95,인천광역시,서구,가좌2동,가좌2동제4투,3599,2781,1201,1276,249,28,4,2758,23,818,43.546047860768674,46.265409717186365,9.028281363306743,1.015228426395939,0.145032632342277
96,인천광역시,서구,가좌3동,관내사전투표,3967,3967,2435,1211,244,45,1,3936,31,0,61.864837398373986,30.76727642276423,6.199186991869919,1.1432926829268293,0.025406504065040653
97,인천광역시,서구,가좌3동,가좌3동제1투,1777,1075,361,616,77,13,1,1068,7,702,33.80149812734082,57.67790262172284,7.209737827715355,1.2172284644194757,0.09363295880149813
98,인천광역시,서구,가좌3동,가좌3동제2투,2165,1272,464,694,84,13,1,1256,16,893,36.94267515923567,55.254777070063696,6.687898089171974,1.0350318471337578,0.07961783439490447
99,인천광역시,서구,가좌3동,가좌3동제3투,2601,1604,663,747,159,23,0,1592,12,997,41.64572864321608,46.92211055276382,9.987437185929648,1.4447236180904524,0.0
100,인천광역시,서구,가좌3동,가좌3동제4투,2454,1604,683,789,109,14,1,1596,8,850,42.794486215538846,49.43609022556391,6.829573934837092,0.8771929824561403,0.06265664160401002
101,인천광역시,서구,가좌4동,관내사전투표,2457,2457,1563,683,177,18,3,2444,13,0,63.95253682487725,27.94599018003273,7.242225859247135,0.7364975450081833,0.12274959083469722
102,인천광역시,서구,가좌4동,가좌4동제1투,2306,1560,636,750,130,32,4,1552,8,746,40.97938144329897,48.324742268041234,8.376288659793813,2.0618556701030926,0.25773195876288657
103,인천광역시,서구,가좌4동,가좌4동제2투,2468,1695,670,832,164,19,2,1687,8,773,39.71547125074096,49.31831653823355,9.721398933017191,1.1262596324836989,0.11855364552459988
104,인천광역시,서구,가좌4동,가좌4동제3투,2143,1428,529,748,122,13,2,1414,14,715,37.41159830268741,52.899575671852894,8.628005657708627,0.9193776520509194,0.14144271570014144
105,인천광역시,서구,검단동,관내사전투표,6313,6312,4366,1464,405,41,3,6279,33,1,69.5333651855391,23.315814620162445,6.4500716674629714,0.6529702181876095,0.047778308647873864
106,인천광역시,서구,검단동,검단동제1투,4083,2629,1225,1117,232,32,3,2609,20,1454,46.952855500191646,42.81333844384822,8.892295898811806,1.2265235722499042,0.11498658489842851
107,인천광역시,서구,검단동,검단동제2투,1927,1161,465,591,90,8,2,1156,5,766,40.22491349480969,51.12456747404844,7.7854671280276815,0.6920415224913495,0.17301038062283738
108,인천광역시,서구,검단동,검단동제3투,2746,1884,809,898,148,12,1,1868,16,862,43.308351177730195,48.0728051391863,7.922912205567452,0.6423982869379015,0.05353319057815846
109,인천광역시,서구,검단동,검단동제4투,4545,2691,1217,1181,246,27,3,2674,17,1854,45.51234106207928,44.166043380703066,9.199700822737473,1.0097232610321616,0.11219147344801794
110,인천광역시,서구,검단동,검단동제5투,3980,2638,1223,1199,171,26,3,2622,16,1342,46.64378337147216,45.72845156369184,6.521739130434782,0.9916094584286803,0.11441647597254005
111,인천광역시,서구,검단동,검단동제6투,2240,1216,510,576,106,9,2,1203,13,1024,42.394014962593516,47.880299251870326,8.811305070656692,0.7481296758104738,0.1662510390689942
112,인천광역시,서구,불로대곡동,관내사전투표,6031,6031,4102,1414,434,50,0,6000,31,0,68.36666666666666,23.566666666666666,7.233333333333333,0.8333333333333334,0.0
113,인천광역시,서구,불로대곡동,불로대곡동제1투,4018,2454,1054,1166,205,17,5,2447,7,1564,43.073150796894154,47.65018389865141,8.377605230894973,0.6947282386595832,0.2043318348998774
114,인천광역시,서구,불로대곡동,불로대곡동제2투,2397,1628,770,722,111,14,4,1621,7,769,47.501542257865516,44.5404071560765,6.847624922887106,0.863664404688464,0.24676125848241826
115,인천광역시,서구,불로대곡동,불로대곡동제3투,3105,2118,943,991,143,24,6,2107,11,987,44.755576649264356,47.033697199810156,6.786900806834362,1.1390602752728998,0.28476506881822494
116,인천광역시,서구,불로대곡동,불로대곡동제4투,3604,2095,905,980,166,26,0,2077,18,1509,43.572460279248915,47.183437650457385,7.992296581608088,1.2518054886856043,0.0
117,인천광역시,서구,불로대곡동,불로대곡동제5투,4187,3197,1787,1004,338,38,2,3169,28,990,56.390028400126226,31.681918586304832,10.665825181445252,1.1991164405175134,0.06311139160618492
118,인천광역시,서구,원당동,관내사전투표,5628,5628,4075,1039,438,43,7,5602,26,0,72.74187790074973,18.546947518743305,7.818636201356659,0.767583006069261,0.12495537308104249
119,인천광역시,서구,원당동,원당동제1투,1951,1224,458,622,130,8,0,1218,6,727,37.60262725779967,51.06732348111659,10.673234811165845,0.6568144499178982,0.0
120,인천광역시,서구,원당동,원당동제2투,2771,1948,959,789,165,21,1,1935,13,823,49.56072351421189,40.775193798449614,8.527131782945736,1.0852713178294573,0.05167958656330749
121,인천광역시,서구,원당동,원당동제3투,2875,1906,985,731,149,23,4,1892,14,969,52.06131078224101,38.63636363636363,7.875264270613108,1.215644820295983,0.21141649048625794
122,인천광역시,서구,원당동,원당동제4투,3091,1825,884,785,134,10,0,1813,12,1266,48.75896304467733,43.298400441257584,7.391064533921677,0.5515719801434087,0.0
123,인천광역시,서구,원당동,원당동제5투,2644,1865,915,736,187,14,3,1855,10,779,49.32614555256065,39.67654986522911,10.080862533692722,0.7547169811320755,0.16172506738544476
124,인천광역시,서구,당하동,관내사전투표,7459,7459,5153,1565,599,79,6,7402,57,0,69.61631991353688,21.14293434206971,8.092407457443935,1.0672791137530397,0.0810591731964334
125,인천광역시,서구,당하동,당하동제1투,3766,2401,1083,1060,213,27,2,2385,16,1365,45.40880503144654,44.44444444444444,8.930817610062892,1.1320754716981132,0.08385744234800838
126,인천광역시,서구,당하동,당하동제2투,3201,2182,1054,908,183,19,3,2167,15,1019,48.63867097369635,41.90124596215966,8.444854637748039,0.8767881864328565,0.1384402399630826
127,인천광역시,서구,당하동,당하동제3투,2527,1705,701,820,149,15,2,1687,18,822,41.55305275637226,48.60699466508595,8.832246591582692,0.8891523414344991,0.11855364552459988
128,인천광역시,서구,당하동,당하동제4투,3046,1983,951,846,163,14,3,1977,6,1063,48.10318664643399,42.792109256449166,8.244815376833586,0.7081436519979768,0.15174506828528073
129,인천광역시,서구,당하동,당하동제5투,2597,1734,871,684,146,20,3,1724,10,863,50.522041763341065,39.675174013921115,8.468677494199536,1.160092807424594,0.17401392111368907
130,인천광역시,서구,오류왕길동,관내사전투표,4864,4863,3303,1198,301,38,8,4848,15,1,68.13118811881188,24.71122112211221,6.208745874587459,0.7838283828382838,0.16501650165016502
131,인천광역시,서구,오류왕길동,오류왕길동제1투,3533,2131,1019,915,165,21,1,2121,10,1402,48.043375766148046,43.14002828854314,7.779349363507778,0.9900990099009901,0.04714757190004715
132,인천광역시,서구,오류왕길동,오류왕길동제2투,3026,2006,861,950,162,21,5,1999,7,1020,43.07153576788394,47.52376188094047,8.104052026013006,1.0505252626313157,0.25012506253126565
133,인천광역시,서구,오류왕길동,오류왕길동제3투,3889,2475,1021,1244,177,18,3,2463,12,1414,41.4535119772635,50.50751116524563,7.186358099878197,0.730816077953715,0.12180267965895249
134,인천광역시,서구,오류왕길동,오류왕길동제4투,3616,2560,1271,1078,166,23,5,2543,17,1056,49.98033818324813,42.39087691702713,6.527723161620133,0.9044435705859222,0.19661816751867872
135,인천광역시,서구,마전동,관내사전투표,5253,5253,3640,1139,406,31,5,5221,32,0,69.71844474238652,21.815744110323692,7.776288067420034,0.5937559854434017,0.0957670944263551
136,인천광역시,서구,마전동,마전동제1투,3229,2134,947,986,167,16,0,2116,18,1095,44.75425330812855,46.59735349716446,7.8922495274102085,0.7561436672967864,0.0
137,인천광역시,서구,마전동,마전동제2투,2396,1648,658,809,146,21,2,1636,12,748,40.2200488997555,49.44987775061125,8.924205378973104,1.2836185819070904,0.12224938875305623
138,인천광역시,서구,마전동,마전동제3투,3600,2463,1223,980,223,25,2,2453,10,1137,49.85731757032206,39.951080309824704,9.090909090909092,1.019160211985324,0.08153281695882593
139,인천광역시,서구,마전동,마전동제4투,1866,1182,488,556,110,13,2,1169,13,684,41.74508126603935,47.56201881950385,9.409751924721984,1.1120615911035072,0.1710863986313088
140,인천광역시,서구,아라동,관내사전투표,9489,9488,6660,1769,914,91,4,9438,50,1,70.56579783852511,18.743377834286925,9.684255138800593,0.9641873278236914,0.04238186056367875
141,인천광역시,서구,아라동,아라동제1투,3169,2325,1186,833,263,27,1,2310,15,844,51.341991341991346,36.06060606060606,11.385281385281386,1.1688311688311688,0.04329004329004329
142,인천광역시,서구,아라동,아라동제2투,3532,2754,1384,1024,302,26,2,2738,16,778,50.54784514243974,37.39956172388605,11.029948867786706,0.9495982468955442,0.07304601899196494
143,인천광역시,서구,아라동,아라동제3투,3492,2608,1302,1019,251,24,1,2597,11,884,50.13477088948787,39.23758182518291,9.664998074701579,0.9241432422025414,0.03850596842510589
144,인천광역시,서구,아라동,아라동제4투,3691,2642,1171,1118,305,32,3,2629,13,1049,44.54165081780145,42.52567516165843,11.601369341955117,1.2171928489920123,0.11411182959300115
145,인천광역시,서구,아라동,아라동제5투,2847,2072,1006,837,195,22,0,2060,12,775,48.834951456310684,40.631067961165044,9.466019417475728,1.0679611650485437,0.0
146,인천광역시,서구,아라동,아라동제6투,4558,3327,1634,1244,366,54,1,3299,28,1231,49.53016065474386,37.70839648378296,11.094270991209457,1.6368596544407397,0.03031221582297666
147,인천광역시,서구,아라동,아라동제7투,4244,2914,1432,1176,251,37,3,2899,15,1330,49.396343566747156,40.56571231459124,8.658157985512245,1.2763021731631596,0.10348395998620215
148,인천광역시,서구,아라동,아라동제8투,3672,2866,1552,1004,267,28,1,2852,14,806,54.4179523141655,35.203366058906035,9.361851332398317,0.9817671809256662,0.03506311360448808
149,인천광역시,서구,아라동,아라동제9투,2991,2171,1070,874,182,26,3,2155,16,820,49.651972157772626,40.556844547563806,8.445475638051043,1.2064965197215778,0.13921113689095127
150,인천광역시,서구,아라동,아라동제10투,2597,1774,732,727,270,26,1,1756,18,823,41.68564920273349,41.40091116173121,15.375854214123008,1.4806378132118452,0.05694760820045558
151,인천광역시,서구,잘못 투입·구분된 투표지,,0,10,4,4,2,0,0,10,0,-10,40.0,40.0,20.0,0.0,0.0
0,인천광역시,강화군,거소·선상투표,,151,138,53,57,21,3,1,135,3,13,39.25925925925926,42.22222222222222,15.555555555555555,2.2222222222222223,0.7407407407407408
1,인천광역시,강화군,관외사전투표,,6271,6268,3041,2491,601,89,7,6229,39,3,48.82003531867073,39.99036763525445,9.648418686787606,1.4288007705891796,0.11237758869802536
2,인천광역시,강화군,재외투표,,341,273,207,41,20,3,0,271,2,68,76.38376383763837,15.129151291512915,7.380073800738007,1.107011070110701,0.0
3,인천광역시,강화군,강화읍,관내사전투표,5453,5453,2999,2043,321,48,6,5417,36,0,55.36274690788259,37.71460217832749,5.925789182204172,0.8860993169651098,0.11076241462063872
4,인천광역시,강화군,강화읍,강화읍제1투,1314,795,234,530,22,6,1,793,2,519,29.508196721311474,66.83480453972257,2.7742749054224465,0.7566204287515763,0.12610340479192939
5,인천광역시,강화군,강화읍,강화읍제2투,2146,1340,408,862,56,3,4,1333,7,806,30.607651912978245,64.6661665416354,4.201050262565642,0.22505626406601648,0.30007501875468867
6,인천광역시,강화군,강화읍,강화읍제3투,1053,617,172,407,29,4,1,613,4,436,28.05872756933116,66.394779771615,4.730831973898858,0.6525285481239804,0.1631321370309951
7,인천광역시,강화군,강화읍,강화읍제4투,1692,1030,326,647,44,5,2,1024,6,662,31.8359375,63.18359375,4.296875,0.48828125,0.1953125
8,인천광역시,강화군,강화읍,강화읍제5투,2642,1705,614,965,96,14,2,1691,14,937,36.30987581312833,57.06682436428149,5.677114133648729,0.827912477823773,0.11827321111768185
9,인천광역시,강화군,강화읍,강화읍제6투,1251,764,217,490,48,6,0,761,3,487,28.51511169513798,64.38896189224704,6.307490144546649,0.7884362680683311,0.0
10,인천광역시,강화군,강화읍,강화읍제7투,1946,1188,386,735,47,9,4,1181,7,758,32.68416596104996,62.235393734123626,3.979678238780694,0.7620660457239627,0.3386960203217612
11,인천광역시,강화군,선원면,관내사전투표,2389,2389,1345,892,120,16,0,2373,16,0,56.67930889169828,37.58954909397387,5.056890012642225,0.67425200168563,0.0
12,인천광역시,강화군,선원면,선원면제1투,1677,1029,269,711,38,2,2,1022,7,648,26.320939334637966,69.56947162426614,3.7181996086105675,0.19569471624266144,0.19569471624266144
13,인천광역시,강화군,선원면,선원면제2투,3273,2092,721,1221,116,22,0,2080,12,1181,34.66346153846154,58.70192307692308,5.5769230769230775,1.0576923076923077,0.0
14,인천광역시,강화군,불은면,관내사전투표,1322,1322,657,595,57,8,1,1318,4,0,49.84825493171472,45.144157814871015,4.324734446130501,0.6069802731411229,0.07587253414264036
15,인천광역시,강화군,불은면,불은면제1투,1792,1023,256,730,28,4,1,1019,4,769,25.122669283611383,71.6388616290481,2.747791952894995,0.39254170755642787,0.09813542688910697
16,인천광역시,강화군,불은면,불은면제2투,950,585,151,406,21,1,0,579,6,365,26.07944732297064,70.12089810017271,3.6269430051813467,0.17271157167530224,0.0
17,인천광역시,강화군,길상면,관내사전투표,2218,2218,1192,911,82,16,3,2204,14,0,54.08348457350273,41.33393829401089,3.720508166969147,0.7259528130671506,0.13611615245009073
18,인천광역시,강화군,길상면,길상면제1투,1570,924,224,646,39,7,0,916,8,646,24.45414847161572,70.52401746724891,4.25764192139738,0.7641921397379913,0.0
19,인천광역시,강화군,길상면,길상면제2투,1008,653,143,488,20,0,0,651,2,355,21.96620583717358,74.96159754224271,3.0721966205837172,0.0,0.0
20,인천광역시,강화군,길상면,길상면제3투,942,592,137,419,30,1,1,588,4,350,23.299319727891156,71.25850340136054,5.1020408163265305,0.17006802721088435,0.17006802721088435
21,인천광역시,강화군,길상면,길상면제4투,520,352,70,264,16,2,0,352,0,168,19.886363636363637,75.0,4.545454545454546,0.5681818181818182,0.0
22,인천광역시,강화군,화도면,관내사전투표,908,908,476,383,39,7,0,905,3,0,52.59668508287293,42.32044198895027,4.30939226519337,0.7734806629834254,0.0
23,인천광역시,강화군,화도면,화도면제1투,967,592,113,453,17,2,0,585,7,375,19.31623931623932,77.43589743589745,2.905982905982906,0.3418803418803419,0.0
24,인천광역시,강화군,화도면,화도면제2투,677,429,98,317,8,4,1,428,1,248,22.897196261682243,74.06542056074767,1.8691588785046727,0.9345794392523363,0.23364485981308408
25,인천광역시,강화군,화도면,화도면제3투,555,355,87,260,7,0,0,354,1,200,24.576271186440678,73.44632768361582,1.977401129943503,0.0,0.0
26,인천광역시,강화군,화도면,화도면제4투,412,252,52,192,8,0,0,252,0,160,20.634920634920633,76.19047619047619,3.1746031746031744,0.0,0.0
27,인천광역시,강화군,양도면,관내사전투표,988,987,446,478,46,8,0,978,9,1,45.603271983640084,48.875255623721884,4.703476482617587,0.81799591002045,0.0
28,인천광역시,강화군,양도면,양도면제1투,1212,677,178,466,30,2,1,677,0,535,26.292466765140325,68.83308714918759,4.431314623338257,0.29542097488921715,0.14771048744460857
29,인천광역시,강화군,양도면,양도면제2투,1126,726,151,543,20,11,0,725,1,400,20.82758620689655,74.89655172413792,2.7586206896551726,1.5172413793103448,0.0
30,인천광역시,강화군,내가면,관내사전투표,812,812,385,377,44,5,0,811,1,0,47.47225647348952,46.48581997533909,5.425400739827373,0.6165228113440198,0.0
31,인천광역시,강화군,내가면,내가면제1투,843,550,141,389,14,2,0,546,4,293,25.82417582417583,71.24542124542124,2.564102564102564,0.3663003663003663,0.0
32,인천광역시,강화군,내가면,내가면제2투,421,288,72,198,15,0,0,285,3,133,25.263157894736842,69.47368421052632,5.263157894736842,0.0,0.0
33,인천광역시,강화군,내가면,내가면제3투,436,312,79,224,7,1,1,312,0,124,25.320512820512818,71.7948717948718,2.2435897435897436,0.3205128205128205,0.3205128205128205
34,인천광역시,강화군,하점면,관내사전투표,1036,1036,505,466,53,8,0,1032,4,0,48.934108527131784,45.15503875968992,5.135658914728682,0.7751937984496124,0.0
35,인천광역시,강화군,하점면,하점면제1투,1066,621,134,461,18,3,2,618,3,445,21.68284789644013,74.59546925566343,2.912621359223301,0.48543689320388345,0.3236245954692557
36,인천광역시,강화군,하점면,하점면제2투,590,389,79,291,13,2,1,386,3,201,20.466321243523318,75.38860103626943,3.3678756476683938,0.5181347150259068,0.2590673575129534
37,인천광역시,강화군,하점면,하점면제3투,612,326,79,232,11,2,0,324,2,286,24.382716049382715,71.60493827160494,3.3950617283950617,0.6172839506172839,0.0
38,인천광역시,강화군,양사면,관내사전투표,380,380,184,173,19,3,0,379,1,0,48.54881266490765,45.64643799472295,5.013192612137203,0.79155672823219,0.0
39,인천광역시,강화군,양사면,양사면제1투,347,235,47,179,7,1,0,234,1,112,20.085470085470085,76.49572649572649,2.9914529914529915,0.4273504273504274,0.0
40,인천광역시,강화군,양사면,양사면제2투,501,332,85,229,11,1,0,326,6,169,26.07361963190184,70.24539877300614,3.374233128834356,0.3067484662576687,0.0
41,인천광역시,강화군,양사면,양사면제3투,236,171,37,125,4,2,0,168,3,65,22.023809523809522,74.40476190476191,2.380952380952381,1.1904761904761905,0.0
42,인천광역시,강화군,송해면,관내사전투표,1197,1197,533,585,64,8,0,1190,7,0,44.78991596638656,49.159663865546214,5.378151260504202,0.6722689075630253,0.0
43,인천광역시,강화군,송해면,송해면투표소,1611,936,213,666,46,7,1,933,3,675,22.829581993569132,71.38263665594855,4.930332261521972,0.7502679528403001,0.10718113612004287
44,인천광역시,강화군,교동면,관내사전투표,801,801,351,392,41,8,0,792,9,0,44.31818181818182,49.494949494949495,5.1767676767676765,1.0101010101010102,0.0
45,인천광역시,강화군,교동면,교동면제1투,643,371,91,263,13,0,0,367,4,272,24.795640326975477,71.66212534059946,3.5422343324250685,0.0,0.0
46,인천광역시,강화군,교동면,교동면제2투,456,303,73,218,8,2,0,301,2,153,24.25249169435216,72.42524916943522,2.6578073089700998,0.6644518272425249,0.0
47,인천광역시,강화군,교동면,교동면제3투,395,250,73,152,5,1,2,233,17,145,31.330472103004293,65.23605150214593,2.1459227467811157,0.4291845493562232,0.8583690987124464
48,인천광역시,강화군,삼산면,관내사전투표,528,528,248,259,16,3,1,527,1,0,47.05882352941176,49.146110056926,3.0360531309297913,0.5692599620493358,0.18975332068311196
49,인천광역시,강화군,삼산면,삼산면제1투,366,210,41,160,7,1,0,209,1,156,19.617224880382775,76.55502392344498,3.349282296650718,0.4784688995215311,0.0
50,인천광역시,강화군,삼산면,삼산면제2투,198,109,35,68,4,0,0,107,2,89,32.71028037383177,63.55140186915887,3.7383177570093453,0.0,0.0
51,인천광역시,강화군,삼산면,삼산면제3투,594,360,74,273,11,2,0,360,0,234,20.555555555555554,75.83333333333333,3.0555555555555554,0.5555555555555556,0.0
52,인천광역시,강화군,삼산면,삼산면제4투,50,42,8,28,4,0,0,40,2,8,20.0,70.0,10.0,0.0,0.0
53,인천광역시,강화군,서도면,관내사전투표,107,107,48,51,7,1,0,107,0,0,44.85981308411215,47.66355140186916,6.5420560747663545,0.9345794392523363,0.0
54,인천광역시,강화군,서도면,서도면제1투,200,132,22,105,3,0,0,130,2,68,16.923076923076923,80.76923076923077,2.307692307692308,0.0,0.0
55,인천광역시,강화군,서도면,서도면제2투,207,160,35,116,5,1,1,158,2,47,22.151898734177212,73.41772151898735,3.1645569620253164,0.6329113924050633,0.6329113924050633
56,인천광역시,강화군,잘못 투입·구분된 투표지,,0,0,0,0,0,0,0,0,0,0,0.0,0.0,0.0,0.0,0.0
0,인천광역시,옹진군,거소·선상투표,,94,85,31,34,15,1,0,81,4,9,38.2716049382716,41.9753086419753,18.51851851851852,1.2345679012345678,0.0
1,인천광역시,옹진군,관외사전투표,,3139,3139,1435,1313,323,32,2,3105,34,0,46.2157809983897,42.2866344605475,10.402576489533011,1.030595813204509,0.06441223832528181
2,인천광역시,옹진군,재외투표,,56,41,32,5,3,1,0,41,0,15,78.04878048780488,12.195121951219512,7.317073170731707,2.4390243902439024,0.0
3,인천광역시,옹진군,북도면,관내사전투표,301,301,105,173,18,2,0,298,3,0,35.23489932885906,58.053691275167786,6.0402684563758395,0.6711409395973155,0.0
4,인천광역시,옹진군,북도면,북도면제1투,305,202,30,164,7,0,1,202,0,103,14.85148514851485,81.1881188118812,3.4653465346534658,0.0,0.49504950495049505
5,인천광역시,옹진군,북도면,북도면제2투,225,131,11,117,1,0,1,130,1,94,8.461538461538462,90.0,0.7692307692307693,0.0,0.7692307692307693
6,인천광역시,옹진군,북도면,북도면제3투,674,509,133,326,17,4,2,482,27,165,27.593360995850624,67.63485477178423,3.5269709543568464,0.8298755186721992,0.4149377593360996
7,인천광역시,옹진군,연평면,관내사전투표,613,613,277,240,80,4,3,604,9,0,45.860927152317885,39.735099337748345,13.245033112582782,0.6622516556291391,0.49668874172185434
8,인천광역시,옹진군,연평면,연평면제1투,818,371,91,254,23,1,0,369,2,447,24.661246612466126,68.83468834688347,6.233062330623306,0.27100271002710025,0.0
9,인천광역시,옹진군,연평면,연평면제2투,66,47,21,21,2,0,0,44,3,19,47.72727272727273,47.72727272727273,4.545454545454546,0.0,0.0
10,인천광역시,옹진군,백령면,관내사전투표,1165,1165,510,460,169,9,2,1150,15,0,44.34782608695652,40.0,14.695652173913043,0.782608695652174,0.17391304347826086
11,인천광역시,옹진군,백령면,백령면제1투,928,533,129,365,31,3,0,528,5,395,24.431818181818183,69.12878787878788,5.871212121212121,0.5681818181818182,0.0
12,인천광역시,옹진군,백령면,백령면제2투,1045,615,155,381,61,4,0,601,14,430,25.79034941763727,63.394342762063225,10.149750415973378,0.6655574043261231,0.0
13,인천광역시,옹진군,백령면,백령면제3투,315,230,46,175,7,0,0,228,2,85,20.175438596491226,76.75438596491229,3.070175438596491,0.0,0.0
14,인천광역시,옹진군,백령면,백령면제4투,267,191,33,145,11,0,0,189,2,76,17.46031746031746,76.71957671957672,5.82010582010582,0.0,0.0
15,인천광역시,옹진군,대청면,관내사전투표,406,406,129,221,45,4,1,400,6,0,32.25,55.25,11.25,1.0,0.25
16,인천광역시,옹진군,대청면,대청면제1투,301,147,33,104,7,3,0,147,0,154,22.448979591836736,70.74829931972789,4.761904761904762,2.0408163265306123,0.0
17,인천광역시,옹진군,대청면,대청면제2투,263,183,48,125,9,0,0,182,1,80,26.373626373626376,68.68131868131869,4.945054945054945,0.0,0.0
18,인천광역시,옹진군,대청면,대청면제3투,175,145,31,104,8,0,0,143,2,30,21.678321678321677,72.72727272727273,5.594405594405594,0.0,0.0
19,인천광역시,옹진군,덕적면,관내사전투표,434,434,195,203,25,5,3,431,3,0,45.243619489559165,47.09976798143852,5.800464037122969,1.160092807424594,0.6960556844547563
20,인천광역시,옹진군,덕적면,덕적면제1투,392,217,53,157,2,2,0,214,3,175,24.766355140186917,73.36448598130842,0.9345794392523363,0.9345794392523363,0.0
21,인천광역시,옹진군,덕적면,덕적면제2투,264,181,49,122,4,1,0,176,5,83,27.84090909090909,69.31818181818183,2.272727272727273,0.5681818181818182,0.0
22,인천광역시,옹진군,덕적면,덕적면제3투,187,132,28,94,6,2,0,130,2,55,21.53846153846154,72.3076923076923,4.615384615384616,1.5384615384615385,0.0
23,인천광역시,옹진군,덕적면,덕적면제4투,65,56,14,41,1,0,0,56,0,9,25.0,73.21428571428571,1.7857142857142856,0.0,0.0
24,인천광역시,옹진군,덕적면,덕적면제5투,41,29,4,24,1,0,0,29,0,12,13.793103448275861,82.75862068965517,3.4482758620689653,0.0,0.0
25,인천광역시,옹진군,덕적면,덕적면제6투,44,31,12,18,0,0,0,30,1,13,40.0,60.0,0.0,0.0,0.0
26,인천광역시,옹진군,자월면,관내사전투표,246,246,94,134,12,2,1,243,3,0,38.68312757201646,55.144032921810705,4.938271604938271,0.823045267489712,0.411522633744856
27,인천광역시,옹진군,자월면,자월면제1투,256,139,28,102,7,1,0,138,1,117,20.28985507246377,73.91304347826086,5.072463768115942,0.7246376811594203,0.0
28,인천광역시,옹진군,자월면,자월면제2투,188,139,43,91,4,0,0,138,1,49,31.15942028985507,65.94202898550725,2.898550724637681,0.0,0.0
29,인천광역시,옹진군,자월면,자월면제3투,212,162,43,116,3,0,0,162,0,50,26.543209876543212,71.60493827160494,1.8518518518518516,0.0,0.0
30,인천광역시,옹진군,자월면,자월면제4투,74,56,7,47,1,0,0,55,1,18,12.727272727272727,85.45454545454545,1.8181818181818181,0.0,0.0
31,인천광역시,옹진군,영흥면,관내사전투표,1797,1797,997,644,120,12,4,1777,20,0,56.10579628587507,36.24085537422622,6.752954417557682,0.6752954417557682,0.22509848058525606
32,인천광역시,옹진군,영흥면,영흥면제1투,1428,804,227,534,29,8,1,799,5,624,28.410513141426787,66.83354192740926,3.629536921151439,1.0012515644555695,0.1251564455569462
33,인천광역시,옹진군,영흥면,영흥면제2투,1180,707,198,460,35,3,1,697,10,473,28.407460545193686,65.99713055954088,5.0215208034433285,0.430416068866571,0.1434720229555237
34,인천광역시,옹진군,영흥면,영흥면제3투,590,419,97,302,15,0,1,415,4,171,23.373493975903614,72.77108433734941,3.614457831325301,0.0,0.24096385542168677
35,인천광역시,옹진군,잘못 투입·구분된 투표지,,0,0,0,0,0,0,0,0,0,0,0.0,0.0,0.0,0.0,0.0
0,광주광역시,동구,거소·선상투표,,268,261,192,32,26,2,0,252,9,7,76.19047619047619,12.698412698412698,10.317460317460316,0.7936507936507936,0.0
1,광주광역시,동구,관외사전투표,,17402,17398,14617,981,1504,182,15,17299,99,4,84.49621365396844,5.670848025897451,8.694144170183247,1.0520839354876004,0.08671021446326377
2,광주광역시,동구,재외투표,,432,368,308,29,21,9,0,367,1,64,83.92370572207084,7.901907356948229,5.722070844686648,2.452316076294278,0.0
3,광주광역시,동구,충장동,관내사전투표,1929,1929,1641,117,140,21,2,1921,8,0,85.42425819885476,6.090577824049974,7.287870900572618,1.0931806350858928,0.10411244143675169
4,광주광역시,동구,충장동,충장동제1투,1203,632,430,119,71,2,1,623,9,571,69.02086677367576,19.101123595505616,11.396468699839486,0.32102728731942215,0.16051364365971107
5,광주광역시,동구,충장동,충장동제2투,1373,730,419,173,114,11,1,718,12,643,58.35654596100278,24.094707520891365,15.87743732590529,1.532033426183844,0.1392757660167131
6,광주광역시,동구,동명동,관내사전투표,1441,1441,1197,94,121,18,0,1430,11,0,83.7062937062937,6.573426573426573,8.461538461538462,1.2587412587412588,0.0
7,광주광역시,동구,동명동,동명동제1투,769,380,234,87,49,4,0,374,6,389,62.56684491978609,23.262032085561497,13.101604278074866,1.06951871657754,0.0
8,광주광역시,동구,동명동,동명동제2투,767,437,322,62,37,12,2,435,2,330,74.02298850574712,14.25287356321839,8.505747126436782,2.7586206896551726,0.45977011494252873
9,광주광역시,동구,계림1동,관내사전투표,2733,2733,2463,131,108,18,1,2721,12,0,90.51819184123484,4.814406468210216,3.9691289966923926,0.6615214994487321,0.03675119441381845
10,광주광역시,동구,계림1동,계림1동제1투,1051,494,378,78,29,5,1,491,3,557,76.9857433808554,15.885947046843176,5.906313645621181,1.0183299389002036,0.20366598778004072
11,광주광역시,동구,계림1동,계림1동제2투,1064,554,416,95,34,1,0,546,8,510,76.19047619047619,17.399267399267398,6.227106227106227,0.18315018315018314,0.0
12,광주광역시,동구,계림1동,계림1동제3투,2205,1727,1283,247,164,21,1,1716,11,478,74.76689976689977,14.393939393939394,9.557109557109557,1.2237762237762237,0.05827505827505827
13,광주광역시,동구,계림2동,관내사전투표,3972,3972,3558,215,150,26,3,3952,20,0,90.03036437246963,5.440283400809717,3.7955465587044532,0.6578947368421052,0.07591093117408906
14,광주광역시,동구,계림2동,계림2동제1투,1779,1224,906,202,96,11,1,1216,8,555,74.50657894736842,16.611842105263158,7.894736842105263,0.9046052631578948,0.08223684210526315
15,광주광역시,동구,계림2동,계림2동제2투,1894,1491,1138,200,129,15,1,1483,8,403,76.73634524612272,13.486176668914363,8.698583951449763,1.0114632501685772,0.06743088334457181
16,광주광역시,동구,계림2동,계림2동제3투,1152,861,642,157,43,15,2,859,2,291,74.73806752037252,18.277066356228172,5.005820721769499,1.7462165308498252,0.23282887077997672
17,광주광역시,동구,산수1동,관내사전투표,2476,2476,2226,129,97,18,0,2470,6,0,90.12145748987854,5.222672064777328,3.9271255060728745,0.728744939271255,0.0
18,광주광역시,동구,산수1동,산수1동제1투,974,605,470,86,33,11,1,601,4,369,78.20299500831946,14.309484193011649,5.490848585690515,1.8302828618968388,0.16638935108153077
19,광주광역시,동구,산수1동,산수1동제2투,1075,595,490,68,25,8,1,592,3,480,82.77027027027027,11.486486486486488,4.222972972972973,1.3513513513513513,0.16891891891891891
20,광주광역시,동구,산수1동,산수1동제3투,949,622,443,117,45,11,1,617,5,327,71.79902755267423,18.962722852512158,7.293354943273905,1.7828200972447326,0.1620745542949757
21,광주광역시,동구,산수2동,관내사전투표,2713,2713,2457,137,80,22,1,2697,16,0,91.10122358175751,5.079718205413422,2.966258806080831,0.8157211716722284,0.03707823507601038
22,광주광역시,동구,산수2동,산수2동제1투,777,402,308,62,23,4,1,398,4,375,77.38693467336684,15.577889447236181,5.778894472361809,1.0050251256281406,0.25125628140703515
23,광주광역시,동구,산수2동,산수2동제2투,1169,834,657,108,47,15,1,828,6,335,79.34782608695652,13.043478260869565,5.676328502415459,1.8115942028985508,0.12077294685990338
24,광주광역시,동구,산수2동,산수2동제3투,840,581,463,76,33,2,2,576,5,259,80.38194444444444,13.194444444444445,5.729166666666666,0.3472222222222222,0.3472222222222222
25,광주광역시,동구,산수2동,산수2동제4투,1022,784,579,164,34,6,0,783,1,238,73.9463601532567,20.94508301404853,4.342273307790549,0.7662835249042145,0.0
26,광주광역시,동구,지산1동,관내사전투표,1639,1639,1367,127,117,18,3,1632,7,0,83.76225490196079,7.7818627450980395,7.169117647058823,1.1029411764705883,0.1838235294117647
27,광주광역시,동구,지산1동,지산1동투표소,1522,803,504,190,90,6,4,794,9,719,63.476070528967256,23.929471032745592,11.335012594458437,0.7556675062972292,0.5037783375314862
28,광주광역시,동구,지산2동,관내사전투표,1147,1147,1005,70,55,9,0,1139,8,0,88.23529411764706,6.145741878841089,4.8287971905179985,0.7901668129938543,0.0
29,광주광역시,동구,지산2동,지산2동제1투,1226,685,450,164,59,2,1,676,9,541,66.5680473372781,24.2603550295858,8.727810650887575,0.2958579881656805,0.14792899408284024
30,광주광역시,동구,지산2동,지산2동제2투,447,221,156,40,19,4,0,219,2,226,71.23287671232876,18.2648401826484,8.67579908675799,1.82648401826484,0.0
31,광주광역시,동구,서남동,관내사전투표,1715,1715,1348,131,199,17,2,1697,18,0,79.43429581614613,7.719505008839128,11.726576311137302,1.0017678255745435,0.11785503830288745
32,광주광역시,동구,서남동,서남동투표소,1303,647,409,125,91,10,2,637,10,656,64.2072213500785,19.623233908948194,14.285714285714285,1.5698587127158554,0.3139717425431711
33,광주광역시,동구,학동,관내사전투표,2254,2254,1885,161,188,12,0,2246,8,0,83.92698130008904,7.168299198575245,8.370436331255565,0.5342831700801425,0.0
34,광주광역시,동구,학동,학동제1투,1328,1040,847,111,69,12,0,1039,1,288,81.52069297401347,10.68334937439846,6.641000962463909,1.1549566891241578,0.0
35,광주광역시,동구,학동,학동제2투,1309,826,494,215,104,7,0,820,6,483,60.24390243902439,26.21951219512195,12.682926829268293,0.853658536585366,0.0
36,광주광역시,동구,학운동,관내사전투표,4363,4363,3902,276,148,20,2,4348,15,0,89.74241030358786,6.347746090156393,3.403863845446182,0.45998160073597055,0.045998160073597055
37,광주광역시,동구,학운동,학운동제1투,871,466,312,110,37,3,0,462,4,405,67.53246753246754,23.809523809523807,8.008658008658008,0.6493506493506493,0.0
38,광주광역시,동구,학운동,학운동제2투,1307,855,575,204,60,8,0,847,8,452,67.88665879574971,24.08500590318772,7.083825265643448,0.9445100354191263,0.0
39,광주광역시,동구,학운동,학운동제3투,875,626,464,117,31,8,0,620,6,249,74.83870967741936,18.870967741935484,5.0,1.2903225806451613,0.0
40,광주광역시,동구,학운동,학운동제4투,1111,779,563,155,45,8,2,773,6,332,72.83311772315653,20.051746442432083,5.821474773609314,1.034928848641656,0.258732212160414
41,광주광역시,동구,지원1동,관내사전투표,3011,3011,2740,133,100,22,1,2996,15,0,91.45527369826435,4.439252336448598,3.337783711615487,0.7343124165554071,0.03337783711615487
42,광주광역시,동구,지원1동,지원1동제1투,1221,774,599,106,58,7,0,770,4,447,77.79220779220779,13.766233766233766,7.532467532467532,0.9090909090909091,0.0
43,광주광역시,동구,지원1동,지원1동제2투,1784,1141,850,181,90,14,1,1136,5,643,74.82394366197182,15.933098591549296,7.922535211267606,1.232394366197183,0.08802816901408451
44,광주광역시,동구,지원2동,관내사전투표,4025,4025,3668,174,143,21,3,4009,16,0,91.49413818907458,4.340234472437017,3.5669743078074334,0.5238214018458469,0.07483162883512097
45,광주광역시,동구,지원2동,지원2동제1투,1366,1048,845,130,57,10,1,1043,5,318,81.01629913710451,12.464046021093,5.465004793863854,0.9587727708533078,0.09587727708533077
46,광주광역시,동구,지원2동,지원2동제2투,1940,1380,1116,172,65,15,2,1370,10,560,81.45985401459855,12.554744525547445,4.744525547445255,1.094890510948905,0.145985401459854
47,광주광역시,동구,지원2동,지원2동제3투,1511,825,615,144,51,10,1,821,4,686,74.90864799025579,17.53958587088916,6.211936662606577,1.2180267965895248,0.12180267965895249
48,광주광역시,동구,지원2동,지원2동제4투,1582,1030,732,200,83,9,0,1024,6,552,71.484375,19.53125,8.10546875,0.87890625,0.0
49,광주광역시,동구,잘못 투입·구분된 투표지,,0,1,1,0,0,0,0,1,0,-1,100.0,0.0,0.0,0.0,0.0
0,광주광역시,서구,거소·선상투표,,510,476,353,56,58,1,0,468,8,34,75.42735042735043,11.965811965811966,12.393162393162394,0.2136752136752137,0.0
1,광주광역시,서구,관외사전투표,,37324,37320,30996,2281,3405,326,44,37052,268,4,83.65540321710029,6.156212889992442,9.189787325920328,0.8798445428047068,0.11875202418223038
2,광주광역시,서구,재외투표,,901,751,646,48,45,8,0,747,4,150,86.47925033467202,6.425702811244979,6.024096385542169,1.07095046854083,0.0
3,광주광역시,서구,양동,관내사전투표,1733,1733,1604,76,41,6,0,1727,6,0,92.87782281412854,4.400694846554718,2.3740590619571513,0.3474232773595831,0.0
4,광주광역시,서구,양동,양동제1투,723,438,344,67,17,7,0,435,3,285,79.08045977011494,15.402298850574713,3.9080459770114944,1.6091954022988506,0.0
5,광주광역시,서구,양동,양동제2투,485,244,192,41,5,1,0,239,5,241,80.3347280334728,17.154811715481173,2.092050209205021,0.41841004184100417,0.0
6,광주광역시,서구,양3동,관내사전투표,1597,1597,1485,48,47,13,2,1595,2,0,93.10344827586206,3.0094043887147337,2.946708463949843,0.8150470219435737,0.12539184952978058
7,광주광역시,서구,양3동,양3동제1투,1047,689,538,91,45,6,2,682,7,358,78.88563049853371,13.343108504398826,6.598240469208211,0.8797653958944283,0.2932551319648094
8,광주광역시,서구,양3동,양3동제2투,519,359,285,46,22,3,1,357,2,160,79.83193277310924,12.885154061624648,6.162464985994398,0.8403361344537815,0.2801120448179272
9,광주광역시,서구,농성1동,관내사전투표,3370,3370,3047,161,129,17,2,3356,14,0,90.79261025029798,4.797377830750894,3.843861740166865,0.5065554231227652,0.05959475566150178
10,광주광역시,서구,농성1동,농성1동제1투,1068,563,432,87,34,6,0,559,4,505,77.28085867620752,15.56350626118068,6.082289803220036,1.073345259391771,0.0
11,광주광역시,서구,농성1동,농성1동제2투,1698,949,680,169,87,5,1,942,7,749,72.1868365180467,17.940552016985137,9.235668789808917,0.5307855626326964,0.10615711252653928
12,광주광역시,서구,농성1동,농성1동제3투,1739,925,648,176,84,12,1,921,4,814,70.35830618892508,19.109663409337678,9.120521172638437,1.3029315960912053,0.10857763300760044
13,광주광역시,서구,농성2동,관내사전투표,2047,2047,1815,99,101,14,2,2031,16,0,89.36484490398819,4.874446085672083,4.972919743968488,0.6893156080748399,0.09847365829640572
14,광주광역시,서구,농성2동,농성2동제1투,991,487,367,82,29,3,0,481,6,504,76.29937629937629,17.04781704781705,6.029106029106029,0.6237006237006237,0.0
15,광주광역시,서구,농성2동,농성2동제2투,930,547,401,91,40,12,0,544,3,383,73.71323529411765,16.727941176470587,7.352941176470589,2.2058823529411766,0.0
16,광주광역시,서구,광천동,관내사전투표,2059,2059,1813,122,97,14,3,2049,10,0,88.48218643240605,5.954123962908736,4.7340165934602245,0.6832601268911664,0.14641288433382138
17,광주광역시,서구,광천동,광천동제1투,925,482,331,101,40,7,0,479,3,443,69.10229645093946,21.08559498956159,8.350730688935283,1.4613778705636742,0.0
18,광주광역시,서구,광천동,광천동제2투,985,645,457,127,44,9,1,638,7,340,71.63009404388715,19.905956112852667,6.896551724137931,1.4106583072100314,0.1567398119122257
19,광주광역시,서구,유덕동,관내사전투표,2575,2575,2372,96,78,14,3,2563,12,0,92.5477955520874,3.745610612563402,3.043308622707764,0.5462348809988294,0.11705033164260631
20,광주광역시,서구,유덕동,유덕동제1투,321,170,140,20,7,0,0,167,3,151,83.8323353293413,11.976047904191617,4.191616766467066,0.0,0.0
21,광주광역시,서구,유덕동,유덕동제2투,2118,1480,1195,139,118,17,3,1472,8,638,81.18206521739131,9.442934782608695,8.016304347826086,1.154891304347826,0.20380434782608695
22,광주광역시,서구,유덕동,유덕동제3투,2042,1462,1189,146,96,21,1,1453,9,580,81.83069511355816,10.048176187198898,6.607019958706125,1.445285615966965,0.06882312456985547
23,광주광역시,서구,치평동,관내사전투표,8808,8808,7862,420,430,53,4,8769,39,0,89.65674535294788,4.7895997263085865,4.90363781503022,0.604401870224655,0.045615235488653205
24,광주광역시,서구,치평동,치평동제1투,2127,1347,1016,218,92,15,0,1341,6,780,75.76435495898583,16.256524981357195,6.86055182699478,1.1185682326621924,0.0
25,광주광역시,서구,치평동,치평동제2투,1808,1226,944,156,99,17,2,1218,8,582,77.504105090312,12.807881773399016,8.12807881773399,1.3957307060755337,0.16420361247947454
26,광주광역시,서구,치평동,치평동제3투,1955,1355,989,228,115,16,0,1348,7,600,73.3679525222552,16.913946587537094,8.531157270029674,1.1869436201780417,0.0
27,광주광역시,서구,치평동,치평동제4투,2500,1725,1331,250,113,19,1,1714,11,775,77.65460910151693,14.585764294049008,6.592765460910152,1.1085180863477246,0.05834305717619603
28,광주광역시,서구,치평동,치평동제5투,1425,1068,838,134,73,14,2,1061,7,357,78.98209236569275,12.629594721960416,6.8803016022620165,1.3195098963242224,0.1885014137606032
29,광주광역시,서구,치평동,치평동제6투,3174,1942,1454,261,183,21,4,1923,19,1232,75.61102444097763,13.57254290171607,9.51638065522621,1.0920436817472698,0.20800832033281333
30,광주광역시,서구,상무1동,관내사전투표,8082,8082,7161,411,433,48,5,8058,24,0,88.86820551005212,5.100521221146686,5.373541821792008,0.5956813104988831,0.06205013651030032
31,광주광역시,서구,상무1동,상무1동제1투,2806,1723,1322,234,132,23,1,1712,11,1083,77.2196261682243,13.66822429906542,7.710280373831775,1.3434579439252337,0.05841121495327102
32,광주광역시,서구,상무1동,상무1동제2투,2043,1352,1059,178,86,17,0,1340,12,691,79.02985074626866,13.28358208955224,6.4179104477611935,1.2686567164179103,0.0
33,광주광역시,서구,상무1동,상무1동제3투,2043,1256,925,198,112,10,2,1247,9,787,74.17802726543705,15.878107457898958,8.981555733761027,0.8019246190858059,0.16038492381716118
34,광주광역시,서구,상무1동,상무1동제4투,1982,792,570,126,78,6,0,780,12,1190,73.07692307692307,16.153846153846153,10.0,0.7692307692307693,0.0
35,광주광역시,서구,상무1동,상무1동제5투,2050,1432,1163,142,97,19,2,1423,9,618,81.72874209416725,9.978917779339422,6.816584680252986,1.3352073085031624,0.14054813773717498
36,광주광역시,서구,상무2동,관내사전투표,6290,6290,5759,288,176,30,5,6258,32,0,92.02620645573666,4.6021093000958775,2.8124001278363697,0.4793863854266539,0.07989773090444231
37,광주광역시,서구,상무2동,상무2동제1투,1569,963,747,143,51,9,2,952,11,606,78.46638655462185,15.021008403361344,5.357142857142857,0.9453781512605042,0.21008403361344538
38,광주광역시,서구,상무2동,상무2동제2투,1290,628,465,130,26,3,2,626,2,662,74.28115015974441,20.766773162939298,4.15335463258786,0.4792332268370607,0.3194888178913738
39,광주광역시,서구,상무2동,상무2동제3투,2068,1373,1018,223,104,20,1,1366,7,695,74.52415812591508,16.325036603221083,7.613469985358712,1.4641288433382138,0.07320644216691069
40,광주광역시,서구,상무2동,상무2동제4투,2211,1193,898,171,102,10,2,1183,10,1018,75.90870667793745,14.454775993237531,8.622147083685546,0.84530853761623,0.16906170752324598
41,광주광역시,서구,상무2동,상무2동제5투,3161,1728,1332,226,134,18,4,1714,14,1433,77.71295215869311,13.185530921820304,7.8179696616102685,1.0501750291715286,0.2333722287047841
42,광주광역시,서구,화정1동,관내사전투표,4199,4199,3760,229,156,32,3,4180,19,0,89.95215311004785,5.478468899521531,3.732057416267943,0.7655502392344498,0.07177033492822966
43,광주광역시,서구,화정1동,화정1동제1투,2324,1715,1360,216,107,17,1,1701,14,609,79.95296884185773,12.698412698412698,6.290417401528512,0.9994121105232217,0.058788947677836566
44,광주광역시,서구,화정1동,화정1동제2투,2355,1419,1036,256,98,15,1,1406,13,936,73.68421052631578,18.207681365576104,6.970128022759601,1.0668563300142246,0.07112375533428165
45,광주광역시,서구,화정1동,화정1동제3투,2716,1509,1093,256,124,26,2,1501,8,1207,72.81812125249833,17.055296469020654,8.261159227181878,1.73217854763491,0.13324450366422386
46,광주광역시,서구,화정2동,관내사전투표,5893,5893,5314,277,243,37,1,5872,21,0,90.49727520435967,4.717302452316076,4.1382833787465945,0.6301089918256131,0.017029972752043595
47,광주광역시,서구,화정2동,화정2동제1투,1748,1116,845,162,88,15,2,1112,4,632,75.98920863309353,14.568345323741008,7.913669064748201,1.3489208633093526,0.1798561151079137
48,광주광역시,서구,화정2동,화정2동제2투,940,671,518,83,56,8,1,666,5,269,77.77777777777779,12.462462462462462,8.408408408408409,1.2012012012012012,0.15015015015015015
49,광주광역시,서구,화정2동,화정2동제3투,2043,1541,1232,193,91,15,1,1532,9,502,80.4177545691906,12.597911227154047,5.939947780678851,0.97911227154047,0.06527415143603134
50,광주광역시,서구,화정2동,화정2동제4투,2117,1587,1212,233,114,21,1,1581,6,530,76.66034155597723,14.73750790638836,7.2106261859582546,1.3282732447817838,0.06325110689437065
51,광주광역시,서구,화정3동,관내사전투표,2274,2274,2029,98,112,17,4,2260,14,0,89.7787610619469,4.336283185840708,4.95575221238938,0.7522123893805309,0.17699115044247787
52,광주광역시,서구,화정3동,화정3동제1투,1964,1195,897,203,77,12,0,1189,6,769,75.44154751892347,17.073170731707318,6.476030277544155,1.0092514718250631,0.0
53,광주광역시,서구,화정3동,화정3동제2투,1946,1373,1078,196,72,13,3,1362,11,573,79.14831130690162,14.390602055800294,5.286343612334802,0.9544787077826725,0.22026431718061676
54,광주광역시,서구,화정4동,관내사전투표,6704,6704,6045,346,248,41,4,6684,20,0,90.43985637342908,5.176540993417116,3.7103530819868342,0.6134051466187912,0.059844404548174746
55,광주광역시,서구,화정4동,화정4동제1투,2089,1467,1131,207,103,14,1,1456,11,622,77.67857142857143,14.217032967032967,7.074175824175824,0.9615384615384616,0.06868131868131869
56,광주광역시,서구,화정4동,화정4동제2투,1772,1215,911,210,79,8,0,1208,7,557,75.41390728476821,17.3841059602649,6.539735099337748,0.6622516556291391,0.0
57,광주광역시,서구,화정4동,화정4동제3투,1304,894,669,162,56,3,2,892,2,410,75.0,18.161434977578477,6.278026905829597,0.336322869955157,0.2242152466367713
58,광주광역시,서구,화정4동,화정4동제4투,1470,862,634,138,69,15,1,857,5,608,73.97899649941657,16.102683780630105,8.051341890315053,1.7502917152858808,0.11668611435239205
59,광주광역시,서구,서창동,관내사전투표,1237,1237,1125,56,44,3,1,1229,8,0,91.53783563873068,4.556550040683483,3.580146460537022,0.24410089503661514,0.08136696501220504
60,광주광역시,서구,서창동,서창동제1투,660,356,301,42,11,1,0,355,1,304,84.78873239436619,11.830985915492958,3.0985915492957745,0.28169014084507044,0.0
61,광주광역시,서구,서창동,서창동제2투,310,200,173,15,7,3,1,199,1,110,86.93467336683418,7.537688442211055,3.5175879396984926,1.507537688442211,0.5025125628140703
62,광주광역시,서구,서창동,서창동제3투,1795,1372,1070,178,97,19,0,1364,8,423,78.4457478005865,13.049853372434017,7.111436950146628,1.3929618768328444,0.0
63,광주광역시,서구,금호1동,관내사전투표,5521,5521,5105,213,152,28,2,5500,21,0,92.81818181818183,3.872727272727273,2.7636363636363637,0.5090909090909091,0.03636363636363636
64,광주광역시,서구,금호1동,금호1동제1투,1900,1284,985,198,79,15,3,1280,4,616,76.953125,15.46875,6.171875,1.171875,0.234375
65,광주광역시,서구,금호1동,금호1동제2투,1758,1226,958,171,83,5,1,1218,8,532,78.65353037766832,14.039408866995073,6.814449917898194,0.41050903119868637,0.08210180623973727
66,광주광역시,서구,금호1동,금호1동제3투,983,476,370,66,31,3,0,470,6,507,78.72340425531915,14.042553191489363,6.595744680851063,0.6382978723404255,0.0
67,광주광역시,서구,금호1동,금호1동제4투,1846,1298,1059,136,78,14,1,1288,10,548,82.22049689440993,10.559006211180124,6.055900621118012,1.0869565217391304,0.07763975155279502
68,광주광역시,서구,금호1동,금호1동제5투,1258,887,703,121,48,12,0,884,3,371,79.52488687782805,13.687782805429865,5.429864253393665,1.3574660633484164,0.0
69,광주광역시,서구,금호2동,관내사전투표,9506,9506,8700,362,378,39,3,9482,24,0,91.75279476903607,3.8177599662518458,3.9865007382408773,0.4113056317232651,0.03163889474794347
70,광주광역시,서구,금호2동,금호2동제1투,2750,1868,1482,225,137,11,2,1857,11,882,79.80613893376413,12.116316639741518,7.377490576198169,0.5923532579429186,0.10770059235325795
71,광주광역시,서구,금호2동,금호2동제2투,2078,1459,1153,176,107,9,2,1447,12,619,79.6821008984105,12.16309606081548,7.394609536973047,0.6219765031098825,0.138217000691085
72,광주광역시,서구,금호2동,금호2동제3투,2226,1786,1502,138,106,24,1,1771,15,440,84.81084133258047,7.792207792207792,5.9853190287972895,1.355166572557877,0.0564652738565782
73,광주광역시,서구,금호2동,금호2동제4투,1759,1231,949,182,87,8,1,1227,4,528,77.34311328443357,14.832925835370823,7.090464547677261,0.6519967400162999,0.08149959250203749
74,광주광역시,서구,금호2동,금호2동제5투,1235,887,700,113,57,9,2,881,6,348,79.45516458569807,12.826333711691259,6.469920544835414,1.0215664018161181,0.22701475595913734
75,광주광역시,서구,풍암동,관내사전투표,10202,10202,9191,480,423,60,7,10161,41,0,90.45369550241118,4.7239444936521995,4.162976085031001,0.5904930617065249,0.06889085719909457
76,광주광역시,서구,풍암동,풍암동제1투,1334,885,669,135,69,7,1,881,4,449,75.93643586833144,15.32349602724177,7.832009080590238,0.7945516458569807,0.11350737797956867
77,광주광역시,서구,풍암동,풍암동제2투,1144,769,611,77,63,8,3,762,7,375,80.18372703412074,10.104986876640421,8.267716535433072,1.0498687664041995,0.39370078740157477
78,광주광역시,서구,풍암동,풍암동제3투,1427,1048,833,131,65,12,1,1042,6,379,79.94241842610364,12.571976967370441,6.238003838771593,1.1516314779270633,0.09596928982725528
79,광주광역시,서구,풍암동,풍암동제4투,1718,1272,950,216,79,16,1,1262,10,446,75.27733755942948,17.11568938193344,6.259904912836767,1.2678288431061806,0.07923930269413629
80,광주광역시,서구,풍암동,풍암동제5투,1385,970,762,129,67,10,0,968,2,415,78.71900826446281,13.326446280991735,6.921487603305786,1.0330578512396695,0.0
81,광주광역시,서구,풍암동,풍암동제6투,1976,1179,889,178,97,12,0,1176,3,797,75.59523809523809,15.136054421768709,8.24829931972789,1.0204081632653061,0.0
82,광주광역시,서구,풍암동,풍암동제7투,2001,1118,843,150,96,10,2,1101,17,883,76.566757493188,13.623978201634879,8.71934604904632,0.9082652134423252,0.18165304268846502
83,광주광역시,서구,풍암동,풍암동제8투,2114,1649,1278,217,131,16,1,1643,6,465,77.78454047474132,13.20754716981132,7.973219720024345,0.9738283627510651,0.06086427267194157
84,광주광역시,서구,동천동,관내사전투표,5273,5273,4786,220,221,28,4,5259,14,0,91.00589465677885,4.183304810800532,4.202319832667808,0.5324206122837042,0.07606008746910059
85,광주광역시,서구,동천동,동천동제1투,1243,862,726,91,30,10,1,858,4,381,84.61538461538461,10.606060606060606,3.4965034965034967,1.1655011655011656,0.11655011655011654
86,광주광역시,서구,동천동,동천동제2투,1572,1194,998,106,64,16,1,1185,9,378,84.21940928270043,8.945147679324894,5.40084388185654,1.350210970464135,0.08438818565400844
87,광주광역시,서구,동천동,동천동제3투,1558,1191,909,181,83,12,0,1185,6,367,76.70886075949367,15.274261603375528,7.0042194092827,1.0126582278481013,0.0
88,광주광역시,서구,동천동,동천동제4투,1407,848,679,107,50,8,1,845,3,559,80.35502958579882,12.662721893491124,5.9171597633136095,0.9467455621301776,0.1183431952662722
89,광주광역시,서구,잘못 투입·구분된 투표지,,0,1,1,0,0,0,0,1,0,-1,100.0,0.0,0.0,0.0,0.0
0,광주광역시,남구,거소·선상투표,,378,361,274,27,39,2,1,343,18,17,79.88338192419825,7.871720116618077,11.370262390670554,0.5830903790087464,0.2915451895043732
1,광주광역시,남구,관외사전투표,,31500,31497,26507,1823,2660,281,27,31298,199,3,84.69231260783437,5.824653332481309,8.498945619528405,0.8978209470253691,0.08626749313055147
2,광주광역시,남구,재외투표,,725,606,511,51,39,3,0,604,2,119,84.60264900662253,8.443708609271523,6.456953642384105,0.49668874172185434,0.0
3,광주광역시,남구,양림동,관내사전투표,2902,2902,2606,149,119,14,1,2889,13,0,90.20422291450329,5.157493942540672,4.119072343371409,0.4845967462789893,0.034614053305642094
4,광주광역시,남구,양림동,양림동제1투,625,382,289,71,16,2,1,379,3,243,76.2532981530343,18.733509234828496,4.221635883905013,0.5277044854881267,0.2638522427440633
5,광주광역시,남구,양림동,양림동제2투,1601,1044,793,158,63,18,1,1033,11,557,76.76669893514037,15.295256534365926,6.098741529525654,1.7424975798644726,0.0968054211035818
6,광주광역시,남구,방림1동,관내사전투표,2619,2619,2356,132,97,20,4,2609,10,0,90.3027980068992,5.0594097355308545,3.717899578382522,0.7665772326561902,0.15331544653123802
7,광주광역시,남구,방림1동,방림1동제1투,1318,802,606,131,51,7,2,797,5,516,76.03513174404016,16.4366373902133,6.398996235884567,0.8782936010037641,0.2509410288582183
8,광주광역시,남구,방림1동,방림1동제2투,994,666,533,90,33,6,2,664,2,328,80.2710843373494,13.55421686746988,4.969879518072289,0.9036144578313252,0.30120481927710846
9,광주광역시,남구,방림2동,관내사전투표,2199,2199,2012,90,79,12,1,2194,5,0,91.70464904284412,4.102096627164995,3.6007292616226074,0.5469462169553327,0.04557885141294439
10,광주광역시,남구,방림2동,방림2동제1투,1069,631,476,92,53,4,2,627,4,438,75.9170653907496,14.673046251993622,8.452950558213717,0.6379585326953748,0.3189792663476874
11,광주광역시,남구,방림2동,방림2동제2투,1626,1127,914,142,56,11,1,1124,3,499,81.31672597864768,12.633451957295375,4.98220640569395,0.9786476868327402,0.0889679715302491
12,광주광역시,남구,방림2동,방림2동제3투,1129,873,719,106,41,3,0,869,4,256,82.73878020713464,12.197928653624857,4.7180667433832,0.34522439585730724,0.0
13,광주광역시,남구,봉선1동,관내사전투표,5522,5522,5003,271,199,26,2,5501,21,0,90.94710052717687,4.926377022359571,3.617524086529722,0.4726413379385566,0.03635702599527359
14,광주광역시,남구,봉선1동,봉선1동제1투,1007,584,433,103,37,7,0,580,4,423,74.6551724137931,17.75862068965517,6.379310344827586,1.206896551724138,0.0
15,광주광역시,남구,봉선1동,봉선1동제2투,1008,648,491,107,41,5,0,644,4,360,76.24223602484473,16.61490683229814,6.366459627329192,0.7763975155279503,0.0
16,광주광역시,남구,봉선1동,봉선1동제3투,1428,820,643,122,39,11,0,815,5,608,78.8957055214724,14.969325153374232,4.785276073619632,1.3496932515337423,0.0
17,광주광역시,남구,봉선1동,봉선1동제4투,1615,1010,759,155,71,15,2,1002,8,605,75.74850299401199,15.469061876247507,7.0858283433133735,1.4970059880239521,0.19960079840319359
18,광주광역시,남구,봉선2동,관내사전투표,7572,7572,6554,493,407,54,10,7518,54,0,87.17744080872572,6.557595105081139,5.413673849428039,0.7182761372705506,0.13301409949454643
19,광주광역시,남구,봉선2동,봉선2동제1투,1893,1406,1007,251,126,14,0,1398,8,487,72.03147353361946,17.954220314735338,9.012875536480687,1.0014306151645207,0.0
20,광주광역시,남구,봉선2동,봉선2동제2투,1265,729,527,138,47,7,2,721,8,536,73.09292649098474,19.14008321775312,6.51872399445215,0.9708737864077669,0.27739251040221913
21,광주광역시,남구,봉선2동,봉선2동제3투,2111,1423,1055,245,93,22,2,1417,6,688,74.4530698659139,17.290049400141143,6.563161609033169,1.55257586450247,0.14114326040931546
22,광주광역시,남구,봉선2동,봉선2동제4투,1899,1340,865,306,146,15,0,1332,8,559,64.93993993993993,22.972972972972975,10.96096096096096,1.1261261261261262,0.0
23,광주광역시,남구,봉선2동,봉선2동제5투,2371,1775,1000,461,281,26,0,1768,7,596,56.56108597285068,26.074660633484164,15.89366515837104,1.4705882352941175,0.0
24,광주광역시,남구,사직동,관내사전투표,1586,1586,1467,78,26,10,1,1582,4,0,92.7307206068268,4.9304677623261695,1.643489254108723,0.6321112515802781,0.06321112515802782
25,광주광역시,남구,사직동,사직동제1투,681,334,259,55,17,2,0,333,1,347,77.77777777777779,16.516516516516518,5.105105105105105,0.6006006006006006,0.0
26,광주광역시,남구,사직동,사직동제2투,1110,620,458,108,47,5,1,619,1,490,73.99030694668821,17.447495961227787,7.592891760904685,0.8077544426494345,0.16155088852988692
27,광주광역시,남구,월산동,관내사전투표,2457,2457,2275,83,74,11,0,2443,14,0,93.12320916905445,3.3974621367171514,3.029062627916496,0.4502660663119116,0.0
28,광주광역시,남구,월산동,월산동제1투,931,606,481,69,45,6,3,604,2,325,79.63576158940397,11.42384105960265,7.450331125827815,0.9933774834437087,0.49668874172185434
29,광주광역시,남구,월산동,월산동제2투,712,387,310,59,12,2,1,384,3,325,80.72916666666666,15.364583333333334,3.125,0.5208333333333333,0.26041666666666663
30,광주광역시,남구,월산동,월산동제3투,558,273,214,30,26,2,0,272,1,285,78.67647058823529,11.029411764705882,9.558823529411764,0.7352941176470588,0.0
31,광주광역시,남구,월산동,월산동제4투,1716,1206,961,158,72,9,1,1201,5,510,80.01665278934222,13.155703580349709,5.995004163197335,0.7493755203996669,0.08326394671107411
32,광주광역시,남구,월산4동,관내사전투표,2658,2658,2458,96,80,12,0,2646,12,0,92.89493575207861,3.6281179138321997,3.0234315948601664,0.45351473922902497,0.0
33,광주광역시,남구,월산4동,월산4동제1투,2109,1060,793,162,87,7,2,1051,9,1049,75.45195052331113,15.413891531874405,8.277830637488107,0.6660323501427212,0.19029495718363465
34,광주광역시,남구,월산4동,월산4동제2투,1016,597,474,92,24,2,1,593,4,419,79.93254637436762,15.51433389544688,4.0472175379426645,0.33726812816188867,0.16863406408094433
35,광주광역시,남구,월산5동,관내사전투표,2594,2594,2389,97,75,15,1,2577,17,0,92.7046953822274,3.7640667442762905,2.910360884749709,0.5820721769499418,0.038804811796662786
36,광주광역시,남구,월산5동,월산5동제1투,1138,563,429,93,36,1,0,559,4,575,76.74418604651163,16.636851520572453,6.440071556350627,0.17889087656529518,0.0
37,광주광역시,남구,월산5동,월산5동제2투,1130,650,527,74,37,7,2,647,3,480,81.45285935085008,11.437403400309119,5.7187017001545595,1.0819165378670788,0.3091190108191654
38,광주광역시,남구,백운1동,관내사전투표,4178,4178,3850,147,125,36,4,4162,16,0,92.5036040365209,3.531955790485344,3.00336376741951,0.8649687650168189,0.09610764055742432
39,광주광역시,남구,백운1동,백운1동제1투,1356,823,627,125,58,9,0,819,4,533,76.55677655677655,15.262515262515263,7.0818070818070815,1.098901098901099,0.0
40,광주광역시,남구,백운1동,백운1동제2투,1446,1032,825,141,48,16,0,1030,2,414,80.09708737864078,13.689320388349516,4.660194174757281,1.5533980582524272,0.0
41,광주광역시,남구,백운1동,백운1동제3투,1518,1059,851,143,51,9,0,1054,5,459,80.74003795066413,13.567362428842506,4.838709677419355,0.8538899430740038,0.0
42,광주광역시,남구,백운2동,관내사전투표,2812,2812,2452,171,147,24,3,2797,15,0,87.66535573829103,6.1136932427601005,5.2556310332499105,0.8580622095101895,0.10725777618877369
43,광주광역시,남구,백운2동,백운2동제1투,1540,798,579,132,67,12,0,790,8,742,73.29113924050633,16.70886075949367,8.481012658227847,1.5189873417721518,0.0
44,광주광역시,남구,백운2동,백운2동제2투,1083,707,567,89,39,3,2,700,7,376,81.0,12.714285714285714,5.571428571428571,0.4285714285714286,0.2857142857142857
45,광주광역시,남구,주월1동,관내사전투표,6216,6216,5604,318,232,45,3,6202,14,0,90.35794904869398,5.127378265075782,3.740728797162206,0.72557239600129,0.04837149306675266
46,광주광역시,남구,주월1동,주월1동제1투,1317,817,621,126,59,6,1,813,4,500,76.38376383763837,15.498154981549817,7.2570725707257075,0.7380073800738007,0.12300123001230012
47,광주광역시,남구,주월1동,주월1동제2투,2012,1183,901,172,92,11,0,1176,7,829,76.6156462585034,14.625850340136054,7.8231292517006805,0.935374149659864,0.0
48,광주광역시,남구,주월1동,주월1동제3투,1500,887,703,106,65,8,0,882,5,613,79.70521541950113,12.01814058956916,7.369614512471655,0.9070294784580499,0.0
49,광주광역시,남구,주월1동,주월1동제4투,2286,1587,1219,236,96,21,3,1575,12,699,77.39682539682539,14.984126984126982,6.095238095238095,1.3333333333333335,0.19047619047619047
50,광주광역시,남구,주월2동,관내사전투표,2889,2889,2672,118,76,14,3,2883,6,0,92.68123482483524,4.092958723551856,2.6361429066944155,0.4856052722858134,0.10405827263267431
51,광주광역시,남구,주월2동,주월2동제1투,1306,696,542,100,40,7,0,689,7,610,78.66473149492018,14.513788098693759,5.805515239477503,1.0159651669085632,0.0
52,광주광역시,남구,주월2동,주월2동제2투,1470,901,732,110,45,6,2,895,6,569,81.7877094972067,12.290502793296088,5.027932960893855,0.6703910614525139,0.22346368715083798
53,광주광역시,남구,진월동,관내사전투표,7537,7537,6807,329,329,49,6,7520,17,0,90.5186170212766,4.375,4.375,0.651595744680851,0.07978723404255318
54,광주광역시,남구,진월동,진월동제1투,1893,1179,881,163,107,15,2,1168,11,714,75.42808219178082,13.955479452054794,9.16095890410959,1.2842465753424657,0.17123287671232876
55,광주광역시,남구,진월동,진월동제2투,1559,1038,794,155,73,9,1,1032,6,521,76.93798449612403,15.01937984496124,7.073643410852713,0.872093023255814,0.09689922480620156
56,광주광역시,남구,진월동,진월동제3투,1928,1431,1125,204,72,21,1,1423,8,497,79.05832747716093,14.335910049191849,5.0597329585383,1.4757554462403373,0.07027406886858749
57,광주광역시,남구,진월동,진월동제4투,1824,1357,1070,180,84,15,3,1352,5,467,79.14201183431953,13.313609467455622,6.21301775147929,1.1094674556213018,0.22189349112426035
58,광주광역시,남구,진월동,진월동제5투,2044,1488,1250,141,79,10,0,1480,8,556,84.45945945945947,9.527027027027026,5.337837837837838,0.6756756756756757,0.0
59,광주광역시,남구,진월동,진월동제6투,1555,1153,975,105,50,14,2,1146,7,402,85.07853403141361,9.162303664921465,4.363001745200698,1.2216404886561953,0.17452006980802792
60,광주광역시,남구,효덕동,관내사전투표,5238,5238,4726,280,191,21,2,5220,18,0,90.53639846743296,5.363984674329502,3.6590038314176248,0.40229885057471265,0.03831417624521073
61,광주광역시,남구,효덕동,효덕동제1투,1827,1293,1058,146,72,10,0,1286,7,534,82.27060653188181,11.35303265940902,5.598755832037325,0.7776049766718507,0.0
62,광주광역시,남구,효덕동,효덕동제2투,2017,1453,1087,241,101,18,1,1448,5,564,75.06906077348067,16.64364640883978,6.975138121546961,1.2430939226519337,0.06906077348066297
63,광주광역시,남구,효덕동,효덕동제3투,2161,1504,1186,182,110,16,2,1496,8,657,79.27807486631015,12.165775401069519,7.352941176470589,1.06951871657754,0.1336898395721925
64,광주광역시,남구,송암동,관내사전투표,3566,3566,3256,116,160,22,0,3554,12,0,91.61508159819921,3.2639279684862124,4.501969611705121,0.6190208216094542,0.0
65,광주광역시,남구,송암동,송암동제1투,1505,975,791,124,45,9,0,969,6,530,81.63054695562435,12.796697626418988,4.643962848297214,0.9287925696594427,0.0
66,광주광역시,남구,송암동,송암동제2투,1223,792,630,90,53,15,1,789,3,431,79.84790874524715,11.406844106463879,6.7173637515842834,1.9011406844106464,0.12674271229404308
67,광주광역시,남구,송암동,송암동제3투,2360,1773,1467,183,95,15,3,1763,10,587,83.21043675553035,10.38003403289847,5.388542257515598,0.8508224617129893,0.17016449234259784
68,광주광역시,남구,송암동,송암동제4투,2255,1685,1354,193,113,16,2,1678,7,570,80.69129916567343,11.501787842669845,6.734207389749702,0.9535160905840285,0.11918951132300357
69,광주광역시,남구,대촌동,관내사전투표,3086,3086,2886,91,86,11,3,3077,9,0,93.79265518362041,2.9574260643483914,2.7949301267468316,0.35749106272343195,0.09749756256093597
70,광주광역시,남구,대촌동,대촌동제1투,2039,1304,1060,156,71,9,1,1297,7,735,81.72706245181188,12.02775636083269,5.474171164225135,0.6939090208172706,0.07710100231303006
71,광주광역시,남구,대촌동,대촌동제2투,372,195,155,27,7,5,1,195,0,177,79.48717948717949,13.846153846153847,3.5897435897435894,2.564102564102564,0.5128205128205128
72,광주광역시,남구,대촌동,대촌동제3투,722,458,417,29,6,1,1,454,4,264,91.85022026431719,6.387665198237885,1.3215859030837005,0.22026431718061676,0.22026431718061676
73,광주광역시,남구,잘못 투입·구분된 투표지,,0,0,0,0,0,0,0,0,0,0,0.0,0.0,0.0,0.0,0.0
0,광주광역시,북구,거소·선상투표,,840,801,611,76,85,5,1,778,23,39,78.53470437017995,9.768637532133676,10.925449871465295,0.6426735218508998,0.12853470437017994
1,광주광역시,북구,관외사전투표,,54902,54893,46005,3152,4768,536,54,54515,378,9,84.38961753645785,5.781894891314318,8.746216637622673,0.9832156287260387,0.09905530587911585
2,광주광역시,북구,재외투표,,1377,1178,987,86,84,12,1,1170,8,199,84.35897435897436,7.350427350427351,7.179487179487179,1.0256410256410255,0.08547008547008547
3,광주광역시,북구,중흥1동,관내사전투표,1752,1752,1597,61,76,9,0,1743,9,0,91.62363740676994,3.499713138267355,4.360298336201951,0.5163511187607573,0.0
4,광주광역시,북구,중흥1동,중흥1동투표소,1813,965,722,138,82,15,1,958,7,848,75.36534446764091,14.40501043841336,8.559498956158663,1.5657620041753653,0.10438413361169101
5,광주광역시,북구,중흥동,관내사전투표,4456,4456,3898,244,247,32,7,4428,28,0,88.03071364046974,5.510388437217705,5.578139114724481,0.7226738934056007,0.15808491418247517
6,광주광역시,북구,중흥동,중흥동제1투,882,565,393,122,36,8,0,559,6,317,70.30411449016101,21.82468694096601,6.440071556350627,1.4311270125223614,0.0
7,광주광역시,북구,중흥동,중흥동제2투,1180,649,445,95,93,8,0,641,8,531,69.42277691107644,14.82059282371295,14.508580343213728,1.24804992199688,0.0
8,광주광역시,북구,중흥동,중흥동제3투,1164,695,509,117,57,8,1,692,3,469,73.55491329479769,16.907514450867055,8.236994219653178,1.1560693641618496,0.1445086705202312
9,광주광역시,북구,중흥동,중흥동제4투,1290,602,391,109,85,7,4,596,6,688,65.60402684563759,18.288590604026847,14.261744966442953,1.174496644295302,0.6711409395973155
10,광주광역시,북구,중흥동,중흥동제5투,1268,798,611,126,48,9,0,794,4,470,76.95214105793451,15.869017632241814,6.045340050377834,1.1335012594458438,0.0
11,광주광역시,북구,중앙동,관내사전투표,2358,2358,2078,101,142,27,1,2349,9,0,88.46317581949766,4.299702000851426,6.04512558535547,1.1494252873563218,0.04257130693912303
12,광주광역시,북구,중앙동,중앙동투표소,1466,773,558,126,72,13,0,769,4,693,72.56176853055916,16.38491547464239,9.362808842652797,1.6905071521456438,0.0
13,광주광역시,북구,임동,관내사전투표,3702,3702,3383,159,115,21,6,3684,18,0,91.82953311617807,4.315960912052117,3.1216069489685125,0.5700325732899023,0.16286644951140067
14,광주광역시,북구,임동,임동제1투,1471,940,748,137,40,10,1,936,4,531,79.91452991452992,14.636752136752138,4.273504273504273,1.0683760683760684,0.10683760683760685
15,광주광역시,북구,임동,임동제2투,3530,2348,1719,380,206,33,1,2339,9,1182,73.492945703292,16.246259085079092,8.80718255664814,1.410859341598974,0.04275331338178709
16,광주광역시,북구,신안동,관내사전투표,3692,3692,3320,158,164,29,2,3673,19,0,90.38932752518377,4.30166076776477,4.465014974135584,0.7895453307922679,0.054451402123604685
17,광주광역시,북구,신안동,신안동제1투,2031,1025,791,135,77,13,2,1018,7,1006,77.70137524557956,13.261296660117877,7.56385068762279,1.2770137524557956,0.19646365422396855
18,광주광역시,북구,신안동,신안동제2투,1213,682,529,84,57,8,0,678,4,531,78.023598820059,12.389380530973451,8.4070796460177,1.1799410029498525,0.0
19,광주광역시,북구,신안동,신안동제3투,1600,934,646,155,102,17,2,922,12,666,70.06507592190889,16.811279826464208,11.062906724511931,1.843817787418655,0.21691973969631237
20,광주광역시,북구,용봉동,관내사전투표,9272,9272,7313,548,1189,130,10,9190,82,0,79.57562568008704,5.9630032644178455,12.9379760609358,1.4145810663764962,0.1088139281828074
21,광주광역시,북구,용봉동,용봉동제1투,2026,1166,781,215,141,13,2,1152,14,860,67.79513888888889,18.663194444444446,12.239583333333332,1.128472222222222,0.1736111111111111
22,광주광역시,북구,용봉동,용봉동제2투,1855,1237,918,184,112,15,0,1229,8,618,74.69487388120423,14.97152156224573,9.113100081366966,1.2205044751830758,0.0
23,광주광역시,북구,용봉동,용봉동제3투,1735,1190,903,181,81,15,2,1182,8,545,76.39593908629442,15.313028764805415,6.852791878172589,1.2690355329949239,0.1692047377326565
24,광주광역시,북구,용봉동,용봉동제4투,1349,710,399,178,106,19,1,703,7,639,56.75675675675676,25.320056899004268,15.078236130867708,2.7027027027027026,0.1422475106685633
25,광주광역시,북구,용봉동,용봉동제5투,1770,1217,977,152,71,10,0,1210,7,553,80.74380165289257,12.561983471074381,5.867768595041322,0.8264462809917356,0.0
26,광주광역시,북구,용봉동,용봉동제6투,1962,1436,1182,160,80,4,2,1428,8,526,82.77310924369748,11.204481792717088,5.602240896358544,0.2801120448179272,0.1400560224089636
27,광주광역시,북구,용봉동,용봉동제7투,1640,1223,948,163,90,15,0,1216,7,417,77.96052631578947,13.404605263157896,7.401315789473683,1.2335526315789473,0.0
28,광주광역시,북구,용봉동,용봉동제8투,1491,1018,809,119,72,12,1,1013,5,473,79.86179664363277,11.747285291214215,7.107601184600197,1.1846001974333662,0.09871668311944717
29,광주광역시,북구,용봉동,용봉동제9투,2067,1515,1224,158,103,18,1,1504,11,552,81.38297872340425,10.50531914893617,6.848404255319148,1.196808510638298,0.06648936170212766
30,광주광역시,북구,운암1동,관내사전투표,5787,5787,5225,277,230,39,2,5773,14,0,90.50753507708296,4.7981985103066,3.9840637450199203,0.6755586350251169,0.034644032565390614
31,광주광역시,북구,운암1동,운암1동제1투,1861,1251,938,200,92,15,1,1246,5,610,75.28089887640449,16.051364365971107,7.3836276083467105,1.2038523274478332,0.08025682182985554
32,광주광역시,북구,운암1동,운암1동제2투,1706,1168,881,183,86,11,0,1161,7,538,75.88285960378983,15.762273901808785,7.4074074074074066,0.9474590869939706,0.0
33,광주광역시,북구,운암1동,운암1동제3투,1223,948,753,130,41,20,1,945,3,275,79.68253968253968,13.756613756613756,4.338624338624339,2.1164021164021163,0.10582010582010583
34,광주광역시,북구,운암1동,운암1동제4투,1983,1494,1179,196,94,11,2,1482,12,489,79.55465587044534,13.225371120107962,6.342780026990553,0.7422402159244265,0.1349527665317139
35,광주광역시,북구,운암2동,관내사전투표,5503,5503,5056,245,148,33,4,5486,17,0,92.16186656944951,4.465913233685746,2.6977761574917976,0.6015311702515495,0.07291286912139992
36,광주광역시,북구,운암2동,운암2동제1투,792,359,263,58,26,5,1,353,6,433,74.5042492917847,16.43059490084986,7.365439093484419,1.41643059490085,0.28328611898017
37,광주광역시,북구,운암2동,운암2동제2투,825,409,327,54,21,2,2,406,3,416,80.54187192118226,13.30049261083744,5.172413793103448,0.49261083743842365,0.49261083743842365
38,광주광역시,북구,운암2동,운암2동제3투,1169,682,567,69,35,7,1,679,3,487,83.50515463917526,10.1620029455081,5.154639175257731,1.0309278350515463,0.14727540500736377
39,광주광역시,북구,운암2동,운암2동제4투,1408,905,685,132,55,23,2,897,8,503,76.36566332218506,14.715719063545151,6.131549609810479,2.564102564102564,0.2229654403567447
40,광주광역시,북구,운암3동,관내사전투표,4991,4991,4436,269,226,31,3,4965,26,0,89.34541792547834,5.417925478348439,4.551863041289024,0.6243705941591138,0.060422960725075525
41,광주광역시,북구,운암3동,운암3동제1투,1405,930,747,108,58,8,6,927,3,475,80.58252427184466,11.650485436893204,6.256742179072276,0.8629989212513484,0.6472491909385114
42,광주광역시,북구,운암3동,운암3동제2투,1718,1154,925,142,72,11,0,1150,4,564,80.43478260869566,12.347826086956522,6.260869565217392,0.9565217391304347,0.0
43,광주광역시,북구,운암3동,운암3동제3투,1697,1127,904,134,67,10,3,1118,9,570,80.85867620751341,11.985688729874775,5.992844364937388,0.8944543828264758,0.26833631484794274
44,광주광역시,북구,동림동,관내사전투표,5335,5335,4874,203,193,34,7,5311,24,0,91.77179438900396,3.822255695725852,3.633967237808322,0.6401807569196009,0.13180192054227077
45,광주광역시,북구,동림동,동림동제1투,1783,1253,1021,139,68,21,0,1249,4,530,81.74539631705365,11.128903122497999,5.44435548438751,1.6813450760608486,0.0
46,광주광역시,북구,동림동,동림동제2투,1184,710,555,106,41,4,1,707,3,474,78.50070721357851,14.992927864214991,5.799151343705799,0.5657708628005658,0.14144271570014144
47,광주광역시,북구,동림동,동림동제3투,1539,1162,911,145,81,18,1,1156,6,377,78.80622837370242,12.54325259515571,7.006920415224914,1.5570934256055362,0.08650519031141869
48,광주광역시,북구,동림동,동림동제4투,2348,1748,1451,179,92,11,1,1734,14,600,83.67935409457901,10.322952710495963,5.3056516724336795,0.6343713956170703,0.05767012687427912
49,광주광역시,북구,동림동,동림동제5투,2502,1807,1504,158,116,17,0,1795,12,695,83.7883008356546,8.802228412256268,6.462395543175488,0.947075208913649,0.0
50,광주광역시,북구,우산동,관내사전투표,4942,4942,4410,246,233,28,2,4919,23,0,89.65236836755437,5.001016466761537,4.736735108761944,0.5692213864606628,0.04065867046147591
51,광주광역시,북구,우산동,우산동제1투,2274,1477,1080,227,140,17,0,1464,13,797,73.77049180327869,15.505464480874318,9.562841530054644,1.1612021857923498,0.0
52,광주광역시,북구,우산동,우산동제2투,946,543,432,67,31,7,0,537,6,403,80.44692737430168,12.476722532588454,5.772811918063315,1.303538175046555,0.0
53,광주광역시,북구,우산동,우산동제3투,906,580,453,89,29,5,0,576,4,326,78.64583333333334,15.45138888888889,5.034722222222222,0.8680555555555556,0.0
54,광주광역시,북구,우산동,우산동제4투,1051,647,530,77,28,5,2,642,5,404,82.55451713395638,11.993769470404985,4.361370716510903,0.778816199376947,0.3115264797507788
55,광주광역시,북구,우산동,우산동제5투,1093,766,570,137,46,8,0,761,5,327,74.90144546649145,18.00262812089356,6.044678055190539,1.0512483574244416,0.0
56,광주광역시,북구,풍향동,관내사전투표,1558,1558,1400,75,71,7,0,1553,5,0,90.1481004507405,4.829362524146812,4.571796522858983,0.4507405022537025,0.0
57,광주광역시,북구,풍향동,풍향동제1투,1271,781,600,109,59,7,2,777,4,490,77.22007722007721,14.028314028314028,7.5933075933075935,0.9009009009009009,0.2574002574002574
58,광주광역시,북구,풍향동,풍향동제2투,493,242,177,45,15,1,0,238,4,251,74.36974789915966,18.907563025210084,6.302521008403361,0.42016806722689076,0.0
59,광주광역시,북구,문화동,관내사전투표,6300,6300,5747,266,208,37,8,6266,34,0,91.71720395786785,4.245132460900096,3.319502074688797,0.5904883498244494,0.12767315671879986
60,광주광역시,북구,문화동,문화동제1투,1176,561,419,97,36,2,4,558,3,615,75.08960573476703,17.38351254480287,6.451612903225806,0.35842293906810035,0.7168458781362007
61,광주광역시,북구,문화동,문화동제2투,746,509,387,84,31,3,0,505,4,237,76.63366336633663,16.633663366336634,6.138613861386139,0.594059405940594,0.0
62,광주광역시,북구,문화동,문화동제3투,1949,1292,1036,142,88,19,3,1288,4,657,80.43478260869566,11.024844720496894,6.832298136645963,1.4751552795031055,0.2329192546583851
63,광주광역시,북구,문화동,문화동제4투,1110,700,543,82,61,6,3,695,5,410,78.12949640287769,11.798561151079138,8.776978417266188,0.8633093525179856,0.4316546762589928
64,광주광역시,북구,문화동,문화동제5투,907,584,466,76,36,5,0,583,1,323,79.93138936535163,13.036020583190394,6.174957118353345,0.8576329331046313,0.0
65,광주광역시,북구,문화동,문화동제6투,2028,1589,1271,183,101,25,1,1581,8,439,80.3921568627451,11.57495256166983,6.388361796331436,1.5812776723592663,0.06325110689437065
66,광주광역시,북구,문화동,문화동제7투,1425,1194,969,113,90,11,3,1186,8,231,81.70320404721754,9.527824620573355,7.588532883642496,0.927487352445194,0.25295109612141653
67,광주광역시,북구,문흥1동,관내사전투표,6027,6027,5500,245,218,43,5,6011,16,0,91.49891864914323,4.0758609216436525,3.626684411911495,0.7153551821660289,0.08318083513558476
68,광주광역시,북구,문흥1동,문흥1동제1투,1047,668,507,95,48,10,1,661,7,379,76.70196671709532,14.37216338880484,7.2617246596066565,1.5128593040847202,0.15128593040847202
69,광주광역시,북구,문흥1동,문흥1동제2투,978,645,502,99,38,4,0,643,2,333,78.0715396578538,15.396578538102643,5.909797822706065,0.6220839813374806,0.0
70,광주광역시,북구,문흥1동,문흥1동제3투,1165,823,635,119,54,12,1,821,2,342,77.34470158343484,14.494518879415347,6.577344701583435,1.46163215590743,0.12180267965895249
71,광주광역시,북구,문흥1동,문흥1동제4투,1024,672,529,81,48,6,3,667,5,352,79.3103448275862,12.14392803598201,7.19640179910045,0.8995502248875562,0.4497751124437781
72,광주광역시,북구,문흥1동,문흥1동제5투,1037,616,469,88,45,9,0,611,5,421,76.759410801964,14.402618657937808,7.3649754500818325,1.4729950900163666,0.0
73,광주광역시,북구,문흥2동,관내사전투표,5781,5781,5255,241,215,43,3,5757,24,0,91.28018064964391,4.18620809449366,3.734583984714261,0.7469167969428522,0.05211047420531526
74,광주광역시,북구,문흥2동,문흥2동제1투,1008,646,521,68,48,4,0,641,5,362,81.2792511700468,10.60842433697348,7.48829953198128,0.62402496099844,0.0
75,광주광역시,북구,문흥2동,문흥2동제2투,985,672,538,76,47,5,0,666,6,313,80.78078078078079,11.411411411411411,7.057057057057057,0.7507507507507507,0.0
76,광주광역시,북구,문흥2동,문흥2동제3투,1177,754,597,93,50,12,0,752,2,423,79.38829787234043,12.367021276595745,6.648936170212766,1.5957446808510638,0.0
77,광주광역시,북구,문흥2동,문흥2동제4투,1350,846,602,158,75,4,0,839,7,504,71.75208581644816,18.831942789034564,8.939213349225268,0.47675804529201427,0.0
78,광주광역시,북구,문흥2동,문흥2동제5투,1296,833,605,148,62,12,0,827,6,463,73.15598548972189,17.89600967351874,7.496977025392987,1.4510278113663846,0.0
79,광주광역시,북구,두암1동,관내사전투표,2852,2852,2590,144,96,13,2,2845,7,0,91.03690685413005,5.061511423550088,3.374340949033392,0.45694200351493847,0.070298769771529
80,광주광역시,북구,두암1동,두암1동제1투,899,536,419,75,36,3,0,533,3,363,78.61163227016885,14.071294559099437,6.75422138836773,0.5628517823639775,0.0
81,광주광역시,북구,두암1동,두암1동제2투,1011,526,407,64,44,6,0,521,5,485,78.1190019193858,12.284069097888676,8.445297504798464,1.1516314779270633,0.0
82,광주광역시,북구,두암1동,두암1동제3투,900,550,432,73,37,4,1,547,3,350,78.97623400365632,13.345521023765997,6.764168190127971,0.7312614259597806,0.18281535648994515
83,광주광역시,북구,두암2동,관내사전투표,5224,5224,4801,228,148,23,6,5206,18,0,92.2205147906262,4.37956204379562,2.8428736073761045,0.44179792547061086,0.11525163273146369
84,광주광역시,북구,두암2동,두암2동제1투,1199,617,456,107,42,5,1,611,6,582,74.63175122749591,17.51227495908347,6.873977086743044,0.8183306055646482,0.16366612111292964
85,광주광역시,북구,두암2동,두암2동제2투,1683,962,751,135,52,15,0,953,9,721,78.80377754459602,14.16579223504722,5.456453305351522,1.5739769150052465,0.0
86,광주광역시,북구,두암2동,두암2동제3투,1267,735,546,131,44,12,0,733,2,532,74.48840381991815,17.871759890859483,6.002728512960437,1.6371077762619373,0.0
87,광주광역시,북구,두암2동,두암2동제4투,1458,995,826,101,53,9,1,990,5,463,83.43434343434343,10.202020202020202,5.353535353535353,0.9090909090909091,0.10101010101010101
88,광주광역시,북구,두암3동,관내사전투표,5348,5348,4917,233,153,28,3,5334,14,0,92.1822272215973,4.368203974503187,2.8683914510686166,0.5249343832020997,0.05624296962879641
89,광주광역시,북구,두암3동,두암3동제1투,1063,466,353,78,28,2,0,461,5,597,76.57266811279827,16.919739696312362,6.073752711496746,0.43383947939262474,0.0
90,광주광역시,북구,두암3동,두암3동제2투,978,560,428,95,28,6,1,558,2,418,76.70250896057348,17.025089605734767,5.017921146953405,1.0752688172043012,0.17921146953405018
91,광주광역시,북구,두암3동,두암3동제3투,1157,614,488,90,26,2,0,606,8,543,80.52805280528052,14.85148514851485,4.29042904290429,0.33003300330033003,0.0
92,광주광역시,북구,두암3동,두암3동제4투,1467,948,790,107,36,11,1,945,3,519,83.5978835978836,11.322751322751323,3.8095238095238098,1.164021164021164,0.10582010582010583
93,광주광역시,북구,삼각동,관내사전투표,4521,4521,4119,177,179,29,4,4508,13,0,91.37089618456078,3.9263531499556343,3.970718722271517,0.6433007985803016,0.08873114463176575
94,광주광역시,북구,삼각동,삼각동제1투,1885,1068,785,174,91,11,0,1061,7,817,73.98680490103676,16.39962299717248,8.576814326107446,1.0367577756833177,0.0
95,광주광역시,북구,삼각동,삼각동제2투,1500,1165,949,117,77,9,1,1153,12,335,82.30702515177796,10.147441457068517,6.678230702515179,0.7805724197745013,0.08673026886383348
96,광주광역시,북구,삼각동,삼각동제3투,1662,1040,807,127,86,12,2,1034,6,622,78.04642166344294,12.282398452611218,8.317214700193423,1.160541586073501,0.19342359767891684
97,광주광역시,북구,일곡동,관내사전투표,8925,8925,8098,347,376,64,5,8890,35,0,91.09111361079864,3.90326209223847,4.2294713160854895,0.7199100112485939,0.05624296962879641
98,광주광역시,북구,일곡동,일곡동제1투,2240,1502,1167,206,105,14,1,1493,9,738,78.16476892163429,13.797722705961151,7.032819825853985,0.9377093101138647,0.06697923643670461
99,광주광역시,북구,일곡동,일곡동제2투,1594,869,636,143,69,12,3,863,6,725,73.69640787949015,16.57010428736964,7.995365005793744,1.3904982618771726,0.34762456546929316
100,광주광역시,북구,일곡동,일곡동제3투,1090,764,623,64,53,15,1,756,8,326,82.4074074074074,8.465608465608465,7.01058201058201,1.984126984126984,0.13227513227513227
101,광주광역시,북구,일곡동,일곡동제4투,1614,1086,865,121,76,15,2,1079,7,528,80.16682113067655,11.214087117701576,7.0435588507877664,1.3901760889712698,0.18535681186283595
102,광주광역시,북구,일곡동,일곡동제5투,1828,1440,1180,158,86,10,2,1436,4,388,82.17270194986072,11.002785515320335,5.988857938718663,0.6963788300835655,0.1392757660167131
103,광주광역시,북구,일곡동,일곡동제6투,1705,1190,882,179,99,16,1,1177,13,515,74.93627867459644,15.208156329651656,8.411214953271028,1.3593882752761257,0.08496176720475786
104,광주광역시,북구,매곡동,관내사전투표,6696,6696,6136,270,217,49,4,6676,20,0,91.91132414619533,4.044337926902337,3.2504493708807667,0.7339724385859796,0.05991611743559017
105,광주광역시,북구,매곡동,매곡동제1투,2057,1189,929,159,81,10,2,1181,8,868,78.66215071972904,13.463166807790008,6.858594411515664,0.8467400508044031,0.1693480101608806
106,광주광역시,북구,매곡동,매곡동제2투,2486,1758,1381,209,130,27,2,1749,9,728,78.95940537449971,11.949685534591195,7.432818753573471,1.5437392795883362,0.11435105774728416
107,광주광역시,북구,오치1동,관내사전투표,3511,3511,3170,158,142,26,4,3500,11,0,90.57142857142857,4.514285714285714,4.057142857142857,0.7428571428571429,0.1142857142857143
108,광주광역시,북구,오치1동,오치1동제1투,1258,678,467,161,37,10,0,675,3,580,69.18518518518518,23.85185185185185,5.481481481481482,1.4814814814814816,0.0
109,광주광역시,북구,오치1동,오치1동제2투,1313,792,588,132,59,7,0,786,6,521,74.80916030534351,16.793893129770993,7.506361323155216,0.8905852417302799,0.0
110,광주광역시,북구,오치1동,오치1동제3투,1439,890,681,117,68,13,4,883,7,549,77.12344280860702,13.250283125707815,7.701019252548131,1.4722536806342015,0.4530011325028313
111,광주광역시,북구,오치2동,관내사전투표,6157,6157,5511,291,275,52,6,6135,22,0,89.82885085574573,4.743276283618582,4.4824775876120615,0.8475957620211898,0.09779951100244498
112,광주광역시,북구,오치2동,오치2동제1투,1096,587,403,117,49,7,3,579,8,509,69.6027633851468,20.207253886010363,8.46286701208981,1.2089810017271159,0.5181347150259068
113,광주광역시,북구,오치2동,오치2동제2투,1025,594,469,88,22,9,4,592,2,431,79.22297297297297,14.864864864864865,3.7162162162162162,1.5202702702702704,0.6756756756756757
114,광주광역시,북구,오치2동,오치2동제3투,1144,606,429,117,43,13,0,602,4,538,71.2624584717608,19.435215946843854,7.142857142857142,2.1594684385382057,0.0
115,광주광역시,북구,오치2동,오치2동제4투,1539,1020,817,113,68,15,2,1015,5,519,80.49261083743843,11.133004926108374,6.6995073891625605,1.477832512315271,0.19704433497536944
116,광주광역시,북구,석곡동,관내사전투표,1177,1177,1075,52,28,16,0,1171,6,0,91.80187873612297,4.44064901793339,2.391118701964133,1.3663535439795047,0.0
117,광주광역시,북구,석곡동,석곡동제1투,570,303,240,46,11,4,1,302,1,267,79.47019867549669,15.2317880794702,3.642384105960265,1.3245033112582782,0.33112582781456956
118,광주광역시,북구,석곡동,석곡동제2투,248,167,135,23,4,4,0,166,1,81,81.32530120481928,13.855421686746988,2.4096385542168677,2.4096385542168677,0.0
119,광주광역시,북구,건국동,관내사전투표,6493,6493,5951,246,207,44,4,6452,41,0,92.23496590204587,3.8127712337259765,3.208307501549907,0.6819590824550528,0.06199628022318661
120,광주광역시,북구,건국동,건국동제1투,3614,2528,2067,257,168,18,1,2511,17,1086,82.31780167264037,10.234966148944643,6.690561529271206,0.7168458781362007,0.039824771007566706
121,광주광역시,북구,건국동,건국동제2투,2049,1362,1071,178,93,10,2,1354,8,687,79.09896602658789,13.146233382570163,6.868537666174299,0.7385524372230428,0.14771048744460857
122,광주광역시,북구,건국동,건국동제3투,1035,581,444,85,42,3,0,574,7,454,77.35191637630662,14.80836236933798,7.317073170731707,0.5226480836236934,0.0
123,광주광역시,북구,건국동,건국동제4투,1592,1111,907,115,66,15,1,1104,7,481,82.15579710144928,10.416666666666668,5.978260869565218,1.358695652173913,0.09057971014492754
124,광주광역시,북구,양산동,관내사전투표,9741,9740,8936,342,342,66,9,9695,45,1,92.17122227952554,3.527591542031975,3.527591542031975,0.6807632800412583,0.09283135636926251
125,광주광역시,북구,양산동,양산동제1투,2736,1418,1101,198,95,17,1,1412,6,1318,77.97450424929178,14.022662889518415,6.7280453257790365,1.2039660056657222,0.0708215297450425
126,광주광역시,북구,양산동,양산동제2투,2053,1264,996,158,83,18,0,1255,9,789,79.36254980079681,12.58964143426295,6.613545816733067,1.4342629482071714,0.0
127,광주광역시,북구,양산동,양산동제3투,1969,1401,1167,125,85,15,1,1393,8,568,83.77602297200288,8.973438621679827,6.101938262742283,1.0768126346015794,0.07178750897343862
128,광주광역시,북구,양산동,양산동제4투,2090,1485,1190,175,93,19,4,1481,4,605,80.35111411208644,11.816340310600944,6.2795408507765025,1.2829169480081026,0.2700877785280216
129,광주광역시,북구,양산동,양산동제5투,2366,1655,1383,159,90,12,2,1646,9,711,84.02187120291616,9.659781287970839,5.467800729040097,0.7290400972053462,0.12150668286755771
130,광주광역시,북구,양산동,양산동제6투,1919,1293,1058,131,82,11,2,1284,9,626,82.398753894081,10.202492211838006,6.386292834890965,0.8566978193146416,0.1557632398753894
131,광주광역시,북구,양산동,양산동제7투,1893,1539,1286,139,91,19,0,1535,4,354,83.77850162866449,9.055374592833875,5.928338762214984,1.2377850162866448,0.0
132,광주광역시,북구,신용동,관내사전투표,7598,7598,6850,272,400,54,3,7579,19,0,90.38131679641114,3.5888639662224566,5.27774112679773,0.7124950521176936,0.039583058450982984
133,광주광역시,북구,신용동,신용동제1투,3193,2273,1821,246,170,22,1,2260,13,920,80.57522123893806,10.88495575221239,7.52212389380531,0.9734513274336283,0.04424778761061947
134,광주광역시,북구,신용동,신용동제2투,2332,1807,1436,195,141,19,2,1793,14,525,80.08923591745678,10.875627440044617,7.863915225878417,1.059676519799219,0.11154489682097045
135,광주광역시,북구,신용동,신용동제3투,1902,1294,1061,124,80,17,2,1284,10,608,82.63239875389408,9.657320872274143,6.230529595015576,1.32398753894081,0.1557632398753894
136,광주광역시,북구,신용동,신용동제4투,2545,1694,1342,181,142,15,2,1682,12,851,79.7859690844233,10.760998810939357,8.442330558858501,0.89179548156956,0.11890606420927466
137,광주광역시,북구,신용동,신용동제5투,1603,1189,984,119,76,9,0,1188,1,414,82.82828282828282,10.016835016835017,6.397306397306397,0.7575757575757576,0.0
138,광주광역시,북구,잘못 투입·구분된 투표지,,0,1,1,0,0,0,0,1,0,-1,100.0,0.0,0.0,0.0,0.0
0,광주광역시,광산구,거소·선상투표,,688,668,451,50,114,4,1,620,48,20,72.74193548387096,8.064516129032258,18.387096774193548,0.6451612903225806,0.16129032258064516
1,광주광역시,광산구,관외사전투표,,43760,43755,35918,2659,4351,422,46,43396,359,5,82.7679970504194,6.1272928380495895,10.026269702276707,0.9724398562079455,0.10600055304636372
2,광주광역시,광산구,재외투표,,904,755,635,44,60,5,0,744,11,149,85.34946236559139,5.913978494623656,8.064516129032258,0.6720430107526881,0.0
3,광주광역시,광산구,송정1동,관내사전투표,3669,3668,3318,161,136,23,5,3643,25,1,91.07878122426571,4.419434531979139,3.7331869338457313,0.631347790282734,0.1372495196266813
4,광주광역시,광산구,송정1동,송정1동제1투,1405,827,621,135,59,5,1,821,6,578,75.6394640682095,16.443361753958587,7.186358099878197,0.6090133982947624,0.12180267965895249
5,광주광역시,광산구,송정1동,송정1동제2투,1102,651,531,73,34,6,1,645,6,451,82.32558139534883,11.317829457364342,5.271317829457364,0.9302325581395349,0.15503875968992248
6,광주광역시,광산구,송정1동,송정1동제3투,1874,1354,1114,125,86,16,1,1342,12,520,83.01043219076007,9.314456035767511,6.4083457526080485,1.1922503725782414,0.07451564828614009
7,광주광역시,광산구,송정2동,관내사전투표,2731,2731,2381,125,179,24,4,2713,18,0,87.76262440103207,4.607445632141541,6.597862145226687,0.8846295613711759,0.1474382602285293
8,광주광역시,광산구,송정2동,송정2동제1투,820,480,354,77,40,4,1,476,4,340,74.36974789915966,16.176470588235293,8.403361344537815,0.8403361344537815,0.21008403361344538
9,광주광역시,광산구,송정2동,송정2동제2투,637,312,228,58,22,2,2,312,0,325,73.07692307692307,18.58974358974359,7.051282051282051,0.641025641025641,0.641025641025641
10,광주광역시,광산구,송정2동,송정2동제3투,1213,835,673,94,51,11,0,829,6,378,81.18214716525934,11.338962605548854,6.15199034981906,1.3268998793727382,0.0
11,광주광역시,광산구,도산동,관내사전투표,5026,5026,4549,209,198,42,3,5001,25,0,90.96180763847231,4.179164167166567,3.9592081583683263,0.8398320335932814,0.05998800239952009
12,광주광역시,광산구,도산동,도산동제1투,1701,1091,872,133,68,7,0,1080,11,610,80.74074074074075,12.314814814814815,6.296296296296296,0.6481481481481481,0.0
13,광주광역시,광산구,도산동,도산동제2투,2448,1605,1237,209,126,17,5,1594,11,843,77.60351317440401,13.111668757841906,7.904642409033877,1.066499372647428,0.3136762860727729
14,광주광역시,광산구,도산동,도산동제3투,2092,1484,1241,145,79,13,0,1478,6,608,83.96481732070366,9.810554803788904,5.345060893098782,0.8795669824086604,0.0
15,광주광역시,광산구,신흥동,관내사전투표,1531,1531,1367,79,63,12,0,1521,10,0,89.87508218277449,5.193951347797501,4.142011834319527,0.7889546351084813,0.0
16,광주광역시,광산구,신흥동,신흥동투표소,1572,911,685,158,48,11,2,904,7,661,75.77433628318585,17.47787610619469,5.3097345132743365,1.2168141592920354,0.22123893805309736
17,광주광역시,광산구,어룡동,관내사전투표,7757,7757,7034,281,330,67,11,7723,34,0,91.07859640036256,3.6384824550045316,4.272950925806033,0.8675385213000129,0.1424316975268678
18,광주광역시,광산구,어룡동,어룡동제1투,2653,1702,1407,154,113,14,1,1689,13,951,83.30373001776199,9.11782119597395,6.690349319123742,0.8288928359976317,0.059206631142687975
19,광주광역시,광산구,어룡동,어룡동제2투,1618,1143,885,147,85,16,1,1134,9,475,78.04232804232805,12.962962962962962,7.495590828924162,1.4109347442680775,0.08818342151675485
20,광주광역시,광산구,어룡동,어룡동제3투,1253,875,705,107,53,7,1,873,2,378,80.75601374570446,12.256586483390606,6.0710194730813285,0.8018327605956471,0.11454753722794961
21,광주광역시,광산구,어룡동,어룡동제4투,1546,882,658,119,80,14,2,873,9,664,75.37227949599084,13.631156930126002,9.163802978235967,1.6036655211912942,0.22909507445589922
22,광주광역시,광산구,어룡동,어룡동제5투,2757,2066,1726,194,104,28,2,2054,12,691,84.03115871470301,9.444985394352482,5.063291139240507,1.3631937682570594,0.09737098344693282
23,광주광역시,광산구,어룡동,어룡동제6투,2013,1475,1199,163,94,12,1,1469,6,538,81.62014976174268,11.095983662355344,6.398910823689585,0.8168822328114363,0.06807351940095302
24,광주광역시,광산구,어룡동,어룡동제7투,2185,1590,1305,155,107,16,2,1585,5,595,82.33438485804416,9.779179810725552,6.750788643533124,1.0094637223974765,0.12618296529968456
25,광주광역시,광산구,우산동,관내사전투표,8722,8722,7905,327,380,53,10,8675,47,0,91.12391930835734,3.7694524495677237,4.380403458213256,0.6109510086455331,0.11527377521613834
26,광주광역시,광산구,우산동,우산동제1투,2122,1260,982,179,76,11,3,1251,9,862,78.49720223820943,14.308553157474021,6.075139888089528,0.8792965627498002,0.2398081534772182
27,광주광역시,광산구,우산동,우산동제2투,2309,1725,1386,182,123,16,0,1707,18,584,81.195079086116,10.66198008201523,7.205623901581721,0.9373169302870533,0.0
28,광주광역시,광산구,우산동,우산동제3투,2310,1449,1237,134,49,8,3,1431,18,861,86.44304682040531,9.36408106219427,3.4241788958770094,0.5590496156533892,0.20964360587002098
29,광주광역시,광산구,우산동,우산동제4투,1791,1236,1001,135,76,10,5,1227,9,555,81.58109209453953,11.00244498777506,6.193969030154849,0.8149959250203749,0.40749796251018744
30,광주광역시,광산구,우산동,우산동제5투,2411,1837,1486,187,129,25,5,1832,5,574,81.11353711790393,10.207423580786026,7.041484716157205,1.3646288209606987,0.2729257641921397
31,광주광역시,광산구,우산동,우산동제6투,1055,591,415,100,64,5,1,585,6,464,70.94017094017094,17.094017094017094,10.94017094017094,0.8547008547008548,0.17094017094017094
32,광주광역시,광산구,우산동,우산동제7투,1417,903,693,133,53,12,4,895,8,514,77.43016759776536,14.860335195530727,5.921787709497207,1.3407821229050279,0.44692737430167595
33,광주광역시,광산구,월곡1동,관내사전투표,4932,4932,4581,170,132,27,5,4915,17,0,93.20447609359105,3.458799593082401,2.685656154628688,0.5493387589013226,0.10172939979654119
34,광주광역시,광산구,월곡1동,월곡1동제1투,746,400,323,53,16,6,0,398,2,346,81.15577889447236,13.316582914572864,4.0201005025125625,1.507537688442211,0.0
35,광주광역시,광산구,월곡1동,월곡1동제2투,676,382,308,50,18,4,0,380,2,294,81.05263157894737,13.157894736842104,4.736842105263158,1.0526315789473684,0.0
36,광주광역시,광산구,월곡1동,월곡1동제3투,1859,1441,1214,111,92,14,2,1433,8,418,84.71737613398464,7.745987438939288,6.4200976971388695,0.9769713886950453,0.13956734124214934
37,광주광역시,광산구,월곡1동,월곡1동제4투,1375,877,702,92,62,11,2,869,8,498,80.7825086306099,10.586881472957423,7.13463751438435,1.2658227848101267,0.23014959723820483
38,광주광역시,광산구,월곡2동,관내사전투표,3513,3513,3210,129,129,28,3,3499,14,0,91.74049728493856,3.6867676478994,3.6867676478994,0.8002286367533581,0.08573878250928837
39,광주광역시,광산구,월곡2동,월곡2동제1투,667,329,251,48,22,3,1,325,4,338,77.23076923076924,14.76923076923077,6.769230769230769,0.9230769230769231,0.3076923076923077
40,광주광역시,광산구,월곡2동,월곡2동제2투,1045,627,502,84,34,4,0,624,3,418,80.44871794871796,13.461538461538462,5.448717948717949,0.641025641025641,0.0
41,광주광역시,광산구,월곡2동,월곡2동제3투,1385,887,705,107,59,10,2,883,4,498,79.841449603624,12.117780294450736,6.681766704416761,1.1325028312570782,0.22650056625141565
42,광주광역시,광산구,월곡2동,월곡2동제4투,1563,1228,1007,115,84,13,4,1223,5,335,82.33851185609157,9.403107113654947,6.86835650040883,1.062959934587081,0.3270645952575634
43,광주광역시,광산구,월곡2동,월곡2동제5투,1310,977,800,79,79,9,1,968,9,333,82.64462809917356,8.16115702479339,8.16115702479339,0.9297520661157025,0.10330578512396695
44,광주광역시,광산구,비아동,관내사전투표,3734,3734,3421,144,119,34,3,3721,13,0,91.93765116904058,3.869927438860522,3.1980650362805694,0.9137328675087342,0.08062348830959419
45,광주광역시,광산구,비아동,비아동제1투,1226,732,548,120,51,8,1,728,4,494,75.27472527472527,16.483516483516482,7.0054945054945055,1.098901098901099,0.13736263736263737
46,광주광역시,광산구,비아동,비아동제2투,1463,835,681,105,37,7,0,830,5,628,82.04819277108435,12.650602409638553,4.457831325301205,0.8433734939759037,0.0
47,광주광역시,광산구,첨단1동,관내사전투표,10927,10927,9552,515,714,78,9,10868,59,0,87.89105631210894,4.7386823702613174,6.5697460434302535,0.7177033492822966,0.08281192491718807
48,광주광역시,광산구,첨단1동,첨단1동제1투,2092,1556,1223,200,104,24,0,1551,5,536,78.85235332043843,12.89490651192779,6.70535138620245,1.5473887814313347,0.0
49,광주광역시,광산구,첨단1동,첨단1동제2투,1949,1418,1107,185,90,21,2,1405,13,531,78.79003558718861,13.167259786476867,6.405693950177936,1.4946619217081851,0.1423487544483986
50,광주광역시,광산구,첨단1동,첨단1동제3투,2365,1771,1408,212,121,19,1,1761,10,594,79.95457126632594,12.038614423622942,6.871095968199886,1.0789324247586598,0.05678591709256105
51,광주광역시,광산구,첨단1동,첨단1동제4투,1689,1212,942,156,96,11,0,1205,7,477,78.17427385892117,12.946058091286309,7.966804979253111,0.9128630705394192,0.0
52,광주광역시,광산구,첨단1동,첨단1동제5투,3106,1899,1379,261,222,18,0,1880,19,1207,73.35106382978724,13.882978723404255,11.808510638297873,0.9574468085106382,0.0
53,광주광역시,광산구,첨단2동,관내사전투표,6997,6997,6301,236,381,50,3,6971,26,0,90.38875340697174,3.3854540238129394,5.465499928274279,0.7172572084349448,0.043035432506096684
54,광주광역시,광산구,첨단2동,첨단2동제1투,1246,730,552,110,56,4,2,724,6,516,76.24309392265194,15.193370165745856,7.734806629834254,0.5524861878453038,0.2762430939226519
55,광주광역시,광산구,첨단2동,첨단2동제2투,2437,1477,1082,196,167,13,1,1459,18,960,74.16038382453736,13.433858807402329,11.446196024674435,0.8910212474297465,0.06854009595613435
56,광주광역시,광산구,첨단2동,첨단2동제3투,1779,1220,985,120,87,13,1,1206,14,559,81.67495854063019,9.950248756218906,7.213930348258707,1.077943615257048,0.08291873963515754
57,광주광역시,광산구,첨단2동,첨단2동제4투,1667,1198,983,115,79,14,0,1191,7,469,82.53568429890848,9.655751469353484,6.633081444164568,1.1754827875734677,0.0
58,광주광역시,광산구,첨단2동,첨단2동제5투,2265,1791,1452,172,140,17,1,1782,9,474,81.48148148148148,9.652076318742985,7.856341189674524,0.9539842873176206,0.05611672278338946
59,광주광역시,광산구,첨단2동,첨단2동제6투,1547,1222,1005,118,68,15,2,1208,14,325,83.19536423841059,9.7682119205298,5.629139072847682,1.2417218543046358,0.16556291390728478
60,광주광역시,광산구,첨단2동,첨단2동제7투,1803,1349,1090,143,88,16,0,1337,12,454,81.52580403889304,10.69558713537771,6.581899775617053,1.1967090501121915,0.0
61,광주광역시,광산구,첨단2동,첨단2동제8투,1649,867,683,108,64,9,2,866,1,782,78.86836027713626,12.471131639722865,7.390300230946882,1.0392609699769053,0.23094688221709006
62,광주광역시,광산구,첨단2동,첨단2동제9투,1931,1528,1257,135,99,23,2,1516,12,403,82.9155672823219,8.905013192612138,6.530343007915568,1.517150395778364,0.13192612137203166
63,광주광역시,광산구,첨단2동,첨단2동제10투,2543,1548,1050,279,194,12,1,1536,12,995,68.359375,18.1640625,12.630208333333334,0.78125,0.06510416666666666
64,광주광역시,광산구,신가동,관내사전투표,5677,5677,5157,194,271,27,3,5652,25,0,91.2420382165605,3.4324133050247703,4.794762915782024,0.47770700636942676,0.05307855626326964
65,광주광역시,광산구,신가동,신가동제1투,2561,1652,1282,207,125,18,3,1635,17,909,78.4097859327217,12.660550458715598,7.64525993883792,1.1009174311926606,0.1834862385321101
66,광주광역시,광산구,신가동,신가동제2투,1743,1283,1083,116,65,10,1,1275,8,460,84.94117647058823,9.098039215686274,5.098039215686274,0.7843137254901961,0.0784313725490196
67,광주광역시,광산구,신가동,신가동제3투,3153,2276,1873,215,150,22,2,2262,14,877,82.8028293545535,9.504862953138815,6.631299734748011,0.9725906277630416,0.08841732979664013
68,광주광역시,광산구,운남동,관내사전투표,8562,8562,7858,266,331,58,10,8523,39,0,92.197583010677,3.1209667957292035,3.8836090578434823,0.6805115569635105,0.11732957878681216
69,광주광역시,광산구,운남동,운남동제1투,1329,900,734,90,59,15,0,898,2,429,81.73719376391982,10.022271714922049,6.570155902004454,1.670378619153675,0.0
70,광주광역시,광산구,운남동,운남동제2투,1615,1178,937,125,89,16,4,1171,7,437,80.01707941929975,10.67463706233988,7.600341588385994,1.3663535439795047,0.3415883859948762
71,광주광역시,광산구,운남동,운남동제3투,2329,1669,1384,164,92,14,4,1658,11,660,83.47406513872136,9.891435464414958,5.548854041013269,0.8443908323281062,0.24125452352231602
72,광주광역시,광산구,운남동,운남동제4투,1618,1226,1019,116,69,10,4,1218,8,392,83.66174055829228,9.523809523809524,5.665024630541872,0.8210180623973727,0.3284072249589491
73,광주광역시,광산구,운남동,운남동제5투,1334,1035,841,104,73,13,0,1031,4,299,81.57129000969933,10.08729388942774,7.080504364694471,1.2609117361784674,0.0
74,광주광역시,광산구,운남동,운남동제6투,1489,1200,960,130,79,18,3,1190,10,289,80.67226890756302,10.92436974789916,6.638655462184874,1.5126050420168067,0.25210084033613445
75,광주광역시,광산구,운남동,운남동제7투,1540,1118,944,83,69,9,5,1110,8,422,85.04504504504504,7.4774774774774775,6.216216216216217,0.8108108108108109,0.45045045045045046
76,광주광역시,광산구,운남동,운남동제8투,1469,1159,981,98,57,15,2,1153,6,310,85.08239375542064,8.49956634865568,4.943625325238508,1.3009540329575022,0.17346053772766695
77,광주광역시,광산구,신창동,관내사전투표,9399,9399,8527,319,442,69,3,9360,39,0,91.10042735042735,3.408119658119658,4.722222222222222,0.7371794871794871,0.03205128205128205
78,광주광역시,광산구,신창동,신창동제1투,649,391,307,51,21,7,0,386,5,258,79.53367875647669,13.21243523316062,5.4404145077720205,1.8134715025906734,0.0
79,광주광역시,광산구,신창동,신창동제2투,2458,1711,1394,167,116,20,2,1699,12,747,82.04826368452031,9.829311359623308,6.827545615067687,1.1771630370806356,0.11771630370806356
80,광주광역시,광산구,신창동,신창동제3투,1274,878,709,86,63,15,0,873,5,396,81.21420389461626,9.851088201603666,7.216494845360824,1.718213058419244,0.0
81,광주광역시,광산구,신창동,신창동제4투,2634,1692,1332,224,97,26,1,1680,12,942,79.28571428571428,13.333333333333334,5.773809523809524,1.5476190476190477,0.05952380952380953
82,광주광역시,광산구,신창동,신창동제5투,2728,1759,1365,206,150,27,3,1751,8,969,77.9554540262707,11.76470588235294,8.566533409480297,1.5419760137064535,0.17133066818960593
83,광주광역시,광산구,신창동,신창동제6투,1827,1473,1224,128,94,19,2,1467,6,354,83.43558282208589,8.7252897068848,6.407634628493525,1.2951601908657124,0.136332651670075
84,광주광역시,광산구,신창동,신창동제7투,2019,1380,1120,122,111,10,3,1366,14,639,81.99121522693997,8.931185944363104,8.125915080527086,0.7320644216691069,0.21961932650073207
85,광주광역시,광산구,수완동,관내사전투표,13115,13115,11808,569,594,88,8,13067,48,0,90.36504170811969,4.354480753042014,4.545802402999923,0.6734522078518405,0.06122292798653096
86,광주광역시,광산구,수완동,수완동제1투,2466,2046,1678,191,147,21,1,2038,8,420,82.33562315996075,9.371933267909716,7.212953876349363,1.030421982335623,0.04906771344455348
87,광주광역시,광산구,수완동,수완동제2투,2593,2035,1675,192,140,19,2,2028,7,558,82.59368836291914,9.467455621301776,6.903353057199212,0.9368836291913214,0.09861932938856016
88,광주광역시,광산구,수완동,수완동제3투,1893,1342,1078,160,82,14,2,1336,6,551,80.688622754491,11.976047904191617,6.137724550898203,1.0479041916167664,0.14970059880239522
89,광주광역시,광산구,수완동,수완동제4투,3490,2440,2025,223,151,23,2,2424,16,1050,83.53960396039604,9.1996699669967,6.229372937293729,0.9488448844884488,0.08250825082508251
90,광주광역시,광산구,수완동,수완동제5투,2100,1590,1259,191,111,25,1,1587,3,510,79.33207309388783,12.035286704473851,6.994328922495274,1.5752993068683048,0.0630119722747322
91,광주광역시,광산구,수완동,수완동제6투,2846,2219,1840,233,113,18,1,2205,14,627,83.44671201814059,10.56689342403628,5.124716553287982,0.8163265306122449,0.045351473922902494
92,광주광역시,광산구,수완동,수완동제7투,2772,1883,1556,171,121,22,0,1870,13,889,83.20855614973262,9.144385026737968,6.470588235294119,1.1764705882352942,0.0
93,광주광역시,광산구,수완동,수완동제8투,2440,1851,1402,285,129,21,1,1838,13,589,76.278563656148,15.505984766050055,7.018498367791078,1.1425462459194777,0.0544069640914037
94,광주광역시,광산구,수완동,수완동제9투,2460,1509,1066,280,141,13,1,1501,8,951,71.01932045303131,18.654230512991337,9.393737508327781,0.866089273817455,0.06662225183211193
95,광주광역시,광산구,수완동,수완동제10투,1836,1312,988,186,120,11,0,1305,7,524,75.70881226053639,14.25287356321839,9.195402298850574,0.8429118773946359,0.0
96,광주광역시,광산구,수완동,수완동제11투,2284,1785,1480,167,113,15,3,1778,7,499,83.23959505061868,9.392575928008998,6.355455568053993,0.843644544431946,0.1687289088863892
97,광주광역시,광산구,수완동,수완동제12투,2182,1469,1121,185,130,24,2,1462,7,713,76.67578659370726,12.65389876880985,8.891928864569083,1.6415868673050615,0.13679890560875513
98,광주광역시,광산구,수완동,수완동제13투,1888,1460,1217,123,93,17,3,1453,7,428,83.75774260151411,8.465244322092223,6.400550584996559,1.1699931176875429,0.20646937370956642
99,광주광역시,광산구,하남동,관내사전투표,8152,8152,7419,283,362,57,2,8123,29,0,91.33325126184907,3.4839345069555585,4.456481595469654,0.7017111904468792,0.02462144527883787
100,광주광역시,광산구,하남동,하남동제1투,2441,1270,971,167,110,12,1,1261,9,1171,77.00237906423474,13.243457573354481,8.723235527359238,0.9516256938937351,0.07930214115781126
101,광주광역시,광산구,하남동,하남동제2투,458,241,198,28,13,0,0,239,2,217,82.84518828451883,11.715481171548117,5.439330543933055,0.0,0.0
102,광주광역시,광산구,하남동,하남동제3투,2535,1850,1572,151,97,18,1,1839,11,685,85.48123980424144,8.210984230560086,5.274605764002175,0.9787928221859705,0.0543773790103317
103,광주광역시,광산구,하남동,하남동제4투,2527,1820,1444,208,132,25,0,1809,11,707,79.82310668877834,11.498065229408514,7.2968490878938645,1.3819789939192924,0.0
104,광주광역시,광산구,하남동,하남동제5투,2716,1702,1321,193,155,20,3,1692,10,1014,78.07328605200946,11.40661938534279,9.160756501182032,1.1820330969267139,0.1773049645390071
105,광주광역시,광산구,임곡동,관내사전투표,1258,1258,1175,48,25,5,1,1254,4,0,93.70015948963317,3.827751196172249,1.9936204146730463,0.3987240829346092,0.07974481658692185
106,광주광역시,광산구,임곡동,임곡동제1투,363,182,150,29,2,1,0,182,0,181,82.41758241758241,15.934065934065933,1.098901098901099,0.5494505494505495,0.0
107,광주광역시,광산구,임곡동,임곡동제2투,301,150,123,16,8,2,0,149,1,151,82.5503355704698,10.738255033557047,5.369127516778524,1.342281879194631,0.0
108,광주광역시,광산구,동곡동,관내사전투표,949,949,848,41,46,8,0,943,6,0,89.92576882290561,4.3478260869565215,4.878048780487805,0.8483563096500532,0.0
109,광주광역시,광산구,동곡동,동곡동투표소,613,357,310,33,9,1,1,354,3,256,87.57062146892656,9.322033898305085,2.5423728813559325,0.2824858757062147,0.2824858757062147
110,광주광역시,광산구,평동,관내사전투표,3090,3090,2847,100,111,15,3,3076,14,0,92.55526657997399,3.2509752925877766,3.6085825747724316,0.4876462938881665,0.0975292587776333
111,광주광역시,광산구,평동,평동제1투,1007,469,380,49,30,7,1,467,2,538,81.37044967880087,10.492505353319057,6.423982869379015,1.4989293361884368,0.21413276231263384
112,광주광역시,광산구,평동,평동제2투,980,568,457,73,29,4,1,564,4,412,81.02836879432624,12.943262411347517,5.141843971631205,0.7092198581560284,0.1773049645390071
113,광주광역시,광산구,삼도동,관내사전투표,1109,1109,987,54,32,10,0,1083,26,0,91.13573407202216,4.986149584487535,2.954755309325946,0.9233610341643583,0.0
114,광주광역시,광산구,삼도동,삼도동제1투,494,230,188,31,9,2,0,230,0,264,81.73913043478261,13.478260869565217,3.91304347826087,0.8695652173913043,0.0
115,광주광역시,광산구,삼도동,삼도동제2투,354,230,203,18,6,1,0,228,2,124,89.03508771929825,7.894736842105263,2.631578947368421,0.43859649122807015,0.0
116,광주광역시,광산구,본량동,관내사전투표,731,731,652,39,14,8,4,717,14,0,90.93444909344491,5.439330543933055,1.9525801952580195,1.1157601115760112,0.5578800557880056
117,광주광역시,광산구,본량동,본량동제1투,471,261,217,28,8,5,3,261,0,210,83.14176245210729,10.727969348659004,3.065134099616858,1.9157088122605364,1.1494252873563218
118,광주광역시,광산구,본량동,본량동제2투,269,132,108,17,5,1,0,131,1,137,82.44274809160305,12.977099236641221,3.816793893129771,0.7633587786259541,0.0
119,광주광역시,광산구,잘못 투입·구분된 투표지,,0,2,1,0,0,0,0,1,1,-2,100.0,0.0,0.0,0.0,0.0
0,대전광역시,동구,거소·선상투표,,315,300,141,92,55,5,1,294,6,15,47.95918367346938,31.292517006802722,18.70748299319728,1.7006802721088436,0.3401360544217687
1,대전광역시,동구,관외사전투표,,19700,19694,11704,4951,2596,204,38,19493,201,6,60.04206638280408,25.39886112963628,13.31760119017083,1.0465295234186631,0.19494177397014315
2,대전광역시,동구,재외투표,,633,522,356,106,46,10,0,518,4,111,68.72586872586872,20.463320463320464,8.880308880308881,1.9305019305019304,0.0
3,대전광역시,동구,중앙동,관내사전투표,1221,1221,738,366,101,6,2,1213,8,0,60.84089035449299,30.17312448474856,8.32646331409728,0.49464138499587795,0.16488046166529266
4,대전광역시,동구,중앙동,중앙동제1투,1270,646,211,410,16,5,1,643,3,624,32.8149300155521,63.76360808709176,2.488335925349922,0.7776049766718507,0.15552099533437014
5,대전광역시,동구,중앙동,중앙동제2투,1033,568,155,370,34,1,1,561,7,465,27.629233511586452,65.9536541889483,6.0606060606060606,0.17825311942959002,0.17825311942959002
6,대전광역시,동구,신인동,관내사전투표,1816,1816,1074,588,113,21,2,1798,18,0,59.733036707452726,32.70300333704116,6.284760845383759,1.1679644048943272,0.11123470522803114
7,대전광역시,동구,신인동,신인동제1투,1834,1231,451,686,76,4,2,1219,12,603,36.99753896636587,56.275635767022145,6.234618539786711,0.3281378178835111,0.16406890894175555
8,대전광역시,동구,신인동,신인동제2투,2289,1540,491,915,104,9,2,1521,19,749,32.28139381985536,60.15779092702169,6.837606837606838,0.591715976331361,0.13149243918474687
9,대전광역시,동구,신인동,신인동제3투,1743,1222,456,665,83,5,3,1212,10,521,37.62376237623762,54.867986798679866,6.8481848184818475,0.4125412541254125,0.24752475247524752
10,대전광역시,동구,신인동,신인동제4투,2553,1815,748,855,179,21,1,1804,11,738,41.46341463414634,47.394678492239464,9.922394678492239,1.164079822616408,0.05543237250554324
11,대전광역시,동구,효동,관내사전투표,5251,5251,3546,1271,357,49,3,5226,25,0,67.85304247990815,24.32070417145044,6.831228473019518,0.9376195943360123,0.0574052812858783
12,대전광역시,동구,효동,효동제1투,2908,2064,746,1154,132,22,0,2054,10,844,36.31937682570594,56.183057448880234,6.426484907497566,1.071080817916261,0.0
13,대전광역시,동구,효동,효동제2투,3577,2509,1100,1018,331,31,3,2483,26,1068,44.30124848973016,40.9987917841321,13.33064840918244,1.2484897301651228,0.12082158679017317
14,대전광역시,동구,효동,효동제3투,2676,1714,718,863,113,11,1,1706,8,962,42.08675263774912,50.586166471277835,6.623681125439624,0.6447831184056272,0.058616647127784284
15,대전광역시,동구,효동,효동제4투,3591,2555,1250,1089,185,19,2,2545,10,1036,49.115913555992144,42.789783889980356,7.269155206286837,0.7465618860510805,0.07858546168958742
16,대전광역시,동구,효동,효동제5투,2432,1561,654,771,120,6,3,1554,7,871,42.084942084942085,49.61389961389961,7.722007722007722,0.3861003861003861,0.19305019305019305
17,대전광역시,동구,판암1동,관내사전투표,3282,3282,2060,909,256,29,2,3256,26,0,63.26781326781327,27.917690417690416,7.862407862407863,0.8906633906633907,0.06142506142506143
18,대전광역시,동구,판암1동,판암1동제1투,1950,1175,402,669,79,13,3,1166,9,775,34.476843910806174,57.37564322469982,6.775300171526586,1.1149228130360207,0.2572898799313894
19,대전광역시,동구,판암1동,판암1동제2투,2545,1717,574,995,122,9,5,1705,12,828,33.665689149560116,58.35777126099707,7.155425219941349,0.5278592375366569,0.2932551319648094
20,대전광역시,동구,판암1동,판암1동제3투,2229,1490,555,792,122,14,1,1484,6,739,37.3989218328841,53.36927223719676,8.221024258760108,0.9433962264150944,0.06738544474393532
21,대전광역시,동구,판암2동,관내사전투표,2461,2461,1444,856,123,15,5,2443,18,0,59.10765452312731,35.03888661481785,5.034793286942285,0.6139991813344249,0.2046663937781416
22,대전광역시,동구,판암2동,판암2동제1투,1341,783,251,461,56,3,4,775,8,558,32.387096774193544,59.483870967741936,7.225806451612904,0.3870967741935484,0.5161290322580645
23,대전광역시,동구,판암2동,판암2동제2투,1496,904,268,581,31,6,5,891,13,592,30.07856341189675,65.20763187429854,3.479236812570146,0.6734006734006733,0.5611672278338945
24,대전광역시,동구,판암2동,판암2동제3투,2065,1313,441,754,85,15,2,1297,16,752,34.00154202004626,58.134155744024675,6.553585196607556,1.156515034695451,0.15420200462606012
25,대전광역시,동구,용운동,관내사전투표,3952,3952,2512,1081,310,28,3,3934,18,0,63.85358413828165,27.478393492628367,7.88002033553635,0.7117437722419928,0.0762582613116421
26,대전광역시,동구,용운동,용운동제1투,1723,992,292,596,88,7,1,984,8,731,29.67479674796748,60.56910569105691,8.94308943089431,0.7113821138211381,0.10162601626016261
27,대전광역시,동구,용운동,용운동제2투,1826,1093,334,675,67,4,1,1081,12,733,30.89731729879741,62.442183163737276,6.1979648473635525,0.37002775208140615,0.09250693802035154
28,대전광역시,동구,용운동,용운동제3투,3011,1986,707,1076,174,12,2,1971,15,1025,35.8701166920345,54.59157787924911,8.82800608828006,0.60882800608828,0.10147133434804667
29,대전광역시,동구,용운동,용운동제4투,2440,1708,684,874,125,14,4,1701,7,732,40.21164021164021,51.38154027042916,7.348618459729571,0.823045267489712,0.23515579071134626
30,대전광역시,동구,용운동,용운동제5투,2754,2033,946,862,197,16,2,2023,10,721,46.7622343054869,42.609985170538806,9.738012852199704,0.7909045971329708,0.09886307464162135
31,대전광역시,동구,대동,관내사전투표,3449,3448,2166,954,270,23,7,3420,28,1,63.33333333333333,27.89473684210526,7.894736842105263,0.672514619883041,0.20467836257309943
32,대전광역시,동구,대동,대동제1투,1879,1042,337,612,79,6,2,1036,6,837,32.528957528957534,59.07335907335908,7.625482625482626,0.5791505791505791,0.19305019305019305
33,대전광역시,동구,대동,대동제2투,1561,943,324,537,60,5,3,929,14,618,34.8762109795479,57.80409041980624,6.458557588805166,0.5382131324004306,0.32292787944025836
34,대전광역시,동구,대동,대동제3투,1759,1192,428,669,71,14,0,1182,10,567,36.209813874788495,56.598984771573605,6.006768189509306,1.1844331641285957,0.0
35,대전광역시,동구,대동,대동제4투,1842,1417,681,601,115,14,0,1411,6,425,48.263642806520195,42.59390503189228,8.15024805102764,0.9922041105598866,0.0
36,대전광역시,동구,자양동,관내사전투표,2915,2913,1628,797,420,29,5,2879,34,2,56.547412295936084,27.683223341438,14.58839874956582,1.0072941993747828,0.1736714136853074
37,대전광역시,동구,자양동,자양동제1투,2196,1237,361,682,154,17,3,1217,20,959,29.663105998356613,56.039441248972885,12.65406737880033,1.3968775677896468,0.24650780608052586
38,대전광역시,동구,자양동,자양동제2투,2596,1402,391,782,192,16,2,1383,19,1194,28.27187274041938,56.54374548083876,13.882863340563992,1.1569052783803326,0.14461315979754158
39,대전광역시,동구,자양동,자양동제3투,2149,1307,447,757,80,14,2,1300,7,842,34.38461538461539,58.23076923076923,6.153846153846154,1.0769230769230769,0.15384615384615385
40,대전광역시,동구,가양1동,관내사전투표,3094,3094,1882,970,194,23,5,3074,20,0,61.22316200390371,31.554977228366948,6.31099544567339,0.7482108002602472,0.16265452179570591
41,대전광역시,동구,가양1동,가양1동제1투,1697,1101,412,612,52,11,2,1089,12,596,37.83287419651056,56.19834710743802,4.775022956841139,1.0101010101010102,0.18365472910927455
42,대전광역시,동구,가양1동,가양1동제2투,1192,776,264,450,45,6,2,767,9,416,34.419817470664924,58.670143415906125,5.867014341590613,0.7822685788787485,0.2607561929595828
43,대전광역시,동구,가양1동,가양1동제3투,2741,1718,603,954,127,18,2,1704,14,1023,35.38732394366197,55.98591549295775,7.453051643192488,1.056338028169014,0.11737089201877934
44,대전광역시,동구,가양1동,가양1동제4투,1943,1159,327,720,90,6,2,1145,14,784,28.558951965065503,62.882096069869,7.860262008733625,0.5240174672489083,0.17467248908296942
45,대전광역시,동구,가양2동,관내사전투표,3092,3092,1922,866,247,26,6,3067,25,0,62.667101402021515,28.236061297685033,8.053472448646886,0.8477339419628301,0.19563090968373
46,대전광역시,동구,가양2동,가양2동제1투,2749,1857,741,985,98,16,5,1845,12,892,40.16260162601626,53.387533875338754,5.311653116531166,0.8672086720867209,0.27100271002710025
47,대전광역시,동구,가양2동,가양2동제2투,2096,1320,461,694,128,20,2,1305,15,776,35.32567049808429,53.18007662835249,9.808429118773947,1.532567049808429,0.15325670498084293
48,대전광역시,동구,가양2동,가양2동제3투,1808,1092,391,597,78,13,1,1080,12,716,36.2037037037037,55.27777777777778,7.222222222222221,1.2037037037037037,0.0925925925925926
49,대전광역시,동구,가양2동,가양2동제4투,2322,1436,497,787,112,22,1,1419,17,886,35.0246652572234,55.461592670895,7.892882311486963,1.550387596899225,0.07047216349541931
50,대전광역시,동구,가양2동,가양2동제5투,2394,1347,455,738,120,10,4,1327,20,1047,34.28786737000753,55.61416729464958,9.04295403165034,0.7535795026375283,0.30143180105501133
51,대전광역시,동구,용전동,관내사전투표,3495,3495,2198,969,268,26,3,3464,31,0,63.45265588914549,27.973441108545032,7.736720554272518,0.7505773672055427,0.08660508083140878
52,대전광역시,동구,용전동,용전동제1투,3040,2017,768,1044,169,14,5,2000,17,1023,38.4,52.2,8.450000000000001,0.7000000000000001,0.25
53,대전광역시,동구,용전동,용전동제2투,3076,1735,612,918,174,11,2,1717,18,1341,35.64356435643564,53.46534653465347,10.13395457192778,0.64065230052417,0.11648223645894001
54,대전광역시,동구,용전동,용전동제3투,3462,1722,612,903,174,14,5,1708,14,1740,35.831381733021075,52.86885245901639,10.187353629976581,0.819672131147541,0.29274004683840754
55,대전광역시,동구,용전동,용전동제4투,2833,1765,643,945,139,17,3,1747,18,1068,36.805953062392675,54.09273039496279,7.95649685174585,0.9730967372638809,0.17172295363480253
56,대전광역시,동구,성남동,관내사전투표,2549,2549,1599,741,173,15,1,2529,20,0,63.22657176749703,29.30011862396204,6.840648477659155,0.5931198102016607,0.039541320680110716
57,대전광역시,동구,성남동,성남동제1투,2589,1748,634,949,136,20,1,1740,8,841,36.4367816091954,54.54022988505747,7.816091954022989,1.1494252873563218,0.05747126436781609
58,대전광역시,동구,성남동,성남동제2투,1611,1063,382,603,56,10,0,1051,12,548,36.346336822074214,57.37392959086585,5.32825880114177,0.9514747859181731,0.0
59,대전광역시,동구,성남동,성남동제3투,2030,1425,551,750,87,21,2,1411,14,605,39.050318922749824,53.153791637136784,6.165839829907867,1.48830616583983,0.14174344436569808
60,대전광역시,동구,홍도동,관내사전투표,2529,2529,1526,691,269,21,1,2508,21,0,60.84529505582137,27.5518341307815,10.725677830940988,0.8373205741626795,0.03987240829346093
61,대전광역시,동구,홍도동,홍도동제1투,1200,792,284,450,42,7,2,785,7,408,36.17834394904458,57.324840764331206,5.35031847133758,0.89171974522293,0.25477707006369427
62,대전광역시,동구,홍도동,홍도동제2투,2670,1838,626,1022,155,19,5,1827,11,832,34.26382047071702,55.938697318007655,8.483853311439518,1.0399562123700055,0.27367268746579093
63,대전광역시,동구,홍도동,홍도동제3투,2857,1535,487,838,176,14,4,1519,16,1322,32.06056616194865,55.16787360105333,11.586570111915734,0.9216589861751152,0.26333113890717574
64,대전광역시,동구,삼성동,관내사전투표,2232,2232,1399,682,110,20,2,2213,19,0,63.217352010845005,30.817894261183916,4.970628106642567,0.903750564844103,0.09037505648441031
65,대전광역시,동구,삼성동,삼성동제1투,1557,1062,398,575,70,8,2,1053,9,495,37.79677113010446,54.605887939221276,6.647673314339982,0.7597340930674265,0.1899335232668566
66,대전광역시,동구,삼성동,삼성동제2투,1161,681,228,398,35,11,4,676,5,480,33.72781065088758,58.875739644970416,5.177514792899409,1.6272189349112427,0.591715976331361
67,대전광역시,동구,삼성동,삼성동제3투,2687,1935,730,1035,137,15,3,1920,15,752,38.02083333333333,53.90625,7.135416666666666,0.78125,0.15625
68,대전광역시,동구,삼성동,삼성동제4투,2390,1446,470,847,104,15,3,1439,7,944,32.661570535093816,58.860319666435025,7.227241139680333,1.0423905489923557,0.20847810979847115
69,대전광역시,동구,대청동,관내사전투표,438,438,227,185,16,5,0,433,5,0,52.42494226327945,42.725173210161664,3.695150115473441,1.1547344110854503,0.0
70,대전광역시,동구,대청동,대청동제1투,676,458,116,312,22,4,2,456,2,218,25.438596491228072,68.42105263157895,4.824561403508771,0.8771929824561403,0.43859649122807015
71,대전광역시,동구,대청동,대청동제2투,664,423,101,301,17,2,0,421,2,241,23.990498812351543,71.49643705463184,4.038004750593824,0.4750593824228029,0.0
72,대전광역시,동구,산내동,관내사전투표,3562,3562,2349,970,189,33,2,3543,19,0,66.29974597798476,27.377928309342366,5.334462320067739,0.9314140558848433,0.056449336720293536
73,대전광역시,동구,산내동,산내동제1투,3158,1878,717,986,139,13,1,1856,22,1280,38.63146551724138,53.125,7.489224137931035,0.7004310344827587,0.05387931034482758
74,대전광역시,동구,산내동,산내동제2투,600,329,98,211,15,2,0,326,3,271,30.061349693251532,64.7239263803681,4.601226993865031,0.6134969325153374,0.0
75,대전광역시,동구,산내동,산내동제3투,3837,2885,1353,1212,257,40,8,2870,15,952,47.14285714285714,42.22996515679442,8.954703832752612,1.3937282229965158,0.2787456445993031
76,대전광역시,동구,산내동,산내동제4투,1633,1145,446,598,82,7,4,1137,8,488,39.22603342128408,52.594547053649954,7.211961301671065,0.6156552330694811,0.3518029903254178
77,대전광역시,동구,산내동,산내동제5투,656,424,141,258,20,4,0,423,1,232,33.33333333333333,60.99290780141844,4.7281323877068555,0.9456264775413712,0.0
78,대전광역시,동구,산내동,산내동제6투,1661,1114,492,540,60,11,2,1105,9,547,44.52488687782805,48.86877828054298,5.429864253393665,0.9954751131221719,0.18099547511312217
79,대전광역시,동구,잘못 투입·구분된 투표지,,0,2,1,0,0,0,1,2,0,-2,50.0,0.0,0.0,0.0,50.0
0,대전광역시,중구,거소·선상투표,,309,286,132,94,49,2,1,278,8,23,47.482014388489205,33.81294964028777,17.62589928057554,0.7194244604316548,0.3597122302158274
1,대전광역시,중구,관외사전투표,,20759,20757,12109,5285,2868,221,30,20513,244,2,59.030858479988304,25.76414956369132,13.981377662945448,1.0773655730512357,0.14624872032369718
2,대전광역시,중구,재외투표,,809,632,447,118,55,9,1,630,2,177,70.95238095238095,18.73015873015873,8.73015873015873,1.4285714285714286,0.15873015873015872
3,대전광역시,중구,은행선화동,관내사전투표,3290,3290,2135,763,334,31,4,3267,23,0,65.35047444138354,23.354759718396082,10.22344658708295,0.9488827670645853,0.12243648607284971
4,대전광역시,중구,은행선화동,은행선화동제1투,2923,1827,795,821,168,29,2,1815,12,1096,43.80165289256198,45.23415977961432,9.256198347107437,1.5977961432506886,0.11019283746556473
5,대전광역시,중구,은행선화동,은행선화동제2투,2795,1713,573,940,160,25,1,1699,14,1082,33.72572101236021,55.32666274278988,9.417304296645085,1.4714537963507945,0.05885815185403178
6,대전광역시,중구,은행선화동,은행선화동제3투,3503,2221,903,1086,184,23,5,2201,20,1282,41.02680599727397,49.341208541572016,8.359836437982734,1.0449795547478418,0.2271694684234439
7,대전광역시,중구,은행선화동,은행선화동제4투,1804,1195,491,537,120,25,3,1176,19,609,41.75170068027211,45.66326530612245,10.204081632653061,2.1258503401360542,0.25510204081632654
8,대전광역시,중구,목동,관내사전투표,3260,3260,2281,637,277,43,2,3240,20,0,70.40123456790124,19.660493827160494,8.549382716049383,1.3271604938271606,0.06172839506172839
9,대전광역시,중구,목동,목동제1투,2908,2071,898,937,194,24,4,2057,14,837,43.6558094312105,45.55177442877978,9.431210500729218,1.166747690811862,0.19445794846864364
10,대전광역시,중구,목동,목동제2투,3049,2181,952,971,220,25,1,2169,12,868,43.89119409866298,44.76717381281697,10.142923005993545,1.1526048870447212,0.04610419548178884
11,대전광역시,중구,목동,목동제3투,2386,1830,847,816,137,20,1,1821,9,556,46.51290499725425,44.81054365733114,7.5233388248215265,1.098297638660077,0.054914881933003847
12,대전광역시,중구,중촌동,관내사전투표,2752,2752,1776,739,180,25,5,2725,27,0,65.1743119266055,27.11926605504587,6.605504587155964,0.9174311926605505,0.1834862385321101
13,대전광역시,중구,중촌동,중촌동제1투,1133,709,225,427,51,3,0,706,3,424,31.869688385269125,60.48158640226629,7.223796033994335,0.424929178470255,0.0
14,대전광역시,중구,중촌동,중촌동제2투,1345,1020,427,505,64,11,0,1007,13,325,42.40317775571003,50.148957298907646,6.355511420059583,1.0923535253227408,0.0
15,대전광역시,중구,중촌동,중촌동제3투,2038,1396,538,709,114,15,4,1380,16,642,38.98550724637681,51.3768115942029,8.26086956521739,1.0869565217391304,0.2898550724637681
16,대전광역시,중구,중촌동,중촌동제4투,2106,1521,709,660,127,16,0,1512,9,585,46.89153439153439,43.65079365079365,8.3994708994709,1.0582010582010581,0.0
17,대전광역시,중구,중촌동,중촌동제5투,2045,1446,561,719,130,13,2,1425,21,599,39.36842105263158,50.456140350877185,9.12280701754386,0.9122807017543859,0.14035087719298245
18,대전광역시,중구,대흥동,관내사전투표,2891,2891,1832,718,265,39,3,2857,34,0,64.12320616030802,25.131256562828142,9.27546377318866,1.3650682534126708,0.10500525026251313
19,대전광역시,중구,대흥동,대흥동제1투,3214,1767,585,969,166,23,4,1747,20,1447,33.48597595878649,55.46651402404122,9.502003434459072,1.316542644533486,0.22896393817973668
20,대전광역시,중구,대흥동,대흥동제2투,1852,1110,391,607,87,11,0,1096,14,742,35.675182481751825,55.38321167883211,7.937956204379562,1.0036496350364963,0.0
21,대전광역시,중구,대흥동,대흥동제3투,2179,1577,607,837,109,14,1,1568,9,602,38.71173469387755,53.380102040816325,6.951530612244898,0.8928571428571428,0.06377551020408163
22,대전광역시,중구,문창동,관내사전투표,1005,1004,629,304,60,7,2,1002,2,1,62.774451097804395,30.33932135728543,5.9880239520958085,0.6986027944111777,0.19960079840319359
23,대전광역시,중구,문창동,문창동제1투,1177,635,182,404,39,7,0,632,3,542,28.79746835443038,63.92405063291139,6.170886075949367,1.1075949367088607,0.0
24,대전광역시,중구,문창동,문창동제2투,1510,992,334,583,54,9,2,982,10,518,34.0122199592668,59.36863543788188,5.4989816700611,0.9164969450101833,0.20366598778004072
25,대전광역시,중구,석교동,관내사전투표,2476,2476,1487,834,115,16,5,2457,19,0,60.52096052096052,33.943833943833944,4.68050468050468,0.6512006512006512,0.20350020350020348
26,대전광역시,중구,석교동,석교동제1투,1739,1105,335,704,45,11,0,1095,10,634,30.59360730593607,64.29223744292237,4.10958904109589,1.004566210045662,0.0
27,대전광역시,중구,석교동,석교동제2투,1804,1112,335,686,68,15,0,1104,8,692,30.344202898550726,62.13768115942029,6.159420289855073,1.358695652173913,0.0
28,대전광역시,중구,석교동,석교동제3투,1644,982,329,563,75,9,0,976,6,662,33.709016393442624,57.684426229508205,7.684426229508197,0.9221311475409836,0.0
29,대전광역시,중구,석교동,석교동제4투,2019,1320,472,748,85,6,1,1312,8,699,35.97560975609756,57.012195121951216,6.478658536585366,0.45731707317073167,0.07621951219512195
30,대전광역시,중구,석교동,석교동제5투,1969,1329,507,727,69,12,4,1319,10,640,38.43821076573162,55.117513267627,5.231235784685367,0.9097801364670205,0.3032600454890068
31,대전광역시,중구,대사동,관내사전투표,1241,1241,728,414,79,10,1,1232,9,0,59.09090909090909,33.603896103896105,6.412337662337662,0.8116883116883116,0.08116883116883117
32,대전광역시,중구,대사동,대사동제1투,1496,931,264,613,38,11,0,926,5,565,28.509719222462206,66.1987041036717,4.103671706263499,1.187904967602592,0.0
33,대전광역시,중구,대사동,대사동제2투,1640,957,294,517,126,5,0,942,15,683,31.210191082802545,54.88322717622081,13.375796178343949,0.5307855626326964,0.0
34,대전광역시,중구,부사동,관내사전투표,1316,1316,818,419,59,12,0,1308,8,0,62.53822629969419,32.03363914373089,4.510703363914373,0.9174311926605505,0.0
35,대전광역시,중구,부사동,부사동제1투,1741,1105,383,636,62,6,2,1089,16,636,35.16988062442608,58.40220385674931,5.693296602387512,0.5509641873278237,0.18365472910927455
36,대전광역시,중구,부사동,부사동제2투,1926,1119,362,673,60,6,5,1106,13,807,32.730560578661844,60.8499095840868,5.424954792043399,0.5424954792043399,0.45207956600361665
37,대전광역시,중구,용두동,관내사전투표,2581,2581,1605,654,273,29,2,2563,18,0,62.62192742879438,25.516972298088174,10.651580179477175,1.1314865392118612,0.07803355442840422
38,대전광역시,중구,용두동,용두동제1투,3131,2043,760,1058,179,28,3,2028,15,1088,37.47534516765286,52.16962524654832,8.826429980276135,1.3806706114398422,0.14792899408284024
39,대전광역시,중구,용두동,용두동제2투,2498,1682,686,763,193,19,2,1663,19,816,41.250751653638,45.88093806374023,11.605532170775707,1.142513529765484,0.12026458208057728
40,대전광역시,중구,오류동,관내사전투표,2503,2503,1536,723,204,18,5,2486,17,0,61.786001609010455,29.08286403861625,8.205953338696702,0.7240547063555913,0.2011263073209976
41,대전광역시,중구,오류동,오류동제1투,2085,1240,400,707,105,12,3,1227,13,845,32.59983700081499,57.62021189894051,8.557457212713937,0.9779951100244498,0.24449877750611246
42,대전광역시,중구,오류동,오류동제2투,1973,1470,428,926,88,12,1,1455,15,503,29.41580756013746,63.64261168384879,6.048109965635739,0.8247422680412372,0.06872852233676977
43,대전광역시,중구,오류동,오류동제3투,1627,1123,316,708,81,8,2,1115,8,504,28.340807174887892,63.497757847533634,7.26457399103139,0.7174887892376681,0.17937219730941703
44,대전광역시,중구,태평1동,관내사전투표,2452,2452,1547,725,149,15,1,2437,15,0,63.47968814115716,29.749692244562986,6.1140746819860485,0.6155108740254411,0.04103405826836274
45,대전광역시,중구,태평1동,태평1동제1투,2064,1564,634,764,129,19,2,1548,16,500,40.95607235142119,49.35400516795866,8.333333333333332,1.227390180878553,0.12919896640826875
46,대전광역시,중구,태평1동,태평1동제2투,1579,985,293,611,58,10,3,975,10,594,30.05128205128205,62.66666666666667,5.948717948717949,1.0256410256410255,0.3076923076923077
47,대전광역시,중구,태평1동,태평1동제3투,2030,1530,670,734,92,14,1,1511,19,500,44.3414956982131,48.5771012574454,6.088682991396426,0.9265387160820648,0.06618133686300463
48,대전광역시,중구,태평1동,태평1동제4투,1409,1063,452,489,96,14,2,1053,10,346,42.92497625830959,46.438746438746435,9.116809116809117,1.3295346628679963,0.1899335232668566
49,대전광역시,중구,태평2동,관내사전투표,3680,3680,2378,1063,195,33,1,3670,10,0,64.79564032697547,28.96457765667575,5.313351498637602,0.8991825613079019,0.027247956403269755
50,대전광역시,중구,태평2동,태평2동제1투,1121,682,204,419,50,3,1,677,5,439,30.132939438700145,61.89069423929099,7.385524372230429,0.4431314623338257,0.14771048744460857
51,대전광역시,중구,태평2동,태평2동제2투,1771,1241,404,745,75,4,2,1230,11,530,32.84552845528455,60.56910569105691,6.097560975609756,0.3252032520325203,0.16260162601626016
52,대전광역시,중구,태평2동,태평2동제3투,2234,1548,506,926,99,10,1,1542,6,686,32.81452658884565,60.05188067444877,6.420233463035019,0.648508430609598,0.06485084306095978
53,대전광역시,중구,태평2동,태평2동제4투,2675,1933,707,1095,109,12,0,1923,10,742,36.76547061882475,56.94227769110765,5.668226729069162,0.62402496099844,0.0
54,대전광역시,중구,태평2동,태평2동제5투,2488,1883,583,1134,146,13,0,1876,7,605,31.076759061833688,60.447761194029844,7.782515991471215,0.6929637526652452,0.0
55,대전광역시,중구,태평2동,태평2동제6투,3004,2273,799,1289,146,25,3,2262,11,731,35.32272325375774,56.98496905393458,6.45446507515473,1.1052166224580018,0.1326259946949602
56,대전광역시,중구,유천1동,관내사전투표,2089,2088,1270,629,160,14,0,2073,15,1,61.26386878919441,30.34249879401833,7.718282682103232,0.6753497346840328,0.0
57,대전광역시,중구,유천1동,유천1동제1투,2142,1228,385,734,97,5,0,1221,7,914,31.53153153153153,60.11466011466011,7.944307944307945,0.4095004095004095,0.0
58,대전광역시,중구,유천1동,유천1동제2투,1527,904,290,533,68,6,0,897,7,623,32.32998885172798,59.42028985507246,7.58082497212932,0.6688963210702341,0.0
59,대전광역시,중구,유천2동,관내사전투표,2380,2380,1495,735,124,7,3,2364,16,0,63.24027072758037,31.091370558375637,5.245346869712352,0.2961082910321489,0.12690355329949238
60,대전광역시,중구,유천2동,유천2동제1투,1214,716,227,439,38,6,0,710,6,498,31.971830985915496,61.83098591549295,5.352112676056338,0.8450704225352111,0.0
61,대전광역시,중구,유천2동,유천2동제2투,1817,1129,357,677,75,5,5,1119,10,688,31.903485254691688,60.50044682752458,6.702412868632708,0.44682752457551383,0.44682752457551383
62,대전광역시,중구,유천2동,유천2동제3투,2142,1396,475,800,94,13,3,1385,11,746,34.29602888086642,57.761732851985556,6.787003610108304,0.9386281588447654,0.21660649819494585
63,대전광역시,중구,유천2동,유천2동제4투,2611,1977,584,1265,108,13,1,1971,6,634,29.629629629629626,64.18061897513952,5.47945205479452,0.6595636732623034,0.050735667174023336
64,대전광역시,중구,문화1동,관내사전투표,3525,3525,2192,971,312,27,4,3506,19,0,62.52139189960069,27.69537934968625,8.899030233884769,0.7701083856246435,0.11409013120365087
65,대전광역시,중구,문화1동,문화1동제1투,2848,2045,761,1104,160,9,2,2036,9,803,37.377210216110015,54.223968565815326,7.858546168958743,0.44204322200392926,0.09823182711198428
66,대전광역시,중구,문화1동,문화1동제2투,741,499,154,292,41,7,1,495,4,242,31.11111111111111,58.98989898989899,8.282828282828284,1.4141414141414141,0.20202020202020202
67,대전광역시,중구,문화1동,문화1동제3투,1629,1116,366,653,85,7,0,1111,5,513,32.943294329432945,58.77587758775877,7.650765076507652,0.6300630063006301,0.0
68,대전광역시,중구,문화1동,문화1동제4투,2865,2169,814,1146,168,25,1,2154,15,696,37.79015784586815,53.2033426183844,7.7994428969359335,1.160631383472609,0.04642525533890436
69,대전광역시,중구,문화1동,문화1동제5투,2982,2142,719,1192,191,24,1,2127,15,840,33.803479078514336,56.041372825575934,8.979783732957216,1.1283497884344147,0.04701457451810061
70,대전광역시,중구,문화2동,관내사전투표,2775,2775,1660,908,159,23,4,2754,21,0,60.27596223674655,32.97022512708787,5.773420479302832,0.8351488743645605,0.14524328249818447
71,대전광역시,중구,문화2동,문화2동제1투,1073,663,213,389,41,8,4,655,8,410,32.51908396946565,59.38931297709924,6.259541984732825,1.2213740458015268,0.6106870229007634
72,대전광역시,중구,문화2동,문화2동제2투,2234,1569,566,890,91,11,1,1559,10,665,36.30532392559333,57.08787684413086,5.837075048107762,0.7055805003207184,0.06414368184733803
73,대전광역시,중구,문화2동,문화2동제3투,1758,1084,339,651,68,11,3,1072,12,674,31.62313432835821,60.72761194029851,6.343283582089552,1.0261194029850746,0.2798507462686567
74,대전광역시,중구,문화2동,문화2동제4투,1637,1046,357,601,70,8,1,1037,9,591,34.42622950819672,57.955641272902604,6.750241080038573,0.7714561234329798,0.09643201542912247
75,대전광역시,중구,산성동,관내사전투표,3302,3301,2062,1022,169,26,5,3284,17,1,62.78928136419001,31.120584652862366,5.146163215590743,0.7917174177831912,0.1522533495736906
76,대전광역시,중구,산성동,산성동제1투,1528,925,280,579,47,7,1,914,11,603,30.63457330415755,63.34792122538293,5.142231947483589,0.7658643326039387,0.10940919037199125
77,대전광역시,중구,산성동,산성동제2투,1765,1179,387,704,67,10,2,1170,9,586,33.07692307692307,60.17094017094017,5.726495726495727,0.8547008547008548,0.17094017094017094
78,대전광역시,중구,산성동,산성동제3투,2414,1509,537,837,98,20,4,1496,13,905,35.89572192513369,55.94919786096256,6.550802139037433,1.3368983957219251,0.267379679144385
79,대전광역시,중구,산성동,산성동제4투,2380,1800,656,995,108,17,3,1779,21,580,36.874648679033164,55.930297920179875,6.070826306913997,0.9555930297920181,0.16863406408094433
80,대전광역시,중구,산성동,산성동제5투,2036,1314,489,720,88,11,0,1308,6,722,37.38532110091743,55.04587155963303,6.727828746177369,0.8409785932721712,0.0
81,대전광역시,중구,산성동,산성동제6투,2677,1739,685,908,121,10,2,1726,13,938,39.68713789107763,52.6071842410197,7.010428736964079,0.5793742757821553,0.11587485515643105
82,대전광역시,중구,산성동,산성동제7투,2672,1731,656,957,93,10,6,1722,9,941,38.095238095238095,55.57491289198606,5.400696864111499,0.5807200929152149,0.34843205574912894
83,대전광역시,중구,산성동,산성동제8투,686,392,120,260,9,1,1,391,1,294,30.69053708439898,66.49616368286445,2.3017902813299234,0.2557544757033248,0.2557544757033248
84,대전광역시,중구,잘못 투입·구분된 투표지,,0,1,0,0,0,0,0,0,1,-1,0.0,0.0,0.0,0.0,0.0
0,대전광역시,서구,거소·선상투표,,554,527,196,183,114,4,3,500,27,27,39.2,36.6,22.8,0.8,0.6
1,대전광역시,서구,관외사전투표,,38204,38199,21814,9531,5885,475,60,37765,434,5,57.76247848537005,25.23765391235271,15.583211968754137,1.2577783662121012,0.15887726731100227
2,대전광역시,서구,재외투표,,1651,1360,915,254,154,21,0,1344,16,291,68.08035714285714,18.898809523809522,11.458333333333332,1.5625,0.0
3,대전광역시,서구,복수동,관내사전투표,4373,4373,2915,1081,309,37,3,4345,28,0,67.08860759493672,24.879171461449943,7.11162255466053,0.8515535097813579,0.06904487917146145
4,대전광역시,서구,복수동,복수동제1투,2715,1964,796,1011,125,19,1,1952,12,751,40.77868852459016,51.79303278688525,6.403688524590163,0.9733606557377049,0.05122950819672131
5,대전광역시,서구,복수동,복수동제2투,3054,2201,873,1093,195,21,2,2184,17,853,39.972527472527474,50.04578754578755,8.928571428571429,0.9615384615384616,0.09157509157509157
6,대전광역시,서구,복수동,복수동제3투,2314,1610,671,818,90,16,5,1600,10,704,41.9375,51.125,5.625,1.0,0.3125
7,대전광역시,서구,복수동,복수동제4투,2906,1672,676,819,148,17,1,1661,11,1234,40.69837447320891,49.30764599638772,8.910295003010235,1.0234798314268514,0.060204695966285374
8,대전광역시,서구,도마1동,관내사전투표,3856,3856,2190,1364,260,22,5,3841,15,0,57.01640197865139,35.51158552460297,6.769070554543087,0.5727675084613382,0.1301744337412132
9,대전광역시,서구,도마1동,도마1동제1투,1464,866,244,551,55,9,0,859,7,598,28.405122235157158,64.14435389988358,6.402793946449361,1.0477299185098952,0.0
10,대전광역시,서구,도마1동,도마1동제2투,3857,2902,1162,1405,279,30,7,2883,19,955,40.30523759972251,48.733957682969134,9.67741935483871,1.040582726326743,0.2428026361429067
11,대전광역시,서구,도마1동,도마1동제3투,1338,816,226,524,53,1,1,805,11,522,28.074534161490682,65.09316770186335,6.583850931677018,0.12422360248447205,0.12422360248447205
12,대전광역시,서구,도마1동,도마1동제4투,2089,1157,396,620,114,13,0,1143,14,932,34.645669291338585,54.24321959755031,9.973753280839896,1.1373578302712162,0.0
13,대전광역시,서구,도마1동,도마1동제5투,2428,1471,511,815,116,9,3,1454,17,957,35.14442916093535,56.05226960110041,7.977991746905088,0.6189821182943603,0.20632737276478677
14,대전광역시,서구,도마2동,관내사전투표,2968,2968,1820,866,226,25,1,2938,30,0,61.94690265486725,29.475833900612663,7.6923076923076925,0.8509189925119129,0.03403675970047651
15,대전광역시,서구,도마2동,도마2동제1투,2015,1214,398,722,73,10,1,1204,10,801,33.056478405315616,59.966777408637874,6.06312292358804,0.8305647840531563,0.08305647840531562
16,대전광역시,서구,도마2동,도마2동제2투,2893,1961,785,967,171,18,2,1943,18,932,40.40144107050952,49.76839938239836,8.800823468862584,0.9264024704065877,0.1029336078229542
17,대전광역시,서구,도마2동,도마2동제3투,1773,1094,376,634,62,9,2,1083,11,679,34.71837488457987,58.54108956602031,5.724838411819022,0.8310249307479225,0.18467220683287164
18,대전광역시,서구,도마2동,도마2동제4투,2468,1648,557,938,124,15,3,1637,11,820,34.025656689065364,57.29993891264509,7.574832009773977,0.916310323762981,0.1832620647525962
19,대전광역시,서구,도마2동,도마2동제5투,2546,1859,585,1111,136,18,1,1851,8,687,31.60453808752026,60.02160994057266,7.347379794705565,0.9724473257698543,0.05402485143165856
20,대전광역시,서구,정림동,관내사전투표,3804,3804,2376,1156,223,29,0,3784,20,0,62.7906976744186,30.549682875264274,5.89323467230444,0.766384778012685,0.0
21,대전광역시,서구,정림동,정림동제1투,1735,1162,384,687,75,8,0,1154,8,573,33.27556325823224,59.53206239168111,6.499133448873485,0.6932409012131715,0.0
22,대전광역시,서구,정림동,정림동제2투,1626,1174,425,650,77,11,2,1165,9,452,36.48068669527897,55.793991416309005,6.609442060085836,0.944206008583691,0.17167381974248927
23,대전광역시,서구,정림동,정림동제3투,1467,905,294,527,66,9,3,899,6,562,32.70300333704116,58.620689655172406,7.341490545050055,1.0011123470522802,0.33370411568409347
24,대전광역시,서구,정림동,정림동제4투,1613,1054,399,578,65,4,1,1047,7,559,38.108882521489974,55.205348615090735,6.208213944603629,0.38204393505253104,0.09551098376313276
25,대전광역시,서구,정림동,정림동제5투,1874,1314,523,672,96,10,3,1304,10,560,40.107361963190186,51.533742331288344,7.361963190184049,0.7668711656441718,0.23006134969325154
26,대전광역시,서구,변동,관내사전투표,1793,1793,1158,513,107,10,0,1788,5,0,64.76510067114094,28.691275167785236,5.984340044742729,0.5592841163310962,0.0
27,대전광역시,서구,변동,변동제1투,2339,1379,449,824,89,11,0,1373,6,960,32.702112163146396,60.014566642388935,6.482155863073562,0.8011653313911145,0.0
28,대전광역시,서구,변동,변동제2투,3368,2079,799,1135,109,23,1,2067,12,1289,38.65505563618771,54.91049830672472,5.2733430091920654,1.1127237542331883,0.04837929366231253
29,대전광역시,서구,변동,변동제3투,2193,1347,482,750,86,16,2,1336,11,846,36.07784431137724,56.137724550898206,6.437125748502994,1.1976047904191618,0.14970059880239522
30,대전광역시,서구,용문동,관내사전투표,4490,4490,2602,1302,482,57,4,4447,43,0,58.51135597031707,29.278165055093318,10.838767708567573,1.2817629862828872,0.08994827973914998
31,대전광역시,서구,용문동,용문동제1투,3571,1902,576,1093,181,25,4,1879,23,1669,30.65460351250665,58.16923895689197,9.632783395423097,1.3304949441192122,0.21287919105907396
32,대전광역시,서구,용문동,용문동제2투,3297,2131,745,1161,187,18,4,2115,16,1166,35.22458628841608,54.8936170212766,8.84160756501182,0.851063829787234,0.18912529550827423
33,대전광역시,서구,용문동,용문동제3투,2883,1857,569,1070,180,21,4,1844,13,1026,30.856832971800436,58.02603036876356,9.761388286334057,1.13882863340564,0.21691973969631237
34,대전광역시,서구,탄방동,관내사전투표,4066,4066,2587,929,474,35,5,4030,36,0,64.19354838709678,23.05210918114144,11.761786600496277,0.8684863523573202,0.12406947890818859
35,대전광역시,서구,탄방동,탄방동제1투,3197,1856,650,941,223,22,4,1840,16,1341,35.32608695652174,51.141304347826086,12.119565217391305,1.1956521739130435,0.21739130434782608
36,대전광역시,서구,탄방동,탄방동제2투,3572,2218,791,1101,283,23,4,2202,16,1354,35.921889191643956,50.0,12.851952770208902,1.0445049954586738,0.18165304268846502
37,대전광역시,서구,탄방동,탄방동제3투,1576,1227,480,618,102,16,0,1216,11,349,39.473684210526315,50.82236842105263,8.388157894736842,1.3157894736842104,0.0
38,대전광역시,서구,탄방동,탄방동제4투,1725,1378,593,647,109,16,1,1366,12,347,43.41142020497804,47.364568081991216,7.979502196193265,1.171303074670571,0.07320644216691069
39,대전광역시,서구,탄방동,탄방동제5투,3245,2130,740,1122,231,17,2,2112,18,1115,35.03787878787879,53.125,10.9375,0.8049242424242424,0.0946969696969697
40,대전광역시,서구,탄방동,탄방동제6투,2330,1544,561,822,131,17,2,1533,11,786,36.59491193737769,53.62035225048923,8.545335942596216,1.1089367253750815,0.1304631441617743
41,대전광역시,서구,둔산1동,관내사전투표,5859,5859,3655,1381,692,86,2,5816,43,0,62.84387895460798,23.744841815680882,11.898211829436038,1.4786795048143053,0.0343878954607978
42,대전광역시,서구,둔산1동,둔산1동제1투,2324,1639,451,992,178,10,1,1632,7,685,27.63480392156863,60.78431372549019,10.906862745098039,0.6127450980392157,0.061274509803921566
43,대전광역시,서구,둔산1동,둔산1동제2투,1962,1576,546,829,162,27,0,1564,12,386,34.910485933503836,53.005115089514064,10.358056265984656,1.7263427109974423,0.0
44,대전광역시,서구,둔산1동,둔산1동제3투,2120,1632,579,874,157,15,1,1626,6,488,35.608856088560884,53.75153751537516,9.655596555965559,0.9225092250922509,0.06150061500615006
45,대전광역시,서구,둔산1동,둔산1동제4투,1911,1535,489,878,145,17,1,1530,5,376,31.960784313725487,57.385620915032675,9.477124183006536,1.1111111111111112,0.065359477124183
46,대전광역시,서구,둔산2동,관내사전투표,5296,5296,3419,1141,623,63,5,5251,45,0,65.11140735098077,21.729194439154448,11.864406779661017,1.1997714721005521,0.09521995810321843
47,대전광역시,서구,둔산2동,둔산2동제1투,2760,2122,812,1068,195,26,2,2103,19,638,38.611507370423205,50.78459343794579,9.272467902995722,1.2363290537327627,0.0951022349025202
48,대전광역시,서구,둔산2동,둔산2동제2투,3114,2482,1043,1100,291,28,1,2463,19,632,42.34673162809582,44.660982541615915,11.814859926918391,1.1368250101502233,0.04060089321965083
49,대전광역시,서구,둔산2동,둔산2동제3투,3095,2351,922,1167,216,29,2,2336,15,744,39.46917808219178,49.957191780821915,9.246575342465754,1.2414383561643836,0.08561643835616438
50,대전광역시,서구,둔산2동,둔산2동제4투,2492,2026,804,1044,158,15,0,2021,5,466,39.782285997031174,51.657595249876294,7.817911924789708,0.7422068283028204,0.0
51,대전광역시,서구,둔산2동,둔산2동제5투,2435,1962,915,800,193,33,3,1944,18,473,47.0679012345679,41.1522633744856,9.927983539094651,1.6975308641975309,0.15432098765432098
52,대전광역시,서구,둔산2동,둔산2동제6투,2506,2051,956,815,228,32,2,2033,18,455,47.024102311854406,40.08853910477128,11.214953271028037,1.5740285292670928,0.0983767830791933
53,대전광역시,서구,둔산2동,둔산2동제7투,2863,1607,589,765,209,26,2,1591,16,1256,37.02074167190446,48.08296668761785,13.136392206159647,1.6341923318667504,0.1257071024512885
54,대전광역시,서구,둔산3동,관내사전투표,5300,5300,3341,1453,435,41,7,5277,23,0,63.31248815614933,27.534584043964372,8.24332006822058,0.7769566041311351,0.13265112753458402
55,대전광역시,서구,둔산3동,둔산3동제1투,1712,1298,456,724,97,10,0,1287,11,414,35.43123543123543,56.25485625485626,7.536907536907537,0.777000777000777,0.0
56,대전광역시,서구,둔산3동,둔산3동제2투,2237,1682,589,938,135,14,0,1676,6,555,35.143198090692124,55.96658711217184,8.05489260143198,0.8353221957040573,0.0
57,대전광역시,서구,둔산3동,둔산3동제3투,1727,1333,318,895,94,20,0,1327,6,394,23.9638281838734,67.44536548605879,7.083647324792766,1.5071590052750565,0.0
58,대전광역시,서구,둔산3동,둔산3동제4투,2960,2090,716,1142,188,27,0,2073,17,870,34.53931500241196,55.08924264351182,9.068982151471298,1.3024602026049203,0.0
59,대전광역시,서구,둔산3동,둔산3동제5투,1329,890,333,496,45,8,0,882,8,439,37.755102040816325,56.235827664399096,5.1020408163265305,0.9070294784580499,0.0
60,대전광역시,서구,괴정동,관내사전투표,2392,2392,1544,554,252,24,1,2375,17,0,65.01052631578948,23.326315789473682,10.610526315789473,1.0105263157894737,0.042105263157894736
61,대전광역시,서구,괴정동,괴정동제1투,3088,1668,609,870,144,18,1,1642,26,1420,37.088915956151034,52.98416565164433,8.76979293544458,1.0962241169305724,0.06090133982947624
62,대전광역시,서구,괴정동,괴정동제2투,3348,1688,622,800,214,24,5,1665,23,1660,37.35735735735736,48.048048048048045,12.852852852852854,1.4414414414414414,0.3003003003003003
63,대전광역시,서구,괴정동,괴정동제3투,2953,1547,532,834,144,18,1,1529,18,1406,34.79398299542184,54.54545454545454,9.417920209287116,1.1772400261608895,0.06540222367560497
64,대전광역시,서구,괴정동,괴정동제4투,2462,1477,564,727,156,16,4,1467,10,985,38.445807770961146,49.55691888207225,10.633946830265849,1.0906612133606,0.27266530334015
65,대전광역시,서구,가장동,관내사전투표,2416,2416,1470,755,151,26,1,2403,13,0,61.173533083645445,31.41905950894715,6.28381190178943,1.0819808572617562,0.04161464835622139
66,대전광역시,서구,가장동,가장동제1투,2436,1552,555,859,101,20,1,1536,16,884,36.1328125,55.924479166666664,6.575520833333333,1.3020833333333335,0.06510416666666666
67,대전광역시,서구,가장동,가장동제2투,2175,1689,603,955,109,11,0,1678,11,486,35.93563766388558,56.9129916567342,6.495828367103695,0.6555423122765197,0.0
68,대전광역시,서구,가장동,가장동제3투,1553,1074,314,641,97,12,3,1067,7,479,29.42830365510778,60.07497656982193,9.090909090909092,1.1246485473289598,0.28116213683223995
69,대전광역시,서구,내동,관내사전투표,3660,3660,2350,1016,237,32,4,3639,21,0,64.57818081890629,27.91975817532289,6.512778235779059,0.8793624622148941,0.10992030777686176
70,대전광역시,서구,내동,내동제1투,1846,1156,433,617,82,9,3,1144,12,690,37.84965034965035,53.93356643356644,7.167832167832168,0.7867132867132868,0.26223776223776224
71,대전광역시,서구,내동,내동제2투,2150,1207,391,687,99,14,1,1192,15,943,32.802013422818796,57.63422818791947,8.305369127516778,1.174496644295302,0.08389261744966443
72,대전광역시,서구,내동,내동제3투,3065,2021,771,1096,122,18,1,2008,13,1044,38.396414342629484,54.581673306772906,6.075697211155378,0.8964143426294822,0.049800796812749
73,대전광역시,서구,내동,내동제4투,2751,2190,763,1273,122,17,2,2177,13,561,35.048231511254016,58.47496554892053,5.604042259990813,0.7808911345888837,0.09186954524575103
74,대전광역시,서구,내동,내동제5투,2791,2023,716,1113,164,13,1,2007,16,768,35.6751370204285,55.4559043348281,8.17140009965122,0.6477329347284505,0.04982561036372695
75,대전광역시,서구,갈마1동,관내사전투표,4317,4317,2708,1233,287,52,3,4283,34,0,63.22671024982489,28.788232547279947,6.7009105766985755,1.2141022647676862,0.07004436142890498
76,대전광역시,서구,갈마1동,갈마1동제1투,1796,1333,408,805,97,12,1,1323,10,463,30.839002267573694,60.84656084656085,7.331821617535904,0.9070294784580499,0.07558578987150416
77,대전광역시,서구,갈마1동,갈마1동제2투,1825,1100,350,638,97,12,1,1098,2,725,31.876138433515482,58.1056466302368,8.83424408014572,1.092896174863388,0.09107468123861566
78,대전광역시,서구,갈마1동,갈마1동제3투,3467,1825,638,926,217,26,0,1807,18,1642,35.3071389042612,51.24515771997786,12.00885445489762,1.4388489208633095,0.0
79,대전광역시,서구,갈마1동,갈마1동제4투,2695,1604,587,824,161,19,1,1592,12,1091,36.87185929648241,51.75879396984925,10.113065326633166,1.193467336683417,0.06281407035175879
80,대전광역시,서구,갈마1동,갈마1동제5투,2994,1761,579,897,243,18,2,1739,22,1233,33.29499712478436,51.58136860264519,13.973548016101208,1.0350776308223115,0.11500862564692352
81,대전광역시,서구,갈마2동,관내사전투표,4678,4678,2972,1103,505,50,7,4637,41,0,64.093163683416,23.786931205520812,10.890662065990943,1.0782833728703902,0.15095967220185466
82,대전광역시,서구,갈마2동,갈마2동제1투,3337,1443,475,709,217,20,4,1425,18,1894,33.33333333333333,49.75438596491228,15.228070175438596,1.4035087719298245,0.2807017543859649
83,대전광역시,서구,갈마2동,갈마2동제2투,2731,1777,717,866,153,24,2,1762,15,954,40.69239500567537,49.148694665153236,8.683314415437003,1.362088535754824,0.11350737797956867
84,대전광역시,서구,갈마2동,갈마2동제3투,2456,1660,694,767,151,26,1,1639,21,796,42.34289200732154,46.79682733374009,9.21293471629042,1.586333129957291,0.06101281269066504
85,대전광역시,서구,갈마2동,갈마2동제4투,2620,1316,466,653,167,14,1,1301,15,1304,35.81860107609531,50.19215987701769,12.836279784780938,1.0760953112990008,0.07686395080707148
86,대전광역시,서구,갈마2동,갈마2동제5투,3268,1892,671,998,178,19,4,1870,22,1376,35.88235294117647,53.36898395721925,9.518716577540106,1.0160427807486632,0.21390374331550802
87,대전광역시,서구,월평1동,관내사전투표,2413,2413,1477,547,317,40,3,2384,29,0,61.95469798657718,22.94463087248322,13.296979865771814,1.6778523489932886,0.12583892617449663
88,대전광역시,서구,월평1동,월평1동제1투,2033,1172,380,600,156,16,0,1152,20,861,32.98611111111111,52.083333333333336,13.541666666666666,1.3888888888888888,0.0
89,대전광역시,서구,월평1동,월평1동제2투,2505,1528,499,802,187,19,2,1509,19,977,33.068257123923125,53.147779986746194,12.392312789927104,1.2591119946984757,0.13253810470510272
90,대전광역시,서구,월평1동,월평1동제3투,2411,1327,422,687,187,16,1,1313,14,1084,32.140137090632145,52.32292460015232,14.242193450114243,1.2185833968012185,0.07616146230007616
91,대전광역시,서구,월평2동,관내사전투표,4144,4144,2537,1153,365,46,3,4104,40,0,61.817738791423004,28.094541910331383,8.893762183235868,1.120857699805068,0.07309941520467836
92,대전광역시,서구,월평2동,월평2동제1투,1097,642,216,362,52,4,0,634,8,455,34.06940063091483,57.09779179810725,8.201892744479496,0.6309148264984227,0.0
93,대전광역시,서구,월평2동,월평2동제2투,2309,1759,613,977,149,12,0,1751,8,550,35.00856653340948,55.796687607081665,8.509423186750428,0.6853226727584237,0.0
94,대전광역시,서구,월평2동,월평2동제3투,1429,922,295,543,68,8,1,915,7,507,32.240437158469945,59.34426229508196,7.431693989071038,0.8743169398907104,0.1092896174863388
95,대전광역시,서구,월평2동,월평2동제4투,2497,1830,520,1170,111,15,0,1816,14,667,28.634361233480178,64.42731277533039,6.112334801762115,0.8259911894273128,0.0
96,대전광역시,서구,월평3동,관내사전투표,4268,4268,2666,1114,406,43,2,4231,37,0,63.01110848499173,26.329472937839753,9.595840226896716,1.0163082013708344,0.04727014890096904
97,대전광역시,서구,월평3동,월평3동제1투,1437,1010,297,609,82,11,0,999,11,427,29.72972972972973,60.96096096096096,8.208208208208207,1.1011011011011012,0.0
98,대전광역시,서구,월평3동,월평3동제2투,1613,1183,430,626,106,14,1,1177,6,430,36.53355989804588,53.18606627017842,9.005947323704333,1.1894647408666101,0.08496176720475786
99,대전광역시,서구,월평3동,월평3동제3투,2673,2117,840,1020,205,31,5,2101,16,556,39.98096144693004,48.54831032841504,9.757258448357925,1.475487862922418,0.23798191337458352
100,대전광역시,서구,월평3동,월평3동제4투,2794,2266,777,1263,180,25,0,2245,21,528,34.61024498886414,56.25835189309577,8.017817371937639,1.1135857461024499,0.0
101,대전광역시,서구,월평3동,월평3동제5투,1793,1325,498,678,127,16,0,1319,6,468,37.75587566338135,51.40257771038665,9.628506444275967,1.2130401819560273,0.0
102,대전광역시,서구,만년동,관내사전투표,3792,3792,2295,869,541,49,5,3759,33,0,61.0534716679968,23.11785049215217,14.392125565309923,1.303538175046555,0.13301409949454643
103,대전광역시,서구,만년동,만년동제1투,2789,1951,610,967,321,28,2,1928,23,838,31.63900414937759,50.155601659751035,16.649377593360995,1.4522821576763485,0.1037344398340249
104,대전광역시,서구,만년동,만년동제2투,1356,1043,407,497,123,12,0,1039,4,313,39.17228103946102,47.83445620789221,11.838306063522618,1.1549566891241578,0.0
105,대전광역시,서구,만년동,만년동제3투,1979,1541,479,905,136,9,2,1531,10,438,31.286740692357935,59.11169170476812,8.883082952318746,0.5878510777269758,0.13063357282821686
106,대전광역시,서구,가수원동,관내사전투표,3405,3405,2114,977,254,32,4,3381,24,0,62.52587991718427,28.896776101745047,7.5125702454895,0.9464655427388345,0.11830819284235432
107,대전광역시,서구,가수원동,가수원동제1투,1659,1043,336,633,61,4,0,1034,9,616,32.495164410058024,61.21856866537717,5.899419729206963,0.3868471953578337,0.0
108,대전광역시,서구,가수원동,가수원동제2투,1989,1330,437,787,83,12,2,1321,9,659,33.08099924299773,59.57607872823618,6.283118849356548,0.9084027252081757,0.1514004542013626
109,대전광역시,서구,가수원동,가수원동제3투,2099,1345,508,733,82,12,0,1335,10,754,38.05243445692884,54.9063670411985,6.142322097378277,0.8988764044943821,0.0
110,대전광역시,서구,도안동,관내사전투표,4268,4268,2907,927,388,23,3,4248,20,0,68.4322033898305,21.822033898305087,9.133709981167607,0.5414312617702448,0.07062146892655367
111,대전광역시,서구,도안동,도안동제1투,3015,2240,931,1078,192,22,1,2224,16,775,41.86151079136691,48.47122302158273,8.633093525179856,0.9892086330935251,0.04496402877697842
112,대전광역시,서구,도안동,도안동제2투,3093,2011,841,903,238,17,0,1999,12,1082,42.07103551775888,45.17258629314657,11.905952976488244,0.8504252126063032,0.0
113,대전광역시,서구,도안동,도안동제3투,1721,1308,637,558,86,18,0,1299,9,413,49.03772132409546,42.956120092378754,6.620477290223249,1.3856812933025404,0.0
114,대전광역시,서구,도안동,도안동제4투,3232,2514,1162,1116,204,21,0,2503,11,718,46.42429085097883,44.586496204554535,8.150219736316421,0.8389932081502196,0.0
115,대전광역시,서구,도안동,도안동제5투,4297,3031,1324,1356,302,34,1,3017,14,1266,43.88465362943321,44.94530991050713,10.00994365263507,1.126947298641034,0.033145508783559825
116,대전광역시,서구,도안동,도안동제6투,3147,2321,1061,987,240,21,2,2311,10,826,45.910861099091306,42.70878407615751,10.38511466897447,0.9086975335352662,0.08654262224145391
117,대전광역시,서구,관저1동,관내사전투표,4159,4158,2698,951,450,33,2,4134,24,1,65.2636671504596,23.00435413642961,10.88534107402032,0.7982583454281567,0.04837929366231253
118,대전광역시,서구,관저1동,관저1동제1투,2758,1798,702,853,206,22,1,1784,14,960,39.34977578475337,47.813901345291484,11.547085201793722,1.2331838565022422,0.05605381165919283
119,대전광역시,서구,관저1동,관저1동제2투,1838,1353,469,742,117,16,0,1344,9,485,34.89583333333333,55.208333333333336,8.705357142857142,1.1904761904761905,0.0
120,대전광역시,서구,관저1동,관저1동제3투,3039,2113,855,1017,199,22,1,2094,19,926,40.83094555873926,48.567335243553,9.50334288443171,1.0506208213944603,0.04775549188156638
121,대전광역시,서구,관저2동,관내사전투표,8790,8789,6040,1954,674,76,7,8751,38,1,69.02068335047423,22.328876699805736,7.701976916923781,0.8684721746086161,0.0799908581876357
122,대전광역시,서구,관저2동,관저2동제1투,1719,1188,408,661,96,12,2,1179,9,531,34.605597964376585,56.06446140797286,8.142493638676845,1.0178117048346056,0.16963528413910092
123,대전광역시,서구,관저2동,관저2동제2투,3100,2296,1050,954,237,28,4,2273,23,804,46.19445666520018,41.970963484381876,10.426748790145183,1.2318521777386713,0.1759788825340959
124,대전광역시,서구,관저2동,관저2동제3투,2506,1725,809,722,162,13,2,1708,17,781,47.36533957845433,42.27166276346605,9.484777517564403,0.7611241217798594,0.117096018735363
125,대전광역시,서구,관저2동,관저2동제4투,3228,2180,905,1006,208,27,2,2148,32,1048,42.13221601489758,46.83426443202979,9.683426443202979,1.2569832402234637,0.0931098696461825
126,대전광역시,서구,관저2동,관저2동제5투,3068,2209,1019,936,216,24,2,2197,12,859,46.38142922166591,42.60355029585799,9.83158852981338,1.0923987255348202,0.09103322712790168
127,대전광역시,서구,관저2동,관저2동제6투,2510,1837,873,766,176,10,3,1828,9,673,47.75711159737418,41.903719912472646,9.62800875273523,0.5470459518599562,0.16411378555798686
128,대전광역시,서구,관저2동,관저2동제7투,2378,1539,709,650,154,15,1,1529,10,839,46.37017658600392,42.51144538914323,10.071942446043165,0.9810333551340745,0.06540222367560497
129,대전광역시,서구,관저2동,관저2동제8투,2454,1733,839,694,164,16,4,1717,16,721,48.86429819452533,40.41933605125219,9.551543389633082,0.9318578916715201,0.23296447291788003
130,대전광역시,서구,관저2동,관저2동제9투,3557,2493,1183,1028,243,24,1,2479,14,1064,47.72085518354175,41.46833400564744,9.802339653085921,0.9681323114158934,0.04033884630899556
131,대전광역시,서구,기성동,관내사전투표,1137,1137,600,443,61,4,3,1111,26,0,54.005400540054005,39.87398739873987,5.4905490549054905,0.36003600360036003,0.27002700270027
132,대전광역시,서구,기성동,기성동제1투,510,277,68,197,8,2,0,275,2,233,24.727272727272727,71.63636363636363,2.909090909090909,0.7272727272727273,0.0
133,대전광역시,서구,기성동,기성동제2투,710,387,129,231,16,2,3,381,6,323,33.85826771653544,60.629921259842526,4.199475065616798,0.5249343832020997,0.7874015748031495
134,대전광역시,서구,기성동,기성동제3투,823,490,123,293,22,10,3,451,39,333,27.27272727272727,64.96674057649668,4.878048780487805,2.2172949002217295,0.6651884700665188
135,대전광역시,서구,잘못 투입·구분된 투표지,,0,1,1,0,0,0,0,1,0,-1,100.0,0.0,0.0,0.0,0.0
0,대전광역시,유성구,거소·선상투표,,374,359,131,139,72,2,1,345,14,15,37.971014492753625,40.28985507246377,20.869565217391305,0.5797101449275363,0.2898550724637681
1,대전광역시,유성구,관외사전투표,,34256,34254,19535,8591,5333,375,31,33865,389,2,57.68492543924406,25.36837442787539,15.747822235346229,1.1073379595452533,0.09153993798907427
2,대전광역시,유성구,재외투표,,1853,1528,979,326,180,29,1,1515,13,325,64.62046204620462,21.51815181518152,11.881188118811881,1.914191419141914,0.066006600660066
3,대전광역시,유성구,진잠동,관내사전투표,3914,3914,2659,966,237,27,3,3892,22,0,68.31963001027749,24.820143884892087,6.089414182939363,0.6937307297019527,0.07708119218910585
4,대전광역시,유성구,진잠동,진잠동제1투,2622,1384,469,782,110,13,2,1376,8,1238,34.0843023255814,56.83139534883721,7.994186046511628,0.944767441860465,0.14534883720930233
5,대전광역시,유성구,진잠동,진잠동제2투,2159,1556,644,748,135,13,1,1541,15,603,41.7910447761194,48.53990914990266,8.760545100584036,0.8436080467229071,0.06489292667099286
6,대전광역시,유성구,진잠동,진잠동제3투,2034,1516,616,754,123,17,0,1510,6,518,40.794701986754966,49.93377483443708,8.14569536423841,1.1258278145695364,0.0
7,대전광역시,유성구,진잠동,진잠동제4투,1971,1085,358,592,114,13,0,1077,8,886,33.24048282265552,54.967502321262764,10.584958217270195,1.2070566388115136,0.0
8,대전광역시,유성구,진잠동,진잠동제5투,322,217,64,138,13,1,0,216,1,105,29.629629629629626,63.888888888888886,6.018518518518518,0.4629629629629629,0.0
9,대전광역시,유성구,진잠동,진잠동제6투,459,312,93,197,15,3,1,309,3,147,30.097087378640776,63.75404530744336,4.854368932038835,0.9708737864077669,0.3236245954692557
10,대전광역시,유성구,진잠동,진잠동제7투,2576,1894,894,864,114,13,0,1885,9,682,47.42705570291777,45.835543766578255,6.047745358090186,0.6896551724137931,0.0
11,대전광역시,유성구,진잠동,진잠동제8투,2459,1764,763,827,144,22,3,1759,5,695,43.37691870380898,47.01534963047186,8.186469584991473,1.250710631040364,0.17055144968732233
12,대전광역시,유성구,학하동,관내사전투표,4841,4841,2966,1171,607,49,7,4800,41,0,61.791666666666664,24.395833333333332,12.645833333333334,1.0208333333333333,0.14583333333333334
13,대전광역시,유성구,학하동,학하동제1투,3134,2008,729,1065,183,15,0,1992,16,1126,36.596385542168676,53.463855421686745,9.186746987951807,0.7530120481927711,0.0
14,대전광역시,유성구,학하동,학하동제2투,2162,1595,651,769,153,14,2,1589,6,567,40.969162995594715,48.39521711768408,9.62869729389553,0.881057268722467,0.12586532410320958
15,대전광역시,유성구,학하동,학하동제3투,2500,1565,489,806,243,7,2,1547,18,935,31.60956690368455,52.10084033613446,15.70782159017453,0.4524886877828055,0.12928248222365868
16,대전광역시,유성구,학하동,학하동제4투,2365,1719,536,1027,125,22,4,1714,5,646,31.271878646441074,59.91831971995333,7.292882147024504,1.2835472578763127,0.2333722287047841
17,대전광역시,유성구,원신흥동,관내사전투표,5782,5782,3815,1344,531,45,5,5740,42,0,66.46341463414635,23.414634146341466,9.250871080139373,0.7839721254355401,0.08710801393728224
18,대전광역시,유성구,원신흥동,원신흥동제1투,2936,2155,871,1071,181,21,3,2147,8,781,40.56823474615743,49.88355845365626,8.430367955286448,0.9781089892873778,0.13972985561248255
19,대전광역시,유성구,원신흥동,원신흥동제2투,2710,2207,852,1104,207,25,2,2190,17,503,38.9041095890411,50.41095890410959,9.452054794520548,1.141552511415525,0.091324200913242
20,대전광역시,유성구,원신흥동,원신흥동제3투,3433,2449,924,1256,236,22,1,2439,10,984,37.88437884378843,51.49651496514965,9.676096760967608,0.9020090200902008,0.04100041000410004
21,대전광역시,유성구,원신흥동,원신흥동제4투,3140,2089,852,1024,175,20,2,2073,16,1051,41.09985528219971,49.39700916546069,8.44187168355041,0.964785335262904,0.0964785335262904
22,대전광역시,유성구,원신흥동,원신흥동제5투,3390,2346,1008,1024,270,22,5,2329,17,1044,43.280377844568484,43.967367969085444,11.5929583512237,0.9446114212108201,0.21468441391155002
23,대전광역시,유성구,상대동,관내사전투표,3504,3504,2274,890,298,26,3,3491,13,0,65.13892867373245,25.494127757089657,8.536236035519908,0.7447722715554282,0.08593526210254941
24,대전광역시,유성구,상대동,상대동제1투,2597,1627,624,833,146,18,0,1621,6,970,38.49475632325725,51.388032078963604,9.006785934608267,1.1104256631708822,0.0
25,대전광역시,유성구,상대동,상대동제2투,2912,2180,822,1089,225,30,2,2168,12,732,37.91512915129152,50.23062730627307,10.378228782287822,1.3837638376383763,0.09225092250922509
26,대전광역시,유성구,상대동,상대동제3투,2841,2269,706,1331,191,32,0,2260,9,572,31.238938053097343,58.89380530973452,8.451327433628318,1.415929203539823,0.0
27,대전광역시,유성구,상대동,상대동제4투,4089,3088,1250,1487,304,28,0,3069,19,1001,40.72987943955686,48.45226458129684,9.905506679700228,0.9123492994460737,0.0
28,대전광역시,유성구,온천1동,관내사전투표,7366,7366,4376,1898,929,79,9,7291,75,0,60.01920175558908,26.032094362913185,12.74173638732684,1.0835276368125086,0.12343985735838706
29,대전광역시,유성구,온천1동,온천1동제1투,3508,2129,714,1133,227,24,1,2099,30,1379,34.0161981896141,53.97808480228681,10.814673654121009,1.1434016198189614,0.04764173415912339
30,대전광역시,유성구,온천1동,온천1동제2투,3611,2148,663,1256,188,20,4,2131,17,1463,31.112153918348195,58.939465039887374,8.822149225715627,0.9385265133740028,0.18770530267480057
31,대전광역시,유성구,온천1동,온천1동제3투,3412,2035,576,1168,247,15,1,2007,28,1377,28.699551569506728,58.19631290483308,12.306925759840558,0.7473841554559043,0.04982561036372695
32,대전광역시,유성구,온천1동,온천1동제4투,3567,2148,732,955,398,36,2,2123,25,1419,34.47951012717852,44.983513895430995,18.747056052755536,1.6957136128120585,0.09420631182289213
33,대전광역시,유성구,온천1동,온천1동제5투,2425,1571,489,797,243,20,0,1549,22,854,31.5687540348612,51.452550032278886,15.687540348612009,1.2911555842479019,0.0
34,대전광역시,유성구,온천2동,관내사전투표,6061,6061,3401,1224,1274,106,4,6009,52,0,56.598435679813605,20.36944583125312,21.201531036778164,1.764020635713097,0.06656681644200366
35,대전광역시,유성구,온천2동,온천2동제1투,2703,1672,590,890,169,13,1,1663,9,1031,35.47805171377029,53.51773902585688,10.16235718580878,0.7817197835237523,0.06013229104028864
36,대전광역시,유성구,온천2동,온천2동제2투,2565,1736,590,978,136,20,0,1724,12,829,34.222737819025525,56.72853828306265,7.888631090487238,1.160092807424594,0.0
37,대전광역시,유성구,온천2동,온천2동제3투,3048,2149,563,1046,480,33,2,2124,25,899,26.50659133709981,49.24670433145009,22.598870056497177,1.5536723163841808,0.09416195856873823
38,대전광역시,유성구,온천2동,온천2동제4투,1579,1176,358,659,129,17,1,1164,12,403,30.756013745704468,56.61512027491409,11.082474226804123,1.4604810996563573,0.0859106529209622
39,대전광역시,유성구,온천2동,온천2동제5투,1809,1419,515,711,149,30,0,1405,14,390,36.654804270462634,50.604982206405694,10.604982206405694,2.135231316725979,0.0
40,대전광역시,유성구,온천2동,온천2동제6투,2101,1574,558,761,216,20,3,1558,16,527,35.815147625160456,48.84467265725289,13.86392811296534,1.2836970474967908,0.19255455712451863
41,대전광역시,유성구,온천2동,온천2동제7투,3084,2240,783,1163,250,22,4,2222,18,844,35.23852385238524,52.340234023402346,11.25112511251125,0.9900990099009901,0.18001800180018002
42,대전광역시,유성구,온천2동,온천2동제8투,2388,1897,812,819,228,25,0,1884,13,491,43.09978768577495,43.47133757961784,12.101910828025478,1.3269639065817411,0.0
43,대전광역시,유성구,온천2동,온천2동제9투,2420,1978,773,903,268,15,2,1961,17,442,39.41866394696583,46.047934727180014,13.66649668536461,0.7649158592554819,0.10198878123406425
44,대전광역시,유성구,온천2동,온천2동제10투,2024,1671,758,693,196,13,0,1660,11,353,45.66265060240964,41.74698795180723,11.80722891566265,0.783132530120482,0.0
45,대전광역시,유성구,노은1동,관내사전투표,6305,6305,4200,1363,618,75,0,6256,49,0,67.13554987212275,21.787084398976983,9.878516624040921,1.198849104859335,0.0
46,대전광역시,유성구,노은1동,노은1동제1투,2228,1527,558,697,229,21,3,1508,19,701,37.0026525198939,46.220159151193634,15.185676392572944,1.3925729442970822,0.1989389920424403
47,대전광역시,유성구,노은1동,노은1동제2투,2314,1778,701,865,173,24,4,1767,11,536,39.67176004527448,48.95302773061687,9.790605546123372,1.3582342954159592,0.22637238256932654
48,대전광역시,유성구,노은1동,노은1동제3투,3051,2157,871,1034,202,28,2,2137,20,894,40.75807206364062,48.38558727187646,9.452503509592887,1.3102480112306973,0.09358914365933552
49,대전광역시,유성구,노은1동,노은1동제4투,2638,1860,599,1115,115,16,0,1845,15,778,32.46612466124662,60.43360433604336,6.233062330623306,0.8672086720867209,0.0
50,대전광역시,유성구,노은2동,관내사전투표,3511,3511,2325,810,317,41,3,3496,15,0,66.5045766590389,23.169336384439358,9.0675057208238,1.1727688787185355,0.08581235697940504
51,대전광역시,유성구,노은2동,노은2동제1투,2965,2276,944,1079,208,25,6,2262,14,689,41.732979664014145,47.701149425287355,9.195402298850574,1.1052166224580018,0.2652519893899204
52,대전광역시,유성구,노은2동,노은2동제2투,3149,2358,1035,1055,209,44,0,2343,15,791,44.1741357234315,45.027742210840806,8.92018779342723,1.8779342723004695,0.0
53,대전광역시,유성구,노은2동,노은2동제3투,2260,1622,638,827,135,14,0,1614,8,638,39.529120198265176,51.23915737298637,8.364312267657994,0.8674101610904585,0.0
54,대전광역시,유성구,노은2동,노은2동제4투,2340,1672,588,904,143,24,2,1661,11,668,35.4003612281758,54.42504515352198,8.609271523178808,1.4449127031908489,0.12040939193257075
55,대전광역시,유성구,노은2동,노은2동제5투,1431,1183,576,472,105,24,1,1178,5,248,48.89643463497453,40.0679117147708,8.913412563667231,2.037351443123939,0.08488964346349745
56,대전광역시,유성구,노은3동,관내사전투표,6920,6919,4830,1420,547,74,2,6873,46,1,70.27498908773462,20.660555798050343,7.958678888403899,1.0766768514476939,0.029099374363451183
57,대전광역시,유성구,노은3동,노은3동제1투,2143,1706,809,717,153,15,3,1697,9,437,47.67236299351797,42.25103123158515,9.015910430170889,0.8839127872716559,0.1767825574543312
58,대전광역시,유성구,노은3동,노은3동제2투,3005,2190,880,1088,179,29,3,2179,11,815,40.38549793483249,49.931161083065625,8.214777420835246,1.3308857273978891,0.13767783386874713
59,대전광역시,유성구,노은3동,노은3동제3투,1948,1504,639,694,141,19,1,1494,10,444,42.77108433734939,46.4524765729585,9.437751004016064,1.2717536813922357,0.06693440428380187
60,대전광역시,유성구,노은3동,노은3동제4투,2038,1599,606,838,141,9,0,1594,5,439,38.01756587202008,52.57214554579674,8.845671267252197,0.5646173149309912,0.0
61,대전광역시,유성구,노은3동,노은3동제5투,2526,2043,958,867,188,18,2,2033,10,483,47.122479094933595,42.6463354648303,9.24741760944417,0.8853910477127398,0.0983767830791933
62,대전광역시,유성구,노은3동,노은3동제6투,1766,1268,594,543,106,14,1,1258,10,498,47.21780604133545,43.1637519872814,8.426073131955485,1.1128775834658187,0.0794912559618442
63,대전광역시,유성구,노은3동,노은3동제7투,2323,1697,820,716,131,20,3,1690,7,626,48.5207100591716,42.36686390532544,7.7514792899408285,1.183431952662722,0.17751479289940827
64,대전광역시,유성구,노은3동,노은3동제8투,2121,1494,546,759,155,20,2,1482,12,627,36.84210526315789,51.21457489878543,10.458839406207828,1.349527665317139,0.1349527665317139
65,대전광역시,유성구,신성동,관내사전투표,6134,6134,3610,1396,991,72,8,6077,57,0,59.40431133783116,22.97186111568208,16.307388514069444,1.18479512917558,0.13164390324173111
66,대전광역시,유성구,신성동,신성동제1투,1548,926,270,477,166,9,0,922,4,622,29.28416485900217,51.735357917570504,18.004338394793926,0.9761388286334056,0.0
67,대전광역시,유성구,신성동,신성동제2투,2955,2317,824,1156,287,29,1,2297,20,638,35.87287766652155,50.32651284283849,12.494558119286026,1.262516325642142,0.043535045711798
68,대전광역시,유성구,신성동,신성동제3투,2500,1796,633,824,289,26,3,1775,21,704,35.66197183098592,46.42253521126761,16.281690140845072,1.4647887323943662,0.16901408450704225
69,대전광역시,유성구,신성동,신성동제4투,1993,1439,528,767,121,12,0,1428,11,554,36.97478991596639,53.71148459383753,8.473389355742297,0.8403361344537815,0.0
70,대전광역시,유성구,신성동,신성동제5투,1767,1234,345,711,161,9,1,1227,7,533,28.117359413202937,57.94621026894865,13.121434392828036,0.7334963325183375,0.08149959250203749
71,대전광역시,유성구,신성동,신성동제6투,2395,1843,441,1154,217,17,0,1829,14,552,24.111536358665937,63.09458720612356,11.864406779661017,0.9294696555494806,0.0
72,대전광역시,유성구,전민동,관내사전투표,6523,6523,4228,1297,859,87,5,6476,47,0,65.28721432983323,20.027794935145153,13.26436071649166,1.343421865348981,0.0772081531809759
73,대전광역시,유성구,전민동,전민동제1투,1998,1344,516,635,161,16,0,1328,16,654,38.855421686746986,47.816265060240966,12.123493975903614,1.2048192771084338,0.0
74,대전광역시,유성구,전민동,전민동제2투,2466,1684,505,836,303,22,2,1668,16,782,30.2757793764988,50.11990407673861,18.165467625899282,1.3189448441247003,0.1199040767386091
75,대전광역시,유성구,전민동,전민동제3투,1912,1482,589,729,134,18,3,1473,9,430,39.98642226748133,49.490835030549896,9.097080787508487,1.2219959266802443,0.20366598778004072
76,대전광역시,유성구,전민동,전민동제4투,2027,1566,639,780,114,17,2,1552,14,461,41.17268041237113,50.25773195876289,7.345360824742269,1.095360824742268,0.12886597938144329
77,대전광역시,유성구,전민동,전민동제5투,2428,1861,715,936,169,27,1,1848,13,567,38.69047619047619,50.649350649350644,9.145021645021645,1.461038961038961,0.05411255411255411
78,대전광역시,유성구,전민동,전민동제6투,2204,1779,785,685,276,14,2,1762,17,425,44.551645856980706,38.87627695800227,15.664018161180476,0.7945516458569807,0.11350737797956867
79,대전광역시,유성구,구즉동,관내사전투표,6525,6525,4521,1308,584,54,4,6471,54,0,69.86555401019935,20.213259156235512,9.024880234894143,0.8344923504867872,0.061814248184206465
80,대전광역시,유성구,구즉동,구즉동제1투,2992,1654,570,787,262,21,1,1641,13,1338,34.73491773308958,47.958561852528945,15.965874466788543,1.2797074954296161,0.06093845216331505
81,대전광역시,유성구,구즉동,구즉동제2투,251,163,40,114,8,1,0,163,0,88,24.539877300613497,69.93865030674846,4.9079754601226995,0.6134969325153374,0.0
82,대전광역시,유성구,구즉동,구즉동제3투,2795,2047,994,817,191,25,6,2033,14,748,48.89326119035908,40.18691588785047,9.394982784062961,1.2297097884899164,0.2951303492375799
83,대전광역시,유성구,구즉동,구즉동제4투,2636,1826,819,758,204,22,5,1808,18,810,45.298672566371685,41.92477876106195,11.283185840707963,1.2168141592920354,0.27654867256637167
84,대전광역시,유성구,구즉동,구즉동제5투,2404,1705,806,695,168,19,4,1692,13,699,47.635933806146575,41.07565011820331,9.929078014184398,1.1229314420803782,0.2364066193853428
85,대전광역시,유성구,구즉동,구즉동제6투,3513,2405,1012,1123,214,32,5,2386,19,1108,42.4140821458508,47.066219614417435,8.968985750209555,1.341156747694887,0.20955574182732606
86,대전광역시,유성구,구즉동,구즉동제7투,3082,2327,1108,879,299,20,6,2312,15,755,47.92387543252595,38.01903114186852,12.932525951557095,0.8650519031141869,0.25951557093425603
87,대전광역시,유성구,관평동,관내사전투표,8385,8385,5621,1595,1007,95,3,8321,64,0,67.55197692585025,19.168369186395868,12.101910828025478,1.1416897007571205,0.03605335897127749
88,대전광역시,유성구,관평동,관평동제1투,2224,1746,822,699,190,16,2,1729,17,478,47.54193175245807,40.42799305957201,10.989010989010989,0.9253903990746095,0.11567379988432619
89,대전광역시,유성구,관평동,관평동제2투,2483,1896,896,789,180,21,0,1886,10,587,47.50795334040297,41.83457051961824,9.544008483563097,1.1134676564156947,0.0
90,대전광역시,유성구,관평동,관평동제3투,2587,1984,879,860,201,31,1,1972,12,603,44.57403651115619,43.6105476673428,10.192697768762677,1.5720081135902637,0.05070993914807302
91,대전광역시,유성구,관평동,관평동제4투,3686,2712,949,1430,291,31,0,2701,11,974,35.13513513513514,52.94335431321733,10.773787486116253,1.1477230655312847,0.0
92,대전광역시,유성구,관평동,관평동제5투,3203,2111,760,986,328,15,7,2096,15,1092,36.25954198473282,47.041984732824424,15.648854961832063,0.7156488549618321,0.33396946564885494
93,대전광역시,유성구,관평동,관평동제6투,3738,2962,1435,1079,387,42,2,2945,17,776,48.72665534804754,36.6383701188455,13.140916808149406,1.4261460101867571,0.06791171477079797
94,대전광역시,유성구,잘못 투입·구분된 투표지,,0,1,0,0,1,0,0,1,0,-1,0.0,0.0,100.0,0.0,0.0
0,대전광역시,대덕구,거소·선상투표,,232,223,96,67,44,2,4,213,10,9,45.07042253521127,31.455399061032864,20.657276995305164,0.9389671361502347,1.8779342723004695
1,대전광역시,대덕구,관외사전투표,,14160,14159,8200,3614,2014,142,25,13995,164,1,58.592354412290106,25.823508395855665,14.390853876384424,1.0146480886030727,0.17863522686673813
2,대전광역시,대덕구,재외투표,,489,387,273,68,41,5,0,387,0,102,70.54263565891473,17.571059431524546,10.594315245478036,1.2919896640826873,0.0
3,대전광역시,대덕구,오정동,관내사전투표,2018,2018,1263,594,136,10,3,2006,12,0,62.96111665004985,29.611166500498502,6.779661016949152,0.4985044865403789,0.14955134596211367
4,대전광역시,대덕구,오정동,오정동제1투,1514,997,362,563,60,8,1,994,3,517,36.41851106639839,56.63983903420523,6.036217303822937,0.8048289738430584,0.1006036217303823
5,대전광역시,대덕구,오정동,오정동제2투,814,520,168,304,37,7,2,518,2,294,32.432432432432435,58.68725868725869,7.142857142857142,1.3513513513513513,0.3861003861003861
6,대전광역시,대덕구,오정동,오정동제3투,1716,1027,305,576,124,13,0,1018,9,689,29.960707269155208,56.581532416502945,12.180746561886052,1.2770137524557956,0.0
7,대전광역시,대덕구,오정동,오정동제4투,1353,740,243,428,56,7,2,736,4,613,33.016304347826086,58.152173913043484,7.608695652173914,0.9510869565217392,0.2717391304347826
8,대전광역시,대덕구,오정동,오정동제5투,1993,1470,600,747,92,14,0,1453,17,523,41.293874741913285,51.41087405368203,6.331727460426703,0.9635237439779766,0.0
9,대전광역시,대덕구,오정동,오정동제6투,1174,800,264,485,35,12,2,798,2,374,33.08270676691729,60.77694235588973,4.385964912280701,1.5037593984962405,0.2506265664160401
10,대전광역시,대덕구,대화동,관내사전투표,1379,1379,891,375,86,12,3,1367,12,0,65.17922457937088,27.432333577176298,6.291148500365765,0.8778346744696415,0.21945866861741037
11,대전광역시,대덕구,대화동,대화동제1투,1342,727,261,365,48,19,5,698,29,615,37.392550143266476,52.29226361031518,6.876790830945559,2.722063037249284,0.7163323782234957
12,대전광역시,대덕구,대화동,대화동제2투,1000,627,231,329,56,6,1,623,4,373,37.07865168539326,52.80898876404494,8.98876404494382,0.9630818619582664,0.16051364365971107
13,대전광역시,대덕구,대화동,대화동제3투,1217,729,281,383,51,9,2,726,3,488,38.705234159779614,52.75482093663911,7.024793388429752,1.2396694214876034,0.27548209366391185
14,대전광역시,대덕구,회덕동,관내사전투표,1829,1829,1166,517,115,16,3,1817,12,0,64.17171161254815,28.45349477160154,6.329113924050633,0.8805723720418271,0.1651073197578426
15,대전광역시,대덕구,회덕동,회덕동제1투,2671,2080,904,948,184,26,4,2066,14,591,43.75605033881897,45.88576960309778,8.906098741529526,1.2584704743465636,0.1936108422071636
16,대전광역시,대덕구,회덕동,회덕동제2투,1584,1057,380,593,65,8,3,1049,8,527,36.22497616777884,56.530028598665396,6.196377502383222,0.7626310772163966,0.2859866539561487
17,대전광역시,대덕구,회덕동,회덕동제3투,1228,706,239,412,45,7,1,704,2,522,33.94886363636363,58.52272727272727,6.392045454545454,0.9943181818181818,0.14204545454545456
18,대전광역시,대덕구,회덕동,회덕동제4투,2289,1718,653,945,94,15,1,1708,10,571,38.231850117096016,55.32786885245902,5.50351288056206,0.8782201405152225,0.0585480093676815
19,대전광역시,대덕구,회덕동,회덕동제5투,374,258,72,158,21,2,1,254,4,116,28.346456692913385,62.20472440944882,8.267716535433072,0.7874015748031495,0.39370078740157477
20,대전광역시,대덕구,비래동,관내사전투표,3118,3118,2072,814,186,25,5,3102,16,0,66.79561573178594,26.24113475177305,5.996131528046422,0.8059316569954869,0.16118633139909735
21,대전광역시,대덕구,비래동,비래동제1투,1781,1210,424,678,88,10,2,1202,8,571,35.27454242928453,56.40599001663894,7.321131447587355,0.8319467554076538,0.16638935108153077
22,대전광역시,대덕구,비래동,비래동제2투,1690,1105,385,619,85,7,2,1098,7,585,35.063752276867035,56.3752276867031,7.741347905282331,0.6375227686703097,0.18214936247723132
23,대전광역시,대덕구,비래동,비래동제3투,1818,1201,482,611,86,8,2,1189,12,617,40.53826745164003,51.38772077375946,7.232968881412952,0.6728343145500421,0.16820857863751051
24,대전광역시,대덕구,비래동,비래동제4투,2099,1474,572,783,88,13,2,1458,16,625,39.231824417009605,53.70370370370371,6.035665294924554,0.8916323731138546,0.1371742112482853
25,대전광역시,대덕구,비래동,비래동제5투,1688,1187,468,629,72,6,3,1178,9,501,39.72835314091681,53.3955857385399,6.112054329371817,0.5093378607809848,0.2546689303904924
26,대전광역시,대덕구,송촌동,관내사전투표,5074,5074,3402,1227,367,46,2,5044,30,0,67.44647105471849,24.325931800158603,7.275971451229184,0.9119746233148296,0.03965107057890563
27,대전광역시,대덕구,송촌동,송촌동제1투,2301,1729,725,823,154,19,1,1722,7,572,42.102206736353075,47.793263646922185,8.94308943089431,1.1033681765389083,0.05807200929152149
28,대전광역시,대덕구,송촌동,송촌동제2투,2344,1631,625,845,132,18,1,1621,10,713,38.556446637877855,52.12831585441086,8.143121529919803,1.1104256631708822,0.061690314620604564
29,대전광역시,대덕구,송촌동,송촌동제3투,2313,1653,729,755,140,20,0,1644,9,660,44.34306569343065,45.92457420924575,8.51581508515815,1.2165450121654502,0.0
30,대전광역시,대덕구,송촌동,송촌동제4투,2511,1892,784,908,145,30,4,1871,21,619,41.90272581507216,48.53019775521112,7.749866381614109,1.6034206306787813,0.2137894174238375
31,대전광역시,대덕구,송촌동,송촌동제5투,2173,1380,512,748,86,14,3,1363,17,793,37.56419662509171,54.878943506969925,6.309611151870873,1.0271460014673515,0.22010271460014674
32,대전광역시,대덕구,송촌동,송촌동제6투,2278,1461,602,739,88,20,0,1449,12,817,41.54589371980676,51.00069013112491,6.073153899240856,1.3802622498274673,0.0
33,대전광역시,대덕구,중리동,관내사전투표,2730,2730,1755,778,161,22,1,2717,13,0,64.5933014354067,28.63452337136548,5.925653294074347,0.8097165991902834,0.0368052999631947
34,대전광역시,대덕구,중리동,중리동제1투,1463,925,302,552,64,2,1,921,4,538,32.79044516829533,59.934853420195445,6.948968512486428,0.21715526601520088,0.10857763300760044
35,대전광역시,대덕구,중리동,중리동제2투,1406,923,399,430,81,5,1,916,7,483,43.5589519650655,46.943231441048034,8.842794759825328,0.5458515283842794,0.10917030567685589
36,대전광역시,대덕구,중리동,중리동제3투,2072,1263,489,623,118,18,0,1248,15,809,39.18269230769231,49.919871794871796,9.455128205128204,1.4423076923076923,0.0
37,대전광역시,대덕구,중리동,중리동제4투,1720,1076,386,586,92,5,0,1069,7,644,36.10851262862489,54.81758652946679,8.606173994387278,0.4677268475210477,0.0
38,대전광역시,대덕구,중리동,중리동제5투,3263,1944,683,1094,135,15,2,1929,15,1319,35.40694660445827,56.713322965266975,6.998444790046657,0.7776049766718507,0.10368066355624676
39,대전광역시,대덕구,중리동,중리동제6투,1492,925,359,492,64,5,0,920,5,567,39.02173913043478,53.47826086956522,6.956521739130435,0.5434782608695652,0.0
40,대전광역시,대덕구,법1동,관내사전투표,2886,2886,1813,823,192,28,4,2860,26,0,63.391608391608386,28.776223776223773,6.713286713286713,0.9790209790209791,0.13986013986013987
41,대전광역시,대덕구,법1동,법1동제1투,2487,1824,724,893,163,19,4,1803,21,663,40.155296727676095,49.528563505269,9.04048807542984,1.0537992235163616,0.22185246810870773
42,대전광역시,대덕구,법1동,법1동제2투,2245,1586,579,866,113,15,2,1575,11,659,36.76190476190476,54.98412698412698,7.174603174603175,0.9523809523809524,0.12698412698412698
43,대전광역시,대덕구,법1동,법1동제3투,2180,1267,428,721,85,14,3,1251,16,913,34.212629896083136,57.63389288569145,6.794564348521183,1.1191047162270185,0.2398081534772182
44,대전광역시,대덕구,법2동,관내사전투표,3413,3413,2035,1098,215,32,3,3383,30,0,60.15370972509607,32.45639964528525,6.355305941472065,0.9459060005911913,0.08867868755542418
45,대전광역시,대덕구,법2동,법2동제1투,1530,981,328,597,31,9,3,968,13,549,33.88429752066116,61.67355371900827,3.202479338842975,0.9297520661157025,0.30991735537190085
46,대전광역시,대덕구,법2동,법2동제2투,2351,1773,595,1030,123,11,1,1760,13,578,33.80681818181818,58.52272727272727,6.988636363636363,0.625,0.056818181818181816
47,대전광역시,대덕구,법2동,법2동제3투,3022,2110,745,1161,158,26,2,2092,18,912,35.61185468451243,55.497131931166344,7.552581261950286,1.24282982791587,0.09560229445506692
48,대전광역시,대덕구,법2동,법2동제4투,1784,1407,614,660,106,16,3,1399,8,377,43.888491779842745,47.176554681915654,7.576840600428877,1.143674052894925,0.21443888491779842
49,대전광역시,대덕구,신탄진동,관내사전투표,3130,3130,1949,868,271,15,4,3107,23,0,62.72932088831671,27.93691663984551,8.722240102993242,0.482780817508851,0.1287415513356936
50,대전광역시,대덕구,신탄진동,신탄진동제1투,1942,1096,362,606,110,8,2,1088,8,846,33.27205882352941,55.69852941176471,10.11029411764706,0.7352941176470588,0.1838235294117647
51,대전광역시,대덕구,신탄진동,신탄진동제2투,1965,1351,497,714,111,18,2,1342,9,614,37.034277198211626,53.20417287630402,8.271236959761548,1.3412816691505216,0.14903129657228018
52,대전광역시,대덕구,신탄진동,신탄진동제3투,2096,1369,529,729,84,15,2,1359,10,727,38.92568064753495,53.64238410596026,6.181015452538632,1.1037527593818985,0.14716703458425312
53,대전광역시,대덕구,신탄진동,신탄진동제4투,342,228,68,137,17,5,0,227,1,114,29.955947136563875,60.352422907488986,7.488986784140969,2.2026431718061676,0.0
54,대전광역시,대덕구,신탄진동,신탄진동제5투,3215,2442,1028,1093,281,19,2,2423,19,773,42.4267437061494,45.10936855138258,11.59719356170037,0.7841518778373916,0.08254230293025176
55,대전광역시,대덕구,석봉동,관내사전투표,3565,3565,2349,872,289,32,3,3545,20,0,66.26234132581101,24.59802538787024,8.152327221438647,0.9026798307475317,0.08462623413258111
56,대전광역시,대덕구,석봉동,석봉동제1투,1950,1235,498,626,84,13,1,1222,13,715,40.752864157119475,51.227495908346974,6.873977086743044,1.0638297872340425,0.08183306055646482
57,대전광역시,대덕구,석봉동,석봉동제2투,1339,788,240,476,55,6,0,777,11,551,30.888030888030887,61.261261261261254,7.078507078507079,0.7722007722007722,0.0
58,대전광역시,대덕구,석봉동,석봉동제3투,3123,2283,966,1034,248,19,1,2268,15,840,42.592592592592595,45.59082892416226,10.934744268077601,0.8377425044091711,0.04409171075837742
59,대전광역시,대덕구,석봉동,석봉동제4투,1991,1417,656,593,148,10,1,1408,9,574,46.590909090909086,42.11647727272727,10.511363636363637,0.7102272727272727,0.07102272727272728
60,대전광역시,대덕구,덕암동,관내사전투표,2594,2594,1683,683,182,27,2,2577,17,0,65.30849825378347,26.503686457120683,7.062475746992628,1.0477299185098952,0.07760962359332557
61,대전광역시,대덕구,덕암동,덕암동제1투,2162,1250,495,609,119,14,1,1238,12,912,39.98384491114701,49.19224555735057,9.61227786752827,1.1308562197092082,0.08077544426494346
62,대전광역시,대덕구,덕암동,덕암동제2투,2735,1775,705,893,155,9,1,1763,12,960,39.98865570051049,50.65229722064662,8.791832104367556,0.5104934770277936,0.05672149744753262
63,대전광역시,대덕구,덕암동,덕암동제3투,2404,1535,608,786,113,16,1,1524,11,869,39.89501312335958,51.574803149606296,7.414698162729659,1.0498687664041995,0.06561679790026247
64,대전광역시,대덕구,덕암동,덕암동제4투,550,383,111,209,49,7,1,377,6,167,29.44297082228117,55.437665782493376,12.9973474801061,1.8567639257294428,0.2652519893899204
65,대전광역시,대덕구,목상동,관내사전투표,1667,1667,1083,432,127,14,3,1659,8,0,65.28028933092224,26.03978300180832,7.655213984327909,0.8438818565400843,0.18083182640144665
66,대전광역시,대덕구,목상동,목상동제1투,1829,981,419,458,85,8,0,970,11,848,43.1958762886598,47.21649484536082,8.762886597938143,0.8247422680412372,0.0
67,대전광역시,대덕구,목상동,목상동제2투,1639,1089,493,486,84,12,4,1079,10,550,45.69045412418906,45.041705282669135,7.784986098239111,1.1121408711770158,0.3707136237256719
68,대전광역시,대덕구,잘못 투입·구분된 투표지,,0,0,0,0,0,0,0,0,0,0,0.0,0.0,0.0,0.0,0.0
0,울산광역시,중구,거소·선상투표,,215,205,53,102,38,1,1,195,10,10,27.17948717948718,52.307692307692314,19.48717948717949,0.5128205128205128,0.5128205128205128
1,울산광역시,중구,관외사전투표,,14171,14169,6913,4882,2056,182,23,14056,113,2,49.18184405236198,34.73249857712009,14.62720546385885,1.294820717131474,0.16363118952760386
2,울산광역시,중구,재외투표,,719,572,374,127,59,7,0,567,5,147,65.96119929453262,22.39858906525573,10.405643738977071,1.2345679012345678,0.0
3,울산광역시,중구,학성동,관내사전투표,2849,2849,1432,1188,181,26,3,2830,19,0,50.600706713780916,41.97879858657244,6.395759717314488,0.9187279151943463,0.10600706713780918
4,울산광역시,중구,학성동,학성동제1투,2411,1647,366,1108,137,19,2,1632,15,764,22.426470588235293,67.8921568627451,8.394607843137255,1.1642156862745099,0.12254901960784313
5,울산광역시,중구,학성동,학성동제2투,1377,951,219,660,56,6,2,943,8,426,23.223753976670203,69.98939554612937,5.938494167550371,0.6362672322375398,0.2120890774125133
6,울산광역시,중구,학성동,학성동제3투,1393,935,238,636,45,13,2,934,1,458,25.481798715203425,68.09421841541756,4.817987152034261,1.3918629550321198,0.21413276231263384
7,울산광역시,중구,학성동,학성동제4투,1477,982,224,688,55,5,2,974,8,495,22.99794661190965,70.63655030800821,5.646817248459959,0.5133470225872689,0.20533880903490762
8,울산광역시,중구,반구1동,관내사전투표,4022,4022,2254,1402,269,56,6,3987,35,0,56.53373463757211,35.164283922748936,6.746927514421872,1.4045648357160772,0.15048908954100826
9,울산광역시,중구,반구1동,반구1동제1투,2109,1461,436,885,108,19,2,1450,11,648,30.06896551724138,61.03448275862069,7.448275862068964,1.3103448275862069,0.13793103448275862
10,울산광역시,중구,반구1동,반구1동제2투,2211,1459,428,911,94,17,1,1451,8,752,29.496898690558236,62.784286698828396,6.47829083390765,1.1716057891109581,0.06891798759476223
11,울산광역시,중구,반구1동,반구1동제3투,2688,1803,464,1197,115,15,4,1795,8,885,25.84958217270195,66.68523676880223,6.406685236768802,0.8356545961002786,0.22284122562674097
12,울산광역시,중구,반구1동,반구1동제4투,2019,1427,487,809,110,14,0,1420,7,592,34.29577464788732,56.971830985915496,7.746478873239436,0.9859154929577465,0.0
13,울산광역시,중구,반구2동,관내사전투표,1929,1929,1004,749,145,18,1,1917,12,0,52.3735002608242,39.07146583202921,7.563901930099114,0.9389671361502347,0.05216484089723526
14,울산광역시,중구,반구2동,반구2동제1투,1715,1112,237,772,77,16,1,1103,9,603,21.486854034451497,69.9909338168631,6.980961015412511,1.4505893019038985,0.09066183136899365
15,울산광역시,중구,반구2동,반구2동제2투,1746,1206,321,769,97,12,0,1199,7,540,26.772310258548792,64.13678065054211,8.090075062552128,1.0008340283569641,0.0
16,울산광역시,중구,반구2동,반구2동제3투,1577,1105,302,693,83,9,1,1088,17,472,27.75735294117647,63.69485294117647,7.6286764705882355,0.8272058823529412,0.09191176470588235
17,울산광역시,중구,복산동,관내사전투표,3033,3033,1768,943,263,33,4,3011,22,0,58.71803387578878,31.31849883759548,8.7346396545998,1.0959814015277316,0.1328462304882099
18,울산광역시,중구,복산동,복산동제1투,1512,1136,314,748,60,10,0,1132,4,376,27.73851590106007,66.07773851590106,5.30035335689046,0.88339222614841,0.0
19,울산광역시,중구,복산동,복산동제2투,4119,3215,1097,1709,350,31,3,3190,25,904,34.38871473354232,53.57366771159875,10.9717868338558,0.9717868338557993,0.09404388714733543
20,울산광역시,중구,복산동,복산동제3투,2100,1441,435,896,88,11,2,1432,9,659,30.377094972067038,62.56983240223464,6.145251396648044,0.7681564245810055,0.13966480446927373
21,울산광역시,중구,복산동,복산동제4투,2484,1853,639,1012,164,21,3,1839,14,631,34.74714518760196,55.02990755845568,8.9178901576944,1.1419249592169658,0.1631321370309951
22,울산광역시,중구,복산동,복산동제5투,1487,1037,293,666,56,11,1,1027,10,450,28.529698149951315,64.84907497565725,5.452775073028238,1.071080817916261,0.09737098344693282
23,울산광역시,중구,성안동,관내사전투표,4852,4852,3086,1331,354,53,1,4825,27,0,63.95854922279792,27.585492227979273,7.336787564766839,1.0984455958549224,0.02072538860103627
24,울산광역시,중구,성안동,성안동제1투,2680,1743,592,992,129,15,2,1730,13,937,34.21965317919075,57.34104046242775,7.4566473988439315,0.8670520231213872,0.11560693641618498
25,울산광역시,중구,성안동,성안동제2투,2581,1697,485,1078,96,21,3,1683,14,884,28.817587641117054,64.05228758169935,5.704099821746881,1.2477718360071302,0.17825311942959002
26,울산광역시,중구,성안동,성안동제3투,3000,2021,664,1186,144,14,2,2010,11,979,33.03482587064677,59.00497512437811,7.164179104477612,0.6965174129353234,0.09950248756218905
27,울산광역시,중구,성안동,성안동제4투,2861,1901,652,1082,139,20,2,1895,6,960,34.406332453825854,57.0976253298153,7.33509234828496,1.0554089709762533,0.10554089709762532
28,울산광역시,중구,중앙동,관내사전투표,2631,2631,1312,1028,246,25,4,2615,16,0,50.17208413001912,39.31166347992352,9.407265774378585,0.9560229445506693,0.15296367112810708
29,울산광역시,중구,중앙동,중앙동제1투,2121,1408,279,1045,73,5,0,1402,6,713,19.900142653352354,74.53637660485022,5.206847360912981,0.3566333808844508,0.0
30,울산광역시,중구,중앙동,중앙동제2투,1910,1284,274,934,51,10,3,1272,12,626,21.540880503144656,73.42767295597484,4.009433962264151,0.7861635220125787,0.2358490566037736
31,울산광역시,중구,중앙동,중앙동제3투,1448,944,200,663,67,5,1,936,8,504,21.367521367521366,70.83333333333334,7.158119658119658,0.5341880341880342,0.10683760683760685
32,울산광역시,중구,중앙동,중앙동제4투,1438,945,205,678,46,9,0,938,7,493,21.85501066098081,72.28144989339019,4.904051172707889,0.9594882729211088,0.0
33,울산광역시,중구,우정동,관내사전투표,3598,3598,1910,1372,250,44,3,3579,19,0,53.366862252025705,38.33473037161218,6.985191394244203,1.2293936853869796,0.08382229673093043
34,울산광역시,중구,우정동,우정동제1투,3454,2311,539,1566,163,24,0,2292,19,1143,23.516579406631763,68.32460732984293,7.111692844677138,1.0471204188481675,0.0
35,울산광역시,중구,우정동,우정동제2투,1582,1061,241,699,91,10,4,1045,16,521,23.062200956937797,66.88995215311004,8.708133971291867,0.9569377990430622,0.3827751196172249
36,울산광역시,중구,우정동,우정동제3투,2979,2329,694,1421,168,24,3,2310,19,650,30.043290043290042,61.51515151515151,7.2727272727272725,1.0389610389610389,0.12987012987012986
37,울산광역시,중구,우정동,우정동제4투,2794,2200,620,1396,142,23,4,2185,15,594,28.37528604118993,63.89016018306636,6.498855835240275,1.0526315789473684,0.1830663615560641
38,울산광역시,중구,태화동,관내사전투표,4543,4543,2723,1420,308,62,6,4519,24,0,60.256693958840444,31.422881168400092,6.815667183005089,1.3719849524231025,0.13277273733126796
39,울산광역시,중구,태화동,태화동제1투,2065,1410,385,904,98,15,1,1403,7,655,27.441197434069853,64.43335709194584,6.98503207412687,1.069137562366358,0.07127583749109052
40,울산광역시,중구,태화동,태화동제2투,1982,1424,382,889,112,25,1,1409,15,558,27.111426543647976,63.09439318665721,7.94889992902768,1.7743080198722498,0.07097232079488999
41,울산광역시,중구,태화동,태화동제3투,2536,1886,526,1202,122,19,2,1871,15,650,28.113308391234632,64.24371993586317,6.520577231427044,1.015499732763228,0.10689470871191875
42,울산광역시,중구,태화동,태화동제4투,2275,1854,648,1066,112,15,4,1845,9,421,35.12195121951219,57.77777777777777,6.070460704607046,0.8130081300813009,0.21680216802168023
43,울산광역시,중구,태화동,태화동제5투,2257,1739,458,1141,113,11,1,1724,15,518,26.5661252900232,66.1832946635731,6.554524361948956,0.6380510440835266,0.058004640371229696
44,울산광역시,중구,태화동,태화동제6투,2491,2057,731,1085,195,27,2,2040,17,434,35.833333333333336,53.18627450980392,9.558823529411764,1.3235294117647058,0.09803921568627451
45,울산광역시,중구,태화동,태화동제7투,2403,1951,769,968,183,23,2,1945,6,452,39.537275064267355,49.768637532133674,9.408740359897172,1.1825192802056554,0.10282776349614395
46,울산광역시,중구,태화동,태화동제8투,1893,1479,563,736,156,17,3,1475,4,414,38.16949152542372,49.898305084745765,10.576271186440678,1.152542372881356,0.2033898305084746
47,울산광역시,중구,다운동,관내사전투표,3716,3716,2080,1317,231,43,5,3676,40,0,56.58324265505985,35.82698585418934,6.284004352557128,1.1697497279651796,0.13601741022850924
48,울산광역시,중구,다운동,다운동제1투,2640,1899,503,1237,118,24,2,1884,15,741,26.698513800424628,65.65817409766454,6.263269639065817,1.2738853503184715,0.10615711252653928
49,울산광역시,중구,다운동,다운동제2투,2200,1483,368,1010,79,15,1,1473,10,717,24.983027834351663,68.56754921928038,5.363204344874406,1.0183299389002036,0.0678886625933469
50,울산광역시,중구,다운동,다운동제3투,1991,1421,395,899,100,16,2,1412,9,570,27.974504249291787,63.668555240793204,7.0821529745042495,1.13314447592068,0.141643059490085
51,울산광역시,중구,다운동,다운동제4투,2396,1670,424,1133,83,16,4,1660,10,726,25.542168674698797,68.25301204819277,5.0,0.9638554216867471,0.24096385542168677
52,울산광역시,중구,다운동,다운동제5투,2337,1757,525,1111,94,12,2,1744,13,580,30.103211009174313,63.70412844036697,5.389908256880735,0.6880733944954129,0.11467889908256881
53,울산광역시,중구,다운동,다운동제6투,2588,1967,713,1106,120,18,2,1959,8,621,36.39612046962736,56.45737621235324,6.1255742725880555,0.9188361408882083,0.10209290454313426
54,울산광역시,중구,병영1동,관내사전투표,4323,4323,2386,1581,262,51,8,4288,35,0,55.64365671641791,36.87033582089552,6.110074626865672,1.189365671641791,0.18656716417910446
55,울산광역시,중구,병영1동,병영1동제1투,1825,1134,246,797,65,17,2,1127,7,691,21.827861579414375,70.7187222715173,5.767524401064774,1.5084294587400178,0.1774622892635315
56,울산광역시,중구,병영1동,병영1동제2투,1778,1152,285,770,73,14,1,1143,9,626,24.93438320209974,67.3665791776028,6.386701662292213,1.2248468941382327,0.08748906386701663
57,울산광역시,중구,병영1동,병영1동제3투,2094,1452,411,937,83,11,1,1443,9,642,28.482328482328484,64.93416493416494,5.751905751905752,0.7623007623007623,0.0693000693000693
58,울산광역시,중구,병영1동,병영1동제4투,1561,1050,249,735,54,2,2,1042,8,511,23.896353166986565,70.53742802303263,5.182341650671785,0.19193857965451055,0.19193857965451055
59,울산광역시,중구,병영1동,병영1동제5투,2329,1793,687,925,145,23,4,1784,9,536,38.50896860986547,51.84977578475336,8.127802690582959,1.289237668161435,0.2242152466367713
60,울산광역시,중구,병영1동,병영1동제6투,2422,1975,753,983,204,30,0,1970,5,447,38.22335025380711,49.898477157360404,10.355329949238579,1.5228426395939088,0.0
61,울산광역시,중구,병영2동,관내사전투표,3093,3093,1890,936,212,37,2,3077,16,0,61.42346441338966,30.419239519012027,6.889827754306142,1.2024699382515438,0.06499837504062399
62,울산광역시,중구,병영2동,병영2동제1투,1888,1303,365,835,76,10,3,1289,14,585,28.316524437548484,64.77889837083009,5.896043444530644,0.7757951900698216,0.23273855702094648
63,울산광역시,중구,병영2동,병영2동제2투,1159,741,239,446,42,9,1,737,4,418,32.42876526458616,60.51560379918589,5.698778833107191,1.2211668928086838,0.13568521031207598
64,울산광역시,중구,병영2동,병영2동제3투,1128,732,171,504,43,11,0,729,3,396,23.456790123456788,69.1358024691358,5.8984910836762685,1.5089163237311385,0.0
65,울산광역시,중구,병영2동,병영2동제4투,1375,896,225,606,51,6,1,889,7,479,25.30933633295838,68.16647919010124,5.736782902137233,0.6749156355455568,0.11248593925759282
66,울산광역시,중구,병영2동,병영2동제5투,2133,1513,534,838,111,21,1,1505,8,620,35.481727574750835,55.68106312292359,7.3754152823920265,1.3953488372093024,0.0664451827242525
67,울산광역시,중구,병영2동,병영2동제6투,3320,2536,1005,1271,207,37,2,2522,14,784,39.84932593180016,50.396510705789055,8.207771609833465,1.4670896114195082,0.07930214115781126
68,울산광역시,중구,약사동,관내사전투표,3192,3192,1901,974,258,41,5,3179,13,0,59.798678829820695,30.638565586662477,8.115759672853098,1.2897137464611514,0.15728216420257943
69,울산광역시,중구,약사동,약사동제1투,2627,1993,663,1113,174,29,3,1982,11,634,33.4510595358224,56.15539858728557,8.779011099899092,1.4631685166498487,0.15136226034308778
70,울산광역시,중구,약사동,약사동제2투,2148,1625,489,947,153,23,1,1613,12,523,30.31618102913825,58.71047737135772,9.485430874147552,1.4259144451332921,0.06199628022318661
71,울산광역시,중구,잘못 투입·구분된 투표지,,0,0,0,0,0,0,0,0,0,0,0.0,0.0,0.0,0.0,0.0
0,울산광역시,남구,거소·선상투표,,339,316,104,131,64,3,2,304,12,23,34.21052631578947,43.09210526315789,21.052631578947366,0.9868421052631579,0.6578947368421052
1,울산광역시,남구,관외사전투표,,19472,19469,9090,6943,2970,233,25,19261,208,3,47.19381132859146,36.04693421940709,15.419760137064534,1.2096983541872177,0.12979596074970148
2,울산광역시,남구,재외투표,,1052,842,501,191,128,12,3,835,7,210,60.0,22.874251497005986,15.32934131736527,1.437125748502994,0.3592814371257485
3,울산광역시,남구,신정1동,관내사전투표,3951,3951,1936,1650,280,48,2,3916,35,0,49.43820224719101,42.13483146067416,7.150153217568948,1.2257405515832482,0.05107252298263534
4,울산광역시,남구,신정1동,신정1동제1투,3096,1943,405,1400,113,11,1,1930,13,1153,20.984455958549223,72.53886010362694,5.854922279792746,0.5699481865284974,0.05181347150259067
5,울산광역시,남구,신정1동,신정1동제2투,2614,1701,401,1159,110,12,5,1687,14,913,23.770005927682273,68.70183758150563,6.520450503852994,0.7113218731475993,0.2963841138114997
6,울산광역시,남구,신정1동,신정1동제3투,2397,1735,445,1145,114,18,2,1724,11,662,25.81206496519722,66.415313225058,6.612529002320186,1.0440835266821344,0.11600928074245939
7,울산광역시,남구,신정1동,신정1동제4투,2956,2132,482,1498,123,14,1,2118,14,824,22.757318224740324,70.72710103871577,5.807365439093484,0.6610009442870632,0.047214353163361665
8,울산광역시,남구,신정2동,관내사전투표,3570,3570,1873,1291,338,42,4,3548,22,0,52.79030439684329,36.38669673055242,9.526493799323562,1.1837655016910935,0.11273957158962795
9,울산광역시,남구,신정2동,신정2동제1투,2341,1473,334,1009,109,8,0,1460,13,868,22.876712328767123,69.10958904109589,7.465753424657534,0.547945205479452,0.0
10,울산광역시,남구,신정2동,신정2동제2투,2525,1968,644,1135,164,12,1,1956,12,557,32.92433537832311,58.02658486707567,8.384458077709612,0.6134969325153374,0.051124744376278126
11,울산광역시,남구,신정2동,신정2동제3투,3639,2804,824,1654,276,32,2,2788,16,835,29.555236728837876,59.32568149210904,9.899569583931134,1.1477761836441895,0.07173601147776185
12,울산광역시,남구,신정2동,신정2동제4투,3295,2458,664,1564,198,22,1,2449,9,837,27.113107390771745,63.86280114332381,8.084932625561454,0.898325847284606,0.04083299305839118
13,울산광역시,남구,신정2동,신정2동제5투,2534,2043,573,1249,202,11,0,2035,8,491,28.157248157248155,61.37592137592137,9.926289926289925,0.5405405405405406,0.0
14,울산광역시,남구,신정3동,관내사전투표,3227,3227,1699,1224,254,29,5,3211,16,0,52.911865462472754,38.118966054188725,7.910308315166614,0.9031454375583929,0.15571473061351604
15,울산광역시,남구,신정3동,신정3동제1투,3069,1946,431,1347,139,13,3,1933,13,1123,22.296947749612002,69.68442834971546,7.19089498189343,0.6725297465080186,0.1551991722710812
16,울산광역시,남구,신정3동,신정3동제2투,3352,2670,841,1559,225,29,2,2656,14,682,31.664156626506024,58.69728915662651,8.471385542168674,1.091867469879518,0.07530120481927711
17,울산광역시,남구,신정3동,신정3동제3투,2772,1770,355,1307,88,7,3,1760,10,1002,20.170454545454543,74.26136363636363,5.0,0.3977272727272727,0.17045454545454544
18,울산광역시,남구,신정4동,관내사전투표,3724,3724,2015,1368,272,36,6,3697,27,0,54.50365160941304,37.00297538544766,7.3573167433053825,0.9737625101433596,0.1622937516905599
19,울산광역시,남구,신정4동,신정4동제1투,3245,2447,831,1402,174,25,3,2435,12,798,34.12731006160164,57.57700205338809,7.145790554414784,1.0266940451745379,0.12320328542094457
20,울산광역시,남구,신정4동,신정4동제2투,2329,1614,374,1100,124,5,0,1603,11,715,23.33125389893949,68.62133499688085,7.735495945102933,0.3119151590767312,0.0
21,울산광역시,남구,신정4동,신정4동제3투,1413,1058,293,661,83,8,3,1048,10,355,27.958015267175572,63.07251908396947,7.919847328244274,0.7633587786259541,0.2862595419847328
22,울산광역시,남구,신정4동,신정4동제4투,1218,744,199,474,59,7,3,742,2,474,26.819407008086255,63.881401617250674,7.951482479784366,0.9433962264150944,0.40431266846361186
23,울산광역시,남구,신정4동,신정4동제5투,2273,1692,612,880,160,24,3,1679,13,581,36.450268016676596,52.412150089338894,9.529481834425253,1.429422275163788,0.1786777843954735
24,울산광역시,남구,신정5동,관내사전투표,2476,2476,1291,932,209,20,1,2453,23,0,52.62943334692214,37.994292702812885,8.520179372197308,0.8153281695882593,0.040766408479412965
25,울산광역시,남구,신정5동,신정5동제1투,2498,1643,347,1150,124,11,2,1634,9,855,21.23623011015912,70.37943696450428,7.588739290085679,0.6731946144430845,0.12239902080783352
26,울산광역시,남구,신정5동,신정5동제2투,2610,1603,397,1056,123,13,4,1593,10,1007,24.921531701192716,66.29001883239172,7.721280602636535,0.8160703075957313,0.25109855618330196
27,울산광역시,남구,달동,관내사전투표,4349,4348,2332,1531,397,45,8,4313,35,1,54.06909343844192,35.497333642476235,9.204729886389984,1.0433572919081846,0.18548574078367724
28,울산광역시,남구,달동,달동제1투,4143,2536,620,1643,219,26,1,2509,27,1607,24.711040255081706,65.48425667596652,8.728577122359505,1.0362694300518136,0.03985651654045436
29,울산광역시,남구,달동,달동제2투,2921,1868,486,1191,163,13,2,1855,13,1053,26.199460916442046,64.20485175202157,8.787061994609164,0.7008086253369272,0.1078167115902965
30,울산광역시,남구,달동,달동제3투,3899,2688,713,1742,186,28,2,2671,17,1211,26.694122051666042,65.21901909397229,6.963684013478098,1.0482965181579933,0.07487832272557095
31,울산광역시,남구,달동,달동제4투,2882,2065,670,1185,169,29,2,2055,10,817,32.60340632603406,57.66423357664233,8.223844282238444,1.4111922141119222,0.09732360097323602
32,울산광역시,남구,달동,달동제5투,2879,2176,752,1223,155,28,2,2160,16,703,34.81481481481482,56.62037037037037,7.175925925925926,1.2962962962962963,0.0925925925925926
33,울산광역시,남구,삼산동,관내사전투표,9138,9138,5262,2794,922,95,6,9079,59,0,57.95792488159489,30.774314351800857,10.155303447516246,1.0463707456768367,0.06608657341116864
34,울산광역시,남구,삼산동,삼산동제1투,3194,2117,546,1356,172,23,5,2102,15,1077,25.97526165556613,64.50999048525215,8.182683158896289,1.0941960038058993,0.23786869647954328
35,울산광역시,남구,삼산동,삼산동제2투,2953,2063,572,1274,181,19,1,2047,16,890,27.94333170493405,62.23742061553493,8.842208109428432,0.9281875915974597,0.048851978505129456
36,울산광역시,남구,삼산동,삼산동제3투,2881,1938,502,1280,135,6,1,1924,14,943,26.09147609147609,66.52806652806653,7.016632016632017,0.31185031185031187,0.05197505197505198
37,울산광역시,남구,삼산동,삼산동제4투,3736,1884,528,1139,188,17,0,1872,12,1852,28.205128205128204,60.84401709401709,10.042735042735043,0.9081196581196582,0.0
38,울산광역시,남구,삼산동,삼산동제5투,3543,2400,883,1234,238,26,5,2386,14,1143,37.007544006705785,51.71835708298408,9.97485331098072,1.0896898575020955,0.20955574182732606
39,울산광역시,남구,삼산동,삼산동제6투,3578,2556,950,1292,253,33,4,2532,24,1022,37.519747235387044,51.026856240126385,9.992101105845181,1.3033175355450237,0.1579778830963665
40,울산광역시,남구,삼산동,삼산동제7투,3809,2824,1200,1322,241,39,0,2802,22,985,42.82655246252677,47.18058529621699,8.600999286224125,1.3918629550321198,0.0
41,울산광역시,남구,삼산동,삼산동제8투,2549,1772,510,1106,121,21,2,1760,12,777,28.97727272727273,62.84090909090909,6.875000000000001,1.1931818181818183,0.11363636363636363
42,울산광역시,남구,삼산동,삼산동제9투,4172,2677,818,1535,277,25,0,2655,22,1495,30.80979284369115,57.81544256120527,10.433145009416195,0.9416195856873822,0.0
43,울산광역시,남구,삼호동,관내사전투표,4671,4671,2505,1686,384,59,3,4637,34,0,54.021996980806556,36.35971533318956,8.281216303644598,1.2723743799870606,0.06469700237222342
44,울산광역시,남구,삼호동,삼호동제1투,2799,2034,533,1313,148,24,1,2019,15,765,26.399207528479447,65.03219415552253,7.330361565131254,1.188707280832095,0.04952947003467063
45,울산광역시,남구,삼호동,삼호동제2투,3654,2449,653,1597,157,20,4,2431,18,1205,26.86137392019745,65.69313039901276,6.458247634718223,0.8227067050596462,0.16454134101192924
46,울산광역시,남구,삼호동,삼호동제3투,3130,2163,558,1370,198,17,3,2146,17,967,26.001863932898416,63.839701770736255,9.226467847157501,0.7921714818266543,0.13979496738117428
47,울산광역시,남구,삼호동,삼호동제4투,2590,1850,577,1086,147,19,2,1831,19,740,31.512834516657563,59.31185144729656,8.028399781540143,1.0376843255051884,0.10922992900054614
48,울산광역시,남구,무거동,관내사전투표,5374,5374,3100,1630,545,59,3,5337,37,0,58.08506651676972,30.541502716882146,10.21172943601274,1.1054899756417464,0.056211354693648116
49,울산광역시,남구,무거동,무거동제1투,3424,2407,634,1499,243,19,1,2396,11,1017,26.46076794657763,62.56260434056762,10.141903171953254,0.7929883138564273,0.041736227045075125
50,울산광역시,남구,무거동,무거동제2투,2101,1544,404,941,179,7,1,1532,12,557,26.370757180156655,61.422976501305484,11.684073107049608,0.45691906005221933,0.06527415143603134
51,울산광역시,남구,무거동,무거동제3투,3885,2906,995,1609,245,37,5,2891,15,979,34.417156693185746,55.65548253199585,8.47457627118644,1.2798339674852992,0.17295053614666206
52,울산광역시,남구,무거동,무거동제4투,3268,2449,559,1628,218,23,1,2429,20,819,23.01358583779333,67.02346644709756,8.974886784685056,0.9468917249897078,0.04116920543433512
53,울산광역시,남구,무거동,무거동제5투,3396,2641,984,1310,272,45,4,2615,26,755,37.62906309751434,50.09560229445506,10.401529636711281,1.7208413001912046,0.15296367112810708
54,울산광역시,남구,무거동,무거동제6투,2985,2339,812,1265,215,23,1,2316,23,646,35.060449050086355,54.620034542314336,9.283246977547496,0.9930915371329878,0.04317789291882556
55,울산광역시,남구,옥동,관내사전투표,4980,4980,2865,1620,389,65,8,4947,33,0,57.91388720436629,32.747119466343236,7.863351526177481,1.3139276329088336,0.16171417020416412
56,울산광역시,남구,옥동,옥동제1투,2847,2073,615,1242,174,20,4,2055,18,774,29.927007299270077,60.43795620437956,8.467153284671532,0.9732360097323601,0.19464720194647203
57,울산광역시,남구,옥동,옥동제2투,2421,1965,620,1170,149,15,1,1955,10,456,31.713554987212277,59.846547314578004,7.6214833759590785,0.7672634271099744,0.051150895140664954
58,울산광역시,남구,옥동,옥동제3투,2382,1878,547,1161,145,14,1,1868,10,504,29.282655246252677,62.15203426124197,7.762312633832977,0.7494646680942184,0.05353319057815846
59,울산광역시,남구,옥동,옥동제4투,2163,1783,670,903,174,21,3,1771,12,380,37.8317334839074,50.988142292490124,9.824957651044608,1.185770750988142,0.16939582156973462
60,울산광역시,남구,옥동,옥동제5투,2299,1709,464,1073,142,17,2,1698,11,590,27.326266195524145,63.191990577149596,8.362779740871613,1.0011778563015312,0.11778563015312131
61,울산광역시,남구,옥동,옥동제6투,2008,1578,450,964,143,14,2,1573,5,430,28.607755880483154,61.28417037507946,9.090909090909092,0.8900190718372537,0.12714558169103624
62,울산광역시,남구,야음장생포동,관내사전투표,1783,1783,908,677,161,23,0,1769,14,0,51.32843414358395,38.270209157716224,9.101187111362352,1.3001695873374788,0.0
63,울산광역시,남구,야음장생포동,야음장생포동제1투,2342,1516,364,1034,78,18,2,1496,20,826,24.331550802139038,69.11764705882352,5.213903743315508,1.2032085561497325,0.1336898395721925
64,울산광역시,남구,야음장생포동,야음장생포동제2투,2260,1610,510,938,128,17,4,1597,13,650,31.934877896055102,58.73512836568566,8.015028177833438,1.0644959298685035,0.25046963055729493
65,울산광역시,남구,야음장생포동,야음장생포동제3투,770,586,141,409,28,3,0,581,5,184,24.268502581755595,70.39586919104991,4.819277108433735,0.5163511187607573,0.0
66,울산광역시,남구,대현동,관내사전투표,7416,7416,4353,2271,656,88,2,7370,46,0,59.06377204884667,30.814111261872455,8.900949796472185,1.1940298507462688,0.027137042062415198
67,울산광역시,남구,대현동,대현동제1투,2488,1839,608,1057,142,19,2,1828,11,649,33.260393873085334,57.822757111597376,7.768052516411379,1.0393873085339167,0.10940919037199125
68,울산광역시,남구,대현동,대현동제2투,2619,2061,647,1248,136,22,1,2054,7,558,31.499513145082762,60.75949367088608,6.621226874391431,1.071080817916261,0.04868549172346641
69,울산광역시,남구,대현동,대현동제3투,2528,1831,504,1178,113,18,4,1817,14,697,27.73802971931756,64.83214089157953,6.219042377545405,0.9906439185470555,0.2201430930104568
70,울산광역시,남구,대현동,대현동제4투,2843,2008,694,1104,178,18,2,1996,12,835,34.76953907815631,55.31062124248497,8.917835671342687,0.9018036072144289,0.1002004008016032
71,울산광역시,남구,대현동,대현동제5투,2860,2118,708,1218,145,26,4,2101,17,742,33.698238933841026,57.972394098048554,6.901475487862922,1.2375059495478342,0.19038553069966682
72,울산광역시,남구,대현동,대현동제6투,3834,2855,930,1550,299,39,2,2820,35,979,32.97872340425532,54.96453900709219,10.602836879432624,1.3829787234042552,0.07092198581560284
73,울산광역시,남구,수암동,관내사전투표,4150,4150,2309,1442,319,46,7,4123,27,0,56.00291050206161,34.974533106960955,7.737084647101625,1.1156924569488236,0.1697792869269949
74,울산광역시,남구,수암동,수암동제1투,3132,2336,749,1371,186,20,1,2327,9,796,32.18736570691878,58.91706059303825,7.993124194241513,0.8594757198109154,0.04297378599054577
75,울산광역시,남구,수암동,수암동제2투,2552,2042,645,1217,138,27,2,2029,13,510,31.789058649581076,59.98028585510104,6.8013799901429275,1.330704780680138,0.09857072449482504
76,울산광역시,남구,수암동,수암동제3투,2844,2162,652,1306,173,15,2,2148,14,682,30.353817504655495,60.80074487895717,8.054003724394786,0.6983240223463687,0.0931098696461825
77,울산광역시,남구,선암동,관내사전투표,1769,1769,965,627,147,14,1,1754,15,0,55.01710376282782,35.74686431014823,8.38084378563284,0.798175598631699,0.05701254275940707
78,울산광역시,남구,선암동,선암동제1투,1959,1300,332,847,92,19,0,1290,10,659,25.736434108527135,65.65891472868218,7.131782945736434,1.4728682170542635,0.0
79,울산광역시,남구,선암동,선암동제2투,3261,2362,838,1293,183,27,4,2345,17,899,35.73560767590618,55.13859275053304,7.803837953091684,1.1513859275053304,0.17057569296375266
80,울산광역시,남구,선암동,선암동제3투,3359,2533,803,1526,151,30,2,2512,21,826,31.966560509554142,60.7484076433121,6.011146496815287,1.194267515923567,0.07961783439490447
81,울산광역시,남구,잘못 투입·구분된 투표지,,0,3,2,1,0,0,0,3,0,-3,66.66666666666666,33.33333333333333,0.0,0.0,0.0
0,울산광역시,동구,거소·선상투표,,187,179,64,57,47,1,3,172,7,8,37.2093023255814,33.13953488372093,27.325581395348834,0.5813953488372093,1.744186046511628
1,울산광역시,동구,관외사전투표,,7323,7322,3582,2371,1138,121,11,7223,99,1,49.591582444967464,32.82569569430984,15.755226360238128,1.6752042087775163,0.15229129170704694
2,울산광역시,동구,재외투표,,363,290,208,50,22,4,0,284,6,73,73.23943661971832,17.6056338028169,7.746478873239436,1.4084507042253522,0.0
3,울산광역시,동구,방어동,관내사전투표,6421,6421,4119,1753,404,88,9,6373,48,0,64.63204142476071,27.506668758826297,6.339243684293111,1.3808253569747373,0.14122077514514358
4,울산광역시,동구,방어동,방어동제1투,3400,1923,649,1108,123,24,3,1907,16,1477,34.0325117986366,58.10173046670163,6.449921342422653,1.2585212375458836,0.15731515469323545
5,울산광역시,동구,방어동,방어동제2투,1911,1201,345,766,69,11,1,1192,9,710,28.942953020134226,64.26174496644296,5.7885906040268456,0.9228187919463088,0.08389261744966443
6,울산광역시,동구,방어동,방어동제3투,1911,1183,436,650,68,18,3,1175,8,728,37.10638297872341,55.319148936170215,5.787234042553192,1.5319148936170213,0.2553191489361702
7,울산광역시,동구,방어동,방어동제4투,1788,1211,441,674,68,18,1,1202,9,577,36.688851913477535,56.07321131447587,5.657237936772046,1.497504159733777,0.08319467554076539
8,울산광역시,동구,방어동,방어동제5투,2702,1755,674,924,107,36,1,1742,13,947,38.69115958668197,53.04247990815155,6.1423650975889785,2.066590126291619,0.0574052812858783
9,울산광역시,동구,방어동,방어동제6투,3117,2100,964,907,177,41,1,2090,10,1017,46.124401913875595,43.397129186602875,8.468899521531101,1.9617224880382775,0.04784688995215311
10,울산광역시,동구,방어동,방어동제7투,2698,1749,734,872,110,22,2,1740,9,949,42.183908045977006,50.114942528735625,6.321839080459771,1.264367816091954,0.11494252873563218
11,울산광역시,동구,방어동,방어동제8투,2571,1468,628,691,120,18,3,1460,8,1103,43.013698630136986,47.328767123287676,8.21917808219178,1.2328767123287672,0.2054794520547945
12,울산광역시,동구,방어동,방어동제9투,2288,1675,728,788,112,30,2,1660,15,613,43.855421686746986,47.46987951807229,6.746987951807229,1.8072289156626504,0.12048192771084339
13,울산광역시,동구,일산동,관내사전투표,2478,2478,1512,739,180,28,5,2464,14,0,61.36363636363637,29.991883116883116,7.305194805194805,1.1363636363636365,0.2029220779220779
14,울산광역시,동구,일산동,일산동제1투,1329,801,225,508,48,10,3,794,7,528,28.337531486146094,63.97984886649874,6.045340050377834,1.2594458438287155,0.3778337531486146
15,울산광역시,동구,일산동,일산동제2투,1770,1171,321,736,86,17,1,1161,10,599,27.648578811369507,63.39362618432386,7.4074074074074066,1.4642549526270456,0.08613264427217916
16,울산광역시,동구,화정동,관내사전투표,3844,3844,2405,1139,215,58,3,3820,24,0,62.95811518324608,29.816753926701573,5.6282722513089,1.5183246073298429,0.07853403141361257
17,울산광역시,동구,화정동,화정동제1투,3161,2524,1177,1036,240,51,4,2508,16,637,46.92982456140351,41.30781499202552,9.569377990430622,2.0334928229665072,0.1594896331738437
18,울산광역시,동구,화정동,화정동제2투,2040,1237,347,806,67,12,1,1233,4,803,28.142741281427412,65.36901865369019,5.43390105433901,0.9732360097323601,0.08110300081103002
19,울산광역시,동구,화정동,화정동제3투,2525,1685,644,854,133,29,1,1661,24,840,38.77182420228778,51.414810355207706,8.007224563515953,1.745936183022276,0.060204695966285374
20,울산광역시,동구,화정동,화정동제4투,2420,1511,508,870,92,24,2,1496,15,909,33.9572192513369,58.155080213903744,6.149732620320856,1.6042780748663104,0.1336898395721925
21,울산광역시,동구,대송동,관내사전투표,2868,2868,1827,803,165,50,1,2846,22,0,64.19536191145467,28.215038650737878,5.797610681658468,1.7568517217146873,0.035137034434293744
22,울산광역시,동구,대송동,대송동제1투,2197,1491,529,801,114,29,5,1478,13,706,35.791610284167795,54.19485791610285,7.7131258457374825,1.962110960757781,0.3382949932341001
23,울산광역시,동구,대송동,대송동제2투,3757,2392,867,1280,184,37,4,2372,20,1365,36.55143338954469,53.96290050590219,7.75716694772344,1.5598650927487352,0.16863406408094433
24,울산광역시,동구,전하1동,관내사전투표,3419,3419,2110,945,285,56,3,3399,20,0,62.07708149455722,27.802294792586054,8.384819064430715,1.6475433951162106,0.088261253309797
25,울산광역시,동구,전하1동,전하1동제1투,3591,2341,728,1362,195,35,0,2320,21,1250,31.379310344827587,58.70689655172414,8.405172413793103,1.5086206896551724,0.0
26,울산광역시,동구,전하1동,전하1동제2투,1888,1320,527,678,79,21,3,1308,12,568,40.29051987767584,51.8348623853211,6.039755351681957,1.6055045871559634,0.22935779816513763
27,울산광역시,동구,전하1동,전하1동제3투,2938,2245,864,1079,234,51,3,2231,14,693,38.72702823845809,48.363962348722545,10.488570147915732,2.285970416853429,0.1344688480502017
28,울산광역시,동구,전하2동,관내사전투표,5541,5540,3439,1638,341,82,9,5509,31,1,62.425122526774366,29.733163913595934,6.189871119985478,1.4884734071519332,0.16336903249228535
29,울산광역시,동구,전하2동,전하2동제1투,2798,1746,534,1047,117,26,5,1729,17,1052,30.884904569115097,60.555234239444765,6.7669172932330826,1.5037593984962405,0.2891844997108155
30,울산광역시,동구,전하2동,전하2동제2투,1239,832,278,478,52,19,2,829,3,407,33.53437876960193,57.65983112183354,6.272617611580217,2.2919179734620023,0.24125452352231602
31,울산광역시,동구,전하2동,전하2동제3투,2146,1704,683,837,135,38,0,1693,11,442,40.3425871234495,49.43886591848789,7.974010632014177,2.244536326048435,0.0
32,울산광역시,동구,전하2동,전하2동제4투,1414,1134,519,483,111,13,0,1126,8,280,46.0923623445826,42.89520426287744,9.857904085257548,1.1545293072824157,0.0
33,울산광역시,동구,전하2동,전하2동제5투,2183,1798,810,787,160,26,2,1785,13,385,45.378151260504204,44.089635854341736,8.96358543417367,1.4565826330532212,0.11204481792717086
34,울산광역시,동구,남목1동,관내사전투표,2316,2316,1487,631,141,43,1,2303,13,0,64.56795484151108,27.399044724272688,6.122448979591836,1.8671298306556665,0.04342162396873643
35,울산광역시,동구,남목1동,남목1동제1투,1234,750,211,469,44,16,2,742,8,484,28.4366576819407,63.20754716981132,5.929919137466308,2.15633423180593,0.2695417789757413
36,울산광역시,동구,남목1동,남목1동제2투,3218,2282,807,1280,141,27,2,2257,25,936,35.75542755870625,56.7124501550731,6.247230837394771,1.1962782454585734,0.08861320336730173
37,울산광역시,동구,남목2동,관내사전투표,5624,5623,3529,1462,493,99,2,5585,38,1,63.18710832587288,26.177260519247987,8.8272157564906,1.7726051924798567,0.03581020590868397
38,울산광역시,동구,남목2동,남목2동제1투,2372,1546,449,883,172,24,1,1529,17,826,29.365598430346633,57.75016350555919,11.249182472204055,1.5696533682145193,0.06540222367560497
39,울산광역시,동구,남목2동,남목2동제2투,3219,2318,976,1071,213,41,2,2303,15,901,42.379504993486755,46.504559270516715,9.24880590534086,1.7802865827181935,0.08684324793747286
40,울산광역시,동구,남목2동,남목2동제3투,1984,1485,599,726,108,32,1,1466,19,499,40.85948158253751,49.5225102319236,7.3669849931787175,2.1828103683492497,0.06821282401091405
41,울산광역시,동구,남목2동,남목2동제4투,2393,1823,757,846,164,42,1,1810,13,570,41.82320441988951,46.74033149171271,9.060773480662982,2.3204419889502765,0.05524861878453039
42,울산광역시,동구,남목2동,남목2동제5투,3528,2842,1196,1197,350,65,4,2812,30,686,42.53200568990042,42.567567567567565,12.446657183499289,2.3115220483641536,0.1422475106685633
43,울산광역시,동구,남목3동,관내사전투표,2908,2908,1924,745,160,56,5,2890,18,0,66.57439446366782,25.77854671280277,5.536332179930796,1.9377162629757785,0.17301038062283738
44,울산광역시,동구,남목3동,남목3동제1투,2803,1839,676,980,120,43,3,1822,17,964,37.102085620197585,53.787047200878156,6.586169045005488,2.3600439077936337,0.1646542261251372
45,울산광역시,동구,남목3동,남목3동제2투,2496,1746,709,864,120,37,2,1732,14,750,40.93533487297921,49.88452655889146,6.928406466512701,2.136258660508083,0.11547344110854503
46,울산광역시,동구,남목3동,남목3동제3투,490,350,75,263,10,1,0,349,1,140,21.48997134670487,75.35816618911176,2.865329512893983,0.28653295128939826,0.0
47,울산광역시,동구,잘못 투입·구분된 투표지,,0,1,1,0,0,0,0,1,0,-1,100.0,0.0,0.0,0.0,0.0
0,울산광역시,북구,거소·선상투표,,208,198,67,72,49,1,1,190,8,10,35.26315789473684,37.89473684210527,25.789473684210527,0.5263157894736842,0.5263157894736842
1,울산광역시,북구,관외사전투표,,14008,14005,7181,4299,2122,212,27,13841,164,3,51.882089444404315,31.059894516292175,15.331262192038148,1.5316812369048478,0.1950726103605231
2,울산광역시,북구,재외투표,,529,420,273,88,51,6,0,418,2,109,65.311004784689,21.052631578947366,12.200956937799043,1.4354066985645932,0.0
3,울산광역시,북구,농소1동,관내사전투표,4097,4097,2589,1188,231,63,0,4071,26,0,63.596168017686075,29.182019159911572,5.674281503316139,1.5475313190862197,0.0
4,울산광역시,북구,농소1동,농소1동제1투,1968,1331,414,789,105,13,1,1322,9,637,31.316187594553707,59.682299546142204,7.94251134644478,0.9833585476550681,0.07564296520423601
5,울산광역시,북구,농소1동,농소1동제2투,1645,1037,218,733,60,14,2,1027,10,608,21.226874391431352,71.37293086660176,5.8422590068159685,1.3631937682570594,0.19474196689386564
6,울산광역시,북구,농소1동,농소1동제3투,2913,2202,824,1143,160,45,7,2179,23,711,37.81551170261588,52.45525470399266,7.342817806333181,2.065167508031207,0.32124827902707664
7,울산광역시,북구,농소1동,농소1동제4투,1171,768,214,490,49,8,0,761,7,403,28.12089356110381,64.38896189224704,6.438896189224705,1.0512483574244416,0.0
8,울산광역시,북구,농소1동,농소1동제5투,1170,848,357,402,64,18,2,843,5,322,42.34875444839858,47.686832740213525,7.591933570581258,2.135231316725979,0.2372479240806643
9,울산광역시,북구,농소1동,농소1동제6투,2597,2026,867,950,164,35,2,2018,8,571,42.96333002973241,47.07631318136769,8.126858275520316,1.734390485629336,0.09910802775024777
10,울산광역시,북구,농소1동,농소1동제7투,1889,1542,742,638,125,24,1,1530,12,347,48.49673202614379,41.69934640522876,8.169934640522875,1.5686274509803921,0.065359477124183
11,울산광역시,북구,농소1동,농소1동제8투,2783,1721,611,951,121,18,2,1703,18,1062,35.87786259541985,55.842630651790955,7.105108631826189,1.0569583088667058,0.11743981209630064
12,울산광역시,북구,농소1동,농소1동제9투,3807,3057,1472,1217,280,67,3,3039,18,750,48.43698585060876,40.04606778545574,9.213557091148404,2.204672589667654,0.09871668311944717
13,울산광역시,북구,농소2동,관내사전투표,8888,8888,5853,2159,651,139,24,8826,62,0,66.31543167912984,24.46181735780648,7.375934738273283,1.574892363471561,0.27192386131883073
14,울산광역시,북구,농소2동,농소2동제1투,3264,2259,918,1069,223,32,3,2245,14,1005,40.89086859688196,47.61692650334076,9.933184855233854,1.4253897550111359,0.13363028953229397
15,울산광역시,북구,농소2동,농소2동제2투,1291,802,261,470,57,6,4,798,4,489,32.70676691729324,58.89724310776943,7.142857142857142,0.7518796992481203,0.5012531328320802
16,울산광역시,북구,농소2동,농소2동제3투,1667,1153,365,715,57,11,2,1150,3,514,31.73913043478261,62.17391304347826,4.956521739130435,0.9565217391304347,0.17391304347826086
17,울산광역시,북구,농소2동,농소2동제4투,1959,1351,450,779,92,18,0,1339,12,608,33.60716952949963,58.17774458551157,6.870799103808813,1.344286781179985,0.0
18,울산광역시,북구,농소2동,농소2동제5투,1994,1376,558,695,103,15,2,1373,3,618,40.64093226511289,50.619082301529495,7.501820830298617,1.0924981791697013,0.14566642388929352
19,울산광역시,북구,농소2동,농소2동제6투,3485,2633,1113,1226,228,43,5,2615,18,852,42.56214149139579,46.88336520076482,8.718929254302104,1.644359464627151,0.19120458891013384
20,울산광역시,북구,농소2동,농소2동제7투,2915,2239,989,989,188,50,5,2221,18,676,44.529491220171096,44.529491220171096,8.464655560558306,2.25123818099955,0.22512381809995496
21,울산광역시,북구,농소2동,농소2동제8투,4130,3028,1461,1218,260,61,4,3004,24,1102,48.63515312916112,40.54593874833555,8.655126498002662,2.030625832223702,0.13315579227696406
22,울산광역시,북구,농소2동,농소2동제9투,2751,2211,1038,905,217,36,2,2198,13,540,47.224749772520475,41.173794358507735,9.872611464968154,1.6378525932666061,0.09099181073703368
23,울산광역시,북구,농소3동,관내사전투표,7285,7285,5174,1490,474,100,8,7246,39,0,71.40491305547889,20.563069279602537,6.541540160088324,1.3800717637317141,0.11040574109853712
24,울산광역시,북구,농소3동,농소3동제1투,2471,1681,635,914,106,14,0,1669,12,790,38.046734571599764,54.76333133612942,6.351108448172559,0.8388256440982624,0.0
25,울산광역시,북구,농소3동,농소3동제2투,3251,2231,866,1093,215,34,5,2213,18,1020,39.13239945774966,49.38996836873023,9.715318572074109,1.5363759602349751,0.22593764121102575
26,울산광역시,북구,농소3동,농소3동제3투,2089,1439,516,768,117,26,1,1428,11,650,36.134453781512605,53.78151260504202,8.193277310924369,1.8207282913165268,0.0700280112044818
27,울산광역시,북구,농소3동,농소3동제4투,2297,1551,610,800,111,17,4,1542,9,746,39.559014267185475,51.88067444876784,7.198443579766536,1.1024643320363166,0.25940337224383914
28,울산광역시,북구,농소3동,농소3동제5투,1541,1044,412,523,80,15,3,1033,11,497,39.8838334946757,50.62923523717329,7.744433688286543,1.452081316553727,0.29041626331074544
29,울산광역시,북구,농소3동,농소3동제6투,2609,1936,923,804,154,31,1,1913,23,673,48.24882383690539,42.02822791427078,8.050182958703607,1.6204913748039729,0.052273915316257184
30,울산광역시,북구,농소3동,농소3동제7투,2953,2248,883,1126,194,34,1,2238,10,705,39.454870420017876,50.312779267202856,8.668453976764969,1.519213583556747,0.044682752457551385
31,울산광역시,북구,농소3동,농소3동제8투,1717,1325,654,519,121,25,1,1320,5,392,49.54545454545455,39.31818181818182,9.166666666666666,1.893939393939394,0.07575757575757576
32,울산광역시,북구,강동동,관내사전투표,3454,3454,2222,933,218,57,3,3433,21,0,64.72473055636469,27.177395863676086,6.3501310806874445,1.6603553743081854,0.08738712496358869
33,울산광역시,북구,강동동,강동동제1투,2485,1584,625,804,126,23,0,1578,6,901,39.60709759188847,50.950570342205324,7.984790874524715,1.4575411913814955,0.0
34,울산광역시,북구,강동동,강동동제2투,950,568,108,424,25,2,1,560,8,382,19.28571428571429,75.71428571428571,4.464285714285714,0.35714285714285715,0.17857142857142858
35,울산광역시,북구,강동동,강동동제3투,496,372,57,292,15,4,0,368,4,124,15.489130434782608,79.34782608695652,4.076086956521739,1.0869565217391304,0.0
36,울산광역시,북구,강동동,강동동제4투,374,260,52,196,11,1,0,260,0,114,20.0,75.38461538461539,4.230769230769231,0.38461538461538464,0.0
37,울산광역시,북구,강동동,강동동제5투,3613,2458,1024,1207,181,31,1,2444,14,1155,41.89852700490999,49.38625204582651,7.405891980360066,1.2684124386252045,0.04091653027823241
38,울산광역시,북구,효문동,관내사전투표,5013,5013,3198,1274,419,81,10,4982,31,0,64.1910879164994,25.572059413890003,8.410276997189884,1.6258530710558008,0.20072260136491368
39,울산광역시,북구,효문동,효문동제1투,1251,790,206,515,58,7,1,787,3,461,26.17534942820839,65.43837357052097,7.369758576874205,0.8894536213468869,0.12706480304955528
40,울산광역시,북구,효문동,효문동제2투,2147,1612,659,711,197,27,0,1594,18,535,41.34253450439147,44.604767879548305,12.358845671267252,1.6938519447929739,0.0
41,울산광역시,북구,효문동,효문동제3투,1932,1567,583,852,92,19,1,1547,20,365,37.68584356819651,55.07433742727861,5.946994182288299,1.2281835811247577,0.06464124111182934
42,울산광역시,북구,효문동,효문동제4투,3587,2525,827,1447,200,25,1,2500,25,1062,33.08,57.879999999999995,8.0,1.0,0.04
43,울산광역시,북구,효문동,효문동제5투,3014,1947,618,1084,197,32,2,1933,14,1067,31.971029487842735,56.07863424728401,10.191412312467667,1.6554578375581996,0.10346611484738748
44,울산광역시,북구,효문동,효문동제6투,2112,1606,646,776,137,33,2,1594,12,506,40.52697616060226,48.68255959849435,8.594730238393977,2.0702634880803013,0.12547051442910914
45,울산광역시,북구,효문동,효문동제7투,3124,2232,685,1280,205,40,1,2211,21,892,30.98145635459068,57.89235639981909,9.271822704658526,1.8091361374943467,0.045228403437358664
46,울산광역시,북구,송정동,관내사전투표,9335,9335,6128,2225,734,168,5,9260,75,0,66.17710583153348,24.028077753779698,7.926565874730021,1.8142548596112311,0.05399568034557236
47,울산광역시,북구,송정동,송정동제1투,2032,1516,529,844,117,19,3,1512,4,516,34.98677248677249,55.82010582010582,7.738095238095238,1.2566137566137565,0.1984126984126984
48,울산광역시,북구,송정동,송정동제2투,1427,1044,390,533,102,15,0,1040,4,383,37.5,51.24999999999999,9.807692307692308,1.4423076923076923,0.0
49,울산광역시,북구,송정동,송정동제3투,2012,1399,447,829,95,19,0,1390,9,613,32.15827338129497,59.64028776978417,6.83453237410072,1.3669064748201438,0.0
50,울산광역시,북구,송정동,송정동제4투,2053,1387,425,818,114,20,1,1378,9,666,30.84179970972424,59.361393323657474,8.272859216255442,1.4513788098693758,0.07256894049346879
51,울산광역시,북구,송정동,송정동제5투,2422,1622,538,918,128,20,0,1604,18,800,33.54114713216958,57.23192019950125,7.98004987531172,1.2468827930174564,0.0
52,울산광역시,북구,송정동,송정동제6투,1990,1483,613,656,179,23,1,1472,11,507,41.64402173913043,44.565217391304344,12.160326086956522,1.5625,0.06793478260869565
53,울산광역시,북구,송정동,송정동제7투,3246,2569,1193,1044,268,42,4,2551,18,677,46.76597412779302,40.9251274010192,10.505684045472364,1.6464131713053702,0.15680125441003528
54,울산광역시,북구,송정동,송정동제8투,3351,2599,1066,1210,270,35,2,2583,16,752,41.269841269841265,46.84475416182733,10.452961672473867,1.3550135501355014,0.07742934572202864
55,울산광역시,북구,양정동,관내사전투표,3192,3192,2063,662,366,68,5,3164,28,0,65.20227560050569,20.922882427307208,11.56763590391909,2.1491782553729455,0.15802781289506954
56,울산광역시,북구,양정동,양정동제1투,3059,2350,1019,1028,223,62,4,2336,14,709,43.62157534246575,44.00684931506849,9.54623287671233,2.654109589041096,0.17123287671232876
57,울산광역시,북구,양정동,양정동제2투,1365,911,299,502,88,17,0,906,5,454,33.00220750551877,55.40838852097131,9.713024282560706,1.8763796909492272,0.0
58,울산광역시,북구,양정동,양정동제3투,1870,1303,282,785,211,19,0,1297,6,567,21.742482652274482,60.5242868157286,16.268311488049346,1.4649190439475714,0.0
59,울산광역시,북구,염포동,관내사전투표,3019,3019,1908,712,308,70,3,3001,18,0,63.578807064311896,23.72542485838054,10.263245584805066,2.332555814728424,0.09996667777407531
60,울산광역시,북구,염포동,염포동제1투,1063,723,247,391,68,11,1,718,5,340,34.401114206128135,54.456824512534816,9.47075208913649,1.532033426183844,0.1392757660167131
61,울산광역시,북구,염포동,염포동제2투,907,594,162,366,46,9,2,585,9,313,27.692307692307693,62.56410256410256,7.863247863247863,1.5384615384615385,0.3418803418803419
62,울산광역시,북구,염포동,염포동제3투,2061,1431,558,720,102,32,0,1412,19,630,39.51841359773371,50.991501416430594,7.223796033994335,2.26628895184136,0.0
63,울산광역시,북구,염포동,염포동제4투,1180,687,170,443,66,4,1,684,3,493,24.853801169590643,64.76608187134502,9.649122807017543,0.5847953216374269,0.14619883040935672
64,울산광역시,북구,잘못 투입·구분된 투표지,,0,0,0,0,0,0,0,0,0,0,0.0,0.0,0.0,0.0,0.0
0,울산광역시,울주군,거소·선상투표,,306,291,97,113,69,5,1,285,6,15,34.03508771929825,39.64912280701755,24.210526315789473,1.7543859649122806,0.3508771929824561
1,울산광역시,울주군,관외사전투표,,18269,18265,8828,6490,2489,242,25,18074,191,4,48.84364280181476,35.907934048910036,13.771162996569657,1.3389399136881708,0.138320239017373
2,울산광역시,울주군,재외투표,,817,613,363,148,86,13,0,610,3,204,59.50819672131148,24.262295081967213,14.098360655737704,2.1311475409836063,0.0
3,울산광역시,울주군,범서읍,관내사전투표,11109,11109,6861,2925,1103,138,7,11034,75,0,62.1805328983143,26.508972267536706,9.99637484139931,1.2506797172376292,0.06344027551205365
4,울산광역시,울주군,범서읍,범서읍제1투,2641,2012,782,1008,168,31,5,1994,18,629,39.217652958876634,50.55165496489469,8.425275827482448,1.5546639919759278,0.25075225677031093
5,울산광역시,울주군,범서읍,범서읍제2투,2396,1713,451,1065,171,11,2,1700,13,683,26.529411764705884,62.64705882352941,10.058823529411764,0.6470588235294118,0.1176470588235294
6,울산광역시,울주군,범서읍,범서읍제3투,1242,900,196,666,28,4,3,897,3,342,21.850613154960982,74.24749163879598,3.121516164994426,0.4459308807134894,0.33444816053511706
7,울산광역시,울주군,범서읍,범서읍제4투,2926,2125,769,1119,196,24,1,2109,16,801,36.46277856804173,53.058321479374115,9.293504030346135,1.1379800853485065,0.0474158368895211
8,울산광역시,울주군,범서읍,범서읍제5투,3999,2962,1135,1551,229,27,1,2943,19,1037,38.566089024804626,52.7013251783894,7.781175671083929,0.9174311926605505,0.03397893306150187
9,울산광역시,울주군,범서읍,범서읍제6투,2106,1621,709,749,125,22,1,1606,15,485,44.14694894146949,46.637608966376085,7.783312577833127,1.36986301369863,0.062266500622665005
10,울산광역시,울주군,범서읍,범서읍제7투,2271,1794,543,1085,142,10,2,1782,12,477,30.47138047138047,60.88664421997755,7.968574635241302,0.5611672278338945,0.11223344556677892
11,울산광역시,울주군,범서읍,범서읍제8투,2957,2155,871,1072,169,30,3,2145,10,802,40.60606060606061,49.976689976689975,7.878787878787878,1.3986013986013985,0.13986013986013987
12,울산광역시,울주군,범서읍,범서읍제9투,2862,2077,807,1063,162,25,4,2061,16,785,39.15574963609898,51.57690441533236,7.860262008733625,1.21300339640951,0.19408054342552158
13,울산광역시,울주군,범서읍,범서읍제10투,2324,1768,627,1002,109,15,4,1757,11,556,35.685828116107,57.029026750142286,6.20375640295959,0.8537279453614115,0.22766078542970974
14,울산광역시,울주군,범서읍,범서읍제11투,1849,1309,483,667,120,28,2,1300,9,540,37.15384615384615,51.30769230769231,9.230769230769232,2.1538461538461537,0.15384615384615385
15,울산광역시,울주군,범서읍,범서읍제12투,2589,1964,808,925,180,30,3,1946,18,625,41.52106885919836,47.53340184994862,9.249743062692703,1.5416238437821173,0.1541623843782117
16,울산광역시,울주군,범서읍,범서읍제13투,3448,2715,1026,1357,275,39,4,2701,14,733,37.98593113661607,50.24065161051462,10.181414291003332,1.4439096630877453,0.1480932987782303
17,울산광역시,울주군,범서읍,범서읍제14투,2885,2317,861,1198,210,29,4,2302,15,568,37.40225890529974,52.04170286707212,9.122502172024326,1.259774109470026,0.1737619461337967
18,울산광역시,울주군,온산읍,관내사전투표,3807,3807,2209,1251,285,32,5,3782,25,0,58.408249603384455,33.07773664727657,7.535695399259651,0.8461131676361713,0.13220518244315177
19,울산광역시,울주군,온산읍,온산읍제1투,1865,928,270,594,52,4,1,921,7,937,29.31596091205212,64.49511400651465,5.646036916395222,0.43431053203040176,0.10857763300760044
20,울산광역시,울주군,온산읍,온산읍제2투,1953,1290,477,647,141,13,4,1282,8,663,37.20748829953198,50.46801872074883,10.998439937597503,1.014040561622465,0.31201248049922
21,울산광역시,울주군,온산읍,온산읍제3투,1984,1115,373,680,47,6,1,1107,8,869,33.694670280036135,61.427280939476056,4.245709123757904,0.5420054200542005,0.09033423667570009
22,울산광역시,울주군,온산읍,온산읍제4투,2235,1309,419,750,119,10,0,1298,11,926,32.280431432973806,57.781201848998464,9.167950693374422,0.7704160246533128,0.0
23,울산광역시,울주군,온산읍,온산읍제5투,1623,916,297,547,59,9,2,914,2,707,32.494529540481395,59.84682713347921,6.455142231947483,0.9846827133479212,0.2188183807439825
24,울산광역시,울주군,온산읍,온산읍제6투,2099,1449,555,773,92,16,6,1442,7,650,38.488210818307905,53.60610263522885,6.38002773925104,1.1095700416088765,0.4160887656033287
25,울산광역시,울주군,온산읍,온산읍제7투,617,425,86,322,12,0,0,420,5,192,20.476190476190474,76.66666666666667,2.857142857142857,0.0,0.0
26,울산광역시,울주군,언양읍,관내사전투표,7286,7286,3831,2788,533,75,13,7240,46,0,52.91436464088398,38.50828729281768,7.361878453038674,1.0359116022099446,0.17955801104972377
27,울산광역시,울주군,언양읍,언양읍제1투,1762,1042,223,760,39,8,3,1033,9,720,21.58760890609874,73.57212003872216,3.77541142303969,0.7744433688286544,0.29041626331074544
28,울산광역시,울주군,언양읍,언양읍제2투,2245,1620,529,961,98,21,2,1611,9,625,32.83674736188703,59.65238981998758,6.083178150217257,1.303538175046555,0.12414649286157665
29,울산광역시,울주군,언양읍,언양읍제3투,2181,1578,449,973,125,15,4,1566,12,603,28.671775223499363,62.132822477650066,7.982120051085569,0.9578544061302682,0.2554278416347382
30,울산광역시,울주군,언양읍,언양읍제4투,2410,1658,433,1059,137,16,1,1646,12,752,26.306196840826246,64.33778857837181,8.323207776427703,0.9720534629404617,0.060753341433778855
31,울산광역시,울주군,언양읍,언양읍제5투,962,603,95,474,20,9,0,598,5,359,15.88628762541806,79.26421404682274,3.3444816053511706,1.5050167224080269,0.0
32,울산광역시,울주군,언양읍,언양읍제6투,2063,1421,395,905,85,20,3,1408,13,642,28.05397727272727,64.27556818181817,6.036931818181818,1.4204545454545454,0.2130681818181818
33,울산광역시,울주군,언양읍,언양읍제7투,2271,1540,508,898,101,17,4,1528,12,731,33.246073298429316,58.7696335078534,6.609947643979057,1.112565445026178,0.2617801047120419
34,울산광역시,울주군,언양읍,언양읍제8투,2385,1854,744,919,146,28,3,1840,14,531,40.43478260869565,49.94565217391304,7.934782608695652,1.5217391304347827,0.16304347826086957
35,울산광역시,울주군,온양읍,관내사전투표,5305,5305,3046,1783,383,53,7,5272,33,0,57.77693474962064,33.82018209408194,7.264795144157815,1.0053110773899847,0.13277693474962063
36,울산광역시,울주군,온양읍,온양읍제1투,1358,827,150,637,30,5,0,822,5,531,18.248175182481752,77.49391727493918,3.64963503649635,0.6082725060827251,0.0
37,울산광역시,울주군,온양읍,온양읍제2투,2546,1796,585,1063,124,14,1,1787,9,750,32.736429770565195,59.48517067711248,6.93900391717963,0.783435926133184,0.05595970900951316
38,울산광역시,울주군,온양읍,온양읍제3투,2078,1224,387,746,68,13,0,1214,10,854,31.87808896210873,61.44975288303131,5.601317957166392,1.070840197693575,0.0
39,울산광역시,울주군,온양읍,온양읍제4투,2431,1674,623,873,144,16,5,1661,13,757,37.50752558699579,52.55869957856712,8.669476219145093,0.963275135460566,0.30102347983142685
40,울산광역시,울주군,온양읍,온양읍제5투,2995,1973,651,1151,130,19,6,1957,16,1022,33.265201839550336,58.81451200817578,6.642820643842616,0.9708737864077669,0.3065917220235054
41,울산광역시,울주군,온양읍,온양읍제6투,3137,2126,856,1053,168,24,2,2103,23,1011,40.703756538278654,50.07132667617689,7.988587731811697,1.1412268188302426,0.0951022349025202
42,울산광역시,울주군,온양읍,온양읍제7투,2002,1462,568,754,114,15,4,1455,7,540,39.03780068728523,51.821305841924406,7.835051546391752,1.0309278350515463,0.27491408934707906
43,울산광역시,울주군,청량읍,관내사전투표,3696,3696,2029,1298,303,28,6,3664,32,0,55.37663755458515,35.42576419213974,8.269650655021834,0.7641921397379913,0.16375545851528384
44,울산광역시,울주군,청량읍,청량읍제1투,1033,667,127,508,22,6,0,663,4,366,19.1553544494721,76.6214177978884,3.3182503770739067,0.904977375565611,0.0
45,울산광역시,울주군,청량읍,청량읍제2투,3070,2191,704,1213,231,26,2,2176,15,879,32.35294117647059,55.74448529411765,10.615808823529411,1.1948529411764706,0.09191176470588235
46,울산광역시,울주군,청량읍,청량읍제3투,2443,1837,508,1171,123,19,3,1824,13,606,27.850877192982455,64.19956140350878,6.743421052631579,1.0416666666666665,0.1644736842105263
47,울산광역시,울주군,청량읍,청량읍제4투,2595,1924,707,1057,115,25,4,1908,16,671,37.0545073375262,55.39832285115304,6.027253668763103,1.3102725366876309,0.20964360587002098
48,울산광역시,울주군,청량읍,청량읍제5투,3037,2149,690,1197,210,36,0,2133,16,888,32.34880450070324,56.118143459915615,9.845288326300984,1.6877637130801686,0.0
49,울산광역시,울주군,삼남읍,관내사전투표,4114,4114,2117,1681,268,24,1,4091,23,0,51.74773893913469,41.0901979956001,6.550965534099243,0.5866536299193351,0.024443901246638963
50,울산광역시,울주군,삼남읍,삼남읍제1투,2916,1776,435,1208,98,19,4,1764,12,1140,24.65986394557823,68.48072562358276,5.555555555555555,1.0770975056689343,0.22675736961451248
51,울산광역시,울주군,삼남읍,삼남읍제2투,2374,1438,331,1013,78,10,0,1432,6,936,23.114525139664803,70.74022346368714,5.4469273743016755,0.6983240223463687,0.0
52,울산광역시,울주군,삼남읍,삼남읍제3투,3000,1950,477,1335,102,17,3,1934,16,1050,24.66390899689762,69.02792140641158,5.274043433298862,0.8790072388831437,0.15511892450879006
53,울산광역시,울주군,삼남읍,삼남읍제4투,1692,1044,217,752,52,7,2,1030,14,648,21.067961165048544,73.00970873786407,5.048543689320388,0.6796116504854369,0.1941747572815534
54,울산광역시,울주군,삼남읍,삼남읍제5투,2863,2029,578,1183,220,28,1,2010,19,834,28.756218905472636,58.85572139303482,10.945273631840797,1.3930348258706469,0.04975124378109452
55,울산광역시,울주군,서생면,관내사전투표,1615,1615,704,794,100,6,1,1605,10,0,43.862928348909655,49.47040498442368,6.230529595015576,0.3738317757009346,0.06230529595015576
56,울산광역시,울주군,서생면,서생면제1투,1712,1146,186,868,75,8,0,1137,9,566,16.358839050131927,76.34124890061565,6.596306068601583,0.7036059806508356,0.0
57,울산광역시,울주군,서생면,서생면제2투,1111,756,155,567,23,4,1,750,6,355,20.666666666666668,75.6,3.0666666666666664,0.5333333333333333,0.13333333333333333
58,울산광역시,울주군,서생면,서생면제3투,2244,1488,405,1023,38,15,3,1484,4,756,27.291105121293803,68.93530997304582,2.560646900269542,1.0107816711590296,0.20215633423180593
59,울산광역시,울주군,웅촌면,관내사전투표,1828,1828,979,710,101,16,3,1809,19,0,54.11829740187949,39.24820342730791,5.583195135433941,0.8844665561083471,0.16583747927031509
60,울산광역시,울주군,웅촌면,웅촌면제1투,1814,1200,246,901,39,9,1,1196,4,614,20.5685618729097,75.33444816053512,3.260869565217391,0.7525083612040134,0.08361204013377926
61,울산광역시,울주군,웅촌면,웅촌면제2투,1070,719,148,535,30,3,0,716,3,351,20.670391061452513,74.72067039106145,4.189944134078212,0.41899441340782123,0.0
62,울산광역시,울주군,웅촌면,웅촌면제3투,1836,1263,357,809,71,15,0,1252,11,573,28.51437699680511,64.61661341853035,5.6709265175718855,1.1980830670926517,0.0
63,울산광역시,울주군,두동면,관내사전투표,1041,1041,493,479,55,6,2,1035,6,0,47.632850241545896,46.28019323671498,5.314009661835748,0.5797101449275363,0.1932367149758454
64,울산광역시,울주군,두동면,두동면제1투,1727,1067,237,773,43,6,0,1059,8,660,22.379603399433428,72.99338999055713,4.0604343720491025,0.56657223796034,0.0
65,울산광역시,울주군,두동면,두동면제2투,765,485,74,391,12,5,1,483,2,280,15.320910973084887,80.95238095238095,2.484472049689441,1.0351966873706004,0.2070393374741201
66,울산광역시,울주군,두서면,관내사전투표,1019,1018,434,451,78,8,7,978,40,1,44.376278118609406,46.11451942740286,7.975460122699387,0.81799591002045,0.7157464212678937
67,울산광역시,울주군,두서면,두서면제1투,1155,755,132,583,27,5,2,749,6,400,17.623497997329775,77.83711615487317,3.6048064085447264,0.6675567423230975,0.26702269692923897
68,울산광역시,울주군,두서면,두서면제2투,562,357,66,275,8,4,1,354,3,205,18.64406779661017,77.68361581920904,2.2598870056497176,1.1299435028248588,0.2824858757062147
69,울산광역시,울주군,상북면,관내사전투표,2399,2399,1154,1088,121,22,2,2387,12,0,48.34520318391286,45.58022622538751,5.0691244239631335,0.9216589861751152,0.0837871805613741
70,울산광역시,울주군,상북면,상북면제1투,1647,1033,224,749,46,5,3,1027,6,614,21.81110029211295,72.93086660175267,4.47906523855891,0.4868549172346641,0.2921129503407984
71,울산광역시,울주군,상북면,상북면제2투,1118,708,140,532,28,3,0,703,5,410,19.91465149359886,75.67567567567568,3.982930298719772,0.42674253200568996,0.0
72,울산광역시,울주군,상북면,상북면제3투,1779,1155,228,872,38,10,1,1149,6,624,19.843342036553523,75.89208006962576,3.307223672758921,0.8703220191470844,0.08703220191470844
73,울산광역시,울주군,삼동면,관내사전투표,612,612,309,260,28,9,2,608,4,0,50.82236842105263,42.76315789473684,4.605263157894736,1.4802631578947367,0.3289473684210526
74,울산광역시,울주군,삼동면,삼동면제1투,596,423,75,330,10,6,0,421,2,173,17.81472684085511,78.38479809976246,2.375296912114014,1.4251781472684086,0.0
75,울산광역시,울주군,삼동면,삼동면제2투,382,283,46,221,10,3,0,280,3,99,16.428571428571427,78.92857142857143,3.571428571428571,1.0714285714285714,0.0
76,울산광역시,울주군,잘못 투입·구분된 투표지,,0,0,0,0,0,0,0,0,0,0,0.0,0.0,0.0,0.0,0.0
0,세종특별자치시,세종특별자치시,거소·선상투표,,443,423,174,147,81,5,1,408,15,20,42.64705882352941,36.029411764705884,19.852941176470587,1.2254901960784315,0.24509803921568626
1,세종특별자치시,세종특별자치시,관외사전투표,,33676,33672,20352,7959,4648,363,42,33364,308,4,60.99988011029852,23.855053350917157,13.931183311353553,1.087999040882388,0.1258841865483755
2,세종특별자치시,세종특별자치시,재외투표,,2230,1895,1240,382,211,45,1,1879,16,335,65.99254922831294,20.329962746141565,11.229377328366152,2.394890899414582,0.05321979776476849
3,세종특별자치시,세종특별자치시,조치원읍,관내사전투표,7070,7070,4348,1944,632,72,13,7009,61,0,62.03452703666714,27.735768297902695,9.016978170923098,1.0272506777000998,0.18547581680696248
4,세종특별자치시,세종특별자치시,조치원읍,조치원읍제1투,1860,1087,367,635,69,5,1,1077,10,773,34.076137418755806,58.96007428040855,6.406685236768802,0.4642525533890436,0.09285051067780872
5,세종특별자치시,세종특별자치시,조치원읍,조치원읍제2투,1174,699,239,410,38,3,2,692,7,475,34.53757225433526,59.2485549132948,5.491329479768786,0.4335260115606936,0.2890173410404624
6,세종특별자치시,세종특별자치시,조치원읍,조치원읍제3투,1999,1215,445,668,81,8,1,1203,12,784,36.990856192851204,55.527847049044055,6.733167082294264,0.6650041562759768,0.0831255195344971
7,세종특별자치시,세종특별자치시,조치원읍,조치원읍제4투,3195,1991,778,1013,169,15,3,1978,13,1204,39.33265925176946,51.21334681496461,8.543983822042467,0.7583417593528816,0.15166835187057634
8,세종특별자치시,세종특별자치시,조치원읍,조치원읍제5투,2439,1707,744,769,154,21,0,1688,19,732,44.07582938388626,45.556872037914694,9.123222748815166,1.2440758293838863,0.0
9,세종특별자치시,세종특별자치시,조치원읍,조치원읍제6투,691,389,125,240,21,1,0,387,2,302,32.299741602067186,62.01550387596899,5.426356589147287,0.2583979328165375,0.0
10,세종특별자치시,세종특별자치시,조치원읍,조치원읍제7투,1438,792,262,376,137,12,0,787,5,646,33.29097839898348,47.77636594663278,17.407878017789074,1.5247776365946633,0.0
11,세종특별자치시,세종특별자치시,조치원읍,조치원읍제8투,3463,2324,1080,1052,156,22,2,2312,12,1139,46.71280276816609,45.501730103806224,6.747404844290658,0.9515570934256056,0.08650519031141869
12,세종특별자치시,세종특별자치시,조치원읍,조치원읍제9투,2125,1382,576,691,94,12,1,1374,8,743,41.92139737991266,50.29112081513828,6.841339155749636,0.8733624454148471,0.0727802037845706
13,세종특별자치시,세종특별자치시,조치원읍,조치원읍제10투,2597,1711,666,900,113,11,1,1691,20,886,39.38497930218806,53.222945002956834,6.682436428149025,0.6505026611472502,0.05913660555884093
14,세종특별자치시,세종특별자치시,조치원읍,조치원읍제11투,3316,2429,1184,1029,163,33,3,2412,17,887,49.08789386401327,42.66169154228855,6.7578772802653395,1.3681592039800996,0.12437810945273632
15,세종특별자치시,세종특별자치시,연기면,관내사전투표,1006,1006,617,300,77,5,1,1000,6,0,61.7,30.0,7.7,0.5,0.1
16,세종특별자치시,세종특별자치시,연기면,연기면투표소,1351,742,239,465,33,3,1,741,1,609,32.25371120107962,62.75303643724697,4.4534412955465585,0.4048582995951417,0.1349527665317139
17,세종특별자치시,세종특별자치시,연동면,관내사전투표,964,964,571,308,68,8,2,957,7,0,59.66562173458725,32.18390804597701,7.105538140020899,0.8359456635318705,0.20898641588296762
18,세종특별자치시,세종특별자치시,연동면,연동면제1투,841,513,140,346,21,2,0,509,4,328,27.5049115913556,67.97642436149313,4.12573673870334,0.3929273084479371,0.0
19,세종특별자치시,세종특별자치시,연동면,연동면제2투,795,523,176,310,31,2,1,520,3,272,33.84615384615385,59.61538461538461,5.961538461538462,0.38461538461538464,0.19230769230769232
20,세종특별자치시,세종특별자치시,부강면,관내사전투표,1975,1975,1125,641,176,14,6,1962,13,0,57.3394495412844,32.67074413863404,8.970438328236494,0.7135575942915392,0.3058103975535168
21,세종특별자치시,세종특별자치시,부강면,부강면제1투,2023,1140,385,655,83,11,0,1134,6,883,33.95061728395062,57.760141093474424,7.319223985890652,0.9700176366843033,0.0
22,세종특별자치시,세종특별자치시,부강면,부강면제2투,931,557,190,333,27,4,0,554,3,374,34.29602888086642,60.108303249097474,4.873646209386282,0.7220216606498195,0.0
23,세종특별자치시,세종특별자치시,금남면,관내사전투표,2073,2073,1191,709,137,14,2,2053,20,0,58.01266439357039,34.53482708231856,6.673161227471993,0.6819288845591817,0.0974184120798831
24,세종특별자치시,세종특별자치시,금남면,금남면제1투,2126,1248,369,766,84,9,2,1230,18,878,30.0,62.27642276422765,6.829268292682928,0.7317073170731708,0.16260162601626016
25,세종특별자치시,세종특별자치시,금남면,금남면제2투,864,587,171,384,23,2,3,583,4,277,29.331046312178387,65.86620926243569,3.9451114922813035,0.34305317324185247,0.5145797598627788
26,세종특별자치시,세종특별자치시,금남면,금남면제3투,886,576,171,365,28,4,1,569,7,310,30.052724077328648,64.14762741652021,4.92091388400703,0.7029876977152899,0.17574692442882248
27,세종특별자치시,세종특별자치시,금남면,금남면제4투,761,496,151,326,17,1,1,496,0,265,30.443548387096776,65.7258064516129,3.4274193548387095,0.20161290322580644,0.20161290322580644
28,세종특별자치시,세종특별자치시,장군면,관내사전투표,1533,1533,954,475,91,4,0,1524,9,0,62.59842519685039,31.167979002624673,5.971128608923885,0.26246719160104987,0.0
29,세종특별자치시,세종특별자치시,장군면,장군면제1투,1632,892,293,513,71,6,0,883,9,740,33.182332955832386,58.0973952434881,8.040770101925254,0.6795016987542469,0.0
30,세종특별자치시,세종특별자치시,장군면,장군면제2투,1618,862,270,512,72,3,0,857,5,756,31.505250875145858,59.74329054842473,8.401400233372229,0.3500583430571762,0.0
31,세종특별자치시,세종특별자치시,장군면,장군면제3투,392,256,79,157,16,1,1,254,2,136,31.10236220472441,61.811023622047244,6.299212598425196,0.39370078740157477,0.39370078740157477
32,세종특별자치시,세종특별자치시,연서면,관내사전투표,2464,2464,1559,657,200,27,3,2446,18,0,63.73671300081766,26.86017988552739,8.176614881439084,1.1038430089942763,0.12264922322158626
33,세종특별자치시,세종특별자치시,연서면,연서면제1투,772,502,166,308,19,4,0,497,5,270,33.400402414486926,61.97183098591549,3.8229376257545273,0.8048289738430584,0.0
34,세종특별자치시,세종특별자치시,연서면,연서면제2투,443,313,119,176,11,3,0,309,4,130,38.51132686084142,56.957928802588995,3.559870550161812,0.9708737864077669,0.0
35,세종특별자치시,세종특별자치시,연서면,연서면제3투,558,336,94,231,9,0,0,334,2,222,28.143712574850298,69.16167664670658,2.694610778443114,0.0,0.0
36,세종특별자치시,세종특별자치시,연서면,연서면제4투,2177,1290,433,728,95,11,3,1270,20,887,34.09448818897638,57.322834645669296,7.480314960629922,0.8661417322834646,0.23622047244094488
37,세종특별자치시,세종특별자치시,전의면,관내사전투표,1634,1634,974,522,91,12,5,1604,30,0,60.723192019950126,32.54364089775561,5.673316708229426,0.7481296758104738,0.3117206982543641
38,세종특별자치시,세종특별자치시,전의면,전의면제1투,1229,710,209,464,28,3,1,705,5,519,29.645390070921984,65.81560283687942,3.9716312056737593,0.425531914893617,0.14184397163120568
39,세종특별자치시,세종특별자치시,전의면,전의면제2투,1263,761,232,489,32,3,0,756,5,502,30.687830687830687,64.68253968253968,4.232804232804233,0.3968253968253968,0.0
40,세종특별자치시,세종특별자치시,전의면,전의면제3투,480,326,103,202,15,4,0,324,2,154,31.790123456790127,62.34567901234568,4.62962962962963,1.2345679012345678,0.0
41,세종특별자치시,세종특별자치시,전동면,관내사전투표,981,981,552,348,49,12,6,967,14,0,57.083764219234745,35.987590486039295,5.067218200620475,1.2409513960703205,0.6204756980351602
42,세종특별자치시,세종특별자치시,전동면,전동면제1투,853,501,153,316,27,1,0,497,4,352,30.784708249496983,63.581488933601605,5.432595573440644,0.2012072434607646,0.0
43,세종특별자치시,세종특별자치시,전동면,전동면제2투,400,258,86,158,11,0,1,256,2,142,33.59375,61.71875,4.296875,0.0,0.390625
44,세종특별자치시,세종특별자치시,전동면,전동면제3투,628,270,76,185,8,0,0,269,1,358,28.25278810408922,68.77323420074349,2.973977695167286,0.0,0.0
45,세종특별자치시,세종특별자치시,소정면,관내사전투표,654,654,354,253,35,8,0,650,4,0,54.46153846153846,38.92307692307692,5.384615384615385,1.2307692307692308,0.0
46,세종특별자치시,세종특별자치시,소정면,소정면투표소,1127,682,182,453,32,8,2,677,5,445,26.88330871491876,66.91285081240767,4.726735598227474,1.1816838995568686,0.29542097488921715
47,세종특별자치시,세종특별자치시,한솔동,관내사전투표,3922,3922,2838,721,301,45,1,3906,16,0,72.65745007680492,18.45878136200717,7.706093189964158,1.1520737327188941,0.025601638504864313
48,세종특별자치시,세종특별자치시,한솔동,한솔동제1투,2104,1630,827,638,138,16,0,1619,11,474,51.080914144533665,39.40704138357011,8.523780111179741,0.9882643607164917,0.0
49,세종특별자치시,세종특별자치시,한솔동,한솔동제2투,1730,1355,682,531,122,14,0,1349,6,375,50.555967383246845,39.362490733876946,9.04373610081542,1.0378057820607858,0.0
50,세종특별자치시,세종특별자치시,한솔동,한솔동제3투,1661,1291,584,561,117,15,2,1279,12,370,45.66067240031275,43.862392494136046,9.147771696638,1.1727912431587177,0.1563721657544957
51,세종특별자치시,세종특별자치시,한솔동,한솔동제4투,2362,1719,710,786,178,24,1,1699,20,643,41.78928781636257,46.26250735726899,10.476751030017658,1.4125956444967627,0.05885815185403178
52,세종특별자치시,세종특별자치시,도담동,관내사전투표,6273,6273,4277,1301,589,66,5,6238,35,0,68.56364219301058,20.85604360371914,9.442128887463932,1.058031420327028,0.0801538954793203
53,세종특별자치시,세종특별자치시,도담동,도담동제1투,1435,1012,416,418,154,10,0,998,14,423,41.68336673346693,41.883767535070135,15.430861723446892,1.002004008016032,0.0
54,세종특별자치시,세종특별자치시,도담동,도담동제2투,1844,1275,464,673,95,25,1,1258,17,569,36.88394276629571,53.49761526232114,7.551669316375199,1.987281399046105,0.0794912559618442
55,세종특별자치시,세종특별자치시,도담동,도담동제3투,3629,2599,1093,1207,253,27,2,2582,17,1030,42.331525948876845,46.746707978311385,9.798605731990705,1.0457010069713402,0.0774593338497289
56,세종특별자치시,세종특별자치시,도담동,도담동제4투,1749,1368,645,553,139,25,0,1362,6,381,47.3568281938326,40.602055800293684,10.205580029368576,1.8355359765051396,0.0
57,세종특별자치시,세종특별자치시,도담동,도담동제5투,2169,1705,717,801,155,22,1,1696,9,464,42.27594339622642,47.22877358490566,9.139150943396226,1.2971698113207548,0.0589622641509434
58,세종특별자치시,세종특별자치시,아름동,관내사전투표,5799,5799,4156,1005,529,70,3,5763,36,0,72.11521776852334,17.43883394065591,9.17924692000694,1.2146451500954365,0.052056220718375845
59,세종특별자치시,세종특별자치시,아름동,아름동제1투,2252,1715,849,614,215,25,0,1703,12,537,49.85320023487962,36.054022313564296,12.62477980035232,1.4679976512037582,0.0
60,세종특별자치시,세종특별자치시,아름동,아름동제2투,1900,1428,730,557,116,12,3,1418,10,472,51.48095909732017,39.28067700987306,8.180535966149506,0.846262341325811,0.21156558533145275
61,세종특별자치시,세종특별자치시,아름동,아름동제3투,2474,1859,916,757,146,22,1,1842,17,615,49.728555917480996,41.096634093376764,7.926167209554831,1.1943539630836049,0.05428881650380022
62,세종특별자치시,세종특별자치시,아름동,아름동제4투,2699,2190,1192,742,195,41,2,2172,18,509,54.88029465930019,34.16206261510129,8.977900552486188,1.8876611418047882,0.09208103130755065
63,세종특별자치시,세종특별자치시,종촌동,관내사전투표,6105,6105,4270,1153,562,69,3,6057,48,0,70.4969456826812,19.03582631665841,9.278520719828299,1.1391778107974244,0.04952947003467063
64,세종특별자치시,세종특별자치시,종촌동,종촌동제1투,2391,1700,850,658,162,19,2,1691,9,691,50.26611472501479,38.91188645771733,9.580130100532228,1.1235955056179776,0.11827321111768185
65,세종특별자치시,세종특별자치시,종촌동,종촌동제2투,1310,952,453,397,80,15,0,945,7,358,47.93650793650794,42.01058201058201,8.465608465608465,1.5873015873015872,0.0
66,세종특별자치시,세종특별자치시,종촌동,종촌동제3투,2407,1927,977,748,164,20,3,1912,15,480,51.09832635983263,39.12133891213389,8.577405857740587,1.0460251046025104,0.15690376569037656
67,세종특별자치시,세종특별자치시,종촌동,종촌동제4투,1832,1443,680,609,127,20,2,1438,5,389,47.28789986091794,42.35048678720445,8.831710709318498,1.3908205841446455,0.13908205841446453
68,세종특별자치시,세종특별자치시,종촌동,종촌동제5투,2281,1606,709,718,152,19,1,1599,7,675,44.34021263289556,44.903064415259536,9.505941213258287,1.188242651657286,0.06253908692933083
69,세종특별자치시,세종특별자치시,종촌동,종촌동제6투,1593,1115,438,549,99,17,2,1105,10,478,39.63800904977376,49.68325791855204,8.959276018099548,1.5384615384615385,0.18099547511312217
70,세종특별자치시,세종특별자치시,고운동,관내사전투표,5802,5802,4335,993,393,56,1,5778,24,0,75.02596053997922,17.1858774662513,6.801661474558671,0.9691934925579786,0.017307026652821047
71,세종특별자치시,세종특별자치시,고운동,고운동제1투,3512,2615,1266,1083,220,23,1,2593,22,897,48.82375626687235,41.766293868106445,8.484381025838797,0.887003470883147,0.03856536829926726
72,세종특별자치시,세종특별자치시,고운동,고운동제2투,4115,2935,1437,1174,278,21,3,2913,22,1180,49.330587023686924,40.30209406110539,9.543426021283901,0.7209062821833162,0.10298661174047373
73,세종특별자치시,세종특별자치시,고운동,고운동제3투,2076,1437,695,609,110,14,1,1429,8,639,48.635409377186846,42.61721483554933,7.697690692792163,0.979706088173548,0.06997900629811056
74,세종특별자치시,세종특별자치시,고운동,고운동제4투,2926,2173,1142,808,180,33,0,2163,10,753,52.79704114655571,37.35552473416551,8.321775312066574,1.5256588072122053,0.0
75,세종특별자치시,세종특별자치시,고운동,고운동제5투,2596,1830,869,793,139,19,0,1820,10,766,47.74725274725275,43.57142857142857,7.637362637362638,1.0439560439560438,0.0
76,세종특별자치시,세종특별자치시,보람동,관내사전투표,5442,5442,3812,983,535,69,3,5402,40,0,70.56645686782673,18.196964087375044,9.90373935579415,1.277304701962236,0.05553498704183636
77,세종특별자치시,세종특별자치시,보람동,보람동제1투,2838,2140,1049,887,175,18,1,2130,10,698,49.24882629107981,41.64319248826291,8.215962441314554,0.8450704225352111,0.046948356807511735
78,세종특별자치시,세종특별자치시,보람동,보람동제2투,2201,1650,717,763,150,11,0,1641,9,551,43.69287020109689,46.496039000609386,9.140767824497258,0.6703229737964655,0.0
79,세종특별자치시,세종특별자치시,보람동,보람동제3투,2886,2152,897,961,239,31,5,2133,19,734,42.05344585091421,45.05391467416784,11.204875761837787,1.4533520862634786,0.23441162681669012
80,세종특별자치시,세종특별자치시,새롬동,관내사전투표,6027,6027,4218,1070,619,69,5,5981,46,0,70.52332385888647,17.889984952349106,10.349439892994482,1.1536532352449422,0.08359806052499581
81,세종특별자치시,세종특별자치시,새롬동,새롬동제1투,1974,1345,540,630,150,17,0,1337,8,629,40.38893044128646,47.12041884816754,11.219147344801796,1.2715033657442034,0.0
82,세종특별자치시,세종특별자치시,새롬동,새롬동제2투,2874,2231,1013,962,224,18,2,2219,12,643,45.65119423163587,43.35286164939161,10.094637223974763,0.811176205497972,0.09013068949977468
83,세종특별자치시,세종특별자치시,새롬동,새롬동제3투,2964,2273,1111,919,192,31,3,2256,17,691,49.24645390070922,40.73581560283688,8.51063829787234,1.374113475177305,0.13297872340425532
84,세종특별자치시,세종특별자치시,새롬동,새롬동제4투,2784,2039,948,827,206,37,4,2022,17,745,46.88427299703264,40.90009891196835,10.187932739861523,1.8298714144411472,0.19782393669634024
85,세종특별자치시,세종특별자치시,대평동,관내사전투표,3121,3121,2179,607,290,33,1,3110,11,0,70.06430868167203,19.517684887459808,9.32475884244373,1.0610932475884245,0.03215434083601286
86,세종특별자치시,세종특별자치시,대평동,대평동제1투,2387,1773,747,808,187,17,2,1761,12,614,42.4190800681431,45.88302101078933,10.618966496308916,0.9653605905735378,0.1135718341851221
87,세종특별자치시,세종특별자치시,대평동,대평동제2투,2415,1672,705,785,152,15,1,1658,14,743,42.5211097708082,47.34620024125452,9.16767189384801,0.9047044632086853,0.060313630880579006
88,세종특별자치시,세종특별자치시,소담동,관내사전투표,5877,5877,4146,1076,547,69,1,5839,38,0,71.00530912827539,18.427812981674943,9.368042473026202,1.1817091967802706,0.017126220243192325
89,세종특별자치시,세종특별자치시,소담동,소담동제1투,2025,1564,741,650,137,21,2,1551,13,461,47.77562862669246,41.90844616376531,8.833010960670535,1.3539651837524178,0.1289490651192779
90,세종특별자치시,세종특별자치시,소담동,소담동제2투,2402,1808,857,737,187,20,0,1801,7,594,47.58467518045531,40.92171016102166,10.383120488617434,1.1104941699056081,0.0
91,세종특별자치시,세종특별자치시,소담동,소담동제3투,2259,1656,739,708,179,17,1,1644,12,603,44.95133819951338,43.06569343065693,10.888077858880779,1.0340632603406326,0.06082725060827251
92,세종특별자치시,세종특별자치시,소담동,소담동제4투,2080,1491,637,675,145,21,1,1479,12,589,43.069641649763355,45.63894523326572,9.803921568627452,1.4198782961460445,0.0676132521974307
93,세종특별자치시,세종특별자치시,다정동,관내사전투표,6230,6230,4354,1168,592,82,3,6199,31,0,70.2371350217777,18.841748669140184,9.549927407646393,1.3227939990321018,0.048394902403613486
94,세종특별자치시,세종특별자치시,다정동,다정동제1투,2889,2254,1075,879,236,41,1,2232,22,635,48.16308243727598,39.38172043010753,10.57347670250896,1.8369175627240144,0.044802867383512544
95,세종특별자치시,세종특별자치시,다정동,다정동제2투,2749,1895,822,814,210,32,2,1880,15,854,43.723404255319146,43.29787234042553,11.170212765957446,1.702127659574468,0.10638297872340426
96,세종특별자치시,세종특별자치시,다정동,다정동제3투,3223,2446,1132,1042,232,28,2,2436,10,777,46.4696223316913,42.77504105090312,9.523809523809524,1.1494252873563218,0.08210180623973727
97,세종특별자치시,세종특별자치시,다정동,다정동제4투,2643,1903,756,927,183,22,1,1889,14,740,40.02117522498676,49.07358390682901,9.68766543144521,1.1646373742721017,0.05293806246691372
98,세종특별자치시,세종특별자치시,해밀동,관내사전투표,4192,4192,3040,676,408,44,2,4170,22,0,72.90167865707434,16.211031175059954,9.784172661870503,1.0551558752997603,0.047961630695443645
99,세종특별자치시,세종특별자치시,해밀동,해밀동제1투,3624,2643,1302,984,288,45,3,2622,21,981,49.65675057208238,37.52860411899314,10.983981693363845,1.7162471395881007,0.11441647597254005
100,세종특별자치시,세종특별자치시,해밀동,해밀동제2투,2860,2217,1194,755,226,26,2,2203,14,643,54.19881979119383,34.27144802541988,10.258738084430322,1.1802088061734,0.09078529278256922
101,세종특별자치시,세종특별자치시,해밀동,해밀동제3투,2536,1902,983,660,220,27,3,1893,9,634,51.92815636555732,34.86529318541997,11.62176439513999,1.4263074484944533,0.15847860538827258
102,세종특별자치시,세종특별자치시,반곡동,관내사전투표,5663,5663,3993,964,593,75,3,5628,35,0,70.94882729211088,17.12864250177683,10.536602700781806,1.3326226012793176,0.053304904051172705
103,세종특별자치시,세종특별자치시,반곡동,반곡동제1투,3209,2386,1133,933,256,39,1,2362,24,823,47.96782387806943,39.5004233700254,10.838272650296359,1.651143099068586,0.04233700254022015
104,세종특별자치시,세종특별자치시,반곡동,반곡동제2투,2964,1968,830,828,254,31,1,1944,24,996,42.69547325102881,42.592592592592595,13.065843621399175,1.594650205761317,0.051440329218107
105,세종특별자치시,세종특별자치시,반곡동,반곡동제3투,2962,2326,1266,763,257,25,2,2313,13,636,54.73411154345007,32.987462170341544,11.11111111111111,1.0808473843493298,0.08646779074794639
106,세종특별자치시,세종특별자치시,반곡동,반곡동제4투,2910,2226,1068,778,319,39,5,2209,17,684,48.34766862833861,35.21955636034404,14.440923494794026,1.765504753282028,0.22634676324128564
107,세종특별자치시,세종특별자치시,어진동,관내사전투표,3843,3843,2522,728,484,64,6,3804,39,0,66.29863301787591,19.137749737118824,12.723449001051526,1.6824395373291272,0.15772870662460567
108,세종특별자치시,세종특별자치시,어진동,어진동제1투,1983,1528,662,620,179,47,1,1509,19,455,43.870112657389,41.086812458581846,11.862160371106693,3.1146454605699136,0.06626905235255136
109,세종특별자치시,세종특별자치시,어진동,어진동제2투,2711,1945,845,785,260,37,1,1928,17,766,43.82780082987552,40.71576763485477,13.485477178423237,1.9190871369294606,0.05186721991701245
110,세종특별자치시,세종특별자치시,나성동,관내사전투표,4072,4072,2792,695,482,66,6,4041,31,0,69.09180895817867,17.198713189804504,11.927740658252908,1.6332590942835932,0.14847809948032664
111,세종특별자치시,세종특별자치시,나성동,나성동제1투,2592,1875,831,779,226,24,1,1861,14,717,44.6534121440086,41.85921547555078,12.144008597528211,1.2896292315959161,0.05373455131649651
112,세종특별자치시,세종특별자치시,나성동,나성동제2투,2558,1728,783,711,193,32,3,1722,6,830,45.47038327526132,41.289198606271775,11.207897793263646,1.8583042973286876,0.17421602787456447
113,세종특별자치시,세종특별자치시,잘못 투입·구분된 투표지,,0,1,0,1,0,0,0,1,0,-1,0.0,100.0,0.0,0.0,0.0
0,경기도,수원시장안구,거소·선상투표,,523,501,201,179,78,8,3,469,32,22,42.857142857142854,38.16631130063966,16.631130063965884,1.7057569296375266,0.6396588486140725
1,경기도,수원시장안구,관외사전투표,,25721,25715,15406,5984,3740,299,37,25466,249,6,60.49634807193905,23.49799732977303,14.686248331108146,1.1741145056153302,0.14529176156443885
2,경기도,수원시장안구,재외투표,,1373,1162,799,211,124,20,1,1155,7,211,69.17748917748918,18.26839826839827,10.735930735930737,1.7316017316017316,0.08658008658008658
3,경기도,수원시장안구,파장동,관내사전투표,4841,4841,3284,1198,288,38,4,4812,29,0,68.24605153782211,24.89609310058188,5.985037406483791,0.7896924355777223,0.0831255195344971
4,경기도,수원시장안구,파장동,파장동제1투,2778,1667,654,872,108,20,3,1657,10,1111,39.46891973445987,52.62522631261316,6.517803258901629,1.2070006035003018,0.18105009052504525
5,경기도,수원시장안구,파장동,파장동제2투,2423,1489,578,776,115,9,0,1478,11,934,39.106901217861974,52.503382949932345,7.7807848443843035,0.6089309878213802,0.0
6,경기도,수원시장안구,파장동,파장동제3투,2200,1769,816,723,194,22,1,1756,13,431,46.46924829157175,41.17312072892938,11.047835990888382,1.2528473804100226,0.05694760820045558
7,경기도,수원시장안구,파장동,파장동제4투,1961,1243,487,627,114,8,1,1237,6,718,39.369442198868235,50.687146321746155,9.21584478577203,0.6467259498787389,0.08084074373484236
8,경기도,수원시장안구,파장동,파장동제5투,1680,995,358,552,69,4,5,988,7,685,36.23481781376518,55.87044534412956,6.983805668016195,0.4048582995951417,0.5060728744939271
9,경기도,수원시장안구,파장동,파장동제6투,2075,1715,768,758,156,23,3,1708,7,360,44.96487119437939,44.37939110070258,9.133489461358314,1.3466042154566744,0.1756440281030445
10,경기도,수원시장안구,파장동,파장동제7투,1919,1634,758,686,159,22,2,1627,7,285,46.58881376767056,42.16349108789183,9.77258758451137,1.352181929932391,0.1229256299938537
11,경기도,수원시장안구,율천동,관내사전투표,8405,8405,4974,1708,1549,88,4,8323,82,0,59.762105010212665,20.521446593776282,18.611077736393128,1.0573110657214946,0.04805959389643157
12,경기도,수원시장안구,율천동,율천동제1투,2633,1860,549,932,340,18,0,1839,21,773,29.853181076672104,50.67971723762915,18.488308863512778,0.9787928221859705,0.0
13,경기도,수원시장안구,율천동,율천동제2투,2600,1716,596,844,240,19,3,1702,14,884,35.01762632197415,49.588719153936545,14.101057579318448,1.1163337250293772,0.17626321974148063
14,경기도,수원시장안구,율천동,율천동제3투,2336,1887,825,739,299,12,1,1876,11,449,43.97654584221748,39.39232409381663,15.93816631130064,0.6396588486140725,0.053304904051172705
15,경기도,수원시장안구,율천동,율천동제4투,2752,2180,1105,844,187,31,3,2170,10,572,50.92165898617511,38.894009216589865,8.617511520737327,1.4285714285714286,0.1382488479262673
16,경기도,수원시장안구,율천동,율천동제5투,2103,1514,540,753,202,7,0,1502,12,589,35.95206391478029,50.13315579227696,13.448735019973368,0.4660452729693742,0.0
17,경기도,수원시장안구,율천동,율천동제6투,2446,1782,812,774,166,16,2,1770,12,664,45.87570621468927,43.728813559322035,9.378531073446329,0.903954802259887,0.11299435028248588
18,경기도,수원시장안구,율천동,율천동제7투,1943,1478,614,664,177,10,0,1465,13,465,41.911262798634816,45.32423208191126,12.081911262798634,0.6825938566552902,0.0
19,경기도,수원시장안구,율천동,율천동제8투,3568,2831,1266,1181,335,30,3,2815,16,737,44.97335701598579,41.95381882770871,11.900532859680284,1.0657193605683837,0.10657193605683836
20,경기도,수원시장안구,율천동,율천동제9투,2743,2167,954,933,226,34,2,2149,18,576,44.39274080967892,43.41554211261052,10.516519311307585,1.5821312238250351,0.09306654257794324
21,경기도,수원시장안구,정자1동,관내사전투표,6164,6164,4224,1392,457,41,3,6117,47,0,69.05345757724375,22.75625306522805,7.470982507765244,0.6702632009154814,0.04904364884747425
22,경기도,수원시장안구,정자1동,정자1동제1투,2994,1865,717,971,144,17,0,1849,16,1129,38.77771768523527,52.51487290427258,7.787993510005409,0.9194159004867496,0.0
23,경기도,수원시장안구,정자1동,정자1동제2투,3905,2985,1389,1251,301,21,5,2967,18,920,46.814964610717894,42.163801820020225,10.144927536231885,0.7077856420626896,0.16852039096730706
24,경기도,수원시장안구,정자1동,정자1동제3투,2995,2169,852,1095,175,25,1,2148,21,826,39.66480446927375,50.977653631284916,8.147113594040968,1.1638733705772812,0.04655493482309125
25,경기도,수원시장안구,정자1동,정자1동제4투,2900,2095,869,1074,128,5,1,2077,18,805,41.83919114106885,51.70919595570535,6.162734713529129,0.2407318247472316,0.04814636494944632
26,경기도,수원시장안구,정자1동,정자1동제5투,3124,2570,1224,1030,278,21,2,2555,15,554,47.906066536203525,40.31311154598826,10.880626223091976,0.821917808219178,0.07827788649706457
27,경기도,수원시장안구,정자1동,정자1동제6투,2985,2424,1162,996,223,31,1,2413,11,561,48.15582262743473,41.27641939494405,9.241607956900125,1.28470783257356,0.04144218814753419
28,경기도,수원시장안구,정자2동,관내사전투표,4583,4583,3011,1217,282,42,2,4554,29,0,66.11769872639438,26.723759332454982,6.192358366271409,0.922266139657444,0.04391743522178305
29,경기도,수원시장안구,정자2동,정자2동제1투,1968,1159,435,623,78,13,0,1149,10,809,37.85900783289817,54.22106179286336,6.7885117493472595,1.1314186248912097,0.0
30,경기도,수원시장안구,정자2동,정자2동제2투,2419,1735,688,876,141,18,1,1724,11,684,39.90719257540603,50.81206496519721,8.178654292343387,1.0440835266821344,0.058004640371229696
31,경기도,수원시장안구,정자2동,정자2동제3투,2421,1516,637,738,121,7,1,1504,12,905,42.35372340425532,49.069148936170215,8.045212765957446,0.4654255319148936,0.06648936170212766
32,경기도,수원시장안구,정자2동,정자2동제4투,2368,1553,577,823,120,19,2,1541,12,815,37.44321868916288,53.40687865022713,7.787151200519143,1.2329656067488644,0.12978585334198572
33,경기도,수원시장안구,정자2동,정자2동제5투,2362,1864,838,803,182,21,4,1848,16,498,45.34632034632035,43.452380952380956,9.848484848484848,1.1363636363636365,0.21645021645021645
34,경기도,수원시장안구,정자2동,정자2동제6투,2496,1821,778,826,180,26,3,1813,8,675,42.912300055157196,45.559845559845556,9.928295642581357,1.4340871483728626,0.1654715940430226
35,경기도,수원시장안구,정자2동,정자2동제7투,3659,2898,1311,1195,331,40,2,2879,19,761,45.5366446682876,41.50746787078847,11.49704758596735,1.3893713094824591,0.06946856547412296
36,경기도,수원시장안구,정자2동,정자2동제8투,3800,2987,1375,1249,314,24,3,2965,22,813,46.3743676222597,42.1247892074199,10.590219224283306,0.8094435075885328,0.1011804384485666
37,경기도,수원시장안구,정자3동,관내사전투표,7861,7861,5553,1484,700,74,6,7817,44,0,71.03748241013177,18.984265063323523,8.954842011001663,0.9466547268773187,0.07675578866572855
38,경기도,수원시장안구,정자3동,정자3동제1투,1887,1351,564,635,125,14,0,1338,13,536,42.152466367713004,47.45889387144992,9.342301943198803,1.046337817638266,0.0
39,경기도,수원시장안구,정자3동,정자3동제2투,1930,1526,600,757,132,27,2,1518,8,404,39.52569169960474,49.86824769433465,8.695652173913043,1.7786561264822136,0.13175230566534915
40,경기도,수원시장안구,정자3동,정자3동제3투,2443,1944,987,715,198,26,2,1928,16,499,51.19294605809128,37.0850622406639,10.269709543568464,1.3485477178423237,0.1037344398340249
41,경기도,수원시장안구,정자3동,정자3동제4투,2147,1740,838,683,180,21,2,1724,16,407,48.60788863109048,39.617169373549885,10.440835266821345,1.2180974477958235,0.11600928074245939
42,경기도,수원시장안구,정자3동,정자3동제5투,3216,2622,1245,1037,284,36,0,2602,20,594,47.847809377402,39.853958493466564,10.91468101460415,1.3835511145272867,0.0
43,경기도,수원시장안구,정자3동,정자3동제6투,3283,2666,1294,1059,280,21,0,2654,12,617,48.75659382064808,39.90203466465712,10.550113036925396,0.7912584777694046,0.0
44,경기도,수원시장안구,정자3동,정자3동제7투,1744,1328,610,558,127,18,3,1316,12,416,46.35258358662614,42.401215805471125,9.650455927051672,1.3677811550151975,0.22796352583586624
45,경기도,수원시장안구,정자3동,정자3동제8투,2763,2195,1161,749,233,31,3,2177,18,568,53.33027101515847,34.40514469453376,10.702802021129996,1.423977951309141,0.13780431786862654
46,경기도,수원시장안구,정자3동,정자3동제9투,1808,1334,544,576,184,13,1,1318,16,474,41.274658573596355,43.70257966616085,13.960546282245827,0.9863429438543246,0.07587253414264036
47,경기도,수원시장안구,영화동,관내사전투표,3723,3723,2427,1085,167,28,2,3709,14,0,65.43542733890536,29.25316796980318,4.502561337287679,0.7549204637368563,0.05392289026691831
48,경기도,수원시장안구,영화동,영화동제1투,2021,1068,399,578,72,9,2,1060,8,953,37.64150943396227,54.52830188679245,6.7924528301886795,0.8490566037735849,0.18867924528301888
49,경기도,수원시장안구,영화동,영화동제2투,2231,1290,469,715,84,13,4,1285,5,941,36.49805447470817,55.6420233463035,6.536964980544748,1.0116731517509727,0.311284046692607
50,경기도,수원시장안구,영화동,영화동제3투,2736,1779,669,974,112,14,4,1773,6,957,37.7326565143824,54.93513818386915,6.316976875352511,0.7896221094190639,0.2256063169768754
51,경기도,수원시장안구,영화동,영화동제4투,2141,1413,576,744,66,12,7,1405,8,728,40.99644128113879,52.953736654804274,4.697508896797153,0.8540925266903915,0.498220640569395
52,경기도,수원시장안구,영화동,영화동제5투,2354,1431,613,709,84,11,1,1418,13,923,43.22990126939351,50.0,5.923836389280677,0.7757404795486601,0.07052186177715092
53,경기도,수원시장안구,송죽동,관내사전투표,3892,3892,2516,1011,305,28,3,3863,29,0,65.130727413927,26.171369402019156,7.895418068858401,0.7248252653378203,0.0776598498576236
54,경기도,수원시장안구,송죽동,송죽동제1투,2131,1348,527,695,105,14,2,1343,5,783,39.24050632911392,51.74981384959047,7.81831720029784,1.0424422933730455,0.14892032762472077
55,경기도,수원시장안구,송죽동,송죽동제2투,2225,1506,618,744,119,10,2,1493,13,719,41.393168117883455,49.83255190890824,7.970529135967849,0.6697923643670463,0.13395847287340923
56,경기도,수원시장안구,송죽동,송죽동제3투,3918,2698,1150,1283,225,23,1,2682,16,1220,42.878448918717375,47.83743475018643,8.389261744966444,0.8575689783743475,0.03728560775540641
57,경기도,수원시장안구,송죽동,송죽동제4투,2333,1421,568,758,86,5,0,1417,4,912,40.08468595624559,53.49329569513056,6.069160197600565,0.35285815102328866,0.0
58,경기도,수원시장안구,조원1동,관내사전투표,4912,4911,3218,1294,326,43,3,4884,27,1,65.88861588861589,26.494676494676494,6.674856674856675,0.8804258804258804,0.06142506142506143
59,경기도,수원시장안구,조원1동,조원1동제1투,2800,1631,627,852,122,14,0,1615,16,1169,38.82352941176471,52.755417956656345,7.554179566563468,0.8668730650154799,0.0
60,경기도,수원시장안구,조원1동,조원1동제2투,2191,1416,584,702,104,10,1,1401,15,775,41.68451106352605,50.107066381156315,7.423269093504639,0.7137758743754461,0.07137758743754462
61,경기도,수원시장안구,조원1동,조원1동제3투,2752,1851,868,796,151,14,2,1831,20,901,47.40578918623703,43.47351174221737,8.246859639541235,0.7646095030038231,0.10922992900054614
62,경기도,수원시장안구,조원1동,조원1동제4투,2295,1554,648,749,133,12,3,1545,9,741,41.94174757281554,48.4789644012945,8.608414239482201,0.7766990291262136,0.1941747572815534
63,경기도,수원시장안구,조원1동,조원1동제5투,2434,1714,575,1012,105,13,0,1705,9,720,33.724340175953074,59.354838709677416,6.158357771260997,0.7624633431085044,0.0
64,경기도,수원시장안구,조원1동,조원1동제6투,1745,1288,499,644,122,12,1,1278,10,457,39.045383411580595,50.39123630672926,9.546165884194053,0.9389671361502347,0.0782472613458529
65,경기도,수원시장안구,조원1동,조원1동제7투,2351,1780,706,909,136,19,1,1771,9,571,39.86448334274421,51.32693393562959,7.679277244494635,1.0728402032749857,0.0564652738565782
66,경기도,수원시장안구,조원2동,관내사전투표,5131,5131,3266,1403,392,45,5,5111,20,0,63.901389160633926,27.45059675210331,7.6697319506945805,0.8804539229113676,0.09782821365681862
67,경기도,수원시장안구,조원2동,조원2동제1투,2668,2011,676,1132,172,16,4,2000,11,657,33.800000000000004,56.599999999999994,8.6,0.8,0.2
68,경기도,수원시장안구,조원2동,조원2동제2투,2272,1735,572,985,145,16,2,1720,15,537,33.25581395348837,57.26744186046512,8.430232558139535,0.9302325581395349,0.11627906976744186
69,경기도,수원시장안구,조원2동,조원2동제3투,2236,1694,652,845,167,17,3,1684,10,542,38.71733966745843,50.178147268408544,9.91686460807601,1.009501187648456,0.17814726840855108
70,경기도,수원시장안구,조원2동,조원2동제4투,1916,1445,473,811,138,10,3,1435,10,471,32.9616724738676,56.51567944250871,9.616724738675957,0.6968641114982579,0.20905923344947736
71,경기도,수원시장안구,연무동,관내사전투표,2765,2765,1727,783,221,16,3,2750,15,0,62.8,28.472727272727273,8.036363636363635,0.5818181818181818,0.1090909090909091
72,경기도,수원시장안구,연무동,연무동제1투,1037,572,204,332,31,2,1,570,2,465,35.78947368421053,58.245614035087726,5.43859649122807,0.3508771929824561,0.17543859649122806
73,경기도,수원시장안구,연무동,연무동제2투,1667,1059,367,600,74,8,1,1050,9,608,34.95238095238095,57.14285714285714,7.0476190476190474,0.7619047619047619,0.09523809523809523
74,경기도,수원시장안구,연무동,연무동제3투,1995,1355,447,776,114,9,1,1347,8,640,33.18485523385301,57.609502598366745,8.463251670378618,0.6681514476614699,0.07423904974016332
75,경기도,수원시장안구,연무동,연무동제4투,2325,1503,552,802,124,13,2,1493,10,822,36.97253851306095,53.717347622237114,8.305425318151373,0.8707300736771602,0.13395847287340923
76,경기도,수원시장안구,연무동,연무동제5투,2731,1844,605,1024,175,20,3,1827,17,887,33.1143951833607,56.048166392993984,9.578544061302683,1.0946907498631637,0.16420361247947454
77,경기도,수원시장안구,연무동,연무동제6투,1713,1414,563,684,143,11,3,1404,10,299,40.0997150997151,48.717948717948715,10.185185185185185,0.7834757834757835,0.2136752136752137
78,경기도,수원시장안구,잘못 투입·구분된 투표지,,0,0,0,0,0,0,0,0,0,0,0.0,0.0,0.0,0.0,0.0
0,경기도,수원시권선구,거소·선상투표,,485,465,211,136,84,5,4,440,25,20,47.95454545454545,30.909090909090907,19.090909090909093,1.1363636363636365,0.9090909090909091
1,경기도,수원시권선구,관외사전투표,,35093,35088,21414,8145,4774,357,40,34730,358,5,61.65850849409732,23.452346674344945,13.74604088684135,1.0279297437374026,0.1151742009789807
2,경기도,수원시권선구,재외투표,,1508,1208,849,216,118,15,1,1199,9,300,70.80900750625521,18.015012510425354,9.841534612176813,1.2510425354462051,0.08340283569641367
3,경기도,수원시권선구,세류1동,관내사전투표,2442,2442,1540,644,221,20,1,2426,16,0,63.478977741137676,26.54575432811212,9.10964550700742,0.8244023083264632,0.041220115416323165
4,경기도,수원시권선구,세류1동,세류1동제1투,1439,1114,432,557,110,4,0,1103,11,325,39.16591115140526,50.49864007252947,9.972801450589303,0.3626473254759746,0.0
5,경기도,수원시권선구,세류1동,세류1동제2투,1911,1211,461,596,114,17,4,1192,19,700,38.6744966442953,50.0,9.563758389261745,1.4261744966442953,0.33557046979865773
6,경기도,수원시권선구,세류1동,세류1동제3투,2258,1684,665,825,162,16,2,1670,14,574,39.82035928143712,49.40119760479042,9.70059880239521,0.9580838323353293,0.11976047904191617
7,경기도,수원시권선구,세류2동,관내사전투표,3509,3509,2286,936,237,30,3,3492,17,0,65.4639175257732,26.804123711340207,6.786941580756014,0.859106529209622,0.0859106529209622
8,경기도,수원시권선구,세류2동,세류2동제1투,2513,1414,544,736,105,17,2,1404,10,1099,38.74643874643874,52.42165242165242,7.478632478632479,1.2108262108262107,0.14245014245014245
9,경기도,수원시권선구,세류2동,세류2동제2투,2111,1402,556,713,109,13,0,1391,11,709,39.97124370956146,51.25808770668584,7.8360891445003595,0.9345794392523363,0.0
10,경기도,수원시권선구,세류2동,세류2동제3투,2465,1364,524,673,136,14,2,1349,15,1101,38.84358784284655,49.88880652335063,10.081541882876206,1.0378057820607858,0.14825796886582654
11,경기도,수원시권선구,세류2동,세류2동제4투,2803,1623,696,780,117,18,1,1612,11,1180,43.17617866004963,48.38709677419355,7.258064516129033,1.1166253101736971,0.062034739454094295
12,경기도,수원시권선구,세류2동,세류2동제5투,2605,1646,661,819,129,17,2,1628,18,959,40.6019656019656,50.30712530712531,7.923832923832924,1.0442260442260443,0.12285012285012285
13,경기도,수원시권선구,세류2동,세류2동제6투,2227,1413,571,674,145,12,3,1405,8,814,40.64056939501779,47.97153024911032,10.320284697508896,0.8540925266903915,0.21352313167259787
14,경기도,수원시권선구,세류3동,관내사전투표,3423,3423,2192,982,206,26,1,3407,16,0,64.33812738479601,28.82301144702084,6.046375110067508,0.7631347226298797,0.0293513354857646
15,경기도,수원시권선구,세류3동,세류3동제1투,2891,1779,662,987,108,12,1,1770,9,1112,37.40112994350282,55.762711864406775,6.101694915254238,0.6779661016949152,0.05649717514124294
16,경기도,수원시권선구,세류3동,세류3동제2투,2229,1253,536,602,91,12,3,1244,9,976,43.08681672025724,48.39228295819936,7.315112540192927,0.964630225080386,0.2411575562700965
17,경기도,수원시권선구,세류3동,세류3동제3투,2844,1811,774,867,132,21,3,1797,14,1033,43.07178631051753,48.24707846410685,7.345575959933222,1.1686143572621035,0.1669449081803005
18,경기도,수원시권선구,세류3동,세류3동제4투,3058,1680,688,844,116,16,2,1666,14,1378,41.29651860744298,50.66026410564226,6.962785114045618,0.9603841536614646,0.12004801920768307
19,경기도,수원시권선구,평동,관내사전투표,5765,5765,3816,1365,489,51,3,5724,41,0,66.66666666666666,23.846960167714883,8.542976939203355,0.890985324947589,0.052410901467505246
20,경기도,수원시권선구,평동,평동제1투,1558,982,319,561,89,6,1,976,6,576,32.6844262295082,57.479508196721305,9.118852459016393,0.6147540983606558,0.10245901639344263
21,경기도,수원시권선구,평동,평동제2투,4011,2604,982,1325,254,26,2,2589,15,1407,37.929702587871766,51.178061027423716,9.81073773657783,1.004248744689069,0.0772499034376207
22,경기도,수원시권선구,평동,평동제3투,2270,1487,667,648,156,5,0,1476,11,783,45.18970189701897,43.90243902439025,10.569105691056912,0.33875338753387535,0.0
23,경기도,수원시권선구,평동,평동제4투,3415,2408,1027,1056,266,35,3,2387,21,1007,43.02471721826561,44.23963133640553,11.143695014662756,1.466275659824047,0.12568077084206117
24,경기도,수원시권선구,평동,평동제5투,3391,2337,1106,1025,163,23,1,2318,19,1054,47.713546160483176,44.21915444348576,7.031924072476273,0.992234685073339,0.04314063848144953
25,경기도,수원시권선구,평동,평동제6투,2632,1965,824,933,169,21,0,1947,18,667,42.321520287621986,47.919876733436055,8.680020544427324,1.078582434514638,0.0
26,경기도,수원시권선구,평동,평동제7투,3168,2449,1174,1049,191,20,2,2436,13,719,48.19376026272578,43.0623973727422,7.8407224958949095,0.8210180623973727,0.08210180623973727
27,경기도,수원시권선구,평동,평동제8투,3927,2941,1393,1277,236,13,3,2922,19,986,47.672826830937716,43.70294318959617,8.076659822039698,0.44490075290896647,0.10266940451745381
28,경기도,수원시권선구,평동,평동제9투,1472,1254,627,444,150,15,2,1238,16,218,50.64620355411955,35.864297253634895,12.116316639741518,1.2116316639741518,0.16155088852988692
29,경기도,수원시권선구,서둔동,관내사전투표,4602,4602,3177,1081,278,40,2,4578,24,0,69.39711664482306,23.61293141109655,6.072520751419834,0.873743993010048,0.043687199650502405
30,경기도,수원시권선구,서둔동,서둔동제1투,2213,1461,583,738,110,15,3,1449,12,752,40.23464458247067,50.931677018633536,7.59144237405107,1.0351966873706004,0.2070393374741201
31,경기도,수원시권선구,서둔동,서둔동제2투,1630,1080,459,527,78,9,1,1074,6,550,42.737430167597765,49.068901303538176,7.262569832402235,0.8379888268156425,0.0931098696461825
32,경기도,수원시권선구,서둔동,서둔동제3투,3279,2138,867,1039,193,21,1,2121,17,1141,40.87694483734088,48.986327204148985,9.0994813767091,0.9900990099009901,0.04714757190004715
33,경기도,수원시권선구,서둔동,서둔동제4투,1702,1027,400,522,81,9,1,1013,14,675,39.486673247778874,51.53010858835143,7.996051332675222,0.8884501480750246,0.09871668311944717
34,경기도,수원시권선구,서둔동,서둔동제5투,2836,1844,773,888,150,14,3,1828,16,992,42.286652078774615,48.57768052516411,8.205689277899344,0.7658643326039387,0.16411378555798686
35,경기도,수원시권선구,서둔동,서둔동제6투,3221,2140,970,994,144,15,3,2126,14,1081,45.62558795860772,46.75446848541863,6.773283160865475,0.7055503292568204,0.14111006585136407
36,경기도,수원시권선구,서둔동,서둔동제7투,2558,1996,785,893,267,28,2,1975,21,562,39.74683544303797,45.21518987341772,13.518987341772151,1.4177215189873418,0.10126582278481014
37,경기도,수원시권선구,서둔동,서둔동제8투,3215,2013,933,883,167,17,2,2002,11,1202,46.603396603396604,44.10589410589411,8.341658341658341,0.8491508491508492,0.0999000999000999
38,경기도,수원시권선구,서둔동,서둔동제9투,3444,2062,967,865,180,23,1,2036,26,1382,47.4950884086444,42.4852652259332,8.840864440078585,1.1296660117878194,0.04911591355599214
39,경기도,수원시권선구,구운동,관내사전투표,4304,4304,2896,1044,303,38,4,4285,19,0,67.58459743290548,24.364060676779463,7.07117852975496,0.8868144690781797,0.09334889148191365
40,경기도,수원시권선구,구운동,구운동제1투,1996,1244,514,572,133,13,4,1236,8,752,41.58576051779935,46.27831715210356,10.760517799352751,1.051779935275081,0.3236245954692557
41,경기도,수원시권선구,구운동,구운동제2투,2540,1942,718,1034,166,14,3,1935,7,598,37.10594315245478,53.43669250645995,8.578811369509044,0.7235142118863048,0.15503875968992248
42,경기도,수원시권선구,구운동,구운동제3투,1855,1243,447,681,87,12,0,1227,16,612,36.43031784841076,55.501222493887525,7.090464547677261,0.9779951100244498,0.0
43,경기도,수원시권선구,구운동,구운동제4투,2593,1836,762,886,146,26,0,1820,16,757,41.86813186813187,48.68131868131868,8.021978021978022,1.4285714285714286,0.0
44,경기도,수원시권선구,구운동,구운동제5투,2648,2074,900,959,177,22,0,2058,16,574,43.731778425655975,46.59863945578231,8.60058309037901,1.0689990281827018,0.0
45,경기도,수원시권선구,구운동,구운동제6투,2182,1214,498,620,78,8,4,1208,6,968,41.22516556291391,51.324503311258276,6.456953642384105,0.6622516556291391,0.33112582781456956
46,경기도,수원시권선구,금곡동,관내사전투표,8543,8543,5966,1734,706,69,3,8478,65,0,70.37037037037037,20.45293701344657,8.327435715970747,0.813871196036801,0.035385704175513094
47,경기도,수원시권선구,금곡동,금곡동제1투,3663,2332,963,1101,218,22,3,2307,25,1331,41.74252275682705,47.724317295188555,9.449501517121803,0.953619419159081,0.13003901170351106
48,경기도,수원시권선구,금곡동,금곡동제2투,2369,1856,836,791,198,22,0,1847,9,513,45.26258798050893,42.82620465619924,10.720086626962642,1.1911207363291825,0.0
49,경기도,수원시권선구,금곡동,금곡동제3투,3851,2579,1096,1185,252,27,1,2561,18,1272,42.79578289730574,46.27098789535338,9.839906286606794,1.0542756735650136,0.03904724716907458
50,경기도,수원시권선구,금곡동,금곡동제4투,2555,1951,836,914,167,25,1,1943,8,604,43.02624806999486,47.040658775090066,8.594956253216674,1.2866700977869274,0.0514668039114771
51,경기도,수원시권선구,금곡동,금곡동제5투,2812,2174,964,986,178,25,5,2158,16,638,44.670991658943464,45.69045412418906,8.2483781278962,1.1584800741427248,0.23169601482854493
52,경기도,수원시권선구,금곡동,금곡동제6투,2536,1772,797,785,159,18,1,1760,12,764,45.28409090909091,44.60227272727273,9.03409090909091,1.0227272727272727,0.056818181818181816
53,경기도,수원시권선구,금곡동,금곡동제7투,2327,1842,996,652,159,22,2,1831,11,485,54.39650464227198,35.60895685417804,8.68377935554342,1.2015292190060076,0.10922992900054614
54,경기도,수원시권선구,금곡동,금곡동제8투,2319,1664,775,761,106,16,1,1659,5,655,46.71488848704038,45.8710066305003,6.389391199517782,0.9644364074743821,0.06027727546714888
55,경기도,수원시권선구,금곡동,금곡동제9투,2448,1969,985,767,184,22,2,1960,9,479,50.255102040816325,39.13265306122449,9.387755102040817,1.1224489795918366,0.10204081632653061
56,경기도,수원시권선구,호매실동,관내사전투표,9039,9039,6549,1749,621,82,0,9001,38,0,72.75858237973559,19.431174313965116,6.899233418509054,0.9110098877902456,0.0
57,경기도,수원시권선구,호매실동,호매실동제1투,2427,1582,624,807,130,11,2,1574,8,845,39.64421855146124,51.27064803049556,8.259212198221093,0.6988564167725541,0.12706480304955528
58,경기도,수원시권선구,호매실동,호매실동제2투,2348,1715,752,786,149,17,2,1706,9,633,44.07971864009379,46.07268464243845,8.73388042203986,0.996483001172333,0.11723329425556857
59,경기도,수원시권선구,호매실동,호매실동제3투,2037,1410,753,521,113,14,2,1403,7,627,53.67070563079116,37.13471133285816,8.05416963649323,0.9978617248752674,0.14255167498218105
60,경기도,수원시권선구,호매실동,호매실동제4투,2721,1744,774,783,163,13,0,1733,11,977,44.66243508366994,45.18176572417772,9.405654933641085,0.7501442585112521,0.0
61,경기도,수원시권선구,호매실동,호매실동제5투,3397,2440,1255,966,180,22,1,2424,16,957,51.773927392739274,39.851485148514854,7.425742574257425,0.9075907590759077,0.041254125412541254
62,경기도,수원시권선구,호매실동,호매실동제6투,2982,2125,1081,812,200,19,1,2113,12,857,51.15948887837198,38.4287742546143,9.46521533364884,0.8991954566966399,0.047326076668244205
63,경기도,수원시권선구,호매실동,호매실동제7투,3867,2718,1324,1092,260,22,1,2699,19,1149,49.055205631715445,40.45942941830308,9.633197480548352,0.8151167098925528,0.037050759540570584
64,경기도,수원시권선구,호매실동,호매실동제8투,1925,1480,761,565,133,18,0,1477,3,445,51.52335815842925,38.25321597833446,9.004739336492891,1.2186865267433988,0.0
65,경기도,수원시권선구,권선1동,관내사전투표,3493,3493,2252,837,346,32,6,3473,20,0,64.84307515116615,24.100201554851715,9.962568384681832,0.9213936078318457,0.17276130146847107
66,경기도,수원시권선구,권선1동,권선1동제1투,2139,1519,531,829,135,10,1,1506,13,620,35.2589641434263,55.046480743691895,8.964143426294822,0.6640106241699867,0.06640106241699867
67,경기도,수원시권선구,권선1동,권선1동제2투,3365,2003,695,1009,268,18,3,1993,10,1362,34.87205218263924,50.62719518314099,13.447064726542902,0.9031610637230305,0.15052684395383845
68,경기도,수원시권선구,권선1동,권선1동제3투,3564,2041,682,1083,251,14,1,2031,10,1523,33.57951747907435,53.32348596750369,12.358444116198916,0.6893156080748399,0.04923682914820286
69,경기도,수원시권선구,권선1동,권선1동제4투,2227,1317,510,678,104,14,1,1307,10,910,39.02065799540934,51.87452180566182,7.957153787299158,1.0711553175210407,0.07651109410864575
70,경기도,수원시권선구,권선1동,권선1동제5투,2110,1277,542,599,108,8,3,1260,17,833,43.01587301587302,47.53968253968254,8.571428571428571,0.6349206349206349,0.2380952380952381
71,경기도,수원시권선구,권선1동,권선1동제6투,2164,1666,712,747,182,16,0,1657,9,498,42.96922148461074,45.08147254073627,10.983705491852746,0.9656004828002415,0.0
72,경기도,수원시권선구,권선2동,관내사전투표,7258,7258,4735,1807,587,80,3,7212,46,0,65.65446478092069,25.055463117027177,8.139212423738213,1.1092623405435387,0.04159733777038269
73,경기도,수원시권선구,권선2동,권선2동제1투,2135,1555,494,909,116,23,1,1543,12,580,32.01555411535969,58.91121192482177,7.517822423849643,1.4906027219701878,0.06480881399870382
74,경기도,수원시권선구,권선2동,권선2동제2투,2683,2087,754,1094,194,25,1,2068,19,596,36.46034816247582,52.90135396518375,9.381044487427467,1.2088974854932302,0.04835589941972921
75,경기도,수원시권선구,권선2동,권선2동제3투,1731,1289,499,665,106,12,1,1283,6,442,38.89321901792673,51.831644583008575,8.261886204208885,0.9353078721745909,0.0779423226812159
76,경기도,수원시권선구,권선2동,권선2동제4투,1751,1178,477,583,95,10,1,1166,12,573,40.909090909090914,50.0,8.147512864493997,0.8576329331046313,0.08576329331046312
77,경기도,수원시권선구,권선2동,권선2동제5투,1916,1422,599,670,128,10,2,1409,13,494,42.51242015613911,47.55145493257629,9.084457061745919,0.7097232079488999,0.14194464158977999
78,경기도,수원시권선구,권선2동,권선2동제6투,2294,1678,663,764,206,22,3,1658,20,616,39.98793727382389,46.07961399276236,12.424607961399277,1.3268998793727382,0.18094089264173704
79,경기도,수원시권선구,권선2동,권선2동제7투,2863,2231,932,1076,191,21,0,2220,11,632,41.98198198198198,48.468468468468465,8.603603603603602,0.945945945945946,0.0
80,경기도,수원시권선구,권선2동,권선2동제8투,2869,2236,882,1097,221,23,1,2224,12,633,39.65827338129496,49.32553956834532,9.93705035971223,1.0341726618705036,0.04496402877697842
81,경기도,수원시권선구,권선2동,권선2동제9투,2790,2244,1009,1005,190,18,3,2225,19,546,45.348314606741575,45.1685393258427,8.539325842696629,0.8089887640449439,0.1348314606741573
82,경기도,수원시권선구,권선2동,권선2동제10투,2247,1793,889,703,178,15,5,1790,3,454,49.66480446927374,39.273743016759774,9.944134078212292,0.8379888268156425,0.27932960893854747
83,경기도,수원시권선구,권선2동,권선2동제11투,2605,2063,952,876,203,18,0,2049,14,542,46.46168862859932,42.75256222547584,9.907271839921913,0.8784773060029283,0.0
84,경기도,수원시권선구,곡선동,관내사전투표,5785,5785,4020,1202,483,40,6,5751,34,0,69.90088680229525,20.90071291949226,8.398539384454876,0.6955312119631368,0.10432968179447052
85,경기도,수원시권선구,곡선동,곡선동제1투,1603,1132,502,474,123,16,2,1117,15,471,44.941808415398384,42.43509400179051,11.011638316920322,1.432408236347359,0.17905102954341987
86,경기도,수원시권선구,곡선동,곡선동제2투,2603,2115,922,958,193,21,4,2098,17,488,43.94661582459485,45.66253574833175,9.199237368922782,1.0009532888465205,0.19065776930409914
87,경기도,수원시권선구,곡선동,곡선동제3투,2081,990,434,443,93,10,0,980,10,1091,44.285714285714285,45.20408163265306,9.489795918367347,1.0204081632653061,0.0
88,경기도,수원시권선구,곡선동,곡선동제4투,2497,1945,904,801,195,21,3,1924,21,552,46.98544698544699,41.63201663201663,10.135135135135135,1.0914760914760915,0.15592515592515593
89,경기도,수원시권선구,곡선동,곡선동제5투,2813,1236,456,579,179,8,0,1222,14,1577,37.315875613747956,47.38134206219313,14.648117839607202,0.6546644844517185,0.0
90,경기도,수원시권선구,곡선동,곡선동제6투,2832,1212,500,551,138,13,2,1204,8,1620,41.52823920265781,45.7641196013289,11.461794019933555,1.0797342192691028,0.16611295681063123
91,경기도,수원시권선구,곡선동,곡선동제7투,2137,1577,565,831,154,16,2,1568,9,560,36.03316326530612,52.99744897959183,9.821428571428571,1.0204081632653061,0.12755102040816327
92,경기도,수원시권선구,곡선동,곡선동제8투,2115,1721,756,728,209,18,0,1711,10,394,44.18468731735827,42.548217416715374,12.215078901227352,1.0520163646990064,0.0
93,경기도,수원시권선구,곡선동,곡선동제9투,2684,2162,967,922,228,29,1,2147,15,522,45.03959012575687,42.94364229156963,10.619469026548673,1.3507219375873312,0.04657661853749418
94,경기도,수원시권선구,입북동,관내사전투표,2827,2827,2050,558,179,24,2,2813,14,0,72.8759331674369,19.83647351581941,6.363313188766441,0.8531816565943833,0.07109847138286526
95,경기도,수원시권선구,입북동,입북동제1투,1890,1384,569,666,129,10,2,1376,8,506,41.35174418604651,48.401162790697676,9.375,0.7267441860465116,0.14534883720930233
96,경기도,수원시권선구,입북동,입북동제2투,4186,3148,1522,1218,343,36,1,3120,28,1038,48.78205128205128,39.03846153846154,10.993589743589743,1.153846153846154,0.03205128205128205
97,경기도,수원시권선구,입북동,입북동제3투,3224,2367,1089,970,256,23,5,2343,24,857,46.478873239436616,41.39991463935126,10.926163038839096,0.9816474605207,0.21340162185232608
98,경기도,수원시권선구,입북동,입북동제4투,2063,1703,811,719,145,16,1,1692,11,360,47.93144208037825,42.494089834515364,8.569739952718676,0.9456264775413712,0.0591016548463357
99,경기도,수원시권선구,잘못 투입·구분된 투표지,,0,0,0,0,0,0,0,0,0,0,0.0,0.0,0.0,0.0,0.0
0,경기도,수원시팔달구,거소·선상투표,,241,220,104,59,42,3,2,210,10,21,49.523809523809526,28.095238095238095,20.0,1.4285714285714286,0.9523809523809524
1,경기도,수원시팔달구,관외사전투표,,19839,19836,11660,4945,2823,210,19,19657,179,3,59.31729155008394,25.156432822912954,14.361296230350511,1.068321717454342,0.09665767919825
2,경기도,수원시팔달구,재외투표,,998,820,567,158,82,9,0,816,4,178,69.48529411764706,19.362745098039216,10.049019607843137,1.1029411764705883,0.0
3,경기도,수원시팔달구,행궁동,관내사전투표,2296,2296,1424,677,160,20,3,2284,12,0,62.34676007005254,29.640980735551665,7.005253940455342,0.8756567425569177,0.13134851138353765
4,경기도,수원시팔달구,행궁동,행궁동제1투,1851,1102,368,642,72,9,4,1095,7,749,33.60730593607306,58.63013698630137,6.575342465753424,0.821917808219178,0.365296803652968
5,경기도,수원시팔달구,행궁동,행궁동제2투,1567,1020,372,586,48,6,1,1013,7,547,36.72260612043436,57.84797630799605,4.738400789733465,0.5923000987166831,0.09871668311944717
6,경기도,수원시팔달구,행궁동,행궁동제3투,2416,1232,376,727,109,9,2,1223,9,1184,30.744071954210956,59.443990188062145,8.912510220768603,0.7358953393295176,0.1635322976287817
7,경기도,수원시팔달구,매교동,관내사전투표,3465,3465,2250,898,277,25,2,3452,13,0,65.17960602549246,26.013904982618776,8.02433371958285,0.7242178447276941,0.057937427578215524
8,경기도,수원시팔달구,매교동,매교동제1투,3359,1903,694,970,211,11,1,1887,16,1456,36.77795442501325,51.40434552199258,11.181770005299416,0.5829358770535241,0.052994170641229466
9,경기도,수원시팔달구,매교동,매교동제2투,3528,2834,1133,1249,396,31,5,2814,20,694,40.262970859985785,44.385216773276476,14.072494669509595,1.1016346837242361,0.17768301350390903
10,경기도,수원시팔달구,매교동,매교동제3투,2926,2406,1056,1034,284,15,1,2390,16,520,44.18410041841005,43.26359832635983,11.882845188284518,0.6276150627615062,0.04184100418410042
11,경기도,수원시팔달구,매교동,매교동제4투,2798,2228,958,977,255,24,3,2217,11,570,43.21154713576906,44.06856111862878,11.502029769959405,1.0825439783491204,0.13531799729364005
12,경기도,수원시팔달구,매산동,관내사전투표,1508,1508,966,378,136,15,2,1497,11,0,64.52905811623246,25.250501002004004,9.084836339345358,1.002004008016032,0.13360053440213762
13,경기도,수원시팔달구,매산동,매산동제1투,2971,1374,530,684,134,11,4,1363,11,1597,38.88481291269259,50.183418928833454,9.83125458547322,0.8070432868672046,0.293470286133529
14,경기도,수원시팔달구,매산동,매산동제2투,2580,2022,714,1122,160,12,0,2008,14,558,35.55776892430279,55.87649402390438,7.968127490039841,0.5976095617529881,0.0
15,경기도,수원시팔달구,매산동,매산동제3투,1180,680,257,354,56,5,2,674,6,500,38.13056379821958,52.52225519287834,8.30860534124629,0.741839762611276,0.2967359050445104
16,경기도,수원시팔달구,고등동,관내사전투표,4195,4195,2764,987,363,50,6,4170,25,0,66.28297362110311,23.66906474820144,8.70503597122302,1.1990407673860912,0.14388489208633093
17,경기도,수원시팔달구,고등동,고등동제1투,2767,2040,829,947,223,20,2,2021,19,727,41.01929737753587,46.85799109351806,11.034141514101929,0.9896091044037605,0.09896091044037605
18,경기도,수원시팔달구,고등동,고등동제2투,3273,2400,1044,1023,291,25,6,2389,11,873,43.70029300962746,42.8212641272499,12.180828798660528,1.0464629552113855,0.25115110925073253
19,경기도,수원시팔달구,고등동,고등동제3투,1726,858,293,488,63,4,2,850,8,868,34.470588235294116,57.41176470588235,7.411764705882352,0.4705882352941176,0.2352941176470588
20,경기도,수원시팔달구,고등동,고등동제4투,2663,1619,581,908,108,9,1,1607,12,1044,36.154324828873676,56.502800248911015,6.72059738643435,0.5600497822028625,0.06222775357809583
21,경기도,수원시팔달구,화서1동,관내사전투표,3605,3605,2455,921,192,21,6,3595,10,0,68.2892906815021,25.618915159944365,5.340751043115438,0.5841446453407511,0.16689847009735745
22,경기도,수원시팔달구,화서1동,화서1동제1투,2358,1491,499,846,116,17,3,1481,10,867,33.693450371370695,57.12356515867657,7.832545577312626,1.1478730587440917,0.2025658338960162
23,경기도,수원시팔달구,화서1동,화서1동제2투,2401,1564,580,839,111,12,4,1546,18,837,37.51617076326003,54.269081500646834,7.179818887451487,0.7761966364812419,0.258732212160414
24,경기도,수원시팔달구,화서1동,화서1동제3투,2806,1824,727,931,127,22,4,1811,13,982,40.14356709000552,51.40806184428492,7.012700165654334,1.2147984538928769,0.22087244616234128
25,경기도,수원시팔달구,화서1동,화서1동제4투,1969,1250,458,709,69,7,0,1243,7,719,36.84633950120676,57.03942075623492,5.551086082059534,0.5631536604987932,0.0
26,경기도,수원시팔달구,화서1동,화서1동제5투,3213,2481,1177,1037,210,30,4,2458,23,732,47.88445890968267,42.18877135882831,8.54353132628153,1.2205044751830758,0.16273393002441008
27,경기도,수원시팔달구,화서2동,관내사전투표,4187,4187,2853,912,364,37,3,4169,18,0,68.43367714080115,21.87574958023507,8.731110578076278,0.8875029983209403,0.07195970256656273
28,경기도,수원시팔달구,화서2동,화서2동제1투,1904,1430,545,744,113,15,0,1417,13,474,38.46153846153847,52.50529287226535,7.974594213126323,1.058574453069866,0.0
29,경기도,수원시팔달구,화서2동,화서2동제2투,2076,1530,558,762,187,11,1,1519,11,546,36.734693877551024,50.16458196181699,12.310730743910467,0.7241606319947334,0.06583278472679394
30,경기도,수원시팔달구,화서2동,화서2동제3투,1752,1420,570,658,163,15,1,1407,13,332,40.511727078891255,46.766169154228855,11.584932480454867,1.0660980810234542,0.07107320540156362
31,경기도,수원시팔달구,화서2동,화서2동제4투,2744,2054,874,965,176,24,3,2042,12,690,42.80117531831537,47.25759059745347,8.619000979431929,1.1753183153770812,0.14691478942213515
32,경기도,수원시팔달구,화서2동,화서2동제5투,2298,1745,641,872,193,22,1,1729,16,553,37.07345286292655,50.43377674956623,11.16252168883748,1.2724117987275883,0.057836899942163095
33,경기도,수원시팔달구,화서2동,화서2동제6투,2956,2325,1054,1004,217,36,3,2314,11,631,45.548833189282625,43.38807260155575,9.37770095073466,1.5557476231633534,0.12964563526361278
34,경기도,수원시팔달구,지동,관내사전투표,2355,2355,1460,727,131,11,1,2330,25,0,62.66094420600859,31.201716738197426,5.622317596566524,0.4721030042918455,0.04291845493562232
35,경기도,수원시팔달구,지동,지동제1투,1843,1103,359,668,60,8,2,1097,6,740,32.72561531449407,60.89334548769371,5.469462169553328,0.7292616226071102,0.18231540565177756
36,경기도,수원시팔달구,지동,지동제2투,1446,882,312,487,67,10,2,878,4,564,35.53530751708428,55.466970387243734,7.6309794988610475,1.1389521640091116,0.22779043280182232
37,경기도,수원시팔달구,지동,지동제3투,1105,694,254,397,29,4,3,687,7,411,36.972343522561864,57.78748180494906,4.2212518195050945,0.5822416302765648,0.43668122270742354
38,경기도,수원시팔달구,지동,지동제4투,1550,974,382,496,78,6,1,963,11,576,39.66770508826583,51.505711318795434,8.09968847352025,0.6230529595015576,0.10384215991692627
39,경기도,수원시팔달구,우만1동,관내사전투표,3181,3181,2035,839,262,24,0,3160,21,0,64.39873417721519,26.55063291139241,8.291139240506329,0.7594936708860759,0.0
40,경기도,수원시팔달구,우만1동,우만1동제1투,2266,1373,473,732,126,19,5,1355,18,893,34.90774907749078,54.02214022140222,9.29889298892989,1.4022140221402213,0.36900369003690037
41,경기도,수원시팔달구,우만1동,우만1동제2투,2624,1642,652,844,115,16,2,1629,13,982,40.02455494168201,51.81092694904849,7.059545733578883,0.9821976672805401,0.12277470841006752
42,경기도,수원시팔달구,우만1동,우만1동제3투,2078,1340,544,646,127,14,2,1333,7,738,40.81020255063766,48.46211552888222,9.527381845461365,1.0502625656414104,0.15003750937734434
43,경기도,수원시팔달구,우만1동,우만1동제4투,2424,1438,566,678,156,25,2,1427,11,986,39.66362999299229,47.51226348983882,10.932025227750525,1.751927119831815,0.1401541695865452
44,경기도,수원시팔달구,우만1동,우만1동제5투,1141,786,325,411,28,5,0,769,17,355,42.26267880364109,53.44603381014304,3.6410923276983094,0.6501950585175552,0.0
45,경기도,수원시팔달구,우만1동,우만1동제6투,1387,1025,416,498,94,10,1,1019,6,362,40.8243375858685,48.871442590775274,9.224730127576054,0.9813542688910697,0.09813542688910697
46,경기도,수원시팔달구,우만2동,관내사전투표,4109,4109,2517,971,551,27,6,4072,37,0,61.812377210216106,23.845776031434184,13.531434184675836,0.6630648330058939,0.14734774066797643
47,경기도,수원시팔달구,우만2동,우만2동제1투,2843,1914,624,980,263,15,2,1884,30,929,33.12101910828025,52.016985138004245,13.959660297239914,0.7961783439490446,0.10615711252653928
48,경기도,수원시팔달구,우만2동,우만2동제2투,2131,1490,444,824,193,16,1,1478,12,641,30.040595399188092,55.751014884979696,13.058186738836266,1.0825439783491204,0.06765899864682003
49,경기도,수원시팔달구,우만2동,우만2동제3투,2317,1791,683,908,171,18,0,1780,11,526,38.37078651685393,51.01123595505618,9.606741573033707,1.0112359550561798,0.0
50,경기도,수원시팔달구,우만2동,우만2동제4투,2225,1753,758,797,168,17,1,1741,12,472,43.53819643882826,45.778288340034464,9.649626651349799,0.9764503159103963,0.05743825387708214
51,경기도,수원시팔달구,인계동,관내사전투표,4593,4593,2891,1064,561,30,5,4551,42,0,63.52450010986597,23.379477038013626,12.326961107448913,0.6591957811470006,0.10986596352450011
52,경기도,수원시팔달구,인계동,인계동제1투,3807,2175,699,1150,293,15,1,2158,17,1632,32.39110287303058,53.29008341056534,13.577386468952735,0.6950880444856349,0.04633920296570899
53,경기도,수원시팔달구,인계동,인계동제2투,3551,2187,877,1050,225,10,3,2165,22,1364,40.5080831408776,48.49884526558891,10.392609699769054,0.4618937644341801,0.13856812933025403
54,경기도,수원시팔달구,인계동,인계동제3투,1772,938,352,455,110,12,0,929,9,834,37.89020452099031,48.977395048439185,11.840688912809473,1.2917115177610334,0.0
55,경기도,수원시팔달구,인계동,인계동제4투,3037,2190,811,1169,172,25,0,2177,13,847,37.25310059715204,53.69774919614147,7.9007808911345885,1.148369315571888,0.0
56,경기도,수원시팔달구,인계동,인계동제5투,3345,2661,1187,1221,209,26,2,2645,16,684,44.87712665406427,46.16257088846881,7.901701323251417,0.9829867674858223,0.07561436672967864
57,경기도,수원시팔달구,인계동,인계동제6투,3022,1440,410,699,300,12,0,1421,19,1582,28.85292047853624,49.19071076706545,21.111893033075297,0.844475721323012,0.0
58,경기도,수원시팔달구,인계동,인계동제7투,2658,1432,567,702,138,13,0,1420,12,1226,39.929577464788736,49.436619718309856,9.71830985915493,0.9154929577464789,0.0
59,경기도,수원시팔달구,인계동,인계동제8투,2353,1491,615,708,136,17,2,1478,13,862,41.61028416779431,47.902571041948576,9.201623815967523,1.1502029769959403,0.13531799729364005
60,경기도,수원시팔달구,인계동,인계동제9투,4979,3959,1827,1599,458,44,4,3932,27,1020,46.46490335707019,40.66632756866734,11.648016276703968,1.119023397761953,0.10172939979654119
61,경기도,수원시팔달구,잘못 투입·구분된 투표지,,0,0,0,0,0,0,0,0,0,0,0.0,0.0,0.0,0.0,0.0
0,경기도,수원시영통구,거소·선상투표,,297,281,112,96,64,2,0,274,7,16,40.87591240875913,35.03649635036496,23.357664233576642,0.7299270072992701,0.0
1,경기도,수원시영통구,관외사전투표,,33823,33819,19200,8323,5552,369,36,33480,339,4,57.34767025089605,24.859617682198326,16.583034647550775,1.1021505376344085,0.10752688172043011
2,경기도,수원시영통구,재외투표,,2553,2111,1370,454,233,33,1,2091,20,442,65.51889048302247,21.71209947393592,11.142993782879005,1.5781922525107603,0.04782400765184123
3,경기도,수원시영통구,매탄1동,관내사전투표,2392,2392,1509,605,244,26,2,2386,6,0,63.243922883487,25.356244761106456,10.226320201173513,1.0896898575020955,0.08382229673093043
4,경기도,수원시영통구,매탄1동,매탄1동제1투,2691,1697,552,937,178,16,1,1684,13,994,32.779097387173394,55.641330166270784,10.570071258907364,0.9501187648456058,0.05938242280285036
5,경기도,수원시영통구,매탄1동,매탄1동제2투,3834,2931,1231,1378,273,23,4,2909,22,903,42.316947404606395,47.37023031969749,9.384668270883465,0.790649707803369,0.13750429700928155
6,경기도,수원시영통구,매탄2동,관내사전투표,2639,2639,1675,707,225,20,3,2630,9,0,63.68821292775665,26.88212927756654,8.555133079847907,0.7604562737642585,0.11406844106463879
7,경기도,수원시영통구,매탄2동,매탄2동제1투,2125,1284,445,693,133,8,0,1279,5,841,34.792806880375295,54.182955433932754,10.398749022673965,0.6254886630179828,0.0
8,경기도,수원시영통구,매탄2동,매탄2동제2투,2115,1340,445,786,90,7,2,1330,10,775,33.45864661654135,59.09774436090226,6.7669172932330826,0.5263157894736842,0.15037593984962408
9,경기도,수원시영통구,매탄2동,매탄2동제3투,2202,1622,670,786,135,17,3,1611,11,580,41.58907510862818,48.78957169459962,8.379888268156424,1.0552451893234016,0.186219739292365
10,경기도,수원시영통구,매탄2동,매탄2동제4투,1550,1181,509,533,111,17,1,1171,10,369,43.46712211784799,45.51665243381725,9.479077711357814,1.4517506404782237,0.08539709649871904
11,경기도,수원시영통구,매탄3동,관내사전투표,6111,6111,3928,1456,620,60,3,6067,44,0,64.74369540135157,23.998681391132358,10.219218724245922,0.9889566507334762,0.049447832536673814
12,경기도,수원시영통구,매탄3동,매탄3동제1투,3682,2951,1392,1220,289,33,4,2938,13,731,47.37916950306331,41.524846834581346,9.836623553437713,1.123213070115725,0.13614703880190604
13,경기도,수원시영통구,매탄3동,매탄3동제2투,3089,2165,968,920,233,23,2,2146,19,924,45.1071761416589,42.87045666356011,10.857409133271203,1.0717614165890028,0.09319664492078285
14,경기도,수원시영통구,매탄3동,매탄3동제3투,2830,2110,891,915,256,26,4,2092,18,720,42.590822179732314,43.738049713193114,12.237093690248566,1.24282982791587,0.19120458891013384
15,경기도,수원시영통구,매탄3동,매탄3동제4투,2622,1919,740,927,200,28,4,1899,20,703,38.96787783043707,48.81516587677725,10.5318588730911,1.474460242232754,0.210637177461822
16,경기도,수원시영통구,매탄3동,매탄3동제5투,2469,1728,634,862,196,17,4,1713,15,741,37.01109165207239,50.32107413893754,11.441914769410392,0.99241097489784,0.23350846468184472
17,경기도,수원시영통구,매탄3동,매탄3동제6투,2520,1907,717,986,170,22,2,1897,10,613,37.796520822351084,51.97680548234054,8.961518186610437,1.1597258829731154,0.10542962572482868
18,경기도,수원시영통구,매탄3동,매탄3동제7투,2129,1230,412,538,252,5,4,1211,19,899,34.02146985962015,44.426094137076795,20.809248554913296,0.41288191577208916,0.3303055326176713
19,경기도,수원시영통구,매탄4동,관내사전투표,3925,3925,2524,924,417,32,3,3900,25,0,64.71794871794872,23.692307692307693,10.692307692307693,0.8205128205128205,0.07692307692307693
20,경기도,수원시영통구,매탄4동,매탄4동제1투,2343,1431,485,758,150,18,3,1414,17,912,34.2998585572843,53.6067892503536,10.608203677510609,1.272984441301273,0.21216407355021216
21,경기도,수원시영통구,매탄4동,매탄4동제2투,2455,1739,700,835,171,15,2,1723,16,716,40.62681369704005,48.46198491004063,9.924550203134068,0.8705745792222866,0.11607661056297155
22,경기도,수원시영통구,매탄4동,매탄4동제3투,2083,1325,528,634,137,10,1,1310,15,758,40.30534351145038,48.396946564885496,10.458015267175574,0.7633587786259541,0.07633587786259542
23,경기도,수원시영통구,매탄4동,매탄4동제4투,2420,1753,788,769,167,16,2,1742,11,667,45.2353616532721,44.14466130884042,9.586681974741676,0.9184845005740528,0.1148105625717566
24,경기도,수원시영통구,매탄4동,매탄4동제5투,2670,1952,737,1030,162,14,0,1943,9,718,37.93103448275862,53.01080802882141,8.337622233659289,0.7205352547606794,0.0
25,경기도,수원시영통구,원천동,관내사전투표,5817,5816,3641,1451,621,58,5,5776,40,1,63.03670360110804,25.121191135734072,10.751385041551247,1.0041551246537395,0.08656509695290858
26,경기도,수원시영통구,원천동,원천동제1투,3157,2384,1035,1066,238,20,3,2362,22,773,43.81879762912786,45.131244707874686,10.076206604572397,0.8467400508044031,0.12701100762066045
27,경기도,수원시영통구,원천동,원천동제2투,3192,2088,645,1149,255,17,6,2072,16,1104,31.12934362934363,55.45366795366795,12.306949806949808,0.8204633204633204,0.28957528957528955
28,경기도,수원시영통구,원천동,원천동제3투,4096,2437,928,1107,363,24,2,2424,13,1659,38.28382838283829,45.66831683168317,14.975247524752474,0.9900990099009901,0.08250825082508251
29,경기도,수원시영통구,원천동,원천동제4투,1782,1258,413,584,231,14,1,1243,15,524,33.2260659694288,46.98310539018504,18.58407079646018,1.1263073209975865,0.08045052292839903
30,경기도,수원시영통구,원천동,원천동제5투,3323,2504,825,1327,304,19,0,2475,29,819,33.33333333333333,53.61616161616162,12.282828282828282,0.7676767676767676,0.0
31,경기도,수원시영통구,원천동,원천동제6투,3362,2677,1033,1353,260,22,1,2669,8,685,38.70363431997003,50.69314349943799,9.74147620831772,0.8242787560884226,0.03746721618583739
32,경기도,수원시영통구,원천동,원천동제7투,4043,3235,1080,1822,296,26,1,3225,10,808,33.48837209302326,56.49612403100775,9.178294573643411,0.8062015503875969,0.0310077519379845
33,경기도,수원시영통구,원천동,원천동제8투,2600,2213,1262,713,210,19,1,2205,8,387,57.23356009070295,32.33560090702948,9.523809523809524,0.8616780045351473,0.045351473922902494
34,경기도,수원시영통구,광교1동,관내사전투표,8818,8818,5434,2015,1211,84,3,8747,71,0,62.12415685377843,23.036469646736023,13.844746770321253,0.9603292557448267,0.0342974734194581
35,경기도,수원시영통구,광교1동,광교1동제1투,3672,2597,801,1317,416,35,0,2569,28,1075,31.179447255741533,51.26508369015181,16.19307123394317,1.3623978201634876,0.0
36,경기도,수원시영통구,광교1동,광교1동제2투,2787,2291,994,967,287,30,2,2280,11,496,43.59649122807018,42.41228070175438,12.587719298245615,1.3157894736842104,0.08771929824561403
37,경기도,수원시영통구,광교1동,광교1동제3투,3136,2307,839,1129,300,20,2,2290,17,829,36.637554585152834,49.301310043668124,13.100436681222707,0.8733624454148471,0.08733624454148471
38,경기도,수원시영통구,광교1동,광교1동제4투,2624,2194,889,1051,208,33,0,2181,13,430,40.76111875286566,48.18890417239798,9.536909674461256,1.5130674002751032,0.0
39,경기도,수원시영통구,광교1동,광교1동제5투,3699,3034,1166,1486,334,29,2,3017,17,665,38.64766324163076,49.2542260523699,11.070599933708984,0.9612197547232351,0.06629101756711965
40,경기도,수원시영통구,광교1동,광교1동제6투,3957,2923,1069,1277,507,32,2,2887,36,1034,37.0280568063734,44.23276757880152,17.561482507793556,1.1084170419120194,0.06927606511950121
41,경기도,수원시영통구,광교1동,광교1동제7투,1605,1275,531,620,114,6,1,1272,3,330,41.74528301886792,48.742138364779876,8.962264150943396,0.4716981132075472,0.07861635220125787
42,경기도,수원시영통구,광교1동,광교1동제8투,2652,2083,807,878,353,27,2,2067,16,569,39.042089985486214,42.4770198355104,17.077890662796325,1.3062409288824384,0.09675858732462506
43,경기도,수원시영통구,광교1동,광교1동제9투,3162,2578,1060,1221,256,28,1,2566,12,584,41.30943102104443,47.58378799688231,9.976617303195635,1.0911925175370227,0.03897116134060795
44,경기도,수원시영통구,광교1동,광교1동제10투,3009,2504,1045,1180,243,19,1,2488,16,505,42.0016077170418,47.42765273311897,9.766881028938906,0.7636655948553055,0.04019292604501608
45,경기도,수원시영통구,광교2동,관내사전투표,4252,4252,2763,984,426,52,2,4227,25,0,65.36550745209368,23.278921220723916,10.078069552874378,1.230186893778093,0.04731488052992666
46,경기도,수원시영통구,광교2동,광교2동제1투,2528,1956,678,1019,229,15,1,1942,14,572,34.9124613800206,52.47167868177137,11.791967044284243,0.772399588053553,0.051493305870236865
47,경기도,수원시영통구,광교2동,광교2동제2투,2416,1738,731,883,105,12,1,1732,6,678,42.20554272517321,50.98152424942263,6.062355658198614,0.6928406466512702,0.057736720554272515
48,경기도,수원시영통구,광교2동,광교2동제3투,3208,2402,865,1150,338,34,0,2387,15,806,36.2379555927943,48.17762882279011,14.160033514872225,1.4243820695433598,0.0
49,경기도,수원시영통구,광교2동,광교2동제4투,2567,2116,966,914,199,25,1,2105,11,451,45.89073634204276,43.42042755344418,9.453681710213777,1.187648456057007,0.047505938242280284
50,경기도,수원시영통구,광교2동,광교2동제5투,2181,1734,774,776,154,19,0,1723,11,447,44.92164828786999,45.03772489843297,8.93789901334881,1.1027278003482297,0.0
51,경기도,수원시영통구,광교2동,광교2동제6투,2804,2255,741,1257,233,13,0,2244,11,549,33.02139037433155,56.01604278074866,10.383244206773618,0.5793226381461676,0.0
52,경기도,수원시영통구,영통1동,관내사전투표,5992,5992,4017,1311,585,39,7,5959,33,0,67.41063936902165,22.00033562678302,9.81708340325558,0.6544722268837053,0.11746937405604967
53,경기도,수원시영통구,영통1동,영통1동제1투,2426,1708,685,785,203,20,1,1694,14,718,40.43683589138134,46.34002361275088,11.983471074380166,1.1806375442739079,0.05903187721369539
54,경기도,수원시영통구,영통1동,영통1동제2투,3298,2455,990,1118,295,33,2,2438,17,843,40.607054963084494,45.85726004922067,12.10008203445447,1.3535684987694832,0.08203445447087777
55,경기도,수원시영통구,영통1동,영통1동제3투,2622,2037,830,942,221,24,5,2022,15,585,41.0484668644906,46.58753709198813,10.9297725024728,1.1869436201780417,0.2472799208704253
56,경기도,수원시영통구,영통1동,영통1동제4투,2970,2444,1211,963,235,27,0,2436,8,526,49.712643678160916,39.532019704433495,9.646962233169129,1.1083743842364533,0.0
57,경기도,수원시영통구,영통1동,영통1동제5투,3536,2704,1053,1322,287,22,4,2688,16,832,39.174107142857146,49.18154761904761,10.677083333333332,0.818452380952381,0.1488095238095238
58,경기도,수원시영통구,영통1동,영통1동제6투,2589,2001,838,905,209,27,3,1982,19,588,42.28052472250252,45.660948536831484,10.544904137235116,1.3622603430877902,0.15136226034308778
59,경기도,수원시영통구,영통2동,관내사전투표,7020,7020,4205,1396,1253,89,3,6946,74,0,60.53843938957674,20.097898070832134,18.039159228332853,1.2813129858911605,0.04319032536711777
60,경기도,수원시영통구,영통2동,영통2동제1투,2304,1747,679,762,266,24,1,1732,15,557,39.20323325635104,43.99538106235566,15.35796766743649,1.3856812933025404,0.057736720554272515
61,경기도,수원시영통구,영통2동,영통2동제2투,3443,2797,1218,1126,397,27,3,2771,26,646,43.95525081198123,40.63514976542764,14.32695777697582,0.9743774810537712,0.10826416456153012
62,경기도,수원시영통구,영통2동,영통2동제3투,2717,2093,798,894,342,33,3,2070,23,624,38.550724637681164,43.188405797101446,16.52173913043478,1.5942028985507246,0.14492753623188406
63,경기도,수원시영통구,영통2동,영통2동제4투,2389,1438,338,651,413,14,3,1419,19,951,23.819591261451727,45.87737843551797,29.105003523608175,0.9866102889358703,0.21141649048625794
64,경기도,수원시영통구,영통2동,영통2동제5투,3711,2934,1271,1206,404,24,6,2911,23,777,43.66197183098591,41.429062177945724,13.878392305049811,0.8244589488148402,0.20611473720371004
65,경기도,수원시영통구,영통3동,관내사전투표,6529,6529,4007,1401,1007,66,2,6483,46,0,61.807805028536166,21.61036557149468,15.532932284436217,1.018047200370199,0.030849915162733305
66,경기도,수원시영통구,영통3동,영통3동제1투,3741,2465,689,1193,533,26,4,2445,20,1276,28.1799591002045,48.79345603271983,21.79959100204499,1.063394683026585,0.16359918200409
67,경기도,수원시영통구,영통3동,영통3동제2투,3049,2310,841,1223,203,29,2,2298,12,739,36.5970409051349,53.22019147084421,8.833768494342907,1.2619669277632724,0.08703220191470844
68,경기도,수원시영통구,영통3동,영통3동제3투,1744,1420,641,566,189,16,0,1412,8,324,45.39660056657224,40.084985835694056,13.385269121813032,1.13314447592068,0.0
69,경기도,수원시영통구,영통3동,영통3동제4투,2458,2023,922,860,205,22,3,2012,11,435,45.82504970178927,42.74353876739563,10.18886679920477,1.0934393638170974,0.14910536779324055
70,경기도,수원시영통구,영통3동,영통3동제5투,2611,2136,1032,852,214,22,3,2123,13,475,48.61045690061234,40.13188883655205,10.080075365049458,1.0362694300518136,0.1413094677343382
71,경기도,수원시영통구,영통3동,영통3동제6투,1918,1475,654,564,232,12,0,1462,13,443,44.73324213406293,38.57729138166895,15.868673050615595,0.8207934336525308,0.0
72,경기도,수원시영통구,영통3동,영통3동제7투,2427,1823,776,775,231,15,2,1799,24,604,43.13507504168983,43.07948860478044,12.840466926070038,0.8337965536409117,0.11117287381878821
73,경기도,수원시영통구,망포1동,관내사전투표,4134,4134,2731,933,399,36,4,4103,31,0,66.56105288813063,22.739458932488425,9.724591762125275,0.8774067755300998,0.09748964172556666
74,경기도,수원시영통구,망포1동,망포1동제1투,2829,2166,871,1047,210,25,1,2154,12,663,40.436397400185704,48.607242339832865,9.749303621169917,1.160631383472609,0.04642525533890436
75,경기도,수원시영통구,망포1동,망포1동제2투,2762,2099,899,947,222,20,2,2090,9,663,43.014354066985646,45.311004784689,10.62200956937799,0.9569377990430622,0.09569377990430622
76,경기도,수원시영통구,망포1동,망포1동제3투,2134,1322,514,577,197,14,1,1303,19,812,39.44742900997697,44.28242517267844,15.118956254796622,1.0744435917114352,0.07674597083653108
77,경기도,수원시영통구,망포1동,망포1동제4투,2558,1864,684,903,242,20,1,1850,14,694,36.972972972972975,48.810810810810814,13.08108108108108,1.0810810810810811,0.05405405405405406
78,경기도,수원시영통구,망포1동,망포1동제5투,2198,1573,649,728,176,16,1,1570,3,625,41.33757961783439,46.36942675159236,11.210191082802549,1.019108280254777,0.06369426751592357
79,경기도,수원시영통구,망포1동,망포1동제6투,3153,2604,1200,1037,304,40,2,2583,21,549,46.45760743321719,40.147115756871855,11.769260549748354,1.548586914440573,0.07742934572202864
80,경기도,수원시영통구,망포2동,관내사전투표,6843,6843,4675,1434,641,54,2,6806,37,0,68.68939171319424,21.069644431384074,9.418160446664707,0.7934175727299441,0.02938583602703497
81,경기도,수원시영통구,망포2동,망포2동제1투,1993,1430,561,714,139,12,0,1426,4,563,39.34081346423562,50.07012622720898,9.747545582047685,0.8415147265077139,0.0
82,경기도,수원시영통구,망포2동,망포2동제2투,2018,1507,589,738,157,13,5,1502,5,511,39.21438082556591,49.134487350199734,10.452729693741677,0.8655126498002662,0.3328894806924101
83,경기도,수원시영통구,망포2동,망포2동제3투,3154,2591,1223,994,322,32,3,2574,17,563,47.51359751359751,38.61693861693862,12.509712509712509,1.2432012432012431,0.11655011655011654
84,경기도,수원시영통구,망포2동,망포2동제4투,4152,3381,1608,1287,433,32,1,3361,20,771,47.84290389764951,38.29217494793216,12.883070514727759,0.9520975900029753,0.02975304968759298
85,경기도,수원시영통구,망포2동,망포2동제5투,3024,2208,995,914,262,24,3,2198,10,816,45.26842584167425,41.58325750682438,11.91992720655141,1.0919017288444042,0.13648771610555052
86,경기도,수원시영통구,망포2동,망포2동제6투,2778,2263,1133,799,304,15,1,2252,11,515,50.31083481349911,35.47957371225577,13.49911190053286,0.6660746003552398,0.04440497335701599
87,경기도,수원시영통구,잘못 투입·구분된 투표지,,0,0,0,0,0,0,0,0,0,0,0.0,0.0,0.0,0.0,0.0
0,경기도,성남시수정구,거소·선상투표,,201,187,96,56,29,1,0,182,5,14,52.74725274725275,30.76923076923077,15.934065934065933,0.5494505494505495,0.0
1,경기도,성남시수정구,관외사전투표,,25025,25024,15600,5934,3024,231,24,24813,211,1,62.87026961673317,23.914883327288113,12.18715995647443,0.9309636077862411,0.09672349171805102
2,경기도,성남시수정구,재외투표,,1331,1081,709,250,100,14,0,1073,8,250,66.07642124883503,23.299161230195715,9.319664492078285,1.30475302889096,0.0
3,경기도,성남시수정구,신흥1동,관내사전투표,3917,3917,2832,829,219,16,2,3898,19,0,72.65264238070806,21.267316572601334,5.618265777321704,0.4104669061056952,0.0513083632632119
4,경기도,성남시수정구,신흥1동,신흥1동제1투,2049,1076,522,469,67,8,1,1067,9,973,48.92221180880975,43.95501405810684,6.279287722586692,0.7497656982193065,0.09372071227741331
5,경기도,성남시수정구,신흥1동,신흥1동제2투,1582,820,394,367,51,6,0,818,2,762,48.16625916870416,44.86552567237164,6.234718826405868,0.7334963325183375,0.0
6,경기도,성남시수정구,신흥1동,신흥1동제3투,1594,904,444,377,68,9,0,898,6,690,49.44320712694877,41.98218262806236,7.57238307349666,1.0022271714922049,0.0
7,경기도,성남시수정구,신흥1동,신흥1동제4투,1802,1034,489,454,73,9,2,1027,7,768,47.614410905550145,44.206426484907496,7.108081791626096,0.8763388510223954,0.19474196689386564
8,경기도,성남시수정구,신흥2동,관내사전투표,4726,4726,3268,1035,363,36,1,4703,23,0,69.48756113119285,22.007229428024665,7.7184775675101,0.7654688496704232,0.021263023601956196
9,경기도,성남시수정구,신흥2동,신흥2동제1투,1446,976,454,438,69,10,0,971,5,470,46.755921730175075,45.1081359423275,7.106076210092688,1.0298661174047374,0.0
10,경기도,성남시수정구,신흥2동,신흥2동제2투,2622,1833,741,917,152,10,0,1820,13,789,40.714285714285715,50.38461538461539,8.35164835164835,0.5494505494505495,0.0
11,경기도,성남시수정구,신흥2동,신흥2동제3투,2958,2390,887,1233,226,23,1,2370,20,568,37.426160337552744,52.0253164556962,9.535864978902953,0.9704641350210972,0.04219409282700422
12,경기도,성남시수정구,신흥2동,신흥2동제4투,3237,2635,1038,1317,238,28,2,2623,12,602,39.57300800609988,50.20968356843309,9.073579870377431,1.067479984750286,0.07624857033930614
13,경기도,성남시수정구,신흥2동,신흥2동제5투,3116,2458,1119,1047,261,21,0,2448,10,658,45.71078431372549,42.76960784313725,10.661764705882353,0.857843137254902,0.0
14,경기도,성남시수정구,신흥2동,신흥2동제6투,3130,2268,978,995,254,22,4,2253,15,862,43.40878828229028,44.163337771859744,11.273857079449623,0.9764758100310698,0.17754105636928538
15,경기도,성남시수정구,신흥3동,관내사전투표,3728,3728,2496,991,198,27,1,3713,15,0,67.22326959332077,26.690008079719902,5.332615136008618,0.7271747912739025,0.026932399676811204
16,경기도,성남시수정구,신흥3동,신흥3동제1투,2162,1196,578,510,91,7,2,1188,8,966,48.65319865319865,42.92929292929293,7.65993265993266,0.5892255892255892,0.16835016835016833
17,경기도,성남시수정구,신흥3동,신흥3동제2투,1557,842,375,386,66,3,3,833,9,715,45.01800720288116,46.33853541416567,7.923169267707082,0.36014405762304924,0.36014405762304924
18,경기도,성남시수정구,신흥3동,신흥3동제3투,2437,1413,597,664,129,12,0,1402,11,1024,42.582025677603426,47.360912981455066,9.20114122681883,0.8559201141226819,0.0
19,경기도,성남시수정구,태평1동,관내사전투표,4037,4037,2808,898,276,31,1,4014,23,0,69.95515695067265,22.371699053313403,6.87593423019432,0.7722969606377678,0.024912805181863475
20,경기도,성남시수정구,태평1동,태평1동제1투,2224,1394,576,685,117,7,0,1385,9,830,41.588447653429604,49.458483754512635,8.447653429602887,0.5054151624548736,0.0
21,경기도,성남시수정구,태평1동,태평1동제2투,2065,1350,583,596,154,7,1,1341,9,715,43.475018642803875,44.44444444444444,11.483967188665176,0.5219985085756897,0.07457121551081282
22,경기도,성남시수정구,태평1동,태평1동제3투,1627,935,399,430,90,6,1,926,9,692,43.08855291576673,46.436285097192226,9.719222462203025,0.6479481641468683,0.10799136069114472
23,경기도,성남시수정구,태평1동,태평1동제4투,2017,1294,596,565,114,10,0,1285,9,723,46.38132295719844,43.96887159533074,8.8715953307393,0.7782101167315175,0.0
24,경기도,성남시수정구,태평2동,관내사전투표,2311,2311,1645,488,145,11,2,2291,20,0,71.80270624181581,21.30074203404627,6.329113924050633,0.48013967699694454,0.08729812309035355
25,경기도,성남시수정구,태평2동,태평2동제1투,1683,996,482,413,81,8,0,984,12,687,48.983739837398375,41.97154471544716,8.231707317073171,0.8130081300813009,0.0
26,경기도,성남시수정구,태평2동,태평2동제2투,2246,1522,764,632,99,15,1,1511,11,724,50.56254136333555,41.82660489741893,6.551952349437459,0.9927200529450696,0.06618133686300463
27,경기도,성남시수정구,태평2동,태평2동제3투,1060,604,291,261,34,4,5,595,9,456,48.90756302521008,43.865546218487395,5.714285714285714,0.6722689075630253,0.8403361344537815
28,경기도,성남시수정구,태평2동,태평2동제4투,1603,1058,482,452,103,10,2,1049,9,545,45.94852240228789,43.088655862726405,9.818875119161106,0.9532888465204957,0.19065776930409914
29,경기도,성남시수정구,태평2동,태평2동제5투,1447,922,454,387,66,5,2,914,8,525,49.671772428884026,42.34135667396061,7.2210065645514225,0.5470459518599562,0.2188183807439825
30,경기도,성남시수정구,태평3동,관내사전투표,3607,3606,2586,764,207,28,1,3586,20,1,72.11377579475739,21.305075292805352,5.77244841048522,0.7808142777467931,0.027886224205242612
31,경기도,성남시수정구,태평3동,태평3동제1투,1718,1191,548,506,114,10,2,1180,11,527,46.440677966101696,42.88135593220339,9.661016949152543,0.847457627118644,0.1694915254237288
32,경기도,성남시수정구,태평3동,태평3동제2투,1412,858,369,417,59,3,1,849,9,554,43.46289752650176,49.11660777385159,6.9493521790341575,0.35335689045936397,0.11778563015312131
33,경기도,성남시수정구,태평3동,태평3동제3투,1589,933,423,427,67,9,1,927,6,656,45.63106796116505,46.062567421790725,7.227615965480043,0.9708737864077669,0.10787486515641855
34,경기도,성남시수정구,태평3동,태평3동제4투,1993,1274,612,559,90,11,0,1272,2,719,48.113207547169814,43.94654088050314,7.0754716981132075,0.8647798742138365,0.0
35,경기도,성남시수정구,태평4동,관내사전투표,2508,2508,1786,541,143,16,3,2489,19,0,71.7557251908397,21.735636801928486,5.745279228605866,0.6428284451586983,0.12053033346725592
36,경기도,성남시수정구,태평4동,태평4동제1투,1990,1147,495,534,96,11,0,1136,11,843,43.57394366197183,47.00704225352113,8.450704225352112,0.9683098591549295,0.0
37,경기도,성남시수정구,태평4동,태평4동제2투,2185,1254,572,588,83,6,1,1250,4,931,45.76,47.04,6.64,0.48,0.08
38,경기도,성남시수정구,태평4동,태평4동제3투,1725,1087,526,463,89,2,0,1080,7,638,48.7037037037037,42.87037037037037,8.24074074074074,0.1851851851851852,0.0
39,경기도,성남시수정구,수진1동,관내사전투표,2776,2776,2007,559,166,26,1,2759,17,0,72.74374773468648,20.26096411743385,6.016672707502718,0.9423704240666908,0.03624501631025734
40,경기도,성남시수정구,수진1동,수진1동제1투,1642,944,447,437,41,8,3,936,8,698,47.756410256410255,46.68803418803419,4.38034188034188,0.8547008547008548,0.3205128205128205
41,경기도,성남시수정구,수진1동,수진1동제2투,1785,1141,582,478,66,7,1,1134,7,644,51.32275132275132,42.151675485008816,5.82010582010582,0.6172839506172839,0.08818342151675485
42,경기도,성남시수정구,수진1동,수진1동제3투,1478,797,348,377,60,3,0,788,9,681,44.16243654822335,47.84263959390863,7.614213197969544,0.3807106598984772,0.0
43,경기도,성남시수정구,수진1동,수진1동제4투,1653,989,419,486,70,5,1,981,8,664,42.71151885830785,49.54128440366973,7.135575942915392,0.509683995922528,0.10193679918450561
44,경기도,성남시수정구,수진2동,관내사전투표,3605,3605,2531,826,212,16,0,3585,20,0,70.59972105997211,23.040446304044632,5.913528591352859,0.44630404463040446,0.0
45,경기도,성남시수정구,수진2동,수진2동제1투,1718,1017,442,487,69,8,3,1009,8,701,43.80574826560951,48.26560951437067,6.838453914767097,0.7928642220019821,0.29732408325074333
46,경기도,성남시수정구,수진2동,수진2동제2투,1767,1041,481,462,79,11,2,1035,6,726,46.47342995169082,44.63768115942029,7.632850241545894,1.0628019323671498,0.1932367149758454
47,경기도,성남시수정구,수진2동,수진2동제3투,1058,614,281,272,57,2,0,612,2,444,45.91503267973856,44.44444444444444,9.313725490196079,0.32679738562091504,0.0
48,경기도,성남시수정구,수진2동,수진2동제4투,1392,999,449,450,87,6,0,992,7,393,45.26209677419355,45.36290322580645,8.770161290322582,0.6048387096774194,0.0
49,경기도,성남시수정구,수진2동,수진2동제5투,2149,1650,674,864,90,14,0,1642,8,499,41.04750304506699,52.61875761266748,5.481120584652863,0.8526187576126675,0.0
50,경기도,성남시수정구,단대동,관내사전투표,2462,2462,1712,580,140,19,2,2453,9,0,69.79209131675499,23.64451691805952,5.707297187117815,0.7745617611088463,0.08153281695882593
51,경기도,성남시수정구,단대동,단대동제1투,2152,1489,657,689,117,12,1,1476,13,663,44.51219512195122,46.680216802168026,7.926829268292683,0.8130081300813009,0.06775067750677506
52,경기도,성남시수정구,단대동,단대동제2투,2642,2014,888,950,147,12,1,1998,16,628,44.44444444444444,47.547547547547545,7.3573573573573565,0.6006006006006006,0.050050050050050046
53,경기도,성남시수정구,단대동,단대동제3투,1510,953,442,424,71,10,1,948,5,557,46.62447257383967,44.72573839662447,7.489451476793249,1.0548523206751055,0.10548523206751054
54,경기도,성남시수정구,단대동,단대동제4투,1421,940,415,451,62,5,1,934,6,481,44.432548179871524,48.28693790149893,6.638115631691649,0.5353319057815845,0.10706638115631692
55,경기도,성남시수정구,산성동,관내사전투표,1605,1605,1099,352,139,9,0,1599,6,0,68.73045653533458,22.013758599124454,8.692933083176985,0.5628517823639775,0.0
56,경기도,성남시수정구,산성동,산성동제1투,2332,1675,847,678,117,14,2,1658,17,657,51.08564535585042,40.89264173703257,7.056694813027745,0.8443908323281062,0.12062726176115801
57,경기도,성남시수정구,산성동,산성동제2투,292,137,59,70,5,0,0,134,3,155,44.02985074626866,52.23880597014925,3.731343283582089,0.0,0.0
58,경기도,성남시수정구,양지동,관내사전투표,3331,3330,2375,744,184,12,1,3316,14,1,71.62243667068758,22.43667068757539,5.548854041013269,0.3618817852834741,0.030156815440289503
59,경기도,성남시수정구,양지동,양지동제1투,1819,1211,570,510,107,15,0,1202,9,608,47.42096505823628,42.42928452579035,8.901830282861898,1.2479201331114809,0.0
60,경기도,성남시수정구,양지동,양지동제2투,1771,1187,591,487,81,10,2,1171,16,584,50.469684030742954,41.58838599487618,6.917164816396243,0.8539709649871904,0.1707941929974381
61,경기도,성남시수정구,양지동,양지동제3투,1256,816,371,373,59,5,1,809,7,440,45.85908529048208,46.10630407911001,7.292954264524104,0.6180469715698393,0.12360939431396785
62,경기도,성남시수정구,복정동,관내사전투표,2711,2711,1832,514,324,19,0,2689,22,0,68.12941613982893,19.11491260691707,12.049088880624767,0.7065823726292302,0.0
63,경기도,성남시수정구,복정동,복정동제1투,1626,1043,378,519,128,11,0,1036,7,583,36.486486486486484,50.0965250965251,12.355212355212355,1.0617760617760617,0.0
64,경기도,성남시수정구,복정동,복정동제2투,2178,1368,530,657,159,12,0,1358,10,810,39.0279823269514,48.379970544919,11.708394698085419,0.8836524300441826,0.0
65,경기도,성남시수정구,복정동,복정동제3투,2030,1396,536,612,218,13,1,1380,16,634,38.84057971014493,44.34782608695652,15.797101449275363,0.9420289855072465,0.07246376811594203
66,경기도,성남시수정구,위례동,관내사전투표,7970,7970,5221,2011,648,47,2,7929,41,0,65.84689115903645,25.36259301299029,8.172531214528945,0.5927607516710809,0.02522386177323748
67,경기도,성남시수정구,위례동,위례동제1투,2368,1811,536,1127,129,9,0,1801,10,557,29.761243753470296,62.57634647418101,7.162687395891172,0.4997223764575236,0.0
68,경기도,성남시수정구,위례동,위례동제2투,3009,2393,914,1250,197,20,1,2382,11,616,38.371116708648195,52.47691015952981,8.270361041141898,0.8396305625524769,0.041981528127623846
69,경기도,성남시수정구,위례동,위례동제3투,3198,2521,1065,1211,209,25,3,2513,8,677,42.37962594508555,48.18941504178273,8.31675288499801,0.9948269001193792,0.11937922801432552
70,경기도,성남시수정구,위례동,위례동제4투,1877,1279,447,638,170,13,1,1269,10,598,35.22458628841608,50.27580772261623,13.396375098502759,1.024428684003152,0.07880220646178093
71,경기도,성남시수정구,위례동,위례동제5투,2653,2067,716,1099,212,23,0,2050,17,586,34.92682926829268,53.609756097560975,10.341463414634147,1.121951219512195,0.0
72,경기도,성남시수정구,위례동,위례동제6투,1812,1259,454,700,86,6,3,1249,10,553,36.34907926341073,56.04483586869495,6.885508406725379,0.4803843074459567,0.24019215372297836
73,경기도,성남시수정구,위례동,위례동제7투,2255,1635,792,696,115,10,2,1615,20,620,49.04024767801858,43.09597523219814,7.120743034055728,0.6191950464396285,0.12383900928792571
74,경기도,성남시수정구,위례동,위례동제8투,2633,1812,880,740,152,18,2,1792,20,821,49.107142857142854,41.294642857142854,8.482142857142858,1.0044642857142858,0.11160714285714285
75,경기도,성남시수정구,위례동,위례동제9투,2016,1543,488,888,143,18,1,1538,5,473,31.729518855656696,57.737321196358906,9.29778933680104,1.1703511053315996,0.06501950585175553
76,경기도,성남시수정구,위례동,위례동제10투,1937,1326,380,802,123,7,2,1314,12,611,28.9193302891933,61.03500761035008,9.360730593607306,0.532724505327245,0.15220700152207
77,경기도,성남시수정구,신촌동,관내사전투표,758,758,486,181,84,5,0,756,2,0,64.28571428571429,23.941798941798943,11.11111111111111,0.6613756613756614,0.0
78,경기도,성남시수정구,신촌동,신촌동투표소,2306,1600,466,924,182,16,2,1590,10,706,29.30817610062893,58.11320754716981,11.446540880503145,1.0062893081761006,0.12578616352201258
79,경기도,성남시수정구,고등동,관내사전투표,2782,2782,1778,649,309,24,1,2761,21,0,64.39695762404925,23.50597609561753,11.191597247374139,0.8692502716407098,0.036218761318362915
80,경기도,성남시수정구,고등동,고등동제1투,2133,1662,741,720,177,14,1,1653,9,471,44.827586206896555,43.55716878402904,10.707803992740473,0.8469449485783425,0.06049606775559589
81,경기도,성남시수정구,고등동,고등동제2투,2183,1647,607,856,160,14,0,1637,10,536,37.08002443494197,52.29077580940745,9.773976786805132,0.8552229688454489,0.0
82,경기도,성남시수정구,고등동,고등동제3투,1781,1270,404,753,98,6,2,1263,7,511,31.987331749802056,59.61995249406176,7.759303246239114,0.4750593824228029,0.1583531274742676
83,경기도,성남시수정구,시흥동,관내사전투표,683,683,411,184,74,6,2,677,6,0,60.70901033973413,27.17872968980798,10.930576070901035,0.8862629246676514,0.29542097488921715
84,경기도,성남시수정구,시흥동,시흥동투표소,1972,1354,337,855,143,9,0,1344,10,618,25.074404761904763,63.61607142857143,10.639880952380953,0.6696428571428571,0.0
85,경기도,성남시수정구,잘못 투입·구분된 투표지,,0,0,0,0,0,0,0,0,0,0,0.0,0.0,0.0,0.0,0.0
0,경기도,성남시중원구,거소·선상투표,,249,234,110,75,36,3,4,228,6,15,48.24561403508772,32.89473684210527,15.789473684210526,1.3157894736842104,1.7543859649122806
1,경기도,성남시중원구,관외사전투표,,24043,24036,15662,5304,2629,202,17,23814,222,7,65.76803560930546,22.272612748803226,11.039724531788025,0.8482405307802133,0.07138657932308726
2,경기도,성남시중원구,재외투표,,869,710,485,134,75,11,0,705,5,159,68.79432624113475,19.00709219858156,10.638297872340425,1.5602836879432624,0.0
3,경기도,성남시중원구,성남동,관내사전투표,6400,6399,4481,1347,496,39,5,6368,31,1,70.36746231155779,21.15263819095477,7.788944723618091,0.6124371859296482,0.0785175879396985
4,경기도,성남시중원구,성남동,성남동제1투,2427,1409,583,670,127,17,1,1398,11,1018,41.70243204577969,47.92560801144492,9.084406294706723,1.2160228898426324,0.07153075822603719
5,경기도,성남시중원구,성남동,성남동제2투,2659,1807,859,784,132,15,2,1792,15,852,47.935267857142854,43.75,7.366071428571429,0.8370535714285714,0.11160714285714285
6,경기도,성남시중원구,성남동,성남동제3투,2462,1781,780,817,153,17,1,1768,13,681,44.11764705882353,46.210407239819006,8.653846153846153,0.9615384615384616,0.056561085972850686
7,경기도,성남시중원구,성남동,성남동제4투,2255,1423,660,645,101,5,3,1414,9,832,46.67609618104668,45.61527581329561,7.142857142857142,0.3536067892503536,0.21216407355021216
8,경기도,성남시중원구,성남동,성남동제5투,3190,2237,1046,952,199,18,4,2219,18,953,47.138350608382154,42.90220820189275,8.96800360522758,0.811176205497972,0.18026137899954936
9,경기도,성남시중원구,성남동,성남동제6투,3148,2147,982,957,174,15,4,2132,15,1001,46.06003752345216,44.887429643527206,8.161350844277674,0.7035647279549718,0.18761726078799248
10,경기도,성남시중원구,성남동,성남동제7투,3305,1964,791,825,303,14,3,1936,28,1341,40.857438016528924,42.61363636363637,15.650826446280991,0.7231404958677686,0.15495867768595042
11,경기도,성남시중원구,중앙동,관내사전투표,3235,3235,2271,756,181,13,2,3223,12,0,70.46230220291653,23.456407074154516,5.615885820663977,0.40335091529630784,0.06205398696866273
12,경기도,성남시중원구,중앙동,중앙동제1투,2281,1372,579,691,90,4,1,1365,7,909,42.417582417582416,50.62271062271062,6.593406593406594,0.29304029304029305,0.07326007326007326
13,경기도,성남시중원구,중앙동,중앙동제2투,1636,1031,504,461,56,5,0,1026,5,605,49.122807017543856,44.9317738791423,5.458089668615984,0.4873294346978557,0.0
14,경기도,성남시중원구,중앙동,중앙동제3투,2704,2050,1049,781,179,26,2,2037,13,654,51.49729995090819,38.34069710358371,8.787432498772704,1.2763868433971526,0.09818360333824251
15,경기도,성남시중원구,중앙동,중앙동제4투,2415,1895,973,733,160,16,0,1882,13,520,51.70031880977683,38.94792773645058,8.501594048884167,0.8501594048884166,0.0
16,경기도,성남시중원구,금광1동,관내사전투표,4479,4479,3135,940,336,32,3,4446,33,0,70.51282051282051,21.14260008996851,7.557354925775979,0.7197480881691408,0.06747638326585695
17,경기도,성남시중원구,금광1동,금광1동제1투,2810,1944,853,875,188,15,3,1934,10,866,44.10548086866598,45.2430196483971,9.720785935884178,0.7755946225439504,0.15511892450879006
18,경기도,성남시중원구,금광1동,금광1동제2투,2908,2162,1091,853,191,14,1,2150,12,746,50.74418604651163,39.674418604651166,8.883720930232558,0.6511627906976745,0.046511627906976744
19,경기도,성남시중원구,금광1동,금광1동제3투,1531,1071,507,462,82,7,1,1059,12,460,47.875354107648725,43.626062322946176,7.743153918791313,0.6610009442870632,0.09442870632672333
20,경기도,성남시중원구,금광1동,금광1동제4투,2638,2040,989,836,179,19,0,2023,17,598,48.88779041028176,41.324765200197724,8.848245180425112,0.9391992090954029,0.0
21,경기도,성남시중원구,금광2동,관내사전투표,4808,4808,3385,1083,278,29,3,4778,30,0,70.8455420678108,22.666387609878612,5.818334030975303,0.6069485140226036,0.06278777731268313
22,경기도,성남시중원구,금광2동,금광2동제1투,2079,1232,553,564,92,14,0,1223,9,847,45.216680294358135,46.116107931316435,7.522485690923958,1.1447260834014716,0.0
23,경기도,성남시중원구,금광2동,금광2동제2투,2098,1197,519,556,98,14,2,1189,8,901,43.65012615643398,46.76198486122792,8.242220353238014,1.1774600504625736,0.16820857863751051
24,경기도,성남시중원구,금광2동,금광2동제3투,1528,960,484,389,66,6,3,948,12,568,51.0548523206751,41.0337552742616,6.962025316455696,0.6329113924050633,0.31645569620253167
25,경기도,성남시중원구,금광2동,금광2동제4투,1823,1111,505,512,78,8,1,1104,7,712,45.742753623188406,46.3768115942029,7.065217391304348,0.7246376811594203,0.09057971014492754
26,경기도,성남시중원구,금광2동,금광2동제5투,2316,1327,549,660,93,10,1,1313,14,989,41.81264280274181,50.266565118050266,7.0830159939070825,0.7616146230007617,0.07616146230007616
27,경기도,성남시중원구,금광2동,금광2동제6투,3203,2547,1211,1107,191,22,1,2532,15,656,47.82780410742496,43.72037914691943,7.543443917851501,0.8688783570300158,0.03949447077409163
28,경기도,성남시중원구,은행1동,관내사전투표,2458,2458,1735,527,154,18,4,2438,20,0,71.16488925348646,21.61607875307629,6.316652994257588,0.7383100902378998,0.16406890894175555
29,경기도,성남시중원구,은행1동,은행1동제1투,1383,847,386,353,89,5,2,835,12,536,46.22754491017964,42.27544910179641,10.658682634730539,0.5988023952095809,0.23952095808383234
30,경기도,성남시중원구,은행1동,은행1동제2투,1668,955,482,361,93,12,2,950,5,713,50.73684210526316,38.0,9.789473684210526,1.263157894736842,0.21052631578947367
31,경기도,성남시중원구,은행1동,은행1동제3투,1849,1429,635,677,94,12,0,1418,11,420,44.781382228490834,47.74330042313117,6.629055007052186,0.846262341325811,0.0
32,경기도,성남시중원구,은행2동,관내사전투표,4634,4634,3330,1025,212,34,6,4607,27,0,72.2813110484046,22.248751899283697,4.601693075754286,0.7380073800738007,0.1302365964836119
33,경기도,성남시중원구,은행2동,은행2동제1투,1533,912,454,376,67,5,3,905,7,621,50.165745856353595,41.546961325966855,7.403314917127071,0.5524861878453038,0.3314917127071823
34,경기도,성남시중원구,은행2동,은행2동제2투,1240,826,443,307,63,8,2,823,3,414,53.82746051032807,37.30255164034022,7.654921020656136,0.9720534629404617,0.24301336573511542
35,경기도,성남시중원구,은행2동,은행2동제3투,1492,969,469,423,64,7,0,963,6,523,48.701973001038425,43.925233644859816,6.645898234683282,0.726895119418484,0.0
36,경기도,성남시중원구,은행2동,은행2동제4투,1299,772,364,335,60,6,0,765,7,527,47.58169934640522,43.790849673202615,7.8431372549019605,0.7843137254901961,0.0
37,경기도,성남시중원구,은행2동,은행2동제5투,1631,1015,506,400,89,10,2,1007,8,616,50.24826216484608,39.72194637537239,8.838133068520357,0.9930486593843099,0.19860973187686196
38,경기도,성남시중원구,은행2동,은행2동제6투,2481,1776,745,887,117,17,1,1767,9,705,42.16185625353707,50.19807583474816,6.621392190152801,0.9620826259196379,0.056593095642331635
39,경기도,성남시중원구,은행2동,은행2동제7투,2294,1515,692,706,93,9,2,1502,13,779,46.07190412782956,47.003994673768304,6.191744340878828,0.5992010652463382,0.13315579227696406
40,경기도,성남시중원구,상대원1동,관내사전투표,4408,4408,3194,919,236,35,5,4389,19,0,72.77284119389383,20.938710412394624,5.377079061289588,0.7974481658692184,0.11392116655274549
41,경기도,성남시중원구,상대원1동,상대원1동제1투,2729,1558,743,689,99,7,1,1539,19,1171,48.278102664067575,44.76933073424301,6.432748538011696,0.4548408057179987,0.0649772579597141
42,경기도,성남시중원구,상대원1동,상대원1동제2투,2773,1636,834,662,116,16,1,1629,7,1137,51.19705340699816,40.638428483732355,7.120933087783916,0.9821976672805401,0.06138735420503376
43,경기도,성남시중원구,상대원1동,상대원1동제3투,1519,894,426,405,47,11,1,890,4,625,47.86516853932584,45.50561797752809,5.280898876404494,1.2359550561797752,0.11235955056179776
44,경기도,성남시중원구,상대원1동,상대원1동제4투,1639,1300,691,516,73,12,1,1293,7,339,53.4416086620263,39.90719257540603,5.645784996133024,0.9280742459396751,0.07733952049497293
45,경기도,성남시중원구,상대원1동,상대원1동제5투,1928,1434,732,611,74,6,1,1424,10,494,51.40449438202247,42.907303370786515,5.196629213483146,0.42134831460674155,0.0702247191011236
46,경기도,성남시중원구,상대원1동,상대원1동제6투,1241,844,384,369,75,8,2,838,6,397,45.82338902147971,44.03341288782816,8.949880668257757,0.9546539379474941,0.23866348448687352
47,경기도,성남시중원구,상대원1동,상대원1동제7투,1967,1321,650,567,82,14,1,1314,7,646,49.467275494672755,43.15068493150685,6.2404870624048705,1.06544901065449,0.076103500761035
48,경기도,성남시중원구,상대원2동,관내사전투표,1223,1223,899,257,51,8,1,1216,7,0,73.93092105263158,21.134868421052634,4.194078947368421,0.6578947368421052,0.08223684210526315
49,경기도,성남시중원구,상대원2동,상대원2동투표소,1718,965,434,459,57,6,3,959,6,753,45.25547445255474,47.862356621480714,5.943691345151199,0.6256517205422315,0.31282586027111575
50,경기도,성남시중원구,상대원3동,관내사전투표,3457,3457,2524,762,137,18,0,3441,16,0,73.35077012496367,22.144725370531823,3.981400755594304,0.5231037489102005,0.0
51,경기도,성남시중원구,상대원3동,상대원3동제1투,2386,1360,631,635,81,5,0,1352,8,1026,46.671597633136095,46.967455621301774,5.991124260355029,0.3698224852071006,0.0
52,경기도,성남시중원구,상대원3동,상대원3동제2투,1836,1113,589,434,73,7,0,1103,10,723,53.39981867633726,39.34723481414324,6.618313689936536,0.6346328195829556,0.0
53,경기도,성남시중원구,상대원3동,상대원3동제3투,2360,1393,690,605,82,4,1,1382,11,967,49.92764109985528,43.777134587554265,5.933429811866859,0.2894356005788712,0.0723589001447178
54,경기도,성남시중원구,하대원동,관내사전투표,4700,4700,3214,1174,250,26,8,4672,28,0,68.79280821917808,25.12842465753425,5.351027397260274,0.5565068493150684,0.17123287671232876
55,경기도,성남시중원구,하대원동,하대원동제1투,1834,1120,486,538,74,6,3,1107,13,714,43.90243902439025,48.59981933152665,6.684733514001806,0.5420054200542005,0.27100271002710025
56,경기도,성남시중원구,하대원동,하대원동제2투,1843,1283,618,550,98,7,1,1274,9,560,48.50863422291994,43.17111459968603,7.6923076923076925,0.5494505494505495,0.07849293563579278
57,경기도,성남시중원구,하대원동,하대원동제3투,2616,1914,875,893,117,16,4,1905,9,702,45.93175853018373,46.876640419947506,6.141732283464567,0.8398950131233596,0.2099737532808399
58,경기도,성남시중원구,하대원동,하대원동제4투,2632,2172,951,1047,146,9,2,2155,17,460,44.129930394431554,48.58468677494199,6.7749419953596295,0.41763341067285387,0.09280742459396751
59,경기도,성남시중원구,하대원동,하대원동제5투,1634,1139,536,479,108,7,1,1131,8,495,47.39168877099912,42.35190097259063,9.549071618037134,0.618921308576481,0.08841732979664013
60,경기도,성남시중원구,도촌동,관내사전투표,4460,4459,3213,984,213,26,1,4437,22,1,72.41379310344827,22.177146720757268,4.800540906017579,0.5859815190443994,0.0225377507324769
61,경기도,성남시중원구,도촌동,도촌동제1투,1681,1222,480,653,71,11,0,1215,7,459,39.50617283950617,53.74485596707819,5.843621399176955,0.9053497942386831,0.0
62,경기도,성남시중원구,도촌동,도촌동제2투,2653,1946,856,919,132,23,4,1934,12,707,44.26059979317476,47.51809720785936,6.8252326783867625,1.189245087900724,0.2068252326783868
63,경기도,성남시중원구,도촌동,도촌동제3투,2473,1685,733,787,135,18,2,1675,10,788,43.76119402985075,46.98507462686567,8.059701492537313,1.0746268656716418,0.11940298507462686
64,경기도,성남시중원구,도촌동,도촌동제4투,3133,2420,1134,1006,245,29,0,2414,6,713,46.97597348798674,41.673570836785416,10.149130074565036,1.2013256006628004,0.0
65,경기도,성남시중원구,도촌동,도촌동제5투,2529,2065,965,892,168,26,2,2053,12,464,47.004383828543595,43.44861178762786,8.18314661471018,1.2664393570384802,0.0974184120798831
66,경기도,성남시중원구,도촌동,도촌동제6투,1235,958,502,401,42,4,0,949,9,277,52.89778714436248,42.2550052687039,4.425711275026344,0.42149631190727077,0.0
67,경기도,성남시중원구,잘못 투입·구분된 투표지,,0,1,0,1,0,0,0,1,0,-1,0.0,100.0,0.0,0.0,0.0
0,경기도,성남시분당구,거소·선상투표,,433,412,154,143,78,6,0,381,31,21,40.419947506561684,37.53280839895013,20.47244094488189,1.574803149606299,0.0
1,경기도,성남시분당구,관외사전투표,,35000,34995,19364,9948,5002,364,30,34708,287,5,55.79117206407744,28.66197994698629,14.411663017171833,1.0487495678229803,0.08643540394145442
2,경기도,성남시분당구,재외투표,,5481,4505,2795,1132,473,71,2,4473,32,976,62.48602727475967,25.30739995528728,10.574558461882406,1.5873015873015872,0.0447127207690588
3,경기도,성남시분당구,분당동,관내사전투표,2485,2485,1616,673,175,17,1,2482,3,0,65.10878323932313,27.115229653505235,7.050765511684126,0.684931506849315,0.040290088638195005
4,경기도,성남시분당구,분당동,분당동제1투,2633,1998,694,1100,171,21,0,1986,12,635,34.94461228600201,55.3877139979859,8.610271903323262,1.0574018126888218,0.0
5,경기도,성남시분당구,분당동,분당동제2투,2236,1809,670,965,144,19,2,1800,9,427,37.22222222222222,53.61111111111111,8.0,1.0555555555555556,0.1111111111111111
6,경기도,성남시분당구,분당동,분당동제3투,2079,1573,409,1026,116,7,2,1560,13,506,26.21794871794872,65.76923076923077,7.435897435897436,0.4487179487179487,0.1282051282051282
7,경기도,성남시분당구,분당동,분당동제4투,2178,1423,504,743,153,12,0,1412,11,755,35.69405099150141,52.62039660056658,10.835694050991501,0.84985835694051,0.0
8,경기도,성남시분당구,분당동,분당동제5투,2284,1747,574,1015,134,11,1,1735,12,537,33.0835734870317,58.501440922190206,7.723342939481268,0.6340057636887608,0.05763688760806917
9,경기도,성남시분당구,분당동,분당동제6투,2271,1580,547,876,144,5,0,1572,8,691,34.79643765903308,55.72519083969466,9.16030534351145,0.3180661577608142,0.0
10,경기도,성남시분당구,수내1동,관내사전투표,4122,4122,2540,1082,440,31,2,4095,27,0,62.02686202686203,26.422466422466425,10.744810744810746,0.757020757020757,0.04884004884004884
11,경기도,성남시분당구,수내1동,수내1동제1투,1801,1340,351,838,136,8,2,1335,5,461,26.29213483146067,62.77153558052434,10.187265917602996,0.599250936329588,0.149812734082397
12,경기도,성남시분당구,수내1동,수내1동제2투,1777,1422,387,899,120,10,0,1416,6,355,27.33050847457627,63.48870056497176,8.47457627118644,0.7062146892655368,0.0
13,경기도,성남시분당구,수내1동,수내1동제3투,3221,2245,757,1205,252,19,1,2234,11,976,33.88540734109221,53.93912264995524,11.280214861235452,0.8504923903312444,0.044762757385854966
14,경기도,성남시분당구,수내1동,수내1동제4투,1274,967,273,592,87,5,0,957,10,307,28.526645768025077,61.859979101358405,9.090909090909092,0.522466039707419,0.0
15,경기도,성남시분당구,수내1동,수내1동제5투,1915,1527,443,919,141,15,1,1519,8,388,29.16392363396972,60.50032916392364,9.282422646477945,0.9874917709019092,0.06583278472679394
16,경기도,성남시분당구,수내2동,관내사전투표,1979,1979,1218,574,157,18,1,1968,11,0,61.890243902439025,29.166666666666668,7.977642276422764,0.9146341463414633,0.05081300813008131
17,경기도,성남시분당구,수내2동,수내2동제1투,1756,1358,386,834,112,19,1,1352,6,398,28.550295857988168,61.68639053254438,8.284023668639055,1.4053254437869822,0.07396449704142012
18,경기도,성남시분당구,수내2동,수내2동제2투,2205,1785,562,1049,151,16,1,1779,6,420,31.590781337830244,58.965711073636875,8.487914558740865,0.8993816750983699,0.056211354693648116
19,경기도,성남시분당구,수내2동,수내2동제3투,1285,1024,304,586,121,9,0,1020,4,261,29.80392156862745,57.45098039215686,11.862745098039214,0.8823529411764706,0.0
20,경기도,성남시분당구,수내3동,관내사전투표,2692,2692,1766,639,248,27,1,2681,11,0,65.87094367773219,23.834390152928012,9.250279746363297,1.0070869078701976,0.03729951510630362
21,경기도,성남시분당구,수내3동,수내3동제1투,2292,1769,644,944,155,14,0,1757,12,523,36.65338645418327,53.7279453614115,8.821855435401252,0.796812749003984,0.0
22,경기도,성남시분당구,수내3동,수내3동제2투,2244,1811,636,1000,150,14,1,1801,10,433,35.31371460299834,55.52470849528039,8.32870627429206,0.7773459189339256,0.055524708495280406
23,경기도,성남시분당구,수내3동,수내3동제3투,2395,1550,541,804,167,22,4,1538,12,845,35.17555266579974,52.275682704811445,10.858257477243173,1.4304291287386215,0.26007802340702213
24,경기도,성남시분당구,정자동,관내사전투표,2834,2834,1683,716,385,26,2,2812,22,0,59.850640113798,25.462304409672832,13.691322901849217,0.9246088193456615,0.07112375533428165
25,경기도,성남시분당구,정자동,정자동제1투,1874,1399,361,890,118,18,4,1391,8,475,25.952552120776417,63.982746225736875,8.48310567936736,1.2940330697340043,0.28756290438533433
26,경기도,성남시분당구,정자동,정자동제2투,2836,2311,686,1401,181,26,6,2300,11,525,29.826086956521742,60.91304347826087,7.869565217391304,1.1304347826086958,0.26086956521739135
27,경기도,성남시분당구,정자동,정자동제3투,1645,1154,376,589,174,7,0,1146,8,491,32.809773123909245,51.396160558464224,15.18324607329843,0.6108202443280977,0.0
28,경기도,성남시분당구,정자동,정자동제4투,1667,1213,370,679,143,9,2,1203,10,454,30.756442227763927,56.442227763923526,11.886949293433084,0.7481296758104738,0.1662510390689942
29,경기도,성남시분당구,정자1동,관내사전투표,4534,4534,2474,1381,586,54,2,4497,37,0,55.01445408049811,30.70936179675339,13.030909495219035,1.200800533689126,0.044474093840338
30,경기도,성남시분당구,정자1동,정자1동제1투,2502,1971,586,1213,145,15,0,1959,12,531,29.913221031138338,61.91934660541092,7.401735579377233,0.7656967840735069,0.0
31,경기도,성남시분당구,정자1동,정자1동제2투,2150,1553,433,908,177,19,1,1538,15,597,28.15344603381014,59.03771131339401,11.508452535760728,1.2353706111833551,0.06501950585175553
32,경기도,성남시분당구,정자1동,정자1동제3투,3812,2498,707,1320,405,28,0,2460,38,1314,28.739837398373986,53.65853658536586,16.463414634146343,1.1382113821138211,0.0
33,경기도,성남시분당구,정자1동,정자1동제4투,2276,1762,354,1258,136,7,1,1756,6,514,20.159453302961275,71.64009111617312,7.744874715261959,0.3986332574031891,0.05694760820045558
34,경기도,성남시분당구,정자1동,정자1동제5투,2303,1668,458,1008,163,19,5,1653,15,635,27.707199032062917,60.98003629764065,9.86085904416213,1.1494252873563218,0.3024803387779794
35,경기도,성남시분당구,정자1동,정자1동제6투,3315,2339,400,1758,157,10,0,2325,14,976,17.20430107526882,75.61290322580645,6.75268817204301,0.43010752688172044,0.0
36,경기도,성남시분당구,정자1동,정자1동제7투,2081,1647,364,1163,106,5,0,1638,9,434,22.22222222222222,71.001221001221,6.471306471306472,0.3052503052503053,0.0
37,경기도,성남시분당구,정자2동,관내사전투표,3535,3535,2238,875,348,42,4,3507,28,0,63.81522668947819,24.9500998003992,9.92301112061591,1.1976047904191618,0.11405759908753922
38,경기도,성남시분당구,정자2동,정자2동제1투,1054,733,229,425,69,4,2,729,4,321,31.412894375857338,58.29903978052127,9.465020576131687,0.5486968449931412,0.2743484224965706
39,경기도,성남시분당구,정자2동,정자2동제2투,1545,1161,375,590,175,13,1,1154,7,384,32.49566724436742,51.12651646447141,15.164644714038127,1.1265164644714039,0.08665511265164644
40,경기도,성남시분당구,정자2동,정자2동제3투,1266,757,338,375,31,6,1,751,6,509,45.00665778961385,49.93342210386152,4.1278295605858855,0.7989347536617843,0.13315579227696406
41,경기도,성남시분당구,정자2동,정자2동제4투,1246,925,318,487,101,8,0,914,11,321,34.79212253829322,53.282275711159734,11.050328227571116,0.87527352297593,0.0
42,경기도,성남시분당구,정자2동,정자2동제5투,1495,1202,465,612,112,6,0,1195,7,293,38.912133891213394,51.21338912133891,9.372384937238493,0.502092050209205,0.0
43,경기도,성남시분당구,정자2동,정자2동제6투,1832,1377,388,857,107,14,1,1367,10,455,28.383321141185075,62.69202633504023,7.827359180687638,1.024140453547915,0.0731528895391368
44,경기도,성남시분당구,정자3동,관내사전투표,3054,3054,1931,809,262,40,0,3042,12,0,63.47797501643655,26.594345825115056,8.61275476660092,1.314924391847469,0.0
45,경기도,성남시분당구,정자3동,정자3동제1투,3842,2911,1000,1604,250,39,0,2893,18,931,34.56619426201175,55.44417559626685,8.641548565502937,1.3480815762184584,0.0
46,경기도,성남시분당구,정자3동,정자3동제2투,2025,1471,524,770,153,14,0,1461,10,554,35.865845311430526,52.70362765229295,10.472279260780287,0.9582477754962354,0.0
47,경기도,성남시분당구,정자3동,정자3동제3투,3033,2350,771,1327,201,22,3,2324,26,683,33.17555938037866,57.099827882960405,8.648881239242685,0.9466437177280551,0.12908777969018934
48,경기도,성남시분당구,서현1동,관내사전투표,7262,7262,4354,2013,786,68,1,7222,40,0,60.288008861811136,27.873165328163946,10.88341179728607,0.9415674328440876,0.013846579894765992
49,경기도,성남시분당구,서현1동,서현1동제1투,3935,2438,734,1323,335,25,1,2418,20,1497,30.355665839536805,54.71464019851117,13.854425144747726,1.0339123242349049,0.0413564929693962
50,경기도,성남시분당구,서현1동,서현1동제2투,3041,2247,587,1417,213,23,1,2241,6,794,26.193663543061135,63.23070058009817,9.504685408299867,1.0263275323516288,0.04462293618920125
51,경기도,성남시분당구,서현1동,서현1동제3투,3096,2442,814,1379,215,23,3,2434,8,654,33.442892358258014,56.655710764174195,8.833196384552178,0.9449465899753493,0.12325390304026293
52,경기도,성남시분당구,서현1동,서현1동제4투,2055,1585,426,1035,104,12,0,1577,8,470,27.013316423589096,65.63094483195941,6.594800253646163,0.7609384908053266,0.0
53,경기도,성남시분당구,서현1동,서현1동제5투,3147,2465,735,1518,178,22,1,2454,11,682,29.95110024449878,61.858190709046454,7.253463732681337,0.8964955175224123,0.040749796251018745
54,경기도,성남시분당구,서현1동,서현1동제6투,1474,1090,330,628,109,10,0,1077,13,384,30.64066852367688,58.310120705663884,10.12070566388115,0.9285051067780872,0.0
55,경기도,성남시분당구,서현2동,관내사전투표,5153,5153,3356,1257,462,45,2,5122,31,0,65.52128074970715,24.54119484576337,9.019914096056228,0.8785630613041782,0.03904724716907458
56,경기도,성남시분당구,서현2동,서현2동제1투,2698,2132,708,1207,185,20,0,2120,12,566,33.39622641509434,56.93396226415094,8.726415094339622,0.9433962264150944,0.0
57,경기도,성남시분당구,서현2동,서현2동제2투,2512,1983,654,1137,156,21,2,1970,13,529,33.19796954314721,57.71573604060913,7.918781725888325,1.065989847715736,0.10152284263959391
58,경기도,성남시분당구,서현2동,서현2동제3투,2341,1710,627,874,178,20,0,1699,11,631,36.90406121247793,51.442024720423774,10.476751030017658,1.1771630370806356,0.0
59,경기도,성남시분당구,서현2동,서현2동제4투,2121,1563,495,899,144,16,1,1555,8,558,31.832797427652732,57.81350482315113,9.260450160771704,1.0289389067524115,0.06430868167202572
60,경기도,성남시분당구,이매1동,관내사전투표,3543,3543,2151,1038,294,40,1,3524,19,0,61.038592508513055,29.455164585698068,8.342792281498298,1.1350737797956867,0.028376844494892167
61,경기도,성남시분당구,이매1동,이매1동제1투,3078,2398,728,1424,207,28,1,2388,10,680,30.485762144053602,59.63149078726968,8.668341708542714,1.1725293132328307,0.04187604690117253
62,경기도,성남시분당구,이매1동,이매1동제2투,2498,2070,700,1136,192,18,3,2049,21,428,34.16300634455832,55.441678867740364,9.370424597364568,0.8784773060029283,0.14641288433382138
63,경기도,성남시분당구,이매1동,이매1동제3투,1955,1585,474,970,119,13,1,1577,8,370,30.0570703868104,61.50919467343057,7.545973367152822,0.8243500317057704,0.06341154090044387
64,경기도,성남시분당구,이매1동,이매1동제4투,2205,1763,584,976,176,14,2,1752,11,442,33.33333333333333,55.70776255707762,10.045662100456621,0.7990867579908676,0.1141552511415525
65,경기도,성남시분당구,이매1동,이매1동제5투,1811,1510,527,770,191,9,3,1500,10,301,35.13333333333333,51.33333333333333,12.733333333333333,0.6,0.2
66,경기도,성남시분당구,이매1동,이매1동제6투,2709,1955,674,1069,174,22,2,1941,14,754,34.72436888201958,55.07470376094796,8.964451313755797,1.1334363730036066,0.10303967027305513
67,경기도,성남시분당구,이매2동,관내사전투표,2819,2818,1764,801,223,24,0,2812,6,1,62.73115220483641,28.4850640113798,7.930298719772404,0.8534850640113799,0.0
68,경기도,성남시분당구,이매2동,이매2동제1투,1911,1431,380,908,126,8,2,1424,7,480,26.685393258426966,63.76404494382022,8.848314606741573,0.5617977528089888,0.1404494382022472
69,경기도,성남시분당구,이매2동,이매2동제2투,2532,1983,577,1199,176,19,2,1973,10,549,29.244804865686767,60.7704004054739,8.9204257475925,0.963000506842372,0.10136847440446022
70,경기도,성남시분당구,이매2동,이매2동제3투,2783,2224,590,1442,165,13,0,2210,14,559,26.69683257918552,65.24886877828054,7.46606334841629,0.5882352941176471,0.0
71,경기도,성남시분당구,야탑1동,관내사전투표,5702,5702,3512,1460,639,45,6,5662,40,0,62.027552101730834,25.785941363475807,11.285764747439067,0.7947721653126103,0.1059696220416814
72,경기도,성남시분당구,야탑1동,야탑1동제1투,1980,1246,307,766,145,14,1,1233,13,734,24.898621248986213,62.12489862124899,11.759935117599351,1.1354420113544201,0.08110300081103002
73,경기도,성남시분당구,야탑1동,야탑1동제2투,2458,1947,619,1161,144,12,1,1937,10,511,31.956633970056792,59.93804852865255,7.43417656169334,0.619514713474445,0.05162622612287042
74,경기도,성남시분당구,야탑1동,야탑1동제3투,1978,1632,611,871,130,12,0,1624,8,346,37.62315270935961,53.63300492610838,8.004926108374384,0.7389162561576355,0.0
75,경기도,성남시분당구,야탑1동,야탑1동제4투,1822,1500,658,695,123,15,1,1492,8,322,44.10187667560322,46.58176943699732,8.243967828418231,1.0053619302949062,0.06702412868632708
76,경기도,성남시분당구,야탑1동,야탑1동제5투,1352,957,292,548,100,9,1,950,7,395,30.736842105263158,57.684210526315795,10.526315789473683,0.9473684210526316,0.10526315789473684
77,경기도,성남시분당구,야탑2동,관내사전투표,3140,3140,1861,912,315,40,0,3128,12,0,59.494884910485936,29.15601023017903,10.070332480818415,1.278772378516624,0.0
78,경기도,성남시분당구,야탑2동,야탑2동제1투,1974,1538,373,1039,111,10,1,1534,4,436,24.315514993481095,67.73142112125163,7.235984354628422,0.651890482398957,0.0651890482398957
79,경기도,성남시분당구,야탑2동,야탑2동제2투,2995,2391,726,1467,161,26,0,2380,11,604,30.50420168067227,61.63865546218488,6.764705882352941,1.0924369747899159,0.0
80,경기도,성남시분당구,야탑2동,야탑2동제3투,2364,1871,625,1058,152,23,1,1859,12,493,33.620225927918234,56.912318450779985,8.176438945669714,1.237224314147391,0.05379236148466917
81,경기도,성남시분당구,야탑2동,야탑2동제4투,1678,1332,466,743,105,8,1,1323,9,346,35.22297808012094,56.160241874527586,7.936507936507936,0.6046863189720333,0.07558578987150416
82,경기도,성남시분당구,야탑3동,관내사전투표,3930,3930,2658,940,282,27,2,3909,21,0,67.99693016116653,24.047070862113074,7.214121258633923,0.6907137375287797,0.051163980557687394
83,경기도,성남시분당구,야탑3동,야탑3동제1투,2552,1743,626,881,202,13,2,1724,19,809,36.31090487238979,51.10208816705336,11.7169373549884,0.7540603248259861,0.11600928074245939
84,경기도,성남시분당구,야탑3동,야탑3동제2투,2124,1605,599,833,157,8,0,1597,8,519,37.507827175954915,52.160300563556675,9.830932999373825,0.5009392611145899,0.0
85,경기도,성남시분당구,야탑3동,야탑3동제3투,2452,1959,733,995,206,12,0,1946,13,493,37.66700924974306,51.13052415210688,10.585817060637206,0.6166495375128468,0.0
86,경기도,성남시분당구,야탑3동,야탑3동제4투,1607,997,416,500,65,8,1,990,7,610,42.02020202020202,50.505050505050505,6.565656565656567,0.8080808080808081,0.10101010101010101
87,경기도,성남시분당구,야탑3동,야탑3동제5투,1678,1356,568,656,109,12,1,1346,10,322,42.199108469539375,48.736998514115896,8.098068350668647,0.8915304606240713,0.07429420505200594
88,경기도,성남시분당구,야탑3동,야탑3동제6투,2040,1533,599,809,102,16,0,1526,7,507,39.25294888597641,53.01441677588466,6.684141546526867,1.0484927916120577,0.0
89,경기도,성남시분당구,야탑3동,야탑3동제7투,2275,1773,813,774,159,17,2,1765,8,502,46.06232294617564,43.85269121813031,9.008498583569406,0.9631728045325779,0.11331444759206798
90,경기도,성남시분당구,금곡동,관내사전투표,4259,4259,2639,1175,367,50,4,4235,24,0,62.314049586776854,27.744982290436838,8.665879574970484,1.1806375442739079,0.09445100354191263
91,경기도,성남시분당구,금곡동,금곡동제1투,2280,1780,626,929,189,25,1,1770,10,500,35.367231638418076,52.48587570621469,10.677966101694915,1.4124293785310735,0.05649717514124294
92,경기도,성남시분당구,금곡동,금곡동제2투,2455,2019,782,1030,174,23,2,2011,8,436,38.88612630532074,51.21829935355544,8.652411735454997,1.1437095972153157,0.09945300845350571
93,경기도,성남시분당구,금곡동,금곡동제3투,1480,943,327,526,71,6,1,931,12,537,35.12352309344791,56.4983888292159,7.626208378088077,0.644468313641246,0.10741138560687433
94,경기도,성남시분당구,금곡동,금곡동제4투,2653,1939,473,1269,175,15,0,1932,7,714,24.4824016563147,65.6832298136646,9.057971014492754,0.7763975155279503,0.0
95,경기도,성남시분당구,금곡동,금곡동제5투,1341,1036,322,584,117,6,0,1029,7,305,31.292517006802722,56.754130223517976,11.370262390670554,0.5830903790087464,0.0
96,경기도,성남시분당구,금곡동,금곡동제6투,3353,2514,837,1408,236,22,0,2503,11,839,33.4398721534159,56.25249700359568,9.428685577307231,0.8789452656811825,0.0
97,경기도,성남시분당구,금곡동,금곡동제7투,2408,1766,436,1220,86,16,1,1759,7,642,24.78681068789085,69.35758953951108,4.88914155770324,0.9096077316657191,0.05685048322910744
98,경기도,성남시분당구,구미동,관내사전투표,3752,3752,2399,1008,292,37,1,3737,15,0,64.19587904736419,26.973508161626974,7.813754348407814,0.9900990099009901,0.02675943270002676
99,경기도,성남시분당구,구미동,구미동제1투,1840,1453,519,800,118,10,2,1449,4,387,35.81780538302277,55.21048999309869,8.143547273982056,0.6901311249137336,0.13802622498274672
100,경기도,성남시분당구,구미동,구미동제2투,1596,1318,493,669,137,10,1,1310,8,278,37.63358778625954,51.06870229007634,10.458015267175574,0.7633587786259541,0.07633587786259542
101,경기도,성남시분당구,구미동,구미동제3투,1343,1139,472,564,84,12,0,1132,7,204,41.69611307420495,49.82332155477032,7.420494699646643,1.0600706713780919,0.0
102,경기도,성남시분당구,구미동,구미동제4투,2196,1482,259,1127,86,6,1,1479,3,714,17.51183231913455,76.2001352265044,5.8147396889790395,0.4056795131845842,0.0676132521974307
103,경기도,성남시분당구,구미동,구미동제5투,2420,1950,665,1110,140,23,1,1939,11,470,34.29602888086642,57.24600309437855,7.2202166064981945,1.186178442496132,0.0515729757607014
104,경기도,성남시분당구,구미동,구미동제6투,1956,1459,412,916,116,11,0,1455,4,497,28.31615120274914,62.955326460481096,7.972508591065291,0.7560137457044673,0.0
105,경기도,성남시분당구,구미동,구미동제7투,3193,2296,762,1268,233,17,4,2284,12,897,33.36252189141856,55.51663747810858,10.20140105078809,0.7443082311733801,0.17513134851138354
106,경기도,성남시분당구,구미동,구미동제8투,2137,1562,674,766,93,10,4,1547,15,575,43.56819650937298,49.51519069166128,6.011635423400129,0.6464124111182934,0.25856496444731736
107,경기도,성남시분당구,구미1동,관내사전투표,6324,6324,3996,1625,614,42,7,6284,40,0,63.59007001909611,25.859325270528327,9.77084659452578,0.668364099299809,0.11139401654996818
108,경기도,성남시분당구,구미1동,구미1동제1투,2786,1830,563,1052,178,18,1,1812,18,956,31.07064017660044,58.05739514348785,9.823399558498897,0.9933774834437087,0.05518763796909492
109,경기도,성남시분당구,구미1동,구미1동제2투,2923,2311,802,1226,249,19,0,2296,15,612,34.930313588850176,53.397212543554005,10.844947735191637,0.8275261324041812,0.0
110,경기도,성남시분당구,구미1동,구미1동제3투,1425,1099,309,676,99,8,2,1094,5,326,28.244972577696526,61.79159049360147,9.049360146252285,0.7312614259597806,0.18281535648994515
111,경기도,성남시분당구,구미1동,구미1동제4투,1648,1349,480,715,134,12,0,1341,8,299,35.79418344519016,53.318419090231174,9.99254287844892,0.8948545861297539,0.0
112,경기도,성남시분당구,판교동,관내사전투표,4353,4353,2862,1056,376,37,2,4333,20,0,66.05123471036234,24.37110546965151,8.67759058389107,0.8539118393722595,0.04615739672282484
113,경기도,성남시분당구,판교동,판교동제1투,2510,1873,704,960,171,26,2,1863,10,637,37.788513150831996,51.52979066022544,9.178743961352657,1.3955984970477724,0.10735373054213634
114,경기도,성남시분당구,판교동,판교동제2투,3122,2529,946,1270,254,31,7,2508,21,593,37.719298245614034,50.63795853269537,10.127591706539075,1.2360446570972885,0.27910685805422647
115,경기도,성남시분당구,판교동,판교동제3투,3258,2483,763,1478,203,29,0,2473,10,775,30.85321471896482,59.765467044076026,8.208653457339263,1.1726647796198948,0.0
116,경기도,성남시분당구,판교동,판교동제4투,2859,2310,913,1113,241,27,3,2297,13,549,39.747496734871575,48.45450587723117,10.491946016543316,1.1754462342185459,0.13060513713539398
117,경기도,성남시분당구,판교동,판교동제5투,2316,1936,687,1058,164,10,2,1921,15,380,35.76262363352421,55.07548152004165,8.537220197813639,0.5205622071837585,0.10411244143675169
118,경기도,성남시분당구,삼평동,관내사전투표,4656,4656,3104,1021,452,54,2,4633,23,0,66.99762572846967,22.03755665875243,9.75609756097561,1.165551478523635,0.04316857327865314
119,경기도,성남시분당구,삼평동,삼평동제1투,3006,2384,886,1199,257,28,2,2372,12,622,37.35244519392917,50.548060708263066,10.834738617200674,1.1804384485666104,0.08431703204047217
120,경기도,성남시분당구,삼평동,삼평동제2투,2306,1738,660,880,172,13,2,1727,11,568,38.21656050955414,50.955414012738856,9.95946728430805,0.7527504342790967,0.11580775911986102
121,경기도,성남시분당구,삼평동,삼평동제3투,2585,1865,862,861,120,11,0,1854,11,720,46.4940668824164,46.44012944983819,6.472491909385113,0.593311758360302,0.0
122,경기도,성남시분당구,삼평동,삼평동제4투,2127,1610,493,852,226,15,2,1588,22,517,31.045340050377835,53.65239294710328,14.231738035264483,0.9445843828715366,0.12594458438287154
123,경기도,성남시분당구,삼평동,삼평동제5투,2695,2243,721,1228,257,22,2,2230,13,452,32.33183856502242,55.067264573991025,11.524663677130045,0.9865470852017937,0.08968609865470852
124,경기도,성남시분당구,백현동,관내사전투표,5571,5571,3646,1308,549,37,1,5541,30,0,65.80039704024544,23.60584731997834,9.907958852192746,0.6677495036996932,0.01804728388377549
125,경기도,성남시분당구,백현동,백현동제1투,3205,2584,875,1435,234,19,2,2565,19,621,34.1130604288499,55.945419103313846,9.12280701754386,0.7407407407407408,0.07797270955165692
126,경기도,성남시분당구,백현동,백현동제2투,2754,2036,683,1034,270,26,3,2016,20,718,33.87896825396825,51.28968253968254,13.392857142857142,1.2896825396825395,0.1488095238095238
127,경기도,성남시분당구,백현동,백현동제3투,2050,1522,454,881,160,18,0,1513,9,528,30.006609385327167,58.22868473231989,10.575016523463319,1.1896893588896233,0.0
128,경기도,성남시분당구,백현동,백현동제4투,2384,1754,837,789,106,10,1,1743,11,630,48.02065404475043,45.26678141135972,6.081468732071142,0.5737234652897304,0.05737234652897303
129,경기도,성남시분당구,백현동,백현동제5투,2164,1646,847,704,76,9,0,1636,10,518,51.77261613691931,43.03178484107579,4.645476772616137,0.5501222493887531,0.0
130,경기도,성남시분당구,백현동,백현동제6투,2243,1744,477,1050,191,20,0,1738,6,499,27.445339470655927,60.414269275028765,10.989643268124281,1.1507479861910241,0.0
131,경기도,성남시분당구,운중동,관내사전투표,5470,5470,3614,1333,427,66,3,5443,27,0,66.39720742237736,24.490170861657173,7.844938453058975,1.2125665993018555,0.055116663604629794
132,경기도,성남시분당구,운중동,운중동제1투,1733,1178,286,804,72,12,1,1175,3,555,24.340425531914896,68.42553191489363,6.127659574468085,1.0212765957446808,0.0851063829787234
133,경기도,성남시분당구,운중동,운중동제2투,2062,1562,487,928,135,5,0,1555,7,500,31.318327974276528,59.67845659163987,8.681672025723474,0.3215434083601286,0.0
134,경기도,성남시분당구,운중동,운중동제3투,2976,2158,693,1271,157,29,0,2150,8,818,32.23255813953488,59.116279069767444,7.3023255813953485,1.3488372093023255,0.0
135,경기도,성남시분당구,운중동,운중동제4투,1471,1197,470,566,139,9,2,1186,11,274,39.62900505902192,47.72344013490725,11.720067453625632,0.7588532883642496,0.16863406408094433
136,경기도,성남시분당구,운중동,운중동제5투,3422,2729,942,1559,192,24,1,2718,11,693,34.65783664459161,57.35835172921265,7.06401766004415,0.8830022075055187,0.03679175864606328
137,경기도,성남시분당구,운중동,운중동제6투,2811,2232,905,1107,198,13,2,2225,7,579,40.67415730337079,49.752808988764045,8.898876404494382,0.5842696629213483,0.0898876404494382
138,경기도,성남시분당구,운중동,운중동제7투,2531,1992,738,1031,196,17,0,1982,10,539,37.2351160443996,52.018163471241174,9.889001009081735,0.8577194752774974,0.0
139,경기도,성남시분당구,운중동,운중동제8투,4032,3238,1451,1429,312,24,3,3219,19,794,45.07611059335197,44.392668530599565,9.692451071761417,0.7455731593662628,0.09319664492078285
140,경기도,성남시분당구,잘못 투입·구분된 투표지,,0,0,0,0,0,0,0,0,0,0,0.0,0.0,0.0,0.0,0.0
0,경기도,의정부시,거소·선상투표,,600,570,274,163,112,2,3,554,16,30,49.458483754512635,29.422382671480147,20.216606498194945,0.36101083032490977,0.5415162454873645
1,경기도,의정부시,관외사전투표,,37293,37285,23476,8444,4619,349,53,36941,344,8,63.549985111393845,22.858070978046076,12.50372215153894,0.9447497360656181,0.1434720229555237
2,경기도,의정부시,재외투표,,1848,1472,1066,246,121,25,0,1458,14,376,73.11385459533608,16.872427983539097,8.299039780521262,1.7146776406035666,0.0
3,경기도,의정부시,의정부1동,관내사전투표,5956,5956,3926,1398,520,58,3,5905,51,0,66.48602878916172,23.674851820491106,8.806096528365792,0.9822184589331074,0.05080440304826418
4,경기도,의정부시,의정부1동,의정부1동제1투,4212,2423,999,1199,191,18,4,2411,12,1789,41.435089174616344,49.73040232268768,7.922024056408129,0.7465781833264206,0.16590626296142677
5,경기도,의정부시,의정부1동,의정부1동제2투,2796,1275,520,617,111,15,1,1264,11,1521,41.139240506329116,48.813291139240505,8.781645569620252,1.1867088607594938,0.07911392405063292
6,경기도,의정부시,의정부1동,의정부1동제3투,4720,2886,1257,1404,179,24,4,2868,18,1834,43.82845188284519,48.95397489539749,6.241283124128313,0.8368200836820083,0.1394700139470014
7,경기도,의정부시,의정부1동,의정부1동제4투,3046,1444,618,631,171,13,1,1434,10,1602,43.09623430962343,44.00278940027894,11.92468619246862,0.906555090655509,0.0697350069735007
8,경기도,의정부시,의정부1동,의정부1동제5투,3801,2266,940,1009,266,23,2,2240,26,1535,41.964285714285715,45.04464285714286,11.875,1.0267857142857142,0.08928571428571429
9,경기도,의정부시,의정부1동,의정부1동제6투,3618,1879,734,941,172,15,2,1864,15,1739,39.377682403433475,50.48283261802575,9.2274678111588,0.8047210300429184,0.1072961373390558
10,경기도,의정부시,의정부1동,의정부1동제7투,3196,2394,1051,1062,242,22,1,2378,16,802,44.19680403700589,44.65937762825904,10.176619007569386,0.9251471825063078,0.04205214465937763
11,경기도,의정부시,의정부2동,관내사전투표,6170,6170,4203,1390,468,55,8,6124,46,0,68.63161332462442,22.697583278902677,7.642064010450686,0.8981058131939909,0.13063357282821686
12,경기도,의정부시,의정부2동,의정부2동제1투,2521,1391,584,636,140,14,1,1375,16,1130,42.472727272727276,46.25454545454545,10.181818181818182,1.0181818181818183,0.07272727272727272
13,경기도,의정부시,의정부2동,의정부2동제2투,2682,1563,650,754,128,13,1,1546,17,1119,42.04398447606727,48.77102199223803,8.279430789133247,0.8408796895213453,0.0646830530401035
14,경기도,의정부시,의정부2동,의정부2동제3투,3665,1998,810,944,206,21,2,1983,15,1667,40.847201210287444,47.60463943519919,10.388300554715078,1.059001512859304,0.10085728693898136
15,경기도,의정부시,의정부2동,의정부2동제4투,3091,1782,765,816,161,16,2,1760,22,1309,43.465909090909086,46.36363636363636,9.147727272727273,0.9090909090909091,0.11363636363636363
16,경기도,의정부시,의정부2동,의정부2동제5투,3849,2314,1015,1103,142,31,5,2296,18,1535,44.207317073170735,48.04006968641115,6.184668989547038,1.3501742160278747,0.21777003484320556
17,경기도,의정부시,의정부2동,의정부2동제6투,2854,2243,1067,960,181,25,0,2233,10,611,47.783251231527096,42.99149126735334,8.105687416032243,1.1195700850873265,0.0
18,경기도,의정부시,호원1동,관내사전투표,7419,7419,5008,1863,432,59,8,7370,49,0,67.95115332428765,25.278154681139757,5.8616010854816825,0.8005427408412483,0.10854816824966079
19,경기도,의정부시,호원1동,호원1동제1투,2358,1531,568,811,126,17,2,1524,7,827,37.270341207349084,53.21522309711286,8.267716535433072,1.1154855643044619,0.13123359580052493
20,경기도,의정부시,호원1동,호원1동제2투,2931,2220,819,1201,162,19,3,2204,16,711,37.15970961887478,54.491833030853,7.350272232304899,0.8620689655172413,0.13611615245009073
21,경기도,의정부시,호원1동,호원1동제3투,2248,1317,592,596,109,14,0,1311,6,931,45.156369183829135,45.46147978642258,8.314263920671243,1.0678871090770405,0.0
22,경기도,의정부시,호원1동,호원1동제4투,3914,2513,1212,1064,194,18,3,2491,22,1401,48.65515857085508,42.713769570453636,7.788036932958652,0.7226013649136892,0.12043356081894822
23,경기도,의정부시,호원1동,호원1동제5투,2661,1819,798,866,125,16,1,1806,13,842,44.18604651162791,47.95127353266888,6.921373200442968,0.8859357696566998,0.05537098560354374
24,경기도,의정부시,호원1동,호원1동제6투,3161,2390,1018,1195,138,23,1,2375,15,771,42.863157894736844,50.31578947368421,5.810526315789474,0.968421052631579,0.042105263157894736
25,경기도,의정부시,호원1동,호원1동제7투,2243,1680,726,798,124,21,2,1671,9,563,43.447037701974864,47.755834829443444,7.4207061639736684,1.2567324955116697,0.11968880909634949
26,경기도,의정부시,호원2동,관내사전투표,8782,8782,5893,2173,576,79,8,8729,53,0,67.51059686103793,24.894031389620803,6.598694008477489,0.9050292129682667,0.09164852789552068
27,경기도,의정부시,호원2동,호원2동제1투,3439,2205,879,1114,167,23,2,2185,20,1234,40.22883295194508,50.983981693363845,7.643020594965676,1.0526315789473684,0.09153318077803205
28,경기도,의정부시,호원2동,호원2동제2투,2444,1838,742,919,134,20,0,1815,23,606,40.88154269972451,50.633608815427,7.382920110192838,1.1019283746556474,0.0
29,경기도,의정부시,호원2동,호원2동제3투,3658,2370,979,1175,177,21,1,2353,17,1288,41.60645983850404,49.93625159371015,7.522311942201446,0.8924776880577986,0.042498937526561836
30,경기도,의정부시,호원2동,호원2동제4투,2381,1713,673,896,109,20,1,1699,14,668,39.61153619776339,52.73690406121248,6.4155385520894646,1.1771630370806356,0.05885815185403178
31,경기도,의정부시,호원2동,호원2동제5투,3092,2111,914,1007,151,21,2,2095,16,981,43.627684964200476,48.066825775656326,7.20763723150358,1.0023866348448687,0.0954653937947494
32,경기도,의정부시,호원2동,호원2동제6투,2676,2080,855,1037,156,22,0,2070,10,596,41.30434782608695,50.09661835748792,7.536231884057972,1.0628019323671498,0.0
33,경기도,의정부시,장암동,관내사전투표,4621,4620,3089,1139,313,41,2,4584,36,1,67.38656195462478,24.847294938917976,6.828097731239093,0.8944153577661431,0.04363001745200698
34,경기도,의정부시,장암동,장암동제1투,2074,1503,621,766,90,14,2,1493,10,571,41.59410582719357,51.306095110515734,6.028131279303416,0.9377093101138647,0.13395847287340923
35,경기도,의정부시,장암동,장암동제2투,2562,1762,768,818,136,26,1,1749,13,800,43.910806174957116,46.76958261863922,7.775871926815323,1.4865637507146943,0.05717552887364208
36,경기도,의정부시,장암동,장암동제3투,1964,1289,469,715,87,14,0,1285,4,675,36.49805447470817,55.6420233463035,6.770428015564202,1.0894941634241244,0.0
37,경기도,의정부시,장암동,장암동제4투,2090,1515,673,700,119,17,1,1510,5,575,44.56953642384106,46.35761589403973,7.880794701986756,1.1258278145695364,0.06622516556291391
38,경기도,의정부시,장암동,장암동제5투,1946,1559,757,665,104,19,2,1547,12,387,48.93341952165481,42.98642533936652,6.722689075630252,1.2281835811247577,0.12928248222365868
39,경기도,의정부시,신곡1동,관내사전투표,6371,6371,4416,1500,370,49,3,6338,33,0,69.67497633322814,23.666771852319343,5.8378037235721045,0.7731145471757652,0.047333543704638686
40,경기도,의정부시,신곡1동,신곡1동제1투,3070,1874,734,980,132,12,3,1861,13,1196,39.44116066630844,52.659860290166584,7.092960773777539,0.6448146157979581,0.16120365394948952
41,경기도,의정부시,신곡1동,신곡1동제2투,2812,1998,880,923,161,20,2,1986,12,814,44.31017119838872,46.47532729103726,8.1067472306143,1.0070493454179255,0.10070493454179255
42,경기도,의정부시,신곡1동,신곡1동제3투,3590,2292,1021,1094,151,16,1,2283,9,1298,44.72185720543145,47.91940429259746,6.614104248795445,0.700832238282961,0.043802014892685065
43,경기도,의정부시,신곡1동,신곡1동제4투,3048,2131,935,1019,131,26,0,2111,20,917,44.291804831833254,48.27096162955945,6.20558976788252,1.231643770724775,0.0
44,경기도,의정부시,신곡1동,신곡1동제5투,3893,2702,1234,1192,228,27,1,2682,20,1191,46.01043997017151,44.44444444444444,8.501118568232663,1.006711409395973,0.03728560775540641
45,경기도,의정부시,신곡1동,신곡1동제6투,2324,1790,879,702,175,19,1,1776,14,534,49.49324324324324,39.52702702702703,9.853603603603604,1.0698198198198199,0.05630630630630631
46,경기도,의정부시,신곡1동,신곡1동제7투,3563,2555,1082,1219,197,32,3,2533,22,1008,42.71614686142913,48.124753257007505,7.777339123568891,1.2633241215949467,0.11843663639952626
47,경기도,의정부시,신곡1동,신곡1동제8투,2468,1974,996,772,177,17,0,1962,12,494,50.764525993883794,39.347604485219165,9.021406727828746,0.8664627930682977,0.0
48,경기도,의정부시,신곡2동,관내사전투표,9655,9655,6477,2420,629,79,4,9609,46,0,67.40555729004059,25.184722655843476,6.545946508481632,0.8221459048808409,0.0416276407534603
49,경기도,의정부시,신곡2동,신곡2동제1투,2357,1612,530,947,111,13,0,1601,11,745,33.10430980637102,59.15053091817614,6.9331667707682705,0.8119925046845722,0.0
50,경기도,의정부시,신곡2동,신곡2동제2투,2570,1762,728,881,122,17,1,1749,13,808,41.62378502001143,50.37164093767868,6.975414522584334,0.9719839908519153,0.05717552887364208
51,경기도,의정부시,신곡2동,신곡2동제3투,3210,2221,1003,1004,180,19,6,2212,9,989,45.34358047016275,45.388788426763114,8.1374321880651,0.8589511754068716,0.27124773960216997
52,경기도,의정부시,신곡2동,신곡2동제4투,3601,2447,1021,1199,180,28,1,2429,18,1154,42.03375874845616,49.361877315767806,7.410456978180322,1.1527377521613833,0.04116920543433512
53,경기도,의정부시,신곡2동,신곡2동제5투,2905,1862,847,850,136,16,1,1850,12,1043,45.78378378378378,45.94594594594595,7.351351351351351,0.8648648648648649,0.05405405405405406
54,경기도,의정부시,신곡2동,신곡2동제6투,3000,2214,1010,979,177,24,1,2191,23,786,46.097672295755366,44.68279324509356,8.07850296668188,1.0953902327704246,0.045641259698767686
55,경기도,의정부시,신곡2동,신곡2동제7투,2622,2014,906,914,160,19,3,2002,12,608,45.25474525474525,45.654345654345654,7.992007992007992,0.949050949050949,0.14985014985014986
56,경기도,의정부시,신곡2동,신곡2동제8투,2652,1768,799,854,91,11,4,1759,9,884,45.42353610005685,48.55031267765776,5.1733939738487775,0.625355315520182,0.22740193291642977
57,경기도,의정부시,신곡2동,신곡2동제9투,2837,2247,1132,887,193,22,1,2235,12,590,50.648769574944076,39.686800894854585,8.635346756152124,0.9843400447427294,0.0447427293064877
58,경기도,의정부시,송산1동,관내사전투표,5399,5399,3648,1314,359,42,6,5369,30,0,67.94561370832557,24.47383125349227,6.686533805177873,0.7822685788787485,0.11175265412553548
59,경기도,의정부시,송산1동,송산1동제1투,2724,1692,610,921,121,22,2,1676,16,1032,36.39618138424821,54.95226730310262,7.219570405727923,1.3126491646778042,0.11933174224343676
60,경기도,의정부시,송산1동,송산1동제2투,3206,2053,865,1021,139,15,1,2041,12,1153,42.381185693287605,50.02449779519843,6.810387065164135,0.7349338559529642,0.04899559039686428
61,경기도,의정부시,송산1동,송산1동제3투,3781,2325,1109,1000,176,20,4,2309,16,1456,48.0294499783456,43.30879168471199,7.622347336509311,0.86617583369424,0.17323516673884798
62,경기도,의정부시,송산1동,송산1동제4투,2137,1534,743,659,103,15,0,1520,14,603,48.88157894736842,43.35526315789473,6.776315789473684,0.9868421052631579,0.0
63,경기도,의정부시,송산1동,송산1동제5투,2232,1282,536,625,105,9,2,1277,5,950,41.973375097885665,48.94283476898982,8.22239624119029,0.7047768206734534,0.15661707126076743
64,경기도,의정부시,송산1동,송산1동제6투,3793,2911,1272,1290,306,21,4,2893,18,882,43.96819910127895,44.59039059799516,10.577255444175595,0.7258900795022468,0.13826477704804702
65,경기도,의정부시,송산2동,관내사전투표,7835,7835,5547,1683,497,56,2,7785,50,0,71.252408477842,21.61849710982659,6.384071933204881,0.7193320488118176,0.02569043031470777
66,경기도,의정부시,송산2동,송산2동제1투,2293,1468,665,645,124,17,3,1454,14,825,45.73590096286107,44.36038514442916,8.528198074277855,1.1691884456671253,0.20632737276478677
67,경기도,의정부시,송산2동,송산2동제2투,3167,2056,955,901,167,18,1,2042,14,1111,46.767874632713024,44.1234084231146,8.178256611165525,0.881488736532811,0.04897159647404505
68,경기도,의정부시,송산2동,송산2동제3투,2831,2040,919,937,148,19,4,2027,13,791,45.33793783917119,46.22594967932906,7.301430685742477,0.9373458312777503,0.19733596447952642
69,경기도,의정부시,송산2동,송산2동제4투,2003,1481,702,645,104,18,1,1470,11,522,47.755102040816325,43.87755102040816,7.07482993197279,1.2244897959183674,0.06802721088435373
70,경기도,의정부시,송산2동,송산2동제5투,2311,1571,704,713,121,19,4,1561,10,740,45.09929532351057,45.67584881486227,7.751441383728379,1.2171684817424726,0.25624599615631005
71,경기도,의정부시,송산2동,송산2동제6투,2651,1778,805,802,141,13,3,1764,14,873,45.63492063492063,45.46485260770975,7.993197278911565,0.7369614512471655,0.17006802721088435
72,경기도,의정부시,송산2동,송산2동제7투,2197,1425,655,613,128,20,0,1416,9,772,46.25706214689266,43.2909604519774,9.03954802259887,1.4124293785310735,0.0
73,경기도,의정부시,송산3동,관내사전투표,8432,8432,6039,1760,537,58,4,8398,34,0,71.90997856632532,20.957370802572044,6.394379614193856,0.6906406287211241,0.04763038818766373
74,경기도,의정부시,송산3동,송산3동제1투,2659,1701,758,795,123,17,1,1694,7,958,44.74616292798111,46.930342384887844,7.260920897284534,1.0035419126328218,0.05903187721369539
75,경기도,의정부시,송산3동,송산3동제2투,2803,2207,1184,782,205,23,2,2196,11,596,53.916211293260474,35.61020036429873,9.335154826958107,1.0473588342440803,0.09107468123861566
76,경기도,의정부시,송산3동,송산3동제3투,3773,2600,1265,1083,212,27,2,2589,11,1173,48.8605639242951,41.83082271147161,8.188489764387795,1.0428736964078795,0.0772499034376207
77,경기도,의정부시,송산3동,송산3동제4투,3805,2736,1381,1057,245,34,4,2721,15,1069,50.75339948548327,38.8460124954061,9.00404263138552,1.2495406100698274,0.1470047776552738
78,경기도,의정부시,송산3동,송산3동제5투,4028,2796,1442,1066,245,29,1,2783,13,1232,51.814588573481856,38.303988501616956,8.803449514911964,1.0420409629895795,0.035932446999640676
79,경기도,의정부시,송산3동,송산3동제6투,3029,1949,960,831,130,13,3,1937,12,1080,49.561177077955605,42.90139390810532,6.7114093959731544,0.6711409395973155,0.15487867836861124
80,경기도,의정부시,송산3동,송산3동제7투,2977,1787,798,806,147,20,0,1771,16,1190,45.059288537549406,45.511010728402034,8.300395256916996,1.129305477131564,0.0
81,경기도,의정부시,자금동,관내사전투표,4596,4596,3154,1086,287,44,5,4576,20,0,68.92482517482517,23.732517482517483,6.2718531468531475,0.9615384615384616,0.10926573426573427
82,경기도,의정부시,자금동,자금동제1투,2272,1225,479,632,91,13,1,1216,9,1047,39.39144736842105,51.973684210526315,7.483552631578948,1.069078947368421,0.08223684210526315
83,경기도,의정부시,자금동,자금동제2투,2783,2111,933,989,157,21,1,2101,10,672,44.40742503569729,47.07282246549263,7.472632079961923,0.9995240361732507,0.047596382674916705
84,경기도,의정부시,자금동,자금동제3투,2263,1396,620,646,99,11,4,1380,16,867,44.927536231884055,46.81159420289855,7.173913043478261,0.7971014492753623,0.2898550724637681
85,경기도,의정부시,자금동,자금동제4투,2070,1348,570,657,85,17,4,1333,15,722,42.760690172543136,49.287321830457614,6.3765941485371345,1.275318829707427,0.30007501875468867
86,경기도,의정부시,자금동,자금동제5투,2552,1732,805,775,122,15,1,1718,14,820,46.85681024447032,45.11059371362049,7.1012805587892895,0.8731082654249126,0.05820721769499418
87,경기도,의정부시,자금동,자금동제6투,3608,2588,1196,1143,206,23,2,2570,18,1020,46.536964980544745,44.474708171206224,8.01556420233463,0.8949416342412451,0.07782101167315175
88,경기도,의정부시,가능동,관내사전투표,6447,6447,4219,1791,356,30,8,6404,43,0,65.88069956277327,27.966895690193628,5.559025608994379,0.4684572142410993,0.12492192379762648
89,경기도,의정부시,가능동,가능동제1투,4256,2278,1001,1075,153,28,2,2259,19,1978,44.31164231961044,47.58742806551572,6.772908366533864,1.239486498450642,0.08853474988933156
90,경기도,의정부시,가능동,가능동제2투,2862,1803,757,880,134,19,2,1792,11,1059,42.24330357142857,49.107142857142854,7.477678571428571,1.0602678571428572,0.11160714285714285
91,경기도,의정부시,가능동,가능동제3투,3167,1945,813,944,146,24,4,1931,14,1222,42.102537545313304,48.8865872604868,7.560849300880373,1.2428793371310203,0.20714655618850336
92,경기도,의정부시,가능동,가능동제4투,3320,1723,711,866,116,14,1,1708,15,1597,41.62763466042155,50.70257611241218,6.791569086651054,0.819672131147541,0.0585480093676815
93,경기도,의정부시,흥선동,관내사전투표,4087,4087,2676,1086,255,34,6,4057,30,0,65.96006901651467,26.768548188316487,6.285432585654424,0.8380576780872565,0.1478925314271629
94,경기도,의정부시,흥선동,흥선동제1투,3139,1734,707,887,111,10,2,1717,17,1405,41.17647058823529,51.6598718695399,6.46476412347117,0.5824111822947,0.11648223645894001
95,경기도,의정부시,흥선동,흥선동제2투,3135,1738,740,834,134,14,2,1724,14,1397,42.92343387470998,48.37587006960557,7.77262180974478,0.8120649651972157,0.11600928074245939
96,경기도,의정부시,흥선동,흥선동제3투,2754,1773,778,832,131,17,1,1759,14,981,44.22967595224559,47.299602046617395,7.447413303013076,0.9664582148948266,0.05685048322910744
97,경기도,의정부시,흥선동,흥선동제4투,1850,1032,402,551,65,10,0,1028,4,818,39.10505836575876,53.599221789883266,6.3229571984435795,0.9727626459143969,0.0
98,경기도,의정부시,녹양동,관내사전투표,4916,4916,3250,1285,301,41,5,4882,34,0,66.5710774272839,26.3211798443261,6.1655059401884476,0.8398197460057353,0.10241704219582139
99,경기도,의정부시,녹양동,녹양동제1투,2746,1628,614,877,113,16,2,1622,6,1118,37.85450061652281,54.069050554870536,6.966707768187423,0.9864364981504316,0.12330456226880394
100,경기도,의정부시,녹양동,녹양동제2투,2835,1913,823,906,155,16,4,1904,9,922,43.22478991596639,47.58403361344538,8.140756302521009,0.8403361344537815,0.21008403361344538
101,경기도,의정부시,녹양동,녹양동제3투,3665,2355,1006,1148,156,23,3,2336,19,1310,43.06506849315068,49.14383561643836,6.678082191780822,0.9845890410958904,0.12842465753424656
102,경기도,의정부시,녹양동,녹양동제4투,1372,829,339,414,61,7,1,822,7,543,41.24087591240876,50.36496350364964,7.420924574209247,0.851581508515815,0.12165450121654502
103,경기도,의정부시,고산동,관내사전투표,5118,5118,3673,970,396,46,3,5088,30,0,72.18946540880503,19.06446540880503,7.783018867924528,0.9040880503144654,0.0589622641509434
104,경기도,의정부시,고산동,고산동제1투,1507,949,373,471,89,12,0,945,4,558,39.470899470899475,49.84126984126984,9.417989417989418,1.2698412698412698,0.0
105,경기도,의정부시,고산동,고산동제2투,495,303,95,187,17,2,1,302,1,192,31.456953642384107,61.920529801324506,5.629139072847682,0.6622516556291391,0.33112582781456956
106,경기도,의정부시,고산동,고산동제3투,3173,2155,1033,872,203,36,0,2144,11,1018,48.18097014925373,40.67164179104478,9.468283582089553,1.6791044776119404,0.0
107,경기도,의정부시,고산동,고산동제4투,3621,2446,1218,999,196,18,3,2434,12,1175,50.04108463434675,41.04354971240756,8.052588331963847,0.7395234182415776,0.12325390304026293
108,경기도,의정부시,고산동,고산동제5투,3557,2653,1349,1017,245,26,0,2637,16,904,51.15661736822147,38.56655290102389,9.290860826697005,0.9859689040576414,0.0
109,경기도,의정부시,고산동,고산동제6투,2733,1992,1017,745,195,20,1,1978,14,741,51.415571284125384,37.664307381193126,9.858442871587462,1.0111223458038423,0.05055611729019212
110,경기도,의정부시,잘못 투입·구분된 투표지,,0,0,0,0,0,0,0,0,0,0,0.0,0.0,0.0,0.0,0.0
0,경기도,안양시만안구,거소·선상투표,,236,225,97,59,61,2,1,220,5,11,44.09090909090909,26.81818181818182,27.727272727272727,0.9090909090909091,0.45454545454545453
1,경기도,안양시만안구,관외사전투표,,21593,21589,13215,5131,2763,228,22,21359,230,4,61.87087410459291,24.022660236902478,12.93599887635189,1.0674657053232828,0.10300107682943958
2,경기도,안양시만안구,재외투표,,1192,996,706,187,94,6,0,993,3,196,71.09768378650554,18.831822759315205,9.466263846928499,0.6042296072507553,0.0
3,경기도,안양시만안구,안양1동,관내사전투표,4055,4055,2575,1053,361,43,1,4033,22,0,63.848251921646415,26.109595834366477,8.951152987850236,1.0662038184973965,0.024795437639474338
4,경기도,안양시만안구,안양1동,안양1동제1투,2937,2309,798,1201,269,21,1,2290,19,628,34.84716157205241,52.44541484716157,11.746724890829695,0.9170305676855894,0.043668122270742356
5,경기도,안양시만안구,안양1동,안양1동제2투,3011,2394,994,1088,261,28,2,2373,21,617,41.88790560471977,45.84913611462284,10.998735777496838,1.1799410029498525,0.08428150021070376
6,경기도,안양시만안구,안양1동,안양1동제3투,1898,1069,422,505,115,12,5,1059,10,829,39.848914069877246,47.68649669499528,10.859301227573184,1.13314447592068,0.4721435316336166
7,경기도,안양시만안구,안양1동,안양1동제4투,2212,1794,630,951,189,10,0,1780,14,418,35.39325842696629,53.426966292134836,10.617977528089888,0.5617977528089888,0.0
8,경기도,안양시만안구,안양2동,관내사전투표,4031,4031,2666,1010,286,37,1,4000,31,0,66.64999999999999,25.25,7.1499999999999995,0.9249999999999999,0.025
9,경기도,안양시만안구,안양2동,안양2동제1투,2584,1626,699,790,120,5,0,1614,12,958,43.30855018587361,48.946716232961585,7.434944237918216,0.30978934324659235,0.0
10,경기도,안양시만안구,안양2동,안양2동제2투,3116,2114,853,988,232,20,3,2096,18,1002,40.69656488549619,47.13740458015267,11.068702290076336,0.9541984732824428,0.1431297709923664
11,경기도,안양시만안구,안양2동,안양2동제3투,2186,1421,598,689,112,12,1,1412,9,765,42.35127478753541,48.79603399433427,7.932011331444759,0.84985835694051,0.0708215297450425
12,경기도,안양시만안구,안양2동,안양2동제4투,2843,2003,755,1026,182,23,1,1987,16,840,37.99698037242074,51.63563160543533,9.159536990437847,1.1575239053850024,0.050327126321087066
13,경기도,안양시만안구,안양2동,안양2동제5투,2417,1874,813,848,178,24,1,1864,10,543,43.61587982832618,45.493562231759654,9.549356223175966,1.2875536480686696,0.0536480686695279
14,경기도,안양시만안구,안양3동,관내사전투표,3521,3521,2351,916,207,31,3,3508,13,0,67.01824401368302,26.111744583808438,5.900798175598632,0.8836944127708095,0.08551881413911061
15,경기도,안양시만안구,안양3동,안양3동제1투,1894,1119,441,581,85,4,2,1113,6,775,39.62264150943396,52.20125786163522,7.637017070979335,0.3593890386343217,0.17969451931716085
16,경기도,안양시만안구,안양3동,안양3동제2투,2138,1401,575,683,116,15,1,1390,11,737,41.36690647482014,49.13669064748201,8.345323741007196,1.079136690647482,0.07194244604316546
17,경기도,안양시만안구,안양3동,안양3동제3투,2815,1719,697,848,151,10,0,1706,13,1096,40.85580304806565,49.70691676436108,8.851113716295428,0.5861664712778429,0.0
18,경기도,안양시만안구,안양3동,안양3동제4투,2089,1582,639,795,118,22,0,1574,8,507,40.59720457433291,50.508259212198226,7.496823379923762,1.3977128335451081,0.0
19,경기도,안양시만안구,안양4동,관내사전투표,2424,2424,1535,701,137,26,2,2401,23,0,63.93169512703041,29.196168263223655,5.705955851728446,1.0828821324448146,0.08329862557267806
20,경기도,안양시만안구,안양4동,안양4동제1투,2077,1303,472,696,105,15,1,1289,14,774,36.61753297129558,53.995345228859584,8.145849495733126,1.1636927851047323,0.07757951900698215
21,경기도,안양시만안구,안양4동,안양4동제2투,1625,1141,440,613,71,9,2,1135,6,484,38.76651982378855,54.008810572687224,6.255506607929516,0.7929515418502203,0.1762114537444934
22,경기도,안양시만안구,안양5동,관내사전투표,3177,3177,2001,926,204,23,2,3156,21,0,63.40304182509505,29.340937896070972,6.4638783269961975,0.7287705956907478,0.06337135614702154
23,경기도,안양시만안구,안양5동,안양5동제1투,2444,1567,547,886,115,10,1,1559,8,877,35.08659397049391,56.8313021167415,7.376523412443873,0.6414368184733804,0.06414368184733803
24,경기도,안양시만안구,안양5동,안양5동제2투,2749,1971,831,894,220,11,2,1958,13,778,42.44126659856997,45.658835546476,11.235955056179774,0.5617977528089888,0.10214504596527069
25,경기도,안양시만안구,안양5동,안양5동제3투,2694,1751,723,843,147,17,2,1732,19,943,41.74364896073903,48.672055427251735,8.48729792147806,0.9815242494226328,0.11547344110854503
26,경기도,안양시만안구,안양6동,관내사전투표,4543,4543,3069,1063,366,16,3,4517,26,0,67.94332521585122,23.53331857427496,8.102723046269649,0.3542174009298207,0.06641576267434138
27,경기도,안양시만안구,안양6동,안양6동제1투,3713,2489,1089,1140,220,20,2,2471,18,1224,44.07122622420073,46.135167948199104,8.903278025091057,0.8093889113719142,0.08093889113719142
28,경기도,안양시만안구,안양6동,안양6동제2투,3187,2300,981,997,279,19,1,2277,23,887,43.08300395256917,43.78568291611769,12.25296442687747,0.834431269213878,0.04391743522178305
29,경기도,안양시만안구,안양6동,안양6동제3투,3293,2222,870,1080,234,17,0,2201,21,1071,39.52748750567924,49.06860517946388,10.631531122217174,0.7723761926397091,0.0
30,경기도,안양시만안구,안양6동,안양6동제4투,2309,1483,584,731,137,13,2,1467,16,826,39.8091342876619,49.82958418541241,9.338786639400135,0.8861622358554875,0.136332651670075
31,경기도,안양시만안구,안양6동,안양6동제5투,2993,2177,923,985,226,24,2,2160,17,816,42.73148148148148,45.601851851851855,10.462962962962962,1.1111111111111112,0.0925925925925926
32,경기도,안양시만안구,안양7동,관내사전투표,3889,3888,2566,902,375,26,2,3871,17,1,66.28778093515886,23.30147248772927,9.68741927150607,0.6716610694910876,0.051666236114699046
33,경기도,안양시만안구,안양7동,안양7동제1투,3332,2587,983,1330,218,34,1,2566,21,745,38.308651597817615,51.831644583008575,8.495713172252534,1.3250194855806703,0.03897116134060795
34,경기도,안양시만안구,안양7동,안양7동제2투,2868,2180,932,1008,204,19,1,2164,16,688,43.068391866913124,46.58040665434381,9.426987060998151,0.878003696857671,0.04621072088724584
35,경기도,안양시만안구,안양7동,안양7동제3투,1359,839,347,399,74,9,1,830,9,520,41.807228915662655,48.07228915662651,8.91566265060241,1.0843373493975903,0.12048192771084339
36,경기도,안양시만안구,안양8동,관내사전투표,2299,2299,1460,626,183,13,3,2285,14,0,63.89496717724289,27.39606126914661,8.00875273522976,0.5689277899343544,0.13129102844638948
37,경기도,안양시만안구,안양8동,안양8동제1투,1293,843,276,482,73,5,1,837,6,450,32.97491039426524,57.58661887694145,8.72162485065711,0.5973715651135006,0.11947431302270012
38,경기도,안양시만안구,안양8동,안양8동제2투,2351,1496,616,725,123,18,2,1484,12,855,41.509433962264154,48.8544474393531,8.288409703504044,1.2129380053908356,0.13477088948787064
39,경기도,안양시만안구,안양8동,안양8동제3투,1160,784,286,421,68,5,0,780,4,376,36.666666666666664,53.97435897435897,8.717948717948717,0.641025641025641,0.0
40,경기도,안양시만안구,안양9동,관내사전투표,3242,3242,2123,916,167,20,3,3229,13,0,65.74790956952616,28.36791576339424,5.1718798389594305,0.6193868070610096,0.09290802105915144
41,경기도,안양시만안구,안양9동,안양9동제1투,1480,996,349,565,63,10,0,987,9,484,35.3596757852077,57.244174265450866,6.382978723404255,1.0131712259371835,0.0
42,경기도,안양시만안구,안양9동,안양9동제2투,2164,1495,584,780,102,17,1,1484,11,669,39.35309973045822,52.56064690026954,6.873315363881402,1.1455525606469004,0.06738544474393532
43,경기도,안양시만안구,안양9동,안양9동제3투,2142,1359,561,677,96,14,2,1350,9,783,41.55555555555556,50.14814814814815,7.111111111111111,1.037037037037037,0.14814814814814814
44,경기도,안양시만안구,안양9동,안양9동제4투,3082,2135,858,1119,131,15,3,2126,9,947,40.35747883349012,52.634054562558795,6.161806208842897,0.7055503292568204,0.14111006585136407
45,경기도,안양시만안구,석수1동,관내사전투표,4076,4076,2734,997,299,27,0,4057,19,0,67.38969682031058,24.574808972146904,7.3699778161202865,0.6655163914222332,0.0
46,경기도,안양시만안구,석수1동,석수1동제1투,2754,2007,718,1076,167,26,1,1988,19,747,36.116700201207244,54.12474849094567,8.400402414486921,1.30784708249497,0.05030181086519115
47,경기도,안양시만안구,석수1동,석수1동제2투,2453,1598,571,899,96,16,1,1583,15,855,36.070751737207836,56.79090334807327,6.0644346178142765,1.010739102969046,0.06317119393556538
48,경기도,안양시만안구,석수1동,석수1동제3투,2275,1895,880,819,160,22,0,1881,14,380,46.783625730994146,43.54066985645933,8.506113769271664,1.1695906432748537,0.0
49,경기도,안양시만안구,석수1동,석수1동제4투,3255,2660,1101,1291,238,21,1,2652,8,595,41.5158371040724,48.68024132730015,8.974358974358974,0.7918552036199095,0.037707390648567124
50,경기도,안양시만안구,석수2동,관내사전투표,5518,5518,3713,1375,356,40,3,5487,31,0,67.66903590304356,25.05923090942227,6.488062693639511,0.7289958082741024,0.054674685620557675
51,경기도,안양시만안구,석수2동,석수2동제1투,1277,847,316,436,75,12,0,839,8,430,37.66388557806913,51.96662693682956,8.939213349225268,1.430274135876043,0.0
52,경기도,안양시만안구,석수2동,석수2동제2투,2574,1918,750,992,161,8,1,1912,6,656,39.22594142259414,51.88284518828452,8.42050209205021,0.41841004184100417,0.05230125523012552
53,경기도,안양시만안구,석수2동,석수2동제3투,1613,1032,392,544,74,10,2,1022,10,581,38.35616438356164,53.22896281800391,7.240704500978473,0.9784735812133072,0.19569471624266144
54,경기도,안양시만안구,석수2동,석수2동제4투,1981,1516,660,736,99,14,0,1509,7,465,43.737574552683895,48.7740225314778,6.560636182902585,0.9277667329357191,0.0
55,경기도,안양시만안구,석수2동,석수2동제5투,1730,1199,521,583,74,9,0,1187,12,531,43.8921651221567,49.11541701769166,6.234203875315923,0.7582139848357203,0.0
56,경기도,안양시만안구,석수2동,석수2동제6투,1979,1222,497,577,126,14,1,1215,7,757,40.90534979423868,47.48971193415638,10.37037037037037,1.1522633744855968,0.0823045267489712
57,경기도,안양시만안구,석수2동,석수2동제7투,3127,2446,1163,1029,202,35,1,2430,16,681,47.86008230452675,42.34567901234568,8.31275720164609,1.440329218106996,0.0411522633744856
58,경기도,안양시만안구,석수2동,석수2동제8투,2902,2346,1192,910,210,19,2,2333,13,556,51.09301328761252,39.00557222460351,9.001285897985428,0.8144020574367767,0.08572653236176596
59,경기도,안양시만안구,충훈동,관내사전투표,2930,2929,1954,745,188,19,3,2909,20,1,67.17084908903404,25.61017531797869,6.462701959436232,0.6531454107940873,0.10312822275696115
60,경기도,안양시만안구,충훈동,충훈동제1투,2325,1566,654,771,119,15,1,1560,6,759,41.92307692307693,49.42307692307693,7.628205128205129,0.9615384615384616,0.0641025641025641
61,경기도,안양시만안구,충훈동,충훈동제2투,2215,1564,688,713,133,17,2,1553,11,651,44.30135222150676,45.9111397295557,8.564069542820347,1.0946555054732776,0.128783000643915
62,경기도,안양시만안구,충훈동,충훈동제3투,1996,1292,571,583,114,9,4,1281,11,704,44.57455113192818,45.51131928181108,8.899297423887589,0.702576112412178,0.312256049960968
63,경기도,안양시만안구,박달1동,관내사전투표,3713,3713,2470,1023,182,14,2,3691,22,0,66.91953400162558,27.71606610674614,4.930913031698727,0.3793010024383636,0.0541858574911948
64,경기도,안양시만안구,박달1동,박달1동제1투,2339,1461,585,728,109,22,3,1447,14,878,40.428472702142365,50.310988251554946,7.532826537664132,1.520387007601935,0.2073255010366275
65,경기도,안양시만안구,박달1동,박달1동제2투,1539,898,383,456,51,2,1,893,5,641,42.889137737961924,51.06382978723404,5.711086226203808,0.22396416573348266,0.11198208286674133
66,경기도,안양시만안구,박달1동,박달1동제3투,1690,1052,394,580,66,7,1,1048,4,638,37.595419847328245,55.343511450381676,6.297709923664121,0.6679389312977099,0.09541984732824427
67,경기도,안양시만안구,박달1동,박달1동제4투,2343,1717,757,815,113,17,1,1703,14,626,44.45096887844979,47.856723429242514,6.635349383440986,0.9982384028185555,0.05871990604815032
68,경기도,안양시만안구,박달2동,관내사전투표,4258,4258,2911,938,327,42,6,4224,34,0,68.9157196969697,22.206439393939394,7.7414772727272725,0.9943181818181818,0.14204545454545456
69,경기도,안양시만안구,박달2동,박달2동제1투,1805,1206,499,568,111,13,4,1195,11,599,41.75732217573222,47.53138075313807,9.288702928870293,1.0878661087866108,0.33472803347280333
70,경기도,안양시만안구,박달2동,박달2동제2투,1738,1385,609,649,108,11,0,1377,8,353,44.226579520697165,47.131445170660854,7.8431372549019605,0.7988380537400145,0.0
71,경기도,안양시만안구,박달2동,박달2동제3투,2299,1662,689,793,143,20,2,1647,15,637,41.833636915604124,48.148148148148145,8.682452944748027,1.214329083181542,0.12143290831815423
72,경기도,안양시만안구,박달2동,박달2동제4투,2571,1843,785,885,146,14,2,1832,11,728,42.84934497816594,48.30786026200873,7.969432314410481,0.7641921397379913,0.10917030567685589
73,경기도,안양시만안구,박달2동,박달2동제5투,2568,2022,874,929,186,18,2,2009,13,546,43.504230960676956,46.241911398705824,9.258337481333998,0.8959681433549029,0.09955201592832255
74,경기도,안양시만안구,잘못 투입·구분된 투표지,,0,0,0,0,0,0,0,0,0,0,0.0,0.0,0.0,0.0,0.0
0,경기도,안양시동안구,거소·선상투표,,282,275,99,98,70,0,0,267,8,7,37.07865168539326,36.70411985018727,26.217228464419474,0.0,0.0
1,경기도,안양시동안구,관외사전투표,,28721,28719,16981,6939,4215,295,28,28458,261,2,59.67039145407267,24.383301707779886,14.811300864431795,1.0366153629910746,0.09839061072457658
2,경기도,안양시동안구,재외투표,,2257,1872,1259,383,206,19,0,1867,5,385,67.43438671665774,20.51419389394751,11.033743974290305,1.0176754151044456,0.0
3,경기도,안양시동안구,비산1동,관내사전투표,4723,4723,3187,1083,386,37,2,4695,28,0,67.88072417465388,23.067092651757186,8.221512247071352,0.7880724174653887,0.042598509052183174
4,경기도,안양시동안구,비산1동,비산1동제1투,1941,1375,556,649,144,16,0,1365,10,566,40.73260073260073,47.54578754578754,10.54945054945055,1.1721611721611722,0.0
5,경기도,안양시동안구,비산1동,비산1동제2투,1841,1489,661,652,157,14,0,1484,5,352,44.541778975741245,43.93530997304582,10.579514824797844,0.9433962264150944,0.0
6,경기도,안양시동안구,비산1동,비산1동제3투,2083,1651,706,742,181,10,2,1641,10,432,43.02254722730043,45.21633150517977,11.029859841560025,0.6093845216331505,0.1218769043266301
7,경기도,안양시동안구,비산1동,비산1동제4투,3070,2356,958,1130,225,24,2,2339,17,714,40.957674219752036,48.31124412141941,9.619495510902095,1.0260795211628901,0.08550662676357418
8,경기도,안양시동안구,비산1동,비산1동제5투,2569,2033,660,1210,147,11,0,2028,5,536,32.544378698224854,59.6646942800789,7.2485207100591715,0.5424063116370809,0.0
9,경기도,안양시동안구,비산1동,비산1동제6투,1813,1466,499,779,160,16,1,1455,11,347,34.29553264604811,53.539518900343644,10.996563573883162,1.0996563573883162,0.06872852233676977
10,경기도,안양시동안구,비산1동,비산1동제7투,1765,1440,573,721,129,14,0,1437,3,325,39.87473903966597,50.17397355601948,8.977035490605429,0.9742519137091163,0.0
11,경기도,안양시동안구,비산2동,관내사전투표,4400,4400,2916,1048,371,41,4,4380,20,0,66.57534246575342,23.926940639269407,8.470319634703197,0.9360730593607305,0.091324200913242
12,경기도,안양시동안구,비산2동,비산2동제1투,2411,1865,744,903,182,22,2,1853,12,546,40.15110631408527,48.731786292498654,9.821910415542364,1.1872638963842417,0.10793308148947653
13,경기도,안양시동안구,비산2동,비산2동제2투,2792,2152,889,973,258,16,1,2137,15,640,41.60037435657464,45.53111839026673,12.072999532054283,0.7487131492746841,0.04679457182966776
14,경기도,안양시동안구,비산2동,비산2동제3투,2136,1643,536,906,164,27,1,1634,9,493,32.80293757649939,55.44675642594859,10.03671970624235,1.6523867809057526,0.06119951040391676
15,경기도,안양시동안구,비산3동,관내사전투표,3984,3984,2582,1015,334,33,3,3967,17,0,65.08696748172423,25.586085202924124,8.419460549533653,0.8318628686664987,0.07562389715149988
16,경기도,안양시동안구,비산3동,비산3동제1투,1870,1312,554,651,81,14,1,1301,11,558,42.5826287471176,50.03843197540354,6.22598001537279,1.0760953112990008,0.07686395080707148
17,경기도,안양시동안구,비산3동,비산3동제2투,2115,1420,498,788,114,6,1,1407,13,695,35.39445628997868,56.00568585643213,8.102345415778252,0.42643923240938164,0.07107320540156362
18,경기도,안양시동안구,비산3동,비산3동제3투,2376,1574,585,836,124,16,3,1564,10,802,37.40409207161125,53.452685421994886,7.928388746803069,1.0230179028132993,0.1918158567774936
19,경기도,안양시동안구,비산3동,비산3동제4투,3464,2655,1059,1238,316,20,0,2633,22,809,40.22028104823395,47.01860995062666,12.001519179642992,0.759589821496392,0.0
20,경기도,안양시동안구,부흥동,관내사전투표,3895,3895,2486,991,334,51,3,3865,30,0,64.32082794307891,25.640362225097025,8.641655886157826,1.3195342820181113,0.07761966364812418
21,경기도,안양시동안구,부흥동,부흥동제1투,1274,838,268,483,68,11,2,832,6,436,32.21153846153847,58.05288461538461,8.173076923076923,1.3221153846153846,0.2403846153846154
22,경기도,안양시동안구,부흥동,부흥동제2투,1654,1347,489,687,144,18,1,1339,8,307,36.51979088872292,51.30694548170276,10.75429424943988,1.344286781179985,0.07468259895444362
23,경기도,안양시동안구,부흥동,부흥동제3투,1339,950,381,501,50,7,1,940,10,389,40.53191489361702,53.297872340425535,5.319148936170213,0.7446808510638299,0.10638297872340426
24,경기도,안양시동안구,부흥동,부흥동제4투,2417,1980,874,931,141,21,2,1969,11,437,44.38801422041646,47.28288471305231,7.160995429151853,1.0665312341289994,0.10157440325038089
25,경기도,안양시동안구,부흥동,부흥동제5투,1876,1485,667,667,128,16,1,1479,6,391,45.09803921568628,45.09803921568628,8.654496281271129,1.0818120351588911,0.0676132521974307
26,경기도,안양시동안구,달안동,관내사전투표,3019,3019,1988,679,286,40,2,2995,24,0,66.37729549248748,22.671118530884808,9.54924874791319,1.335559265442404,0.0667779632721202
27,경기도,안양시동안구,달안동,달안동제1투,1874,1245,463,608,143,13,3,1230,15,629,37.642276422764226,49.43089430894309,11.6260162601626,1.056910569105691,0.24390243902439024
28,경기도,안양시동안구,달안동,달안동제2투,1802,1272,451,649,141,13,0,1254,18,530,35.96491228070175,51.75438596491229,11.24401913875598,1.036682615629984,0.0
29,경기도,안양시동안구,달안동,달안동제3투,2059,1611,679,757,145,17,4,1602,9,448,42.38451935081148,47.25343320848939,9.051186017478152,1.0611735330836454,0.24968789013732834
30,경기도,안양시동안구,관양동,관내사전투표,5644,5644,3828,1401,340,37,5,5611,33,0,68.22313313134913,24.968811263589377,6.059525931206559,0.6594189983960078,0.08911067545891997
31,경기도,안양시동안구,관양동,관양동제1투,2159,1458,563,732,134,15,2,1446,12,701,38.93499308437068,50.62240663900415,9.266943291839558,1.0373443983402488,0.13831258644536654
32,경기도,안양시동안구,관양동,관양동제2투,2578,1837,567,1108,135,16,2,1828,9,741,31.01750547045952,60.61269146608315,7.385120350109409,0.87527352297593,0.10940919037199125
33,경기도,안양시동안구,관양동,관양동제3투,2195,1396,470,772,125,13,2,1382,14,799,34.00868306801736,55.861070911722145,9.044862518089724,0.9406657018813315,0.1447178002894356
34,경기도,안양시동안구,관양동,관양동제4투,2074,1331,534,673,102,5,2,1316,15,743,40.577507598784194,51.139817629179326,7.750759878419452,0.3799392097264438,0.1519756838905775
35,경기도,안양시동안구,관양동,관양동제5투,2647,1889,781,880,198,12,1,1872,17,758,41.72008547008547,47.008547008547005,10.576923076923077,0.641025641025641,0.05341880341880342
36,경기도,안양시동안구,관양동,관양동제6투,2301,1653,681,797,145,11,0,1634,19,648,41.676866585067316,48.776009791921666,8.87392900856793,0.6731946144430845,0.0
37,경기도,안양시동안구,관양동,관양동제7투,2777,2158,795,1153,165,24,1,2138,20,619,37.18428437792329,53.928905519176794,7.717492984097288,1.1225444340505144,0.04677268475210477
38,경기도,안양시동안구,관양동,관양동제8투,2840,2228,940,1084,167,20,1,2212,16,612,42.495479204339965,49.00542495479204,7.549728752260398,0.9041591320072333,0.045207956600361664
39,경기도,안양시동안구,인덕원동,관내사전투표,3867,3867,2526,913,363,29,1,3832,35,0,65.91858037578288,23.825678496868477,9.472860125260961,0.75678496868476,0.026096033402922752
40,경기도,안양시동안구,인덕원동,인덕원동제1투,1774,1127,437,549,110,17,1,1114,13,647,39.22800718132854,49.281867145421906,9.874326750448834,1.526032315978456,0.08976660682226212
41,경기도,안양시동안구,인덕원동,인덕원동제2투,2038,1264,442,656,142,9,2,1251,13,774,35.33173461231015,52.438049560351715,11.35091926458833,0.7194244604316548,0.15987210231814547
42,경기도,안양시동안구,인덕원동,인덕원동제3투,1561,986,345,516,106,9,1,977,9,575,35.312180143295805,52.81473899692938,10.849539406345956,0.9211873080859775,0.1023541453428864
43,경기도,안양시동안구,인덕원동,인덕원동제4투,2738,2115,780,1091,206,21,1,2099,16,623,37.160552644116244,51.97713196760362,9.81419723677942,1.0004764173415912,0.04764173415912339
44,경기도,안양시동안구,인덕원동,인덕원동제5투,2549,2190,1047,901,198,25,1,2172,18,359,48.204419889502766,41.48250460405157,9.116022099447514,1.1510128913443831,0.04604051565377532
45,경기도,안양시동안구,부림동,관내사전투표,5550,5550,3728,1173,551,64,2,5518,32,0,67.56071040231969,21.25770206596593,9.985501993475896,1.1598405219282348,0.03624501631025734
46,경기도,안양시동안구,부림동,부림동제1투,2230,1541,578,739,197,17,1,1532,9,689,37.72845953002611,48.237597911227155,12.859007832898172,1.1096605744125325,0.06527415143603134
47,경기도,안양시동안구,부림동,부림동제2투,1769,1383,578,626,158,12,0,1374,9,386,42.066957787481805,45.56040756914119,11.499272197962155,0.8733624454148471,0.0
48,경기도,안양시동안구,부림동,부림동제3투,2391,1921,870,858,164,9,4,1905,16,470,45.66929133858268,45.03937007874016,8.608923884514436,0.47244094488188976,0.2099737532808399
49,경기도,안양시동안구,부림동,부림동제4투,2212,1740,769,772,172,15,1,1729,11,472,44.476576055523424,44.65008675534992,9.947946790052054,0.8675534991324465,0.057836899942163095
50,경기도,안양시동안구,부림동,부림동제5투,2846,2025,743,981,267,11,0,2002,23,821,37.11288711288711,49.000999000999,13.336663336663337,0.5494505494505495,0.0
51,경기도,안양시동안구,부림동,부림동제6투,2728,1877,760,882,214,8,0,1864,13,851,40.772532188841204,47.317596566523605,11.48068669527897,0.4291845493562232,0.0
52,경기도,안양시동안구,평촌동,관내사전투표,4140,4140,2703,1009,367,34,6,4119,21,0,65.62272396212673,24.496236950716195,8.909929594561786,0.8254430687059966,0.14566642388929352
53,경기도,안양시동안구,평촌동,평촌동제1투,2255,1757,700,867,158,16,3,1744,13,498,40.137614678899084,49.71330275229357,9.059633027522935,0.9174311926605505,0.17201834862385323
54,경기도,안양시동안구,평촌동,평촌동제2투,2453,1838,703,929,179,15,1,1827,11,615,38.4783798576902,50.84838533114395,9.797482211275314,0.8210180623973727,0.05473453749315819
55,경기도,안양시동안구,평촌동,평촌동제3투,2789,2231,857,1101,235,23,1,2217,14,558,38.655841226883176,49.6617050067659,10.599909788001805,1.0374379792512405,0.04510599909788002
56,경기도,안양시동안구,평안동,관내사전투표,4895,4895,3309,1034,467,53,3,4866,29,0,68.00246609124537,21.24948623099055,9.597205096588574,1.0891903000411014,0.06165228113440197
57,경기도,안양시동안구,평안동,평안동제1투,1712,1241,475,596,148,13,2,1234,7,471,38.49270664505672,48.29821717990275,11.9935170178282,1.053484602917342,0.1620745542949757
58,경기도,안양시동안구,평안동,평안동제2투,2322,1904,748,925,200,19,1,1893,11,418,39.51399894347596,48.86423666138405,10.565240359218173,1.0036978341257263,0.05282620179609086
59,경기도,안양시동안구,평안동,평안동제3투,2007,1556,602,767,152,21,2,1544,12,451,38.98963730569948,49.67616580310881,9.844559585492227,1.3601036269430051,0.1295336787564767
60,경기도,안양시동안구,평안동,평안동제4투,2113,1703,726,794,150,21,2,1693,10,410,42.88245717660957,46.89899586532782,8.860011813349084,1.2404016538688718,0.11813349084465447
61,경기도,안양시동안구,평안동,평안동제5투,2881,2360,1181,927,206,29,2,2345,15,521,50.362473347547976,39.530916844349676,8.784648187633262,1.236673773987207,0.08528784648187633
62,경기도,안양시동안구,귀인동,관내사전투표,2723,2723,1828,637,214,29,2,2710,13,0,67.45387453874538,23.505535055350553,7.8966789667896675,1.0701107011070112,0.07380073800738007
63,경기도,안양시동안구,귀인동,귀인동제1투,2312,1850,616,1040,161,18,4,1839,11,462,33.49646547036433,56.55247417074497,8.754758020663404,0.9787928221859705,0.2175095160413268
64,경기도,안양시동안구,귀인동,귀인동제2투,2855,2304,886,1188,190,28,1,2293,11,551,38.63933711295247,51.809856083733095,8.286088094199737,1.2211077191452246,0.04361098996947231
65,경기도,안양시동안구,귀인동,귀인동제3투,2710,2057,979,852,194,18,3,2046,11,653,47.8494623655914,41.64222873900293,9.481915933528837,0.8797653958944283,0.1466275659824047
66,경기도,안양시동안구,호계1동,관내사전투표,4499,4499,2949,1103,391,33,1,4477,22,0,65.8700022336386,24.63703372794282,8.733526915345097,0.7371007371007371,0.02233638597274961
67,경기도,안양시동안구,호계1동,호계1동제1투,2373,1841,741,872,194,25,1,1833,8,532,40.42553191489361,47.57228587015821,10.583742498636116,1.3638843426077467,0.05455537370430987
68,경기도,안양시동안구,호계1동,호계1동제2투,2239,1879,865,796,185,22,0,1868,11,360,46.30620985010707,42.61241970021413,9.903640256959315,1.177730192719486,0.0
69,경기도,안양시동안구,호계1동,호계1동제3투,3648,3007,1310,1278,376,23,1,2988,19,641,43.84203480589023,42.77108433734939,12.583668005354752,0.7697456492637216,0.03346720214190094
70,경기도,안양시동안구,호계1동,호계1동제4투,2890,2357,985,1037,296,23,3,2344,13,533,42.022184300341294,44.24061433447099,12.627986348122866,0.9812286689419796,0.12798634812286688
71,경기도,안양시동안구,호계1동,호계1동제5투,2628,1925,697,964,228,16,2,1907,18,703,36.54955427372837,50.55060304142632,11.955951756685893,0.8390141583639223,0.1048767697954903
72,경기도,안양시동안구,호계2동,관내사전투표,4424,4424,3010,1008,342,46,2,4408,16,0,68.28493647912886,22.867513611615244,7.758620689655173,1.043557168784029,0.045372050816696916
73,경기도,안양시동안구,호계2동,호계2동제1투,2927,2351,987,1029,282,32,3,2333,18,576,42.306043720531505,44.106300900128595,12.087441063009,1.3716245177882553,0.12858979854264896
74,경기도,안양시동안구,호계2동,호계2동제2투,2790,2108,859,1018,191,23,0,2091,17,682,41.080822572931616,48.68483978957437,9.134385461501674,1.099952175992348,0.0
75,경기도,안양시동안구,호계2동,호계2동제3투,2941,2240,892,1051,257,26,1,2227,13,701,40.05388414907948,47.19353390211046,11.540188594521778,1.1674898967220475,0.044903457566232596
76,경기도,안양시동안구,호계2동,호계2동제4투,2830,2153,898,999,206,26,0,2129,24,677,42.17942696101456,46.923438233912634,9.67590418036637,1.2212306247064348,0.0
77,경기도,안양시동안구,호계2동,호계2동제5투,2450,1888,638,1042,184,11,2,1877,11,562,33.99041022908897,55.51411827384124,9.802876931273309,0.5860415556739478,0.10655301012253596
78,경기도,안양시동안구,호계3동,관내사전투표,5010,5010,3315,1238,375,50,5,4983,27,0,66.52618904274533,24.844471202087096,7.525586995785671,1.0034115994380894,0.10034115994380895
79,경기도,안양시동안구,호계3동,호계3동제1투,2592,1794,677,960,131,19,0,1787,7,798,37.8847229994404,53.72132064913262,7.330721880246223,1.0632344711807498,0.0
80,경기도,안양시동안구,호계3동,호계3동제2투,3128,2189,906,1014,236,15,2,2173,16,939,41.69351127473539,46.66359871145882,10.860561435803037,0.6902899217671422,0.09203865623561897
81,경기도,안양시동안구,호계3동,호계3동제3투,1946,1438,611,680,121,15,2,1429,9,508,42.75717284814556,47.585724282715184,8.467459762071378,1.0496850944716585,0.13995801259622112
82,경기도,안양시동안구,호계3동,호계3동제4투,1983,1512,605,769,109,17,1,1501,11,471,40.306462358427716,51.232511658894076,7.261825449700201,1.1325782811459029,0.06662225183211193
83,경기도,안양시동안구,호계3동,호계3동제5투,2590,2000,807,996,161,16,5,1985,15,590,40.65491183879093,50.176322418136024,8.110831234256926,0.8060453400503778,0.2518891687657431
84,경기도,안양시동안구,범계동,관내사전투표,5080,5080,3248,1181,570,47,1,5047,33,0,64.35506241331484,23.40003962750149,11.293837923518922,0.9312462849217357,0.01981375074301565
85,경기도,안양시동안구,범계동,범계동제1투,2586,1875,625,1014,190,26,3,1858,17,711,33.63832077502691,54.57481162540366,10.22604951560818,1.3993541442411195,0.16146393972012918
86,경기도,안양시동안구,범계동,범계동제2투,1816,1327,515,651,131,17,0,1314,13,489,39.19330289193303,49.54337899543379,9.969558599695585,1.2937595129375952,0.0
87,경기도,안양시동안구,범계동,범계동제3투,1953,1591,484,938,140,18,3,1583,8,362,30.574857864813644,59.25457991156032,8.843967150979154,1.137081490840177,0.18951358180669614
88,경기도,안양시동안구,범계동,범계동제4투,1750,1435,486,795,127,15,0,1423,12,315,34.15319747013352,55.867884750527054,8.924806746310612,1.0541110330288124,0.0
89,경기도,안양시동안구,신촌동,관내사전투표,3241,3241,2159,734,284,34,4,3215,26,0,67.15396578538103,22.830482115085537,8.833592534992224,1.0575427682737168,0.1244167962674961
90,경기도,안양시동안구,신촌동,신촌동제1투,2671,2068,764,1041,222,25,4,2056,12,603,37.159533073929964,50.63229571984436,10.797665369649806,1.2159533073929962,0.19455252918287938
91,경기도,안양시동안구,신촌동,신촌동제2투,2435,1842,676,954,176,22,2,1830,12,593,36.939890710382514,52.131147540983605,9.617486338797814,1.2021857923497268,0.1092896174863388
92,경기도,안양시동안구,신촌동,신촌동제3투,1057,851,329,432,76,9,1,847,4,206,38.84297520661157,51.00354191263282,8.972845336481699,1.062573789846517,0.11806375442739078
93,경기도,안양시동안구,갈산동,관내사전투표,2023,2023,1267,539,185,20,4,2015,8,0,62.878411910669975,26.74937965260546,9.181141439205955,0.9925558312655087,0.19851116625310172
94,경기도,안양시동안구,갈산동,갈산동제1투,2332,1801,571,1054,152,16,0,1793,8,531,31.84606804238706,58.78416062465143,8.477412158393753,0.8923591745677636,0.0
95,경기도,안양시동안구,갈산동,갈산동제2투,1474,1201,420,677,88,10,0,1195,6,273,35.146443514644346,56.65271966527197,7.364016736401674,0.8368200836820083,0.0
96,경기도,안양시동안구,갈산동,갈산동제3투,1652,1141,445,557,107,13,2,1124,17,511,39.59074733096085,49.555160142348754,9.519572953736654,1.1565836298932384,0.1779359430604982
97,경기도,안양시동안구,잘못 투입·구분된 투표지,,0,0,0,0,0,0,0,0,0,0,0.0,0.0,0.0,0.0,0.0
0,경기도,광명시,거소·선상투표,,325,311,124,108,67,0,2,301,10,14,41.19601328903654,35.880398671096344,22.259136212624583,0.0,0.6644518272425249
1,경기도,광명시,관외사전투표,,22583,22578,13616,5322,3172,248,24,22382,196,5,60.83459923152533,23.77803592172281,14.172102582432311,1.10803324099723,0.10722902332231257
2,경기도,광명시,재외투표,,1467,1186,806,236,121,14,0,1177,9,281,68.47918436703483,20.050977060322854,10.2803738317757,1.1894647408666101,0.0
3,경기도,광명시,광명1동,관내사전투표,736,736,513,152,62,4,1,732,4,0,70.08196721311475,20.76502732240437,8.469945355191257,0.546448087431694,0.1366120218579235
4,경기도,광명시,광명1동,광명1동제1투,2127,1740,747,746,208,26,3,1730,10,387,43.179190751445084,43.12138728323699,12.023121387283236,1.5028901734104045,0.17341040462427745
5,경기도,광명시,광명1동,광명1동제2투,1899,1516,673,607,202,21,3,1506,10,383,44.687915006640104,40.30544488711819,13.41301460823373,1.394422310756972,0.199203187250996
6,경기도,광명시,광명2동,관내사전투표,1870,1870,1239,483,125,13,2,1862,8,0,66.54135338345864,25.93984962406015,6.713211600429646,0.6981740064446832,0.10741138560687433
7,경기도,광명시,광명2동,광명2동투표소,1622,1024,402,537,64,14,0,1017,7,598,39.52802359882006,52.8023598820059,6.293018682399214,1.376597836774828,0.0
8,경기도,광명시,광명3동,관내사전투표,2013,2013,1321,561,105,13,1,2001,12,0,66.01699150424788,28.035982008995504,5.247376311844078,0.6496751624187905,0.04997501249375312
9,경기도,광명시,광명3동,광명3동제1투,2095,1387,576,703,82,9,0,1370,17,708,42.043795620437955,51.313868613138695,5.985401459854015,0.656934306569343,0.0
10,경기도,광명시,광명3동,광명3동제2투,1769,1176,491,582,86,7,0,1166,10,593,42.109777015437395,49.914236706689536,7.375643224699828,0.6003430531732418,0.0
11,경기도,광명시,광명3동,광명3동제3투,2032,1266,487,673,82,11,0,1253,13,766,38.86671987230647,53.711093375897846,6.5442936951316835,0.8778930566640064,0.0
12,경기도,광명시,광명4동,관내사전투표,2822,2822,1802,745,224,32,1,2804,18,0,64.26533523537803,26.56918687589158,7.988587731811697,1.1412268188302426,0.03566333808844508
13,경기도,광명시,광명4동,광명4동제1투,1621,974,373,526,62,8,0,969,5,647,38.493292053663566,54.282765737874094,6.398348813209494,0.8255933952528379,0.0
14,경기도,광명시,광명4동,광명4동제2투,2476,1902,675,1046,139,28,1,1889,13,574,35.733192165166756,55.37321334039175,7.358390682901006,1.4822657490735838,0.05293806246691372
15,경기도,광명시,광명5동,관내사전투표,2515,2515,1704,652,130,16,2,2504,11,0,68.05111821086261,26.038338658146966,5.1916932907348246,0.6389776357827476,0.07987220447284345
16,경기도,광명시,광명5동,광명5동제1투,3084,1904,725,1034,114,17,1,1891,13,1180,38.339502908514014,54.680063458487574,6.028556319407721,0.8989952406134322,0.052882072977260705
17,경기도,광명시,광명5동,광명5동제2투,3169,2235,956,1069,162,33,3,2223,12,934,43.00494826810616,48.088169140800716,7.28744939271255,1.484480431848853,0.1349527665317139
18,경기도,광명시,광명6동,관내사전투표,2881,2881,1921,715,202,27,3,2868,13,0,66.98047419804742,24.930264993026498,7.043235704323571,0.9414225941422595,0.10460251046025104
19,경기도,광명시,광명6동,광명6동제1투,1988,1509,569,778,136,16,1,1500,9,479,37.93333333333334,51.866666666666674,9.066666666666666,1.0666666666666667,0.06666666666666667
20,경기도,광명시,광명6동,광명6동제2투,2175,1599,681,754,140,14,0,1589,10,576,42.857142857142854,47.45122718691,8.81057268722467,0.881057268722467,0.0
21,경기도,광명시,광명6동,광명6동제3투,2096,1472,613,712,111,17,7,1460,12,624,41.986301369863014,48.76712328767123,7.602739726027398,1.1643835616438356,0.4794520547945206
22,경기도,광명시,광명6동,광명6동제4투,336,241,61,170,5,2,0,238,3,95,25.630252100840334,71.42857142857143,2.100840336134454,0.8403361344537815,0.0
23,경기도,광명시,광명7동,관내사전투표,5844,5844,3945,1432,391,48,4,5820,24,0,67.78350515463917,24.60481099656357,6.718213058419244,0.8247422680412372,0.06872852233676977
24,경기도,광명시,광명7동,광명7동제1투,3910,2863,1166,1338,297,38,6,2845,18,1047,40.984182776801404,47.0298769771529,10.439367311072056,1.335676625659051,0.210896309314587
25,경기도,광명시,광명7동,광명7동제2투,2752,2091,931,925,195,27,3,2081,10,661,44.73810667948102,44.449783757808746,9.370494954348871,1.2974531475252282,0.14416146083613646
26,경기도,광명시,광명7동,광명7동제3투,2740,1922,797,897,190,21,1,1906,16,818,41.81532004197272,47.061909758656874,9.968520461699896,1.1017838405036726,0.05246589716684155
27,경기도,광명시,광명7동,광명7동제4투,1830,1321,547,645,99,16,1,1308,13,509,41.81957186544342,49.31192660550459,7.568807339449542,1.2232415902140672,0.0764525993883792
28,경기도,광명시,광명7동,광명7동제5투,2266,1538,684,718,115,17,2,1536,2,728,44.53125,46.74479166666667,7.486979166666667,1.1067708333333335,0.13020833333333331
29,경기도,광명시,철산1동,관내사전투표,2620,2620,1786,609,188,19,4,2606,14,0,68.53415195702226,23.369148119723715,7.214121258633923,0.7290867229470452,0.15349194167306215
30,경기도,광명시,철산1동,철산1동제1투,2341,1727,735,782,180,18,1,1716,11,614,42.83216783216783,45.57109557109557,10.48951048951049,1.048951048951049,0.05827505827505827
31,경기도,광명시,철산1동,철산1동제2투,2519,1874,787,893,162,20,2,1864,10,645,42.22103004291846,47.907725321888414,8.690987124463518,1.0729613733905579,0.1072961373390558
32,경기도,광명시,철산2동,관내사전투표,1812,1812,1183,488,111,15,4,1801,11,0,65.68573014991671,27.096057745696832,6.163242642976124,0.8328706274292059,0.22209883398112162
33,경기도,광명시,철산2동,철산2동제1투,491,325,128,170,24,3,0,325,0,166,39.38461538461539,52.307692307692314,7.384615384615385,0.9230769230769231,0.0
34,경기도,광명시,철산2동,철산2동제2투,356,218,87,114,11,4,0,216,2,138,40.27777777777778,52.77777777777778,5.092592592592593,1.8518518518518516,0.0
35,경기도,광명시,철산2동,철산2동제3투,2097,1283,462,714,92,9,1,1278,5,814,36.15023474178404,55.86854460093896,7.198748043818466,0.7042253521126761,0.0782472613458529
36,경기도,광명시,철산3동,관내사전투표,7247,7247,4914,1580,628,66,3,7191,56,0,68.33541927409262,21.97190933110833,8.733138645529134,0.917813934084272,0.041718815185648725
37,경기도,광명시,철산3동,철산3동제1투,1967,1548,592,792,139,16,1,1540,8,419,38.44155844155844,51.42857142857142,9.025974025974026,1.0389610389610389,0.06493506493506493
38,경기도,광명시,철산3동,철산3동제2투,1976,1544,545,840,136,16,1,1538,6,432,35.43563068920676,54.61638491547465,8.84265279583875,1.0403120936280885,0.06501950585175553
39,경기도,광명시,철산3동,철산3동제3투,1555,1278,600,552,101,19,1,1273,5,277,47.13275726630008,43.362136684996074,7.9340141398271795,1.4925373134328357,0.07855459544383347
40,경기도,광명시,철산3동,철산3동제4투,2467,1808,636,949,191,18,0,1794,14,659,35.45150501672241,52.89855072463768,10.64659977703456,1.0033444816053512,0.0
41,경기도,광명시,철산3동,철산3동제5투,2734,2073,912,925,204,19,2,2062,11,661,44.228903976721625,44.85935984481087,9.893307468477207,0.921435499515034,0.09699321047526674
42,경기도,광명시,철산3동,철산3동제6투,2864,2308,1000,1072,186,29,2,2289,19,556,43.6871996505024,46.83267802533857,8.125819134993446,1.2669287898645698,0.08737439930100481
43,경기도,광명시,철산3동,철산3동제7투,1626,1351,615,591,121,14,1,1342,9,275,45.827123695976155,44.03874813710879,9.01639344262295,1.0432190760059614,0.07451564828614009
44,경기도,광명시,철산3동,철산3동제8투,2078,1723,744,790,158,23,1,1716,7,355,43.35664335664335,46.03729603729604,9.207459207459207,1.3403263403263403,0.05827505827505827
45,경기도,광명시,철산3동,철산3동제9투,2299,1851,777,879,155,28,0,1839,12,448,42.25122349102774,47.79771615008156,8.428493746601413,1.5225666122892878,0.0
46,경기도,광명시,철산4동,관내사전투표,2364,2364,1708,403,214,24,0,2349,15,0,72.71179225202214,17.156236696466582,9.110259684972329,1.0217113665389528,0.0
47,경기도,광명시,철산4동,철산4동제1투,1911,1455,714,563,141,31,0,1449,6,456,49.275362318840585,38.8543823326432,9.730848861283643,2.139406487232574,0.0
48,경기도,광명시,철산4동,철산4동제2투,1218,922,372,424,100,13,2,911,11,296,40.83424807903403,46.54226125137212,10.976948408342482,1.4270032930845227,0.21953896816684962
49,경기도,광명시,철산4동,철산4동제3투,1660,1356,589,617,123,21,0,1350,6,304,43.629629629629626,45.7037037037037,9.11111111111111,1.5555555555555556,0.0
50,경기도,광명시,하안1동,관내사전투표,4476,4476,3111,1000,298,46,1,4456,20,0,69.81597845601436,22.44165170556553,6.687612208258528,1.0323159784560145,0.02244165170556553
51,경기도,광명시,하안1동,하안1동제1투,1592,1131,470,570,76,10,2,1128,3,461,41.66666666666667,50.53191489361703,6.73758865248227,0.8865248226950355,0.1773049645390071
52,경기도,광명시,하안1동,하안1동제2투,2240,1659,650,834,138,23,1,1646,13,581,39.48967193195625,50.66828675577156,8.383961117861482,1.3973268529769136,0.060753341433778855
53,경기도,광명시,하안1동,하안1동제3투,2886,1856,810,895,122,12,3,1842,14,1030,43.97394136807817,48.588490770901196,6.623235613463627,0.6514657980456027,0.16286644951140067
54,경기도,광명시,하안1동,하안1동제4투,2263,1826,790,835,168,24,0,1817,9,437,43.47826086956522,45.95487066593286,9.246009906439186,1.3208585580627408,0.0
55,경기도,광명시,하안1동,하안1동제5투,2179,1758,832,730,169,16,2,1749,9,421,47.57004002287022,41.73813607775872,9.662664379645513,0.9148084619782733,0.11435105774728416
56,경기도,광명시,하안1동,하안1동제6투,2432,2034,928,897,178,21,0,2024,10,398,45.8498023715415,44.31818181818182,8.794466403162057,1.0375494071146245,0.0
57,경기도,광명시,하안2동,관내사전투표,3774,3774,2520,896,303,34,3,3756,18,0,67.0926517571885,23.85516506922258,8.067092651757187,0.9052183173588925,0.07987220447284345
58,경기도,광명시,하안2동,하안2동제1투,1366,984,425,452,90,13,1,981,3,382,43.323139653414884,46.07543323139653,9.174311926605505,1.325178389398573,0.10193679918450561
59,경기도,광명시,하안2동,하안2동제2투,1677,1215,497,590,106,11,1,1205,10,462,41.244813278008294,48.96265560165975,8.796680497925312,0.9128630705394192,0.08298755186721991
60,경기도,광명시,하안2동,하안2동제3투,1820,1245,538,579,104,11,1,1233,12,575,43.63341443633414,46.95863746958637,8.43471208434712,0.8921330089213302,0.08110300081103002
61,경기도,광명시,하안2동,하안2동제4투,1960,1377,614,624,110,18,0,1366,11,583,44.94875549048316,45.68081991215227,8.052708638360176,1.3177159590043925,0.0
62,경기도,광명시,하안3동,관내사전투표,4899,4898,3417,1114,310,34,4,4879,19,1,70.03484320557492,22.832547653207623,6.353761016601762,0.6968641114982579,0.0819840131174421
63,경기도,광명시,하안3동,하안3동제1투,2161,1534,619,726,164,11,0,1520,14,627,40.723684210526315,47.76315789473684,10.789473684210527,0.7236842105263158,0.0
64,경기도,광명시,하안3동,하안3동제2투,1293,886,390,400,80,7,0,877,9,407,44.469783352337515,45.61003420752566,9.122006841505131,0.798175598631699,0.0
65,경기도,광명시,하안3동,하안3동제3투,1764,1329,586,612,102,16,5,1321,8,435,44.36033308099924,46.32853898561696,7.721423164269494,1.2112036336109009,0.3785011355034065
66,경기도,광명시,하안3동,하안3동제4투,1972,1567,684,720,126,24,2,1556,11,405,43.958868894601544,46.27249357326478,8.097686375321336,1.5424164524421593,0.12853470437017994
67,경기도,광명시,하안3동,하안3동제5투,1570,1255,609,521,102,17,2,1251,4,315,48.6810551558753,41.6466826538769,8.15347721822542,1.3589128697042365,0.15987210231814547
68,경기도,광명시,하안3동,하안3동제6투,812,457,174,248,26,2,1,451,6,355,38.58093126385809,54.988913525498894,5.764966740576496,0.4434589800443459,0.22172949002217296
69,경기도,광명시,하안3동,하안3동제7투,810,515,199,289,20,3,0,511,4,295,38.94324853228962,56.555772994129164,3.9138943248532287,0.5870841487279843,0.0
70,경기도,광명시,하안4동,관내사전투표,3655,3655,2491,794,312,39,0,3636,19,0,68.50935093509351,21.837183718371836,8.58085808580858,1.0726072607260726,0.0
71,경기도,광명시,하안4동,하안4동제1투,2019,1491,622,691,141,22,0,1476,15,528,42.140921409214094,46.81571815718157,9.552845528455284,1.4905149051490514,0.0
72,경기도,광명시,하안4동,하안4동제2투,1979,1516,648,694,149,16,0,1507,9,463,42.99933642999336,46.05175846051758,9.887193098871931,1.06171201061712,0.0
73,경기도,광명시,하안4동,하안4동제3투,2091,1568,679,698,164,16,2,1559,9,523,43.55355997434253,44.772289929441946,10.519563822963438,1.0262989095574084,0.12828736369467605
74,경기도,광명시,소하1동,관내사전투표,6077,6077,4293,1315,382,50,3,6043,34,0,71.0408737382095,21.760714876716865,6.321363561145127,0.8274036074797286,0.04964421644878371
75,경기도,광명시,소하1동,소하1동제1투,2014,1485,610,709,131,21,2,1473,12,529,41.412084181941616,48.133061778682965,8.893414799728445,1.4256619144602851,0.1357773251866938
76,경기도,광명시,소하1동,소하1동제2투,1972,1572,752,658,128,20,0,1558,14,400,48.267008985879336,42.23363286264441,8.21566110397946,1.2836970474967908,0.0
77,경기도,광명시,소하1동,소하1동제3투,1767,1381,600,603,148,18,1,1370,11,386,43.79562043795621,44.01459854014598,10.802919708029197,1.313868613138686,0.072992700729927
78,경기도,광명시,소하1동,소하1동제4투,3149,2152,984,958,175,18,4,2139,13,997,46.00280504908836,44.78728377746611,8.18139317438055,0.8415147265077139,0.18700327255726976
79,경기도,광명시,소하1동,소하1동제5투,2136,1615,712,758,115,17,2,1604,11,521,44.38902743142145,47.256857855361595,7.169576059850375,1.059850374064838,0.12468827930174563
80,경기도,광명시,소하1동,소하1동제6투,1851,1525,796,546,158,18,1,1519,6,326,52.40289664252798,35.944700460829495,10.401579986833443,1.184990125082291,0.06583278472679394
81,경기도,광명시,소하1동,소하1동제7투,2783,2179,1017,969,158,21,2,2167,12,604,46.931241347485006,44.71619750807568,7.291185971389017,0.9690816797415782,0.09229349330872173
82,경기도,광명시,소하2동,관내사전투표,6134,6134,4222,1398,417,49,7,6093,41,0,69.29263088790415,22.94436238306253,6.843919251600197,0.80420154275398,0.11488593467914
83,경기도,광명시,소하2동,소하2동제1투,1147,672,256,358,51,3,1,669,3,475,38.2660687593423,53.51270553064275,7.623318385650224,0.4484304932735426,0.14947683109118087
84,경기도,광명시,소하2동,소하2동제2투,2067,1372,605,615,129,11,0,1360,12,695,44.48529411764706,45.220588235294116,9.485294117647058,0.8088235294117648,0.0
85,경기도,광명시,소하2동,소하2동제3투,2304,1600,764,707,105,15,0,1591,9,704,48.020113136392204,44.43746071653049,6.599622878692646,0.9428032683846637,0.0
86,경기도,광명시,소하2동,소하2동제4투,2594,1928,821,951,123,20,2,1917,11,666,42.82733437663015,49.60876369327074,6.416275430359937,1.0432968179447053,0.10432968179447052
87,경기도,광명시,소하2동,소하2동제5투,2097,1589,725,712,121,21,0,1579,10,508,45.91513616212793,45.09183027232426,7.6630778974034195,1.3299556681443951,0.0
88,경기도,광명시,소하2동,소하2동제6투,1970,1496,711,672,92,8,1,1484,12,474,47.911051212938006,45.28301886792453,6.199460916442049,0.5390835579514826,0.06738544474393532
89,경기도,광명시,소하2동,소하2동제7투,2032,1527,621,730,139,27,0,1517,10,505,40.936058009228745,48.12129202373105,9.162821357943308,1.7798286090969018,0.0
90,경기도,광명시,일직동,관내사전투표,5040,5038,3198,1168,583,52,1,5002,36,2,63.934426229508205,23.35065973610556,11.655337864854058,1.0395841663334666,0.019992003198720514
91,경기도,광명시,일직동,일직동제1투,1414,923,359,395,139,20,1,914,9,491,39.27789934354486,43.21663019693654,15.207877461706785,2.1881838074398248,0.10940919037199125
92,경기도,광명시,일직동,일직동제2투,2558,2025,767,1006,226,18,0,2017,8,533,38.026772434308384,49.87605354486861,11.204759543877046,0.8924144769459593,0.0
93,경기도,광명시,일직동,일직동제3투,2114,1606,570,848,159,21,0,1598,8,508,35.66958698372966,53.066332916145186,9.949937421777221,1.3141426783479349,0.0
94,경기도,광명시,일직동,일직동제4투,1276,968,402,450,98,9,0,959,9,308,41.918665276329506,46.92387904066736,10.218978102189782,0.9384775808133473,0.0
95,경기도,광명시,일직동,일직동제5투,3037,2242,855,1107,237,24,0,2223,19,795,38.46153846153847,49.797570850202426,10.6612685560054,1.0796221322537112,0.0
96,경기도,광명시,학온동,관내사전투표,609,609,356,211,36,3,0,606,3,0,58.745874587458744,34.81848184818482,5.9405940594059405,0.49504950495049505,0.0
97,경기도,광명시,학온동,학온동제1투,434,299,68,223,5,0,2,298,1,135,22.818791946308725,74.83221476510067,1.6778523489932886,0.0,0.6711409395973155
98,경기도,광명시,학온동,학온동제2투,627,439,127,286,22,4,0,439,0,188,28.929384965831435,65.14806378132118,5.0113895216400905,0.9111617312072893,0.0
99,경기도,광명시,잘못 투입·구분된 투표지,,0,3,2,0,0,0,1,3,0,-3,66.66666666666666,0.0,0.0,0.0,33.33333333333333
0,경기도,평택시,거소·선상투표,,1225,1180,448,356,323,5,9,1141,39,45,39.263803680981596,31.200701139351445,28.308501314636285,0.43821209465381245,0.7887817703768624
1,경기도,평택시,관외사전투표,,37047,37044,20768,10277,5236,344,43,36668,376,3,56.63794043852951,28.02716264863096,14.279480746154686,0.9381477037198648,0.1172684629649831
2,경기도,평택시,재외투표,,2044,1594,1079,330,150,29,1,1589,5,450,67.90434235368156,20.767778477029577,9.439899307740717,1.825047199496539,0.06293266205160479
3,경기도,평택시,팽성읍,관내사전투표,5418,5418,3378,1613,368,30,4,5393,25,0,62.63675134433525,29.9091414796959,6.823660300389394,0.5562766549230485,0.07417022065640645
4,경기도,평택시,팽성읍,팽성읍제1투,2614,1646,571,961,87,16,2,1637,9,968,34.88087965791081,58.70494807574832,5.31459987782529,0.9773976786805132,0.12217470983506415
5,경기도,평택시,팽성읍,팽성읍제2투,2618,1710,699,916,74,7,0,1696,14,908,41.214622641509436,54.009433962264154,4.363207547169811,0.41273584905660377,0.0
6,경기도,평택시,팽성읍,팽성읍제3투,3194,1670,609,937,104,7,0,1657,13,1524,36.75316837658419,56.547978273989145,6.2764031382015695,0.4224502112251056,0.0
7,경기도,평택시,팽성읍,팽성읍제4투,1617,838,244,551,35,4,0,834,4,779,29.256594724220626,66.06714628297362,4.1966426858513195,0.4796163069544364,0.0
8,경기도,평택시,팽성읍,팽성읍제5투,1545,1006,291,673,35,5,1,1005,1,539,28.955223880597014,66.96517412935323,3.482587064676617,0.4975124378109453,0.09950248756218905
9,경기도,평택시,팽성읍,팽성읍제6투,1429,828,274,488,56,5,1,824,4,601,33.25242718446602,59.22330097087378,6.796116504854369,0.6067961165048543,0.12135922330097086
10,경기도,평택시,팽성읍,팽성읍제7투,2128,1233,450,709,51,10,0,1220,13,895,36.885245901639344,58.114754098360656,4.180327868852459,0.819672131147541,0.0
11,경기도,평택시,팽성읍,팽성읍제8투,2459,1350,476,790,64,11,1,1342,8,1109,35.46944858420268,58.867362146050674,4.769001490312966,0.819672131147541,0.07451564828614009
12,경기도,평택시,안중읍,관내사전투표,7412,7412,5039,1701,566,67,7,7380,32,0,68.27913279132791,23.04878048780488,7.669376693766939,0.9078590785907859,0.0948509485094851
13,경기도,평택시,안중읍,안중읍제1투,3208,1860,825,870,140,15,4,1854,6,1348,44.49838187702265,46.92556634304207,7.5512405609492985,0.8090614886731391,0.2157497303128371
14,경기도,평택시,안중읍,안중읍제2투,3411,1984,729,1098,132,8,2,1969,15,1427,37.02386998476384,55.764347384459114,6.70391061452514,0.40629761300152356,0.10157440325038089
15,경기도,평택시,안중읍,안중읍제3투,1550,1061,476,502,69,6,1,1054,7,489,45.16129032258064,47.6280834914611,6.546489563567362,0.5692599620493358,0.09487666034155598
16,경기도,평택시,안중읍,안중읍제4투,1766,1126,591,448,75,6,1,1121,5,640,52.72078501338091,39.964317573595004,6.6904549509366635,0.535236396074933,0.08920606601248886
17,경기도,평택시,안중읍,안중읍제5투,2689,1827,911,733,149,23,0,1816,11,862,50.16519823788547,40.363436123348016,8.204845814977974,1.2665198237885462,0.0
18,경기도,평택시,안중읍,안중읍제6투,3575,1758,742,812,178,18,2,1752,6,1817,42.35159817351598,46.34703196347032,10.159817351598173,1.0273972602739725,0.1141552511415525
19,경기도,평택시,안중읍,안중읍제7투,3479,2490,1305,955,184,23,4,2471,19,989,52.812626467017395,38.6483205180089,7.446377984621611,0.9307972480777014,0.16187778227438285
20,경기도,평택시,안중읍,안중읍제8투,2250,1636,880,622,108,14,2,1626,10,614,54.12054120541205,38.25338253382534,6.642066420664207,0.8610086100861009,0.12300123001230012
21,경기도,평택시,안중읍,안중읍제9투,2653,1864,970,711,145,24,1,1851,13,789,52.404105888708806,38.41166936790924,7.833603457590492,1.2965964343598055,0.05402485143165856
22,경기도,평택시,포승읍,관내사전투표,5835,5834,3937,1310,505,43,5,5800,34,1,67.87931034482759,22.586206896551726,8.706896551724137,0.7413793103448276,0.08620689655172414
23,경기도,평택시,포승읍,포승읍제1투,3210,1778,659,993,107,9,4,1772,6,1432,37.18961625282167,56.03837471783296,6.038374717832957,0.5079006772009029,0.2257336343115124
24,경기도,평택시,포승읍,포승읍제2투,897,594,198,351,26,2,2,579,15,303,34.196891191709845,60.62176165803109,4.490500863557859,0.3454231433506045,0.3454231433506045
25,경기도,평택시,포승읍,포승읍제3투,3998,2117,932,940,204,16,5,2097,20,1881,44.44444444444444,44.82594182164998,9.72818311874106,0.7629947544110633,0.2384358607534573
26,경기도,평택시,포승읍,포승읍제4투,1868,1020,401,500,104,6,1,1012,8,848,39.62450592885375,49.40711462450593,10.276679841897234,0.592885375494071,0.09881422924901186
27,경기도,평택시,포승읍,포승읍제5투,3410,1961,1082,686,167,18,0,1953,8,1449,55.40194572452637,35.12544802867383,8.55094726062468,0.9216589861751152,0.0
28,경기도,평택시,청북읍,관내사전투표,4014,4014,2816,866,284,26,4,3996,18,0,70.47047047047047,21.67167167167167,7.107107107107106,0.6506506506506506,0.10010010010010009
29,경기도,평택시,청북읍,청북읍제1투,1427,789,215,520,41,3,4,783,6,638,27.458492975734355,66.41123882503193,5.236270753512133,0.38314176245210724,0.5108556832694764
30,경기도,평택시,청북읍,청북읍제2투,1379,818,252,500,59,2,0,813,5,561,30.996309963099634,61.50061500615006,7.2570725707257075,0.24600246002460024,0.0
31,경기도,평택시,청북읍,청북읍제3투,757,522,144,359,12,1,2,518,4,235,27.7992277992278,69.3050193050193,2.3166023166023164,0.19305019305019305,0.3861003861003861
32,경기도,평택시,청북읍,청북읍제4투,4066,2708,1555,867,236,31,2,2691,17,1358,57.78520995912301,32.21850613154961,8.769973987365292,1.1519881085098476,0.07432181345224824
33,경기도,평택시,청북읍,청북읍제5투,4318,2933,1731,965,195,20,4,2915,18,1385,59.38250428816466,33.104631217838765,6.689536878216123,0.6861063464837049,0.13722126929674097
34,경기도,평택시,청북읍,청북읍제6투,2861,2099,1291,611,169,16,3,2090,9,762,61.770334928229666,29.234449760765553,8.086124401913876,0.7655502392344498,0.14354066985645933
35,경기도,평택시,진위면,관내사전투표,2383,2383,1496,674,180,17,0,2367,16,0,63.20236586396282,28.474862695395014,7.604562737642586,0.7182087029995775,0.0
36,경기도,평택시,진위면,진위면제1투,1696,1090,303,709,60,12,2,1086,4,606,27.900552486187845,65.28545119705342,5.524861878453039,1.1049723756906076,0.1841620626151013
37,경기도,평택시,진위면,진위면제2투,2538,1527,598,824,83,9,4,1518,9,1011,39.39393939393939,54.28194993412385,5.467720685111989,0.592885375494071,0.2635046113306983
38,경기도,평택시,진위면,진위면제3투,2458,1493,658,688,124,15,1,1486,7,965,44.27994616419919,46.29878869448183,8.344549125168237,1.0094212651413188,0.06729475100942127
39,경기도,평택시,서탄면,관내사전투표,1082,1082,660,340,68,10,1,1079,3,0,61.16774791473587,31.510658016682115,6.302131603336422,0.9267840593141797,0.09267840593141798
40,경기도,평택시,서탄면,서탄면제1투,857,570,156,383,22,1,1,563,7,287,27.708703374777976,68.02841918294848,3.9076376554174073,0.17761989342806395,0.17761989342806395
41,경기도,평택시,서탄면,서탄면제2투,742,450,128,293,23,4,0,448,2,292,28.57142857142857,65.40178571428571,5.133928571428571,0.8928571428571428,0.0
42,경기도,평택시,서탄면,서탄면제3투,493,269,107,144,14,0,0,265,4,224,40.37735849056604,54.339622641509436,5.283018867924529,0.0,0.0
43,경기도,평택시,고덕면,관내사전투표,3559,3559,2267,878,378,20,1,3544,15,0,63.96726862302483,24.774266365688487,10.66591422121896,0.5643340857787811,0.02821670428893905
44,경기도,평택시,고덕면,고덕면제1투,3106,2188,1075,868,204,25,3,2175,13,918,49.42528735632184,39.90804597701149,9.379310344827587,1.1494252873563218,0.13793103448275862
45,경기도,평택시,고덕면,고덕면제2투,1775,999,244,683,59,4,2,992,7,776,24.596774193548388,68.8508064516129,5.947580645161291,0.4032258064516129,0.20161290322580644
46,경기도,평택시,고덕면,고덕면제3투,2180,1328,604,588,115,14,1,1322,6,852,45.688350983358546,44.47806354009077,8.69894099848714,1.059001512859304,0.07564296520423601
47,경기도,평택시,고덕면,고덕면제4투,1200,723,246,426,42,4,3,721,2,477,34.11927877947296,59.084604715672675,5.825242718446602,0.5547850208044383,0.4160887656033287
48,경기도,평택시,오성면,관내사전투표,2449,2449,1569,714,136,22,1,2442,7,0,64.25061425061425,29.238329238329236,5.569205569205569,0.9009009009009009,0.040950040950040956
49,경기도,평택시,오성면,오성면제1투,2249,1304,484,723,77,9,0,1293,11,945,37.4323279195669,55.91647331786543,5.955143078112916,0.6960556844547563,0.0
50,경기도,평택시,오성면,오성면제2투,1106,708,221,456,23,2,2,704,4,398,31.392045454545453,64.77272727272727,3.2670454545454546,0.2840909090909091,0.2840909090909091
51,경기도,평택시,오성면,오성면제3투,402,284,64,204,10,4,0,282,2,118,22.69503546099291,72.3404255319149,3.546099290780142,1.4184397163120568,0.0
52,경기도,평택시,현덕면,관내사전투표,2566,2566,1613,773,149,19,3,2557,9,0,63.0817364098553,30.230739147438406,5.8271411810715685,0.7430582714118107,0.11732499022291748
53,경기도,평택시,현덕면,현덕면제1투,1785,1099,401,610,72,11,1,1095,4,686,36.62100456621005,55.70776255707762,6.575342465753424,1.004566210045662,0.091324200913242
54,경기도,평택시,현덕면,현덕면제2투,720,477,107,347,18,2,0,474,3,243,22.573839662447256,73.20675105485233,3.79746835443038,0.42194092827004215,0.0
55,경기도,평택시,현덕면,현덕면제3투,838,503,146,331,17,7,0,501,2,335,29.141716566866265,66.06786427145708,3.3932135728542914,1.3972055888223553,0.0
56,경기도,평택시,중앙동,관내사전투표,7447,7447,4691,1909,726,58,11,7395,52,0,63.43475321162948,25.81473968897904,9.817444219066937,0.7843137254901961,0.14874915483434753
57,경기도,평택시,중앙동,중앙동제1투,2491,1263,412,650,179,9,1,1251,12,1228,32.93365307753797,51.95843325339729,14.308553157474021,0.7194244604316548,0.07993605115907274
58,경기도,평택시,중앙동,중앙동제2투,3294,1839,511,946,354,8,1,1820,19,1455,28.076923076923077,51.978021978021985,19.450549450549453,0.43956043956043955,0.054945054945054944
59,경기도,평택시,중앙동,중앙동제3투,3048,2096,942,1003,132,10,0,2087,9,952,45.13655965500718,48.059415428845234,6.324868231911836,0.4791566842357451,0.0
60,경기도,평택시,중앙동,중앙동제4투,2256,1623,519,953,123,5,5,1605,18,633,32.33644859813084,59.37694704049844,7.663551401869159,0.3115264797507788,0.3115264797507788
61,경기도,평택시,중앙동,중앙동제5투,2686,1895,919,812,142,10,1,1884,11,791,48.7791932059448,43.09978768577495,7.537154989384288,0.5307855626326964,0.05307855626326964
62,경기도,평택시,중앙동,중앙동제6투,3337,2250,976,982,251,23,3,2235,15,1087,43.66890380313199,43.93736017897092,11.23042505592841,1.029082774049217,0.1342281879194631
63,경기도,평택시,중앙동,중앙동제7투,2531,1892,870,853,135,21,4,1883,9,639,46.202867764206054,45.300053106744556,7.169410515135423,1.1152416356877324,0.21242697822623471
64,경기도,평택시,중앙동,중앙동제8투,2618,1854,851,848,130,11,1,1841,13,764,46.22487778381314,46.06192286800652,7.061379684953829,0.5975013579576317,0.05431830526887561
65,경기도,평택시,중앙동,중앙동제9투,2615,1827,808,882,100,21,2,1813,14,788,44.567015995587425,48.64864864864865,5.515719801434087,1.1583011583011582,0.11031439602868175
66,경기도,평택시,중앙동,중앙동제10투,2714,1735,689,879,129,22,3,1722,13,979,40.0116144018583,51.045296167247386,7.491289198606271,1.2775842044134729,0.17421602787456447
67,경기도,평택시,서정동,관내사전투표,4701,4701,3061,1254,318,30,6,4669,32,0,65.560077104305,26.85799957164275,6.81088027414864,0.642535874919683,0.1285071749839366
68,경기도,평택시,서정동,서정동제1투,2778,1356,565,660,95,16,5,1341,15,1422,42.132736763609245,49.21700223713646,7.084265473527218,1.193139448173005,0.37285607755406414
69,경기도,평택시,서정동,서정동제2투,3749,2378,974,1147,217,23,1,2362,16,1371,41.23624047417443,48.56054191363251,9.187129551227773,0.9737510584250635,0.04233700254022015
70,경기도,평택시,서정동,서정동제3투,1744,993,398,508,63,10,2,981,12,751,40.57084607543323,51.783893985728845,6.422018348623854,1.019367991845056,0.20387359836901123
71,경기도,평택시,서정동,서정동제4투,1416,781,286,447,34,7,0,774,7,635,36.95090439276486,57.751937984496124,4.3927648578811365,0.9043927648578811,0.0
72,경기도,평택시,서정동,서정동제5투,2365,1363,525,731,88,8,0,1352,11,1002,38.83136094674556,54.0680473372781,6.508875739644971,0.591715976331361,0.0
73,경기도,평택시,서정동,서정동제6투,1911,1109,453,555,79,11,2,1100,9,802,41.18181818181818,50.45454545454545,7.1818181818181825,1.0,0.18181818181818182
74,경기도,평택시,서정동,서정동제7투,2201,1369,536,707,101,11,1,1356,13,832,39.52802359882006,52.138643067846616,7.448377581120943,0.8112094395280236,0.07374631268436578
75,경기도,평택시,송탄동,관내사전투표,3620,3620,2498,808,275,22,2,3605,15,0,69.29264909847434,22.413314840499307,7.628294036061026,0.6102635228848822,0.055478502080443824
76,경기도,평택시,송탄동,송탄동제1투,2085,1224,448,663,92,12,3,1218,6,861,36.7816091954023,54.43349753694581,7.55336617405583,0.9852216748768473,0.24630541871921183
77,경기도,평택시,송탄동,송탄동제2투,2269,1475,580,791,84,12,1,1468,7,794,39.509536784741144,53.88283378746594,5.722070844686648,0.8174386920980926,0.06811989100817438
78,경기도,평택시,송탄동,송탄동제3투,3300,2577,1285,1074,185,21,3,2568,9,723,50.03894080996885,41.822429906542055,7.20404984423676,0.8177570093457943,0.11682242990654204
79,경기도,평택시,송탄동,송탄동제4투,3890,2677,1278,1009,335,27,5,2654,23,1213,48.15373021853805,38.0180859080633,12.622456669178597,1.0173323285606632,0.18839487565938207
80,경기도,평택시,송탄동,송탄동제5투,2146,1459,710,564,153,17,1,1445,14,687,49.13494809688581,39.03114186851211,10.588235294117647,1.1764705882352942,0.06920415224913494
81,경기도,평택시,지산동,관내사전투표,3044,3044,1980,823,196,18,2,3019,25,0,65.58463067240808,27.2606823451474,6.492215965551507,0.5962239152037099,0.06624710168930109
82,경기도,평택시,지산동,지산동제1투,4468,2009,733,971,257,22,4,1987,22,2459,36.88978359335682,48.86763965777554,12.934071464519375,1.1071967790639154,0.20130850528434827
83,경기도,평택시,지산동,지산동제2투,3344,2139,952,969,179,19,3,2122,17,1205,44.863336475023566,45.66446748350613,8.435438265786994,0.8953817153628653,0.1413760603204524
84,경기도,평택시,송북동,관내사전투표,4551,4551,2866,1364,269,25,3,4527,24,0,63.30903468080407,30.130329136293348,5.942125027612105,0.552242102937928,0.06626905235255136
85,경기도,평택시,송북동,송북동제1투,1518,844,283,486,60,8,2,839,5,674,33.730631704410015,57.92610250297974,7.151370679380214,0.9535160905840285,0.23837902264600713
86,경기도,평택시,송북동,송북동제2투,2563,1505,538,849,103,8,0,1498,7,1058,35.91455273698264,56.67556742323098,6.875834445927905,0.5340453938584779,0.0
87,경기도,평택시,송북동,송북동제3투,3444,2249,887,1180,151,16,3,2237,12,1195,39.65131873044256,52.749217702279836,6.750111756817166,0.7152436298614215,0.13410818059901655
88,경기도,평택시,송북동,송북동제4투,2871,1853,762,924,127,15,4,1832,21,1018,41.5938864628821,50.43668122270743,6.932314410480349,0.8187772925764192,0.21834061135371177
89,경기도,평택시,송북동,송북동제5투,2036,1307,629,560,95,15,2,1301,6,729,48.34742505764796,43.04381245196003,7.30207532667179,1.1529592621060722,0.15372790161414296
90,경기도,평택시,신장1동,관내사전투표,1675,1675,1018,511,118,14,1,1662,13,0,61.25150421179302,30.74608904933815,7.099879663056559,0.842358604091456,0.060168471720818295
91,경기도,평택시,신장1동,신장1동제1투,1880,967,353,541,62,6,0,962,5,913,36.694386694386694,56.237006237006234,6.4449064449064455,0.6237006237006237,0.0
92,경기도,평택시,신장1동,신장1동제2투,2074,1056,405,532,101,6,4,1048,8,1018,38.645038167938935,50.76335877862596,9.63740458015267,0.5725190839694656,0.38167938931297707
93,경기도,평택시,신장2동,관내사전투표,1507,1507,843,502,135,11,0,1491,16,0,56.53923541247485,33.668678739101274,9.054325955734406,0.7377598926894702,0.0
94,경기도,평택시,신장2동,신장2동제1투,1826,883,251,560,63,4,1,879,4,943,28.555176336746303,63.70875995449374,7.167235494880546,0.4550625711035267,0.11376564277588168
95,경기도,평택시,신장2동,신장2동제2투,1367,736,251,430,45,5,0,731,5,631,34.33652530779754,58.82352941176471,6.155950752393981,0.6839945280437756,0.0
96,경기도,평택시,신평동,관내사전투표,3771,3771,2367,1063,285,31,4,3750,21,0,63.12,28.346666666666664,7.6,0.8266666666666667,0.10666666666666667
97,경기도,평택시,신평동,신평동제1투,1824,1200,425,680,70,14,2,1191,9,624,35.684298908480265,57.094878253568424,5.877413937867338,1.1754827875734677,0.16792611251049538
98,경기도,평택시,신평동,신평동제2투,2555,1276,401,687,162,10,0,1260,16,1279,31.825396825396822,54.52380952380952,12.857142857142856,0.7936507936507936,0.0
99,경기도,평택시,신평동,신평동제3투,2798,1738,580,1023,104,19,3,1729,9,1060,33.5454019664546,59.167148640832856,6.015037593984962,1.098901098901099,0.1735106998264893
100,경기도,평택시,신평동,신평동제4투,3349,1745,682,895,130,12,1,1720,25,1604,39.651162790697676,52.03488372093024,7.55813953488372,0.6976744186046512,0.05813953488372093
101,경기도,평택시,신평동,신평동제5투,478,345,116,205,17,2,1,341,4,133,34.01759530791789,60.117302052785924,4.9853372434017595,0.5865102639296188,0.2932551319648094
102,경기도,평택시,신평동,신평동제6투,2067,1573,647,757,140,16,1,1561,12,494,41.44778987828315,48.49455477258168,8.968609865470851,1.0249839846252402,0.06406149903907751
103,경기도,평택시,원평동,관내사전투표,3450,3450,2104,999,288,33,3,3427,23,0,61.39480595272834,29.15086081120514,8.40385176539247,0.9629413481178875,0.08754012255617158
104,경기도,평택시,원평동,원평동제1투,2457,1282,404,761,100,6,1,1272,10,1175,31.761006289308174,59.82704402515723,7.861635220125786,0.4716981132075472,0.07861635220125787
105,경기도,평택시,원평동,원평동제2투,2096,1405,567,702,113,8,4,1394,11,691,40.67431850789096,50.3586800573888,8.106169296987087,0.5738880918220948,0.2869440459110474
106,경기도,평택시,원평동,원평동제3투,2646,1748,607,938,184,8,0,1737,11,898,34.94530800230282,54.00115141047783,10.592976396085204,0.4605641911341394,0.0
107,경기도,평택시,원평동,원평동제4투,714,392,129,235,25,0,0,389,3,322,33.16195372750643,60.411311053984576,6.426735218508997,0.0,0.0
108,경기도,평택시,통복동,관내사전투표,3743,3743,2330,1036,318,32,2,3718,25,0,62.66810112963959,27.864443249058635,8.5529854760624,0.8606777837547067,0.05379236148466917
109,경기도,평택시,통복동,통복동제1투,2222,1449,575,713,136,12,0,1436,13,773,40.041782729805014,49.65181058495822,9.47075208913649,0.8356545961002786,0.0
110,경기도,평택시,통복동,통복동제2투,1313,796,237,474,67,8,0,786,10,517,30.15267175572519,60.30534351145038,8.524173027989821,1.0178117048346056,0.0
111,경기도,평택시,비전1동,관내사전투표,7787,7787,5495,1624,558,63,7,7747,40,0,70.93068284497225,20.96295340131664,7.202788176068155,0.8132180198786627,0.09035755776429585
112,경기도,평택시,비전1동,비전1동제1투,2501,1633,618,877,119,9,1,1624,9,868,38.05418719211823,54.00246305418719,7.327586206896551,0.5541871921182266,0.06157635467980296
113,경기도,평택시,비전1동,비전1동제2투,1398,839,301,484,46,4,0,835,4,559,36.047904191616766,57.964071856287426,5.508982035928144,0.47904191616766467,0.0
114,경기도,평택시,비전1동,비전1동제3투,2252,1726,813,730,154,22,1,1720,6,526,47.26744186046511,42.44186046511628,8.953488372093023,1.2790697674418605,0.05813953488372093
115,경기도,평택시,비전1동,비전1동제4투,1264,976,364,539,60,7,0,970,6,288,37.52577319587629,55.56701030927835,6.185567010309279,0.7216494845360825,0.0
116,경기도,평택시,비전1동,비전1동제5투,1165,802,247,509,40,4,0,800,2,363,30.875000000000004,63.625,5.0,0.5,0.0
117,경기도,평택시,비전1동,비전1동제6투,3144,1915,827,929,123,13,1,1893,22,1229,43.68726888536714,49.07554146856841,6.497622820919176,0.6867406233491812,0.05282620179609086
118,경기도,평택시,비전1동,비전1동제7투,3324,2283,1080,952,217,22,1,2272,11,1041,47.53521126760563,41.901408450704224,9.551056338028168,0.9683098591549295,0.04401408450704226
119,경기도,평택시,비전1동,비전1동제8투,2697,1852,868,773,166,26,2,1835,17,845,47.30245231607629,42.12534059945504,9.04632152588556,1.416893732970027,0.10899182561307902
120,경기도,평택시,비전1동,비전1동제9투,2907,2023,922,898,164,25,1,2010,13,884,45.87064676616915,44.67661691542288,8.159203980099502,1.2437810945273633,0.04975124378109452
121,경기도,평택시,비전1동,비전1동제10투,2835,1802,883,699,180,27,2,1791,11,1033,49.30206588498046,39.028475711892796,10.050251256281408,1.507537688442211,0.11166945840312675
122,경기도,평택시,비전1동,비전1동제11투,2097,1447,713,586,113,12,2,1426,21,650,50.0,41.09396914446003,7.924263674614306,0.8415147265077139,0.1402524544179523
123,경기도,평택시,비전1동,비전1동제12투,3078,2324,1216,857,211,19,2,2305,19,754,52.75488069414317,37.18004338394794,9.15401301518438,0.824295010845987,0.08676789587852494
124,경기도,평택시,비전2동,관내사전투표,8394,8394,5436,2124,687,78,10,8335,59,0,65.21895620875824,25.482903419316138,8.242351529694062,0.9358128374325135,0.11997600479904018
125,경기도,평택시,비전2동,비전2동제1투,3979,2466,932,1336,162,21,2,2453,13,1513,37.994292702812885,54.46392172849572,6.604158173664901,0.8560945780676722,0.08153281695882593
126,경기도,평택시,비전2동,비전2동제2투,1710,1166,397,663,87,8,2,1157,9,544,34.312878133102856,57.30337078651685,7.519446845289542,0.6914433880726015,0.17286084701815038
127,경기도,평택시,비전2동,비전2동제3투,2489,1560,531,890,117,12,1,1551,9,929,34.23597678916828,57.38233397807866,7.543520309477756,0.7736943907156674,0.06447453255963895
128,경기도,평택시,비전2동,비전2동제4투,3408,2514,1019,1270,176,27,2,2494,20,894,40.85805934242181,50.922213311948674,7.056936647955093,1.082598235765838,0.08019246190858059
129,경기도,평택시,비전2동,비전2동제5투,4713,3249,1250,1704,241,25,4,3224,25,1464,38.77171215880894,52.853598014888334,7.475186104218362,0.7754342431761787,0.12406947890818859
130,경기도,평택시,비전2동,비전2동제6투,2731,2032,872,957,166,26,1,2022,10,699,43.125618199802176,47.32937685459941,8.209693372898121,1.2858555885262115,0.04945598417408506
131,경기도,평택시,비전2동,비전2동제7투,1938,1451,618,668,144,11,3,1444,7,487,42.797783933518005,46.26038781163435,9.97229916897507,0.7617728531855956,0.20775623268698062
132,경기도,평택시,비전2동,비전2동제8투,3729,2799,1463,1041,255,23,3,2785,14,930,52.53141831238779,37.37881508078995,9.156193895870736,0.8258527827648114,0.10771992818671454
133,경기도,평택시,비전2동,비전2동제9투,3440,2615,1256,1080,247,18,0,2601,14,825,48.28911956939639,41.522491349480966,9.496347558631296,0.6920415224913495,0.0
134,경기도,평택시,비전2동,비전2동제10투,4386,3276,1623,1313,293,31,3,3263,13,1110,49.73950352436408,40.23904382470119,8.97946674839105,0.9500459699662888,0.09193993257738277
135,경기도,평택시,세교동,관내사전투표,4521,4521,2952,1177,336,34,4,4503,18,0,65.55629580279813,26.138130135465243,7.461692205196535,0.7550521874306019,0.08882966910948256
136,경기도,평택시,세교동,세교동제1투,3457,2182,823,1171,153,16,3,2166,16,1275,37.99630655586334,54.06278855032317,7.063711911357341,0.7386888273314866,0.13850415512465375
137,경기도,평택시,세교동,세교동제2투,3362,2174,929,1008,201,25,1,2164,10,1188,42.92975970425139,46.58040665434381,9.288354898336413,1.155268022181146,0.04621072088724584
138,경기도,평택시,세교동,세교동제3투,776,459,139,283,32,2,1,457,2,317,30.41575492341357,61.925601750547045,7.00218818380744,0.437636761487965,0.2188183807439825
139,경기도,평택시,세교동,세교동제4투,4743,3635,1582,1603,392,30,1,3608,27,1108,43.8470066518847,44.429046563192905,10.864745011086473,0.8314855875831485,0.02771618625277162
140,경기도,평택시,세교동,세교동제5투,2446,1691,747,783,132,12,2,1676,15,755,44.57040572792363,46.71837708830549,7.875894988066825,0.7159904534606205,0.11933174224343676
141,경기도,평택시,세교동,세교동제6투,2750,2008,833,979,169,14,2,1997,11,742,41.71256885327992,49.02353530295443,8.462694041061592,0.7010515773660491,0.10015022533800699
142,경기도,평택시,세교동,세교동제7투,4268,3154,1424,1378,298,35,0,3135,19,1114,45.422647527910684,43.95534290271132,9.505582137161085,1.1164274322169059,0.0
143,경기도,평택시,용이동,관내사전투표,4836,4836,3432,911,423,34,5,4805,31,0,71.42559833506765,18.959417273673257,8.803329864724246,0.7075962539021852,0.10405827263267431
144,경기도,평택시,용이동,용이동제1투,2971,1415,500,685,195,16,0,1396,19,1556,35.816618911174785,49.06876790830946,13.968481375358166,1.146131805157593,0.0
145,경기도,평택시,용이동,용이동제2투,1863,1463,770,531,136,17,0,1454,9,400,52.95735900962861,36.51994497936727,9.353507565337003,1.1691884456671253,0.0
146,경기도,평택시,용이동,용이동제3투,2362,1880,979,717,149,18,3,1866,14,482,52.465166130760984,38.42443729903537,7.984994640943194,0.964630225080386,0.1607717041800643
147,경기도,평택시,용이동,용이동제4투,2845,2274,980,1067,179,27,3,2256,18,571,43.43971631205674,47.29609929078014,7.934397163120567,1.196808510638298,0.13297872340425532
148,경기도,평택시,용이동,용이동제5투,2124,1605,864,587,131,19,0,1601,4,519,53.96627108057464,36.66458463460337,8.182386008744533,1.1867582760774515,0.0
149,경기도,평택시,용이동,용이동제6투,2391,1443,695,576,143,12,2,1428,15,948,48.66946778711485,40.33613445378151,10.014005602240896,0.8403361344537815,0.1400560224089636
150,경기도,평택시,동삭동,관내사전투표,6640,6640,4550,1352,649,48,4,6603,37,0,68.90807208844465,20.475541420566408,9.828865667121006,0.7269422989550204,0.060578524912918374
151,경기도,평택시,동삭동,동삭동제1투,3794,2686,1222,1117,298,28,4,2669,17,1108,45.784938179093295,41.85088047958037,11.165230423379544,1.049082053203447,0.14986886474334957
152,경기도,평택시,동삭동,동삭동제2투,3000,2280,1038,944,265,17,4,2268,12,720,45.767195767195766,41.622574955908284,11.684303350970017,0.7495590828924161,0.1763668430335097
153,경기도,평택시,동삭동,동삭동제3투,2337,1660,680,811,141,16,0,1648,12,677,41.262135922330096,49.211165048543684,8.555825242718447,0.9708737864077669,0.0
154,경기도,평택시,동삭동,동삭동제4투,1910,1385,672,565,128,15,1,1381,4,525,48.66039102099928,40.91238233164374,9.268645908761766,1.0861694424330195,0.0724112961622013
155,경기도,평택시,동삭동,동삭동제5투,3128,2411,1190,963,214,25,3,2395,16,717,49.68684759916493,40.208768267223384,8.935281837160751,1.0438413361169103,0.12526096033402923
156,경기도,평택시,동삭동,동삭동제6투,2302,1691,780,700,179,19,1,1679,12,611,46.45622394282311,41.69148302561048,10.661107802263253,1.1316259678379987,0.05955926146515784
157,경기도,평택시,동삭동,동삭동제7투,3487,1632,647,763,197,10,4,1621,11,1855,39.913633559531156,47.069710055521284,12.152991980259099,0.6169031462060457,0.24676125848241826
158,경기도,평택시,동삭동,동삭동제8투,3594,2428,1120,942,316,26,0,2404,24,1166,46.58901830282861,39.1846921797005,13.14475873544093,1.0815307820299502,0.0
159,경기도,평택시,고덕동,관내사전투표,5904,5904,3486,1271,1054,42,4,5857,47,0,59.51852484206932,21.70052928120198,17.995560867338227,0.7170906607478231,0.06829434864264983
160,경기도,평택시,고덕동,고덕동제1투,3083,2166,882,927,312,22,3,2146,20,917,41.09972041006524,43.19664492078285,14.538676607642126,1.0251630941286114,0.13979496738117428
161,경기도,평택시,고덕동,고덕동제2투,4016,2987,1272,1349,317,22,7,2967,20,1029,42.871587462082914,45.46680148297944,10.684192787327266,0.741489720256151,0.23592854735422988
162,경기도,평택시,고덕동,고덕동제3투,3613,2672,1178,1158,306,17,0,2659,13,941,44.30236931177134,43.55020684467845,11.50808574652125,0.6393380970289583,0.0
163,경기도,평택시,고덕동,고덕동제4투,3255,2102,884,880,298,19,1,2082,20,1153,42.45917387127761,42.267050912584054,14.31316042267051,0.9125840537944284,0.04803073967339097
164,경기도,평택시,고덕동,고덕동제5투,4914,3446,1626,1369,392,33,3,3423,23,1468,47.50219106047327,39.99415717207128,11.451942740286299,0.9640666082383873,0.0876424189307625
165,경기도,평택시,고덕동,고덕동제6투,4835,3585,1743,1379,406,34,4,3566,19,1250,48.878295008412785,38.670779584969154,11.385305664610208,0.9534492428491307,0.11217049915872125
166,경기도,평택시,고덕동,고덕동제7투,4788,3475,1416,1422,569,32,2,3441,34,1313,41.15082824760244,41.325196163905844,16.535890729439117,0.929962220284801,0.058122638767800064
167,경기도,평택시,고덕동,고덕동제8투,2750,1307,404,663,212,8,1,1288,19,1443,31.366459627329192,51.475155279503106,16.459627329192546,0.6211180124223602,0.07763975155279502
168,경기도,평택시,잘못 투입·구분된 투표지,,0,2,2,0,0,0,0,2,0,-2,100.0,0.0,0.0,0.0,0.0
0,경기도,양주시,거소·선상투표,,731,656,285,192,126,10,5,618,38,75,46.116504854368934,31.06796116504854,20.388349514563107,1.6181229773462782,0.8090614886731391
1,경기도,양주시,관외사전투표,,24632,24630,15243,6015,2907,212,29,24406,224,2,62.45595345406867,24.645578955994427,11.911005490453167,0.8686388592968943,0.11882324018683929
2,경기도,양주시,재외투표,,939,786,574,124,78,10,0,786,0,153,73.02798982188295,15.776081424936386,9.923664122137405,1.2722646310432568,0.0
3,경기도,양주시,백석읍,관내사전투표,4771,4771,3153,1346,224,24,1,4748,23,0,66.40690817186183,28.348778433024428,4.717775905644482,0.5054759898904801,0.02106149957877001
4,경기도,양주시,백석읍,백석읍제1투,2718,1424,486,842,75,10,2,1415,9,1294,34.34628975265018,59.505300353356894,5.30035335689046,0.7067137809187279,0.1413427561837456
5,경기도,양주시,백석읍,백석읍제2투,2221,1399,589,693,92,13,1,1388,11,822,42.435158501440924,49.92795389048991,6.628242074927954,0.9365994236311239,0.07204610951008646
6,경기도,양주시,백석읍,백석읍제3투,2128,1348,414,848,68,10,3,1343,5,780,30.8265078183172,63.14221891288161,5.063291139240507,0.7446016381236039,0.22338049143708116
7,경기도,양주시,백석읍,백석읍제4투,3120,2042,865,1034,109,12,3,2023,19,1078,42.75827978250123,51.11220958971824,5.388037567968364,0.5931784478497282,0.14829461196243204
8,경기도,양주시,백석읍,백석읍제5투,1633,1018,387,559,56,6,1,1009,9,615,38.35480673934589,55.4013875123885,5.550049554013875,0.5946481665014867,0.09910802775024777
9,경기도,양주시,백석읍,백석읍제6투,1841,1229,574,564,72,9,0,1219,10,612,47.08777686628384,46.267432321575065,5.906480721903199,0.7383100902378998,0.0
10,경기도,양주시,백석읍,백석읍제7투,1939,1402,687,611,88,6,4,1396,6,537,49.212034383954155,43.76790830945559,6.303724928366762,0.42979942693409745,0.28653295128939826
11,경기도,양주시,은현면,관내사전투표,1762,1762,1076,570,100,6,3,1755,7,0,61.31054131054131,32.47863247863248,5.698005698005698,0.3418803418803419,0.17094017094017094
12,경기도,양주시,은현면,은현면제1투,827,467,141,296,22,6,1,466,1,360,30.257510729613735,63.519313304721024,4.721030042918455,1.2875536480686696,0.2145922746781116
13,경기도,양주시,은현면,은현면제2투,1227,726,196,485,40,1,0,722,4,501,27.146814404432135,67.17451523545706,5.540166204986149,0.13850415512465375,0.0
14,경기도,양주시,은현면,은현면제3투,528,348,113,208,24,1,1,347,1,180,32.564841498559076,59.94236311239193,6.9164265129683,0.2881844380403458,0.2881844380403458
15,경기도,양주시,은현면,은현면제4투,603,396,111,263,16,3,0,393,3,207,28.24427480916031,66.92111959287533,4.071246819338422,0.7633587786259541,0.0
16,경기도,양주시,남면,관내사전투표,1492,1492,819,536,114,11,2,1482,10,0,55.26315789473685,36.16734143049933,7.6923076923076925,0.7422402159244265,0.1349527665317139
17,경기도,양주시,남면,남면제1투,1489,862,276,515,54,7,2,854,8,627,32.31850117096019,60.304449648711945,6.323185011709602,0.819672131147541,0.234192037470726
18,경기도,양주시,남면,남면제2투,597,375,113,251,9,0,0,373,2,222,30.29490616621984,67.29222520107238,2.4128686327077746,0.0,0.0
19,경기도,양주시,남면,남면제3투,1125,667,189,434,31,6,1,661,6,458,28.593040847201213,65.65809379727685,4.689863842662632,0.9077155824508321,0.15128593040847202
20,경기도,양주시,남면,남면제4투,525,347,120,201,19,4,2,346,1,178,34.68208092485549,58.092485549132945,5.491329479768786,1.1560693641618496,0.5780346820809248
21,경기도,양주시,광적면,관내사전투표,3763,3762,2247,1253,216,20,3,3739,23,1,60.0962824284568,33.51163412677187,5.776945707408398,0.5349023803155925,0.08023535704733886
22,경기도,양주시,광적면,광적면제1투,2767,1410,491,823,73,12,3,1402,8,1357,35.02139800285307,58.7018544935806,5.206847360912981,0.8559201141226819,0.21398002853067047
23,경기도,양주시,광적면,광적면제2투,2080,1251,490,663,82,6,3,1244,7,829,39.38906752411576,53.29581993569131,6.591639871382636,0.482315112540193,0.2411575562700965
24,경기도,양주시,광적면,광적면제3투,246,170,45,114,9,0,0,168,2,76,26.785714285714285,67.85714285714286,5.357142857142857,0.0,0.0
25,경기도,양주시,광적면,광적면제4투,787,517,157,324,27,5,0,513,4,270,30.60428849902534,63.1578947368421,5.263157894736842,0.9746588693957114,0.0
26,경기도,양주시,장흥면,관내사전투표,2556,2556,1584,805,140,12,0,2541,15,0,62.33766233766234,31.68044077134986,5.5096418732782375,0.47225501770956313,0.0
27,경기도,양주시,장흥면,장흥면제1투,3298,1915,581,1242,74,7,1,1905,10,1383,30.498687664041995,65.19685039370079,3.884514435695538,0.3674540682414698,0.05249343832020997
28,경기도,양주시,장흥면,장흥면제2투,4063,2437,898,1374,136,15,0,2423,14,1626,37.06149401568304,56.70656211308296,5.6128765992571195,0.6190672719768882,0.0
29,경기도,양주시,양주1동,관내사전투표,1525,1525,943,411,150,10,1,1515,10,0,62.244224422442244,27.12871287128713,9.900990099009901,0.6600660066006601,0.066006600660066
30,경기도,양주시,양주1동,양주1동제1투,975,607,206,371,26,0,0,603,4,368,34.16252072968491,61.52570480928689,4.311774461028192,0.0,0.0
31,경기도,양주시,양주1동,양주1동제2투,659,467,132,313,19,1,2,467,0,192,28.26552462526767,67.02355460385438,4.068522483940043,0.21413276231263384,0.4282655246252677
32,경기도,양주시,양주1동,양주1동제3투,1414,933,368,517,35,8,0,928,5,481,39.6551724137931,55.71120689655172,3.771551724137931,0.8620689655172413,0.0
33,경기도,양주시,양주2동,관내사전투표,8687,8685,6176,1922,478,58,5,8639,46,2,71.48975575876838,22.247945364046764,5.533047806459081,0.6713740016205579,0.05787706910522051
34,경기도,양주시,양주2동,양주2동제1투,2598,1669,730,792,107,17,4,1650,19,929,44.24242424242424,48.0,6.484848484848485,1.0303030303030303,0.24242424242424243
35,경기도,양주시,양주2동,양주2동제2투,2799,1911,840,881,162,18,1,1902,9,888,44.164037854889585,46.31966351209253,8.517350157728707,0.9463722397476341,0.052576235541535225
36,경기도,양주시,양주2동,양주2동제3투,4550,3164,1603,1278,227,23,7,3138,26,1386,51.08349267049076,40.72657743785851,7.233906947100063,0.7329509241555131,0.22307202039515617
37,경기도,양주시,양주2동,양주2동제4투,2382,1671,807,723,101,23,2,1656,15,711,48.731884057971016,43.65942028985507,6.099033816425121,1.3888888888888888,0.12077294685990338
38,경기도,양주시,양주2동,양주2동제5투,3491,2539,1289,1064,143,25,5,2526,13,952,51.029295328582734,42.12193190815518,5.661124307205067,0.9897070467141725,0.1979414093428345
39,경기도,양주시,양주2동,양주2동제6투,2761,1912,977,808,104,12,2,1903,9,849,51.339989490278505,42.45927482921702,5.4650551760378345,0.6305832895428272,0.10509721492380451
40,경기도,양주시,양주2동,양주2동제7투,2255,1473,605,749,97,7,4,1462,11,782,41.381668946648425,51.2311901504788,6.6347469220246245,0.478796169630643,0.27359781121751026
41,경기도,양주시,양주2동,양주2동제8투,2112,1314,530,702,63,9,2,1306,8,798,40.58192955589586,53.751914241960186,4.823889739663093,0.6891271056661562,0.1531393568147014
42,경기도,양주시,양주2동,양주2동제9투,2825,1682,771,774,114,11,1,1671,11,1143,46.14003590664273,46.319569120287255,6.822262118491921,0.6582884500299222,0.059844404548174746
43,경기도,양주시,양주2동,양주2동제10투,2268,1522,742,604,142,19,0,1507,15,746,49.23689449236895,40.07962840079629,9.42269409422694,1.26078301260783,0.0
44,경기도,양주시,회천1동,관내사전투표,2284,2284,1490,586,175,11,2,2264,20,0,65.81272084805654,25.88339222614841,7.729681978798586,0.48586572438162545,0.08833922261484099
45,경기도,양주시,회천1동,회천1동제1투,2185,1378,536,708,110,12,4,1370,8,807,39.12408759124087,51.67883211678832,8.02919708029197,0.8759124087591241,0.291970802919708
46,경기도,양주시,회천1동,회천1동제2투,2115,1274,530,650,73,13,2,1268,6,841,41.798107255520506,51.26182965299685,5.757097791798108,1.025236593059937,0.15772870662460567
47,경기도,양주시,회천1동,회천1동제3투,686,424,126,266,25,4,0,421,3,262,29.928741092636578,63.18289786223278,5.938242280285035,0.9501187648456058,0.0
48,경기도,양주시,회천2동,관내사전투표,7627,7627,5260,1809,467,45,4,7585,42,0,69.34739617666446,23.849703361898484,6.156888595912986,0.5932762030323006,0.05273566249176005
49,경기도,양주시,회천2동,회천2동제1투,2526,1416,625,668,88,16,5,1402,14,1110,44.57917261055635,47.646219686162624,6.276747503566334,1.1412268188302426,0.3566333808844508
50,경기도,양주시,회천2동,회천2동제2투,3592,2083,952,947,135,22,8,2064,19,1509,46.12403100775194,45.88178294573643,6.540697674418605,1.065891472868217,0.3875968992248062
51,경기도,양주시,회천2동,회천2동제3투,4402,2897,1445,1122,291,23,0,2881,16,1505,50.15619576535924,38.944810829573065,10.100659493231518,0.7983339118361681,0.0
52,경기도,양주시,회천2동,회천2동제4투,2467,1599,673,752,153,13,1,1592,7,868,42.27386934673367,47.23618090452261,9.610552763819095,0.8165829145728644,0.06281407035175879
53,경기도,양주시,회천2동,회천2동제5투,4144,2949,1494,1169,226,31,3,2923,26,1195,51.111871365035924,39.993157714676705,7.73178241532672,1.0605542251111872,0.10263427984946973
54,경기도,양주시,회천2동,회천2동제6투,3860,2449,1105,1134,174,17,4,2434,15,1411,45.39852095316352,46.589975349219394,7.14872637633525,0.6984387838948234,0.16433853738701726
55,경기도,양주시,회천2동,회천2동제7투,2761,1982,1003,720,223,19,1,1966,16,779,51.01729399796541,36.62258392675483,11.342828077314344,0.9664292980671414,0.050864699898270596
56,경기도,양주시,회천2동,회천2동제8투,2231,1477,634,677,132,12,4,1459,18,754,43.45442083618917,46.401644962302946,9.047292666209733,0.822481151473612,0.2741603838245374
57,경기도,양주시,회천3동,관내사전투표,5931,5931,3948,1499,397,42,6,5892,39,0,67.0061099796334,25.441276306856754,6.737949762389681,0.7128309572301426,0.10183299389002036
58,경기도,양주시,회천3동,회천3동제1투,2007,1238,516,619,86,8,1,1230,8,769,41.951219512195124,50.32520325203252,6.991869918699186,0.6504065040650406,0.08130081300813008
59,경기도,양주시,회천3동,회천3동제2투,2596,1509,678,695,112,10,2,1497,12,1087,45.29058116232465,46.42618570474282,7.481629926519706,0.6680026720106881,0.13360053440213762
60,경기도,양주시,회천3동,회천3동제3투,2436,1520,705,684,112,13,0,1514,6,916,46.56538969616909,45.1783355350066,7.397622192866579,0.8586525759577279,0.0
61,경기도,양주시,회천3동,회천3동제4투,1832,1332,548,671,92,9,2,1322,10,500,41.45234493192133,50.75642965204236,6.959152798789712,0.680786686838124,0.15128593040847202
62,경기도,양주시,회천3동,회천3동제5투,2080,1329,607,589,110,13,1,1320,9,751,45.984848484848484,44.621212121212125,8.333333333333332,0.9848484848484848,0.07575757575757576
63,경기도,양주시,회천3동,회천3동제6투,2772,1911,849,896,133,13,3,1894,17,861,44.825765575501585,47.30728616684266,7.022175290390707,0.6863780359028511,0.15839493136219643
64,경기도,양주시,옥정1동,관내사전투표,6054,6054,4364,1204,408,43,2,6021,33,0,72.47965454243482,19.996678292642418,6.776283009466866,0.7141670818800864,0.03321707357581797
65,경기도,양주시,옥정1동,옥정1동제1투,3663,2190,916,993,243,16,2,2170,20,1473,42.21198156682028,45.76036866359447,11.198156682027651,0.7373271889400922,0.09216589861751152
66,경기도,양주시,옥정1동,옥정1동제2투,2848,1749,794,814,113,8,0,1729,20,1099,45.9224985540775,47.07923655292076,6.53556969346443,0.46269519953730476,0.0
67,경기도,양주시,옥정1동,옥정1동제3투,1648,1033,406,529,82,6,2,1025,8,615,39.609756097560975,51.609756097560975,8.0,0.5853658536585366,0.1951219512195122
68,경기도,양주시,옥정1동,옥정1동제4투,3333,2028,909,862,220,17,1,2009,19,1305,45.2463912394226,42.906918865107016,10.95072175211548,0.8461921353907417,0.049776007964161276
69,경기도,양주시,옥정1동,옥정1동제5투,2839,2142,1152,774,186,15,2,2129,13,697,54.10991075622358,36.355096289337716,8.736496007515266,0.7045561296383279,0.09394081728511039
70,경기도,양주시,옥정1동,옥정1동제6투,3442,2506,1281,990,199,24,2,2496,10,936,51.32211538461539,39.66346153846153,7.97275641025641,0.9615384615384616,0.08012820512820512
71,경기도,양주시,옥정1동,옥정1동제7투,1522,1141,647,405,78,3,0,1133,8,381,57.10503089143866,35.745807590467784,6.884377758164166,0.264783759929391,0.0
72,경기도,양주시,옥정1동,옥정1동제8투,2668,1953,1006,715,195,20,2,1938,15,715,51.909184726522184,36.893704850361196,10.061919504643962,1.0319917440660475,0.10319917440660474
73,경기도,양주시,옥정2동,관내사전투표,9628,9628,6943,1745,799,84,4,9575,53,0,72.51174934725849,18.22454308093995,8.344647519582244,0.877284595300261,0.04177545691906005
74,경기도,양주시,옥정2동,옥정2동제1투,2342,1616,774,662,151,18,1,1606,10,726,48.194271481942714,41.220423412204234,9.402241594022415,1.1207970112079702,0.062266500622665005
75,경기도,양주시,옥정2동,옥정2동제2투,3050,2033,963,861,180,21,3,2028,5,1017,47.485207100591715,42.455621301775146,8.875739644970414,1.0355029585798818,0.14792899408284024
76,경기도,양주시,옥정2동,옥정2동제3투,2122,1566,824,599,123,13,1,1560,6,556,52.820512820512825,38.3974358974359,7.884615384615384,0.8333333333333334,0.0641025641025641
77,경기도,양주시,옥정2동,옥정2동제4투,2298,1797,892,756,125,10,1,1784,13,501,50.0,42.37668161434978,7.006726457399102,0.5605381165919282,0.05605381165919283
78,경기도,양주시,옥정2동,옥정2동제5투,3302,2243,1208,847,153,24,2,2234,9,1059,54.0734109221128,37.914055505819164,6.84870188003581,1.0743061772605194,0.08952551477170993
79,경기도,양주시,옥정2동,옥정2동제6투,2992,1780,959,640,149,17,1,1766,14,1212,54.303510758776895,36.2400906002265,8.437146092865232,0.9626274065685164,0.05662514156285391
80,경기도,양주시,옥정2동,옥정2동제7투,3419,2164,1015,888,223,20,2,2148,16,1255,47.25325884543762,41.340782122905026,10.381750465549349,0.931098696461825,0.0931098696461825
81,경기도,양주시,옥정2동,옥정2동제8투,2707,1841,892,795,123,13,6,1829,12,866,48.769819573537454,43.46637506834335,6.724986331328594,0.7107709130672498,0.3280481137233461
82,경기도,양주시,옥정2동,옥정2동제9투,2821,1985,1018,770,173,10,2,1973,12,836,51.596553471870244,39.02686264571718,8.768373035985809,0.5068423720223011,0.10136847440446022
83,경기도,양주시,옥정2동,옥정2동제10투,4300,2976,1572,1132,216,30,3,2953,23,1324,53.23399932272266,38.33389773112089,7.314595326786319,1.015916017609211,0.1015916017609211
84,경기도,양주시,잘못 투입·구분된 투표지,,0,2,2,0,0,0,0,2,0,-2,100.0,0.0,0.0,0.0,0.0
0,경기도,동두천시,거소·선상투표,,225,214,104,64,32,0,3,203,11,11,51.231527093596064,31.527093596059114,15.763546798029557,0.0,1.477832512315271
1,경기도,동두천시,관외사전투표,,5831,5831,3429,1545,730,58,14,5776,55,0,59.36634349030471,26.74861495844875,12.638504155124652,1.0041551246537395,0.24238227146814403
2,경기도,동두천시,재외투표,,353,272,196,51,22,0,0,269,3,81,72.86245353159852,18.95910780669145,8.178438661710038,0.0,0.0
3,경기도,동두천시,생연1동,관내사전투표,1472,1472,925,473,64,6,0,1468,4,0,63.01089918256131,32.22070844686649,4.35967302452316,0.4087193460490463,0.0
4,경기도,동두천시,생연1동,생연1동제1투,1729,946,376,498,54,9,1,938,8,783,40.085287846481876,53.09168443496801,5.756929637526652,0.9594882729211088,0.10660980810234541
5,경기도,동두천시,생연1동,생연1동제2투,1798,998,355,579,51,9,1,995,3,800,35.678391959798994,58.19095477386935,5.125628140703518,0.9045226130653266,0.10050251256281408
6,경기도,동두천시,생연2동,관내사전투표,3144,3144,1927,1031,142,21,5,3126,18,0,61.64427383237364,32.981445937300066,4.54254638515675,0.6717850287907869,0.1599488163787588
7,경기도,동두천시,생연2동,생연2동제1투,1170,725,259,415,41,6,0,721,4,445,35.92233009708738,57.558945908460466,5.6865464632454925,0.8321775312066574,0.0
8,경기도,동두천시,생연2동,생연2동제2투,2332,1471,611,752,73,18,2,1456,15,861,41.964285714285715,51.64835164835166,5.013736263736264,1.2362637362637363,0.13736263736263737
9,경기도,동두천시,생연2동,생연2동제3투,723,418,133,256,23,2,1,415,3,305,32.04819277108434,61.686746987951814,5.542168674698795,0.48192771084337355,0.24096385542168677
10,경기도,동두천시,생연2동,생연2동제4투,1715,1047,462,514,58,5,2,1041,6,668,44.38040345821326,49.375600384245914,5.571565802113352,0.48030739673390976,0.19212295869356388
11,경기도,동두천시,중앙동,관내사전투표,1792,1792,995,696,76,16,1,1784,8,0,55.77354260089686,39.01345291479821,4.260089686098654,0.8968609865470852,0.05605381165919283
12,경기도,동두천시,중앙동,중앙동제1투,1678,870,302,508,45,7,1,863,7,808,34.994206257242176,58.86442641946697,5.214368482039398,0.8111239860950173,0.11587485515643105
13,경기도,동두천시,중앙동,중앙동제2투,1004,562,182,348,23,5,0,558,4,442,32.61648745519714,62.365591397849464,4.121863799283155,0.8960573476702508,0.0
14,경기도,동두천시,보산동,관내사전투표,848,848,546,261,37,2,0,846,2,0,64.53900709219859,30.851063829787233,4.373522458628842,0.2364066193853428,0.0
15,경기도,동두천시,보산동,보산동투표소,1543,805,260,494,34,8,2,798,7,738,32.581453634085214,61.904761904761905,4.260651629072681,1.0025062656641603,0.2506265664160401
16,경기도,동두천시,불현동,관내사전투표,4669,4669,3043,1357,217,23,5,4645,24,0,65.51130247578041,29.21420882669537,4.6716899892357375,0.49515608180839615,0.1076426264800861
17,경기도,동두천시,불현동,불현동제1투,3085,1688,617,941,100,11,5,1674,14,1397,36.857825567502985,56.2126642771804,5.973715651135006,0.6571087216248507,0.2986857825567503
18,경기도,동두천시,불현동,불현동제2투,1673,967,383,509,61,6,1,960,7,706,39.895833333333336,53.02083333333333,6.354166666666666,0.625,0.10416666666666667
19,경기도,동두천시,불현동,불현동제3투,1514,912,329,527,51,4,1,912,0,602,36.07456140350877,57.78508771929825,5.592105263157895,0.43859649122807015,0.10964912280701754
20,경기도,동두천시,불현동,불현동제4투,2753,1691,717,843,107,16,1,1684,7,1062,42.5771971496437,50.05938242280285,6.353919239904989,0.9501187648456058,0.05938242280285036
21,경기도,동두천시,불현동,불현동제5투,3925,2449,1037,1208,173,18,3,2439,10,1476,42.51742517425174,49.528495284952854,7.093070930709307,0.7380073800738007,0.12300123001230012
22,경기도,동두천시,불현동,불현동제6투,1550,909,279,582,36,5,1,903,6,641,30.89700996677741,64.45182724252491,3.9867109634551494,0.5537098560354374,0.11074197120708748
23,경기도,동두천시,송내동,관내사전투표,4950,4950,3345,1296,242,34,2,4919,31,0,68.00162634681845,26.346818459036392,4.919699125838585,0.6911973978450905,0.04065867046147591
24,경기도,동두천시,송내동,송내동제1투,3719,2331,1058,1067,168,23,1,2317,14,1388,45.66249460509279,46.05092792403971,7.250755287009064,0.9926629261976695,0.04315925766076824
25,경기도,동두천시,송내동,송내동제2투,3033,2092,938,969,147,16,2,2072,20,941,45.27027027027027,46.76640926640926,7.094594594594595,0.7722007722007722,0.09652509652509653
26,경기도,동두천시,송내동,송내동제3투,3367,2029,847,1025,122,17,2,2013,16,1338,42.07650273224044,50.919026328862394,6.0606060606060606,0.8445106805762544,0.09935419771485346
27,경기도,동두천시,송내동,송내동제4투,1617,1010,419,520,60,6,1,1006,4,607,41.65009940357853,51.689860834990064,5.964214711729622,0.5964214711729622,0.09940357852882703
28,경기도,동두천시,송내동,송내동제5투,2422,1393,598,656,117,12,4,1387,6,1029,43.114635904830564,47.29632299927901,8.435472242249459,0.8651766402307137,0.2883922134102379
29,경기도,동두천시,소요동,관내사전투표,1756,1756,1105,529,88,10,3,1735,21,0,63.68876080691642,30.48991354466859,5.072046109510087,0.5763688760806917,0.1729106628242075
30,경기도,동두천시,소요동,소요동제1투,993,523,197,286,34,1,2,520,3,470,37.88461538461539,55.00000000000001,6.538461538461539,0.19230769230769232,0.38461538461538464
31,경기도,동두천시,소요동,소요동제2투,1850,1158,477,590,75,3,0,1145,13,692,41.65938864628821,51.52838427947598,6.550218340611353,0.26200873362445415,0.0
32,경기도,동두천시,소요동,소요동제3투,432,277,100,169,6,2,0,277,0,155,36.101083032490976,61.01083032490975,2.166064981949458,0.7220216606498195,0.0
33,경기도,동두천시,소요동,소요동제4투,1341,841,320,479,34,5,0,838,3,500,38.18615751789976,57.15990453460621,4.05727923627685,0.5966587112171837,0.0
34,경기도,동두천시,소요동,소요동제5투,666,389,119,254,13,1,0,387,2,277,30.749354005167955,65.63307493540051,3.359173126614987,0.2583979328165375,0.0
35,경기도,동두천시,상패동,관내사전투표,1342,1342,845,415,65,5,3,1333,9,0,63.390847711927975,31.13278319579895,4.876219054763691,0.3750937734433608,0.22505626406601648
36,경기도,동두천시,상패동,상패동제1투,1918,1079,367,647,51,4,1,1070,9,839,34.29906542056075,60.46728971962617,4.766355140186916,0.3738317757009346,0.09345794392523366
37,경기도,동두천시,상패동,상패동제2투,995,609,231,327,43,3,0,604,5,386,38.24503311258278,54.13907284768212,7.119205298013245,0.49668874172185434,0.0
38,경기도,동두천시,잘못 투입·구분된 투표지,,0,0,0,0,0,0,0,0,0,0,0.0,0.0,0.0,0.0,0.0
0,경기도,안산시상록구,거소·선상투표,,487,460,228,127,84,5,1,445,15,27,51.23595505617977,28.539325842696627,18.876404494382022,1.1235955056179776,0.22471910112359553
1,경기도,안산시상록구,관외사전투표,,25638,25634,15673,5909,3454,278,43,25357,277,4,61.809362306266515,23.303229877351423,13.621485191465869,1.096344204756083,0.1695784201601136
2,경기도,안산시상록구,재외투표,,1333,1089,766,193,107,17,0,1083,6,244,70.72945521698985,17.820867959372112,9.879963065558634,1.569713758079409,0.0
3,경기도,안산시상록구,일동,관내사전투표,4877,4877,3521,948,333,41,5,4848,29,0,72.62788778877888,19.554455445544555,6.868811881188119,0.8457095709570958,0.10313531353135312
4,경기도,안산시상록구,일동,일동제1투,3247,1773,897,739,109,13,2,1760,13,1474,50.965909090909086,41.98863636363636,6.193181818181818,0.7386363636363636,0.11363636363636363
5,경기도,안산시상록구,일동,일동제2투,3055,1888,881,821,151,16,2,1871,17,1167,47.087119187600216,43.88027792624265,8.070550507749866,0.85515766969535,0.10689470871191875
6,경기도,안산시상록구,일동,일동제3투,4281,2729,1402,1088,196,22,8,2716,13,1552,51.62002945508101,40.058910162002945,7.216494845360824,0.8100147275405009,0.29455081001472755
7,경기도,안산시상록구,일동,일동제4투,3019,1873,940,766,130,18,1,1855,18,1146,50.673854447439346,41.293800539083556,7.008086253369273,0.9703504043126685,0.05390835579514825
8,경기도,안산시상록구,이동,관내사전투표,3348,3348,2395,679,229,19,5,3327,21,0,71.98677487225729,20.4087766756838,6.883077847911031,0.5710850616170725,0.15028554253080853
9,경기도,안산시상록구,이동,이동제1투,2101,1285,618,541,98,16,2,1275,10,816,48.470588235294116,42.431372549019606,7.686274509803921,1.2549019607843137,0.1568627450980392
10,경기도,안산시상록구,이동,이동제2투,2377,1314,618,554,112,15,2,1301,13,1063,47.501921598770174,42.5826287471176,8.608762490392007,1.1529592621060722,0.15372790161414296
11,경기도,안산시상록구,이동,이동제3투,2599,1396,654,563,150,19,4,1390,6,1203,47.05035971223022,40.50359712230216,10.79136690647482,1.3669064748201438,0.28776978417266186
12,경기도,안산시상록구,이동,이동제4투,2074,1078,481,454,123,13,0,1071,7,996,44.91129785247433,42.39028944911298,11.484593837535014,1.2138188608776845,0.0
13,경기도,안산시상록구,이동,이동제5투,3699,2181,973,979,189,23,3,2167,14,1518,44.90078449469313,45.17766497461929,8.721735117674204,1.0613751730503,0.1384402399630826
14,경기도,안산시상록구,이동,이동제6투,1974,1512,648,723,118,13,1,1503,9,462,43.11377245508982,48.10379241516966,7.850964737192283,0.8649367930805056,0.0665335994677312
15,경기도,안산시상록구,사동,관내사전투표,6945,6945,4784,1284,748,61,9,6886,59,0,69.47429567237874,18.64652918966018,10.86261980830671,0.8858553586988092,0.13069997095556202
16,경기도,안산시상록구,사동,사동제1투,3115,1636,826,629,147,20,1,1623,13,1479,50.893407270486755,38.755391250770174,9.057301293900185,1.2322858903265557,0.06161429451632779
17,경기도,안산시상록구,사동,사동제2투,3071,1880,808,866,175,20,2,1871,9,1191,43.18546231961518,46.285408872260824,9.353287012292892,1.0689470871191877,0.10689470871191875
18,경기도,안산시상록구,사동,사동제3투,2115,1163,490,532,121,7,3,1153,10,952,42.497831743278404,46.14050303555941,10.49436253252385,0.6071118820468344,0.26019080659150046
19,경기도,안산시상록구,사동,사동제4투,2472,1779,893,712,123,19,2,1749,30,693,51.05774728416238,40.70897655803316,7.032590051457976,1.0863350485991996,0.11435105774728416
20,경기도,안산시상록구,사동,사동제5투,2074,1666,865,610,163,17,4,1659,7,408,52.139843279083784,36.76913803496082,9.82519590114527,1.024713682941531,0.24110910186859552
21,경기도,안산시상록구,사동,사동제6투,2726,1598,767,675,138,9,0,1589,9,1128,48.26935179358087,42.47954688483323,8.684707363121461,0.5663939584644431,0.0
22,경기도,안산시상록구,사동,사동제7투,2064,1361,686,526,114,21,1,1348,13,703,50.89020771513353,39.02077151335311,8.456973293768547,1.5578635014836795,0.0741839762611276
23,경기도,안산시상록구,사동,사동제8투,1638,1097,465,509,106,10,2,1092,5,541,42.582417582417584,46.61172161172161,9.706959706959708,0.9157509157509158,0.18315018315018314
24,경기도,안산시상록구,사이동,관내사전투표,5023,5023,3529,1133,309,26,4,5001,22,0,70.56588682263548,22.655468906218758,6.1787642471505695,0.5198960207958409,0.07998400319936012
25,경기도,안산시상록구,사이동,사이동제1투,1739,1265,411,740,94,11,1,1257,8,474,32.69689737470167,58.8703261734288,7.478122513922036,0.8750994431185362,0.07955449482895784
26,경기도,안산시상록구,사이동,사이동제2투,2437,1746,695,877,151,13,0,1736,10,691,40.034562211981566,50.5184331797235,8.69815668202765,0.748847926267281,0.0
27,경기도,안산시상록구,사이동,사이동제3투,1838,1348,501,693,132,12,0,1338,10,490,37.44394618834081,51.79372197309418,9.865470852017937,0.8968609865470852,0.0
28,경기도,안산시상록구,사이동,사이동제4투,2689,1718,885,648,155,16,0,1704,14,971,51.93661971830986,38.028169014084504,9.096244131455398,0.9389671361502347,0.0
29,경기도,안산시상록구,사이동,사이동제5투,2513,1615,892,552,133,19,3,1599,16,898,55.784865540963104,34.52157598499062,8.317698561601,1.188242651657286,0.18761726078799248
30,경기도,안산시상록구,사이동,사이동제6투,3192,2039,1004,838,165,17,0,2024,15,1153,49.60474308300395,41.40316205533597,8.152173913043478,0.8399209486166008,0.0
31,경기도,안산시상록구,사이동,사이동제7투,3612,2354,1264,873,170,21,5,2333,21,1258,54.1791684526361,37.419631375910846,7.286755250750107,0.9001285897985427,0.21431633090441493
32,경기도,안산시상록구,해양동,관내사전투표,5478,5478,3719,1296,393,39,4,5451,27,0,68.22601357549074,23.775454045129337,7.20968629609246,0.7154650522839846,0.0733810310034856
33,경기도,안산시상록구,해양동,해양동제1투,3606,2563,870,1230,416,18,1,2535,28,1043,34.319526627218934,48.5207100591716,16.41025641025641,0.7100591715976331,0.03944773175542406
34,경기도,안산시상록구,해양동,해양동제2투,2710,2011,873,922,185,16,2,1998,13,699,43.69369369369369,46.146146146146144,9.25925925925926,0.8008008008008007,0.10010010010010009
35,경기도,안산시상록구,해양동,해양동제3투,2868,2068,814,1069,160,14,1,2058,10,800,39.55296404275997,51.94363459669582,7.774538386783285,0.6802721088435374,0.048590864917395525
36,경기도,안산시상록구,해양동,해양동제4투,2837,2227,1085,904,208,18,3,2218,9,610,48.917944093778175,40.75743913435528,9.377817853922453,0.8115419296663661,0.1352569882777277
37,경기도,안산시상록구,해양동,해양동제5투,3787,3047,1466,1240,297,31,2,3036,11,740,48.28722002635046,40.843214756258234,9.782608695652174,1.0210803689064558,0.06587615283267458
38,경기도,안산시상록구,해양동,해양동제6투,2649,2157,1022,917,183,21,3,2146,11,492,47.62348555452004,42.73066169617894,8.527493010251632,0.97856477166822,0.13979496738117428
39,경기도,안산시상록구,해양동,해양동제7투,2621,2039,962,828,214,16,0,2020,19,582,47.62376237623762,40.99009900990099,10.594059405940595,0.7920792079207921,0.0
40,경기도,안산시상록구,본오1동,관내사전투표,5793,5793,4259,1138,322,42,1,5762,31,0,73.9153071850052,19.7500867754252,5.588337382853176,0.7289135716765013,0.017355085039916694
41,경기도,안산시상록구,본오1동,본오1동제1투,3113,1729,840,724,127,22,3,1716,13,1384,48.95104895104895,42.19114219114219,7.400932400932401,1.282051282051282,0.17482517482517482
42,경기도,안산시상록구,본오1동,본오1동제2투,2738,1639,852,618,135,17,2,1624,15,1099,52.463054187192114,38.05418719211823,8.312807881773399,1.0467980295566501,0.12315270935960591
43,경기도,안산시상록구,본오1동,본오1동제3투,2639,1563,787,622,118,19,3,1549,14,1076,50.806972240154934,40.15493867010974,7.617817947062622,1.2265978050355069,0.19367333763718528
44,경기도,안산시상록구,본오1동,본오1동제4투,2583,1580,817,616,119,16,1,1569,11,1003,52.071383046526456,39.26067558954748,7.58444869343531,1.0197578075207139,0.06373486297004462
45,경기도,안산시상록구,본오1동,본오1동제5투,3270,1965,995,793,135,18,3,1944,21,1305,51.18312757201646,40.79218106995885,6.944444444444445,0.9259259259259258,0.15432098765432098
46,경기도,안산시상록구,본오1동,본오1동제6투,2435,1380,715,554,86,12,2,1369,11,1055,52.22790357925493,40.46749452154857,6.281957633308985,0.8765522279035792,0.1460920379839299
47,경기도,안산시상록구,본오1동,본오1동제7투,2562,1516,777,587,125,15,2,1506,10,1046,51.59362549800797,38.97742363877822,8.300132802124834,0.9960159362549801,0.13280212483399734
48,경기도,안산시상록구,본오1동,본오1동제8투,1902,1233,540,592,85,9,1,1227,6,669,44.00977995110024,48.24775876120619,6.927465362673186,0.7334963325183375,0.08149959250203749
49,경기도,안산시상록구,본오2동,관내사전투표,3191,3191,2348,631,166,16,4,3165,26,0,74.18641390205372,19.93680884676145,5.2448657187993675,0.5055292259083728,0.1263823064770932
50,경기도,안산시상록구,본오2동,본오2동제1투,2269,1309,645,553,87,14,2,1301,8,960,49.57724827056111,42.50576479631053,6.68716372021522,1.0760953112990008,0.15372790161414296
51,경기도,안산시상록구,본오2동,본오2동제2투,2208,1277,658,513,89,6,3,1269,8,931,51.85185185185185,40.42553191489361,7.0133963750985036,0.4728132387706856,0.2364066193853428
52,경기도,안산시상록구,본오2동,본오2동제3투,3314,1936,969,791,147,16,2,1925,11,1378,50.33766233766234,41.090909090909086,7.636363636363637,0.8311688311688312,0.1038961038961039
53,경기도,안산시상록구,본오2동,본오2동제4투,2113,1594,780,653,127,20,1,1581,13,519,49.33586337760911,41.30297280202404,8.032890575585071,1.265022137887413,0.06325110689437065
54,경기도,안산시상록구,본오2동,본오2동제5투,3401,2555,1209,1113,190,27,5,2544,11,846,47.52358490566038,43.75,7.468553459119496,1.0613207547169812,0.19654088050314467
55,경기도,안산시상록구,본오2동,본오2동제6투,2306,1787,831,778,150,15,1,1775,12,519,46.816901408450704,43.83098591549296,8.450704225352112,0.8450704225352111,0.056338028169014086
56,경기도,안산시상록구,본오3동,관내사전투표,5858,5858,4056,1254,448,50,4,5812,46,0,69.78664831383344,21.57604955264969,7.708189951823813,0.8602890571231934,0.06882312456985547
57,경기도,안산시상록구,본오3동,본오3동제1투,1958,1144,485,548,78,15,1,1127,17,814,43.03460514640639,48.62466725820763,6.921029281277728,1.3309671694764862,0.08873114463176575
58,경기도,안산시상록구,본오3동,본오3동제2투,1921,1472,641,665,143,10,2,1461,11,449,43.87405886379192,45.516769336071185,9.787816563997263,0.6844626967830253,0.13689253935660506
59,경기도,안산시상록구,본오3동,본오3동제3투,3276,2106,946,949,170,25,1,2091,15,1170,45.2415112386418,45.38498326159732,8.130081300813007,1.1956001912960306,0.04782400765184123
60,경기도,안산시상록구,본오3동,본오3동제4투,2723,1622,714,736,146,11,4,1611,11,1101,44.320297951582866,45.68590937306021,9.062693978895096,0.6828057107386716,0.2482929857231533
61,경기도,안산시상록구,본오3동,본오3동제5투,1444,1136,500,522,90,14,3,1129,7,308,44.28697962798937,46.235606731620905,7.971656333038086,1.2400354295837024,0.2657218777679362
62,경기도,안산시상록구,부곡동,관내사전투표,4139,4138,2989,879,213,33,3,4117,21,1,72.60140879281029,21.350497935389846,5.17367014816614,0.801554529997571,0.07286859363614283
63,경기도,안산시상록구,부곡동,부곡동제1투,3595,2148,961,966,182,18,4,2131,17,1447,45.096198967620836,45.330830595964336,8.540591271703425,0.8446738620366024,0.18770530267480057
64,경기도,안산시상록구,부곡동,부곡동제2투,2834,1646,696,790,130,14,4,1634,12,1188,42.59485924112607,48.34761321909425,7.9559363525091795,0.8567931456548347,0.24479804161566704
65,경기도,안산시상록구,부곡동,부곡동제3투,2639,1631,810,654,131,24,2,1621,10,1008,49.9691548426897,40.34546576187539,8.081431215299197,1.4805675508945095,0.12338062924120913
66,경기도,안산시상록구,부곡동,부곡동제4투,3109,2078,991,864,183,26,4,2068,10,1031,47.92069632495164,41.77949709864603,8.849129593810446,1.2572533849129592,0.19342359767891684
67,경기도,안산시상록구,월피동,관내사전투표,5415,5415,3933,1104,313,33,4,5387,28,0,73.00909597178392,20.493781325413032,5.810284017078151,0.6125858548357156,0.07425283088917765
68,경기도,안산시상록구,월피동,월피동제1투,2997,1651,766,732,126,18,0,1642,9,1346,46.65042630937881,44.579780755176614,7.673568818514006,1.0962241169305724,0.0
69,경기도,안산시상록구,월피동,월피동제2투,3512,2197,1026,962,174,15,2,2179,18,1315,47.085819183111525,44.14869206057825,7.985314364387333,0.6883891693437356,0.09178522257916476
70,경기도,안산시상록구,월피동,월피동제3투,2855,1961,901,828,179,26,5,1939,22,894,46.46725116039195,42.70242392986076,9.23156266116555,1.3408973697782363,0.25786487880350695
71,경기도,안산시상록구,월피동,월피동제4투,2449,1622,748,705,139,13,3,1608,14,827,46.517412935323385,43.843283582089555,8.644278606965173,0.808457711442786,0.18656716417910446
72,경기도,안산시상록구,월피동,월피동제5투,2372,1852,923,711,176,21,2,1833,19,520,50.35460992907801,38.788870703764324,9.601745771958537,1.1456628477905073,0.10911074740861974
73,경기도,안산시상록구,월피동,월피동제6투,2398,1831,885,711,195,32,3,1826,5,567,48.46659364731654,38.93756845564075,10.679079956188389,1.7524644030668126,0.16429353778751368
74,경기도,안산시상록구,월피동,월피동제7투,3009,1901,916,780,160,27,4,1887,14,1108,48.54266030736619,41.33545310015898,8.479067302596714,1.4308426073131957,0.21197668256491786
75,경기도,안산시상록구,월피동,월피동제8투,3237,1991,961,808,182,16,5,1972,19,1246,48.732251521298174,40.97363083164301,9.22920892494929,0.8113590263691683,0.2535496957403651
76,경기도,안산시상록구,성포동,관내사전투표,5154,5154,3483,1210,388,37,2,5120,34,0,68.02734375,23.6328125,7.578124999999999,0.72265625,0.0390625
77,경기도,안산시상록구,성포동,성포동제1투,2881,2205,836,1138,193,23,1,2191,14,676,38.156093108169785,51.93975353719763,8.808763121862164,1.0497489730716567,0.045641259698767686
78,경기도,안산시상록구,성포동,성포동제2투,2323,1632,608,846,151,14,2,1621,11,691,37.50771128932758,52.19000616903146,9.31523750771129,0.863664404688464,0.12338062924120913
79,경기도,안산시상록구,성포동,성포동제3투,2487,1867,779,909,151,16,3,1858,9,620,41.92680301399354,48.92357373519914,8.127018299246501,0.8611410118406888,0.16146393972012918
80,경기도,안산시상록구,성포동,성포동제4투,3698,2756,1174,1311,216,37,3,2741,15,942,42.831083546151035,47.829259394381616,7.880335643925575,1.34987230937614,0.10944910616563297
81,경기도,안산시상록구,성포동,성포동제5투,2963,2169,1018,927,179,27,5,2156,13,794,47.217068645640076,42.99628942486085,8.302411873840446,1.2523191094619666,0.2319109461966605
82,경기도,안산시상록구,반월동,관내사전투표,3977,3977,2686,1015,221,27,4,3953,24,0,67.94839362509487,25.676701239564885,5.590690614722995,0.6830255502150265,0.10118897040222614
83,경기도,안산시상록구,반월동,반월동제1투,3219,2158,822,1121,177,21,4,2145,13,1061,38.32167832167832,52.26107226107226,8.251748251748252,0.9790209790209791,0.1864801864801865
84,경기도,안산시상록구,반월동,반월동제2투,2790,2139,930,997,171,26,2,2126,13,651,43.74412041392286,46.89557855126999,8.043273753527751,1.2229539040451554,0.09407337723424271
85,경기도,안산시상록구,반월동,반월동제3투,2044,1320,522,706,73,8,2,1311,9,724,39.816933638443935,53.85202135774219,5.5682684973302825,0.6102212051868803,0.15255530129672007
86,경기도,안산시상록구,반월동,반월동제4투,1354,1018,428,520,58,4,1,1011,7,336,42.33432245301682,51.43422354104846,5.736894164193868,0.3956478733926805,0.09891196834817012
87,경기도,안산시상록구,반월동,반월동제5투,650,445,172,246,20,2,2,442,3,205,38.91402714932127,55.65610859728507,4.524886877828054,0.4524886877828055,0.4524886877828055
88,경기도,안산시상록구,안산동,관내사전투표,2038,2038,1371,562,92,5,1,2031,7,0,67.50369276218612,27.671097981290004,4.529788281634663,0.2461841457410143,0.04923682914820286
89,경기도,안산시상록구,안산동,안산동제1투,2164,1337,530,710,76,10,1,1327,10,827,39.939713639789,53.50414468726451,5.727204220045215,0.7535795026375283,0.07535795026375283
90,경기도,안산시상록구,안산동,안산동제2투,2650,1716,773,796,114,20,3,1706,10,934,45.31066822977726,46.658851113716295,6.682297772567409,1.1723329425556859,0.1758499413833529
91,경기도,안산시상록구,잘못 투입·구분된 투표지,,0,0,0,0,0,0,0,0,0,0,0.0,0.0,0.0,0.0,0.0
0,경기도,안산시단원구,거소·선상투표,,497,450,195,160,80,4,2,441,9,47,44.21768707482993,36.281179138321995,18.140589569160998,0.9070294784580499,0.45351473922902497
1,경기도,안산시단원구,관외사전투표,,21775,21771,13093,5148,3036,215,49,21541,230,4,60.78176500626712,23.898611949305977,14.094053200872755,0.9980966528944804,0.22747319065967225
2,경기도,안산시단원구,재외투표,,957,789,556,126,94,7,0,783,6,168,71.00893997445722,16.091954022988507,12.005108556832694,0.8939974457215836,0.0
3,경기도,안산시단원구,와동,관내사전투표,5441,5441,4051,1033,262,41,10,5397,44,0,75.06021863998518,19.140263109134704,4.854548823420419,0.7596813044283861,0.18528812303131367
4,경기도,안산시단원구,와동,와동제1투,2489,1400,724,569,88,10,1,1392,8,1089,52.01149425287356,40.87643678160919,6.321839080459771,0.7183908045977011,0.07183908045977011
5,경기도,안산시단원구,와동,와동제2투,3107,2047,1060,799,144,21,4,2028,19,1060,52.26824457593688,39.39842209072978,7.100591715976331,1.0355029585798818,0.19723865877712032
6,경기도,안산시단원구,와동,와동제3투,2860,1902,974,746,145,17,4,1886,16,958,51.64369034994698,39.55461293743372,7.688229056203605,0.9013785790031814,0.2120890774125133
7,경기도,안산시단원구,와동,와동제4투,3090,1776,937,692,122,16,3,1770,6,1314,52.93785310734464,39.09604519774012,6.892655367231638,0.903954802259887,0.1694915254237288
8,경기도,안산시단원구,와동,와동제5투,3057,1676,857,667,122,11,2,1659,17,1381,51.657625075346594,40.20494273658831,7.353827606992164,0.6630500301386377,0.12055455093429776
9,경기도,안산시단원구,와동,와동제6투,2250,1279,723,429,100,9,7,1268,11,971,57.018927444794954,33.83280757097792,7.886435331230284,0.7097791798107256,0.5520504731861199
10,경기도,안산시단원구,와동,와동제7투,3085,1720,859,699,132,13,4,1707,13,1365,50.32220269478618,40.94903339191564,7.732864674868189,0.7615700058582308,0.23432923257176333
11,경기도,안산시단원구,와동,와동제8투,2694,1489,845,526,96,13,0,1480,9,1205,57.0945945945946,35.54054054054054,6.486486486486487,0.8783783783783784,0.0
12,경기도,안산시단원구,고잔동,관내사전투표,4726,4726,3269,1040,346,33,6,4694,32,0,69.64209629314017,22.155943757988922,7.3711120579463145,0.7030251384746485,0.1278227524499361
13,경기도,안산시단원구,고잔동,고잔동제1투,2013,1215,577,535,85,12,1,1210,5,798,47.68595041322314,44.214876033057855,7.024793388429752,0.9917355371900827,0.08264462809917356
14,경기도,안산시단원구,고잔동,고잔동제2투,1397,898,346,466,71,9,0,892,6,499,38.789237668161434,52.242152466367706,7.959641255605381,1.0089686098654709,0.0
15,경기도,안산시단원구,고잔동,고잔동제3투,3580,2420,1060,1022,274,30,6,2392,28,1160,44.314381270903006,42.725752508361204,11.454849498327759,1.254180602006689,0.2508361204013378
16,경기도,안산시단원구,고잔동,고잔동제4투,2513,1641,797,640,162,24,3,1626,15,872,49.0159901599016,39.36039360393604,9.96309963099631,1.4760147601476015,0.18450184501845018
17,경기도,안산시단원구,고잔동,고잔동제5투,2669,1714,886,644,147,18,3,1698,16,955,52.179034157832746,37.926972909305064,8.657243816254418,1.0600706713780919,0.17667844522968199
18,경기도,안산시단원구,중앙동,관내사전투표,5857,5857,3786,1389,570,69,5,5819,38,0,65.06272555421894,23.870080769891732,9.795497508162915,1.185770750988142,0.08592541673827118
19,경기도,안산시단원구,중앙동,중앙동제1투,1825,1237,494,589,127,15,2,1227,10,588,40.260798696006525,48.00325998370008,10.350448247758761,1.2224938875305624,0.16299918500407498
20,경기도,안산시단원구,중앙동,중앙동제2투,3960,2476,952,1141,339,26,2,2460,16,1484,38.699186991869915,46.38211382113821,13.78048780487805,1.056910569105691,0.08130081300813008
21,경기도,안산시단원구,중앙동,중앙동제3투,3126,1977,784,964,202,15,0,1965,12,1149,39.89821882951654,49.05852417302799,10.279898218829517,0.7633587786259541,0.0
22,경기도,안산시단원구,중앙동,중앙동제4투,2518,1680,669,826,144,20,2,1661,19,838,40.27694160144491,49.72907886815172,8.669476219145093,1.2040939193257074,0.12040939193257075
23,경기도,안산시단원구,중앙동,중앙동제5투,2503,1671,736,717,178,24,1,1656,15,832,44.44444444444444,43.29710144927536,10.748792270531402,1.4492753623188406,0.06038647342995169
24,경기도,안산시단원구,호수동,관내사전투표,6969,6969,4823,1458,567,60,12,6920,49,0,69.69653179190752,21.06936416184971,8.193641618497109,0.8670520231213872,0.17341040462427745
25,경기도,안산시단원구,호수동,호수동제1투,2154,1522,646,681,164,15,1,1507,15,632,42.866622428666226,45.18911745189118,10.88254810882548,0.9953550099535502,0.06635700066357
26,경기도,안산시단원구,호수동,호수동제2투,3746,2949,1301,1357,246,28,3,2935,14,797,44.32708688245315,46.2350936967632,8.38160136286201,0.9540034071550256,0.10221465076660989
27,경기도,안산시단원구,호수동,호수동제3투,2462,1461,620,661,153,16,1,1451,10,1001,42.72915230875258,45.55478980013783,10.544452101998623,1.1026878015161956,0.06891798759476223
28,경기도,안산시단원구,호수동,호수동제4투,2585,1901,793,914,163,13,4,1887,14,684,42.02437731849496,48.436671966083736,8.638049814520404,0.688924218335983,0.21197668256491786
29,경기도,안산시단원구,호수동,호수동제5투,2977,2411,1269,874,215,32,5,2395,16,566,52.98538622129436,36.49269311064718,8.977035490605429,1.336116910229645,0.20876826722338201
30,경기도,안산시단원구,호수동,호수동제6투,2970,2375,1103,995,231,28,1,2358,17,595,46.77692960135708,42.19677692960136,9.79643765903308,1.1874469889737065,0.04240882103477523
31,경기도,안산시단원구,호수동,호수동제7투,2566,1885,871,789,186,20,5,1871,14,681,46.552645644040616,42.16996258685195,9.941207910208446,1.0689470871191877,0.26723677177979693
32,경기도,안산시단원구,호수동,호수동제8투,2761,2247,1028,953,209,39,3,2232,15,514,46.0573476702509,42.69713261648745,9.36379928315412,1.747311827956989,0.13440860215053765
33,경기도,안산시단원구,호수동,호수동제9투,2825,2307,1075,955,230,23,2,2285,22,518,47.04595185995623,41.79431072210066,10.065645514223196,1.0065645514223196,0.087527352297593
34,경기도,안산시단원구,원곡동,관내사전투표,1308,1308,955,268,65,10,0,1298,10,0,73.57473035439138,20.647149460708782,5.007704160246533,0.7704160246533128,0.0
35,경기도,안산시단원구,원곡동,원곡동제1투,781,305,138,156,10,0,0,304,1,476,45.39473684210527,51.31578947368421,3.289473684210526,0.0,0.0
36,경기도,안산시단원구,원곡동,원곡동제2투,736,356,142,198,14,0,0,354,2,380,40.11299435028249,55.932203389830505,3.954802259887006,0.0,0.0
37,경기도,안산시단원구,원곡동,원곡동제3투,1847,976,493,397,67,7,1,965,11,871,51.0880829015544,41.13989637305699,6.94300518134715,0.7253886010362695,0.10362694300518134
38,경기도,안산시단원구,백운동,관내사전투표,5999,5999,3945,1491,476,48,6,5966,33,0,66.12470667113644,24.99161917532685,7.978545088836741,0.8045591686221925,0.10056989607777406
39,경기도,안산시단원구,백운동,백운동제1투,2122,1542,755,631,133,13,2,1534,8,580,49.21773142112125,41.134289439374186,8.670143415906127,0.847457627118644,0.1303780964797914
40,경기도,안산시단원구,백운동,백운동제2투,2320,1726,803,766,136,9,2,1716,10,594,46.794871794871796,44.63869463869464,7.925407925407925,0.5244755244755245,0.11655011655011654
41,경기도,안산시단원구,백운동,백운동제3투,2107,1430,642,660,99,14,5,1420,10,677,45.2112676056338,46.478873239436616,6.971830985915493,0.9859154929577465,0.35211267605633806
42,경기도,안산시단원구,백운동,백운동제4투,1154,833,337,413,69,10,0,829,4,321,40.651387213510255,49.819059107358264,8.323281061519904,1.2062726176115801,0.0
43,경기도,안산시단원구,백운동,백운동제5투,2380,1452,626,666,142,13,1,1448,4,928,43.232044198895025,45.99447513812155,9.806629834254144,0.8977900552486188,0.06906077348066297
44,경기도,안산시단원구,백운동,백운동제6투,3430,2266,968,1005,254,26,2,2255,11,1164,42.926829268292686,44.567627494456765,11.263858093126386,1.1529933481152994,0.08869179600886917
45,경기도,안산시단원구,신길동,관내사전투표,3828,3828,2740,815,229,26,3,3813,15,0,71.85942827170207,21.374246000524522,6.005769735116706,0.6818777865198007,0.07867820613690008
46,경기도,안산시단원구,신길동,신길동제1투,2180,1562,707,693,138,12,1,1551,11,618,45.58349451966473,44.680851063829785,8.897485493230175,0.7736943907156674,0.06447453255963895
47,경기도,안산시단원구,신길동,신길동제2투,2221,1700,820,744,109,19,0,1692,8,521,48.46335697399527,43.97163120567376,6.442080378250591,1.1229314420803782,0.0
48,경기도,안산시단원구,신길동,신길동제3투,1746,924,435,416,57,8,2,918,6,822,47.385620915032675,45.31590413943355,6.209150326797386,0.8714596949891068,0.2178649237472767
49,경기도,안산시단원구,신길동,신길동제4투,1806,1166,554,524,78,6,3,1165,1,640,47.55364806866953,44.97854077253219,6.695278969957082,0.5150214592274678,0.2575107296137339
50,경기도,안산시단원구,신길동,신길동제5투,2412,1506,649,715,116,10,4,1494,12,906,43.44042838018742,47.85809906291834,7.764390896921017,0.6693440428380187,0.2677376171352075
51,경기도,안산시단원구,신길동,신길동제6투,2142,1565,796,622,118,17,3,1556,9,577,51.156812339331616,39.97429305912596,7.583547557840617,1.0925449871465296,0.1928020565552699
52,경기도,안산시단원구,초지동,관내사전투표,7639,7639,5293,1620,621,62,4,7600,39,0,69.64473684210526,21.31578947368421,8.171052631578947,0.8157894736842105,0.05263157894736842
53,경기도,안산시단원구,초지동,초지동제1투,2076,1665,817,665,149,16,4,1651,14,411,49.485160508782556,40.2786190187765,9.024833434282254,0.9691096305269533,0.24227740763173833
54,경기도,안산시단원구,초지동,초지동제2투,2002,1617,786,665,142,12,1,1606,11,385,48.94146948941469,41.40722291407223,8.84184308841843,0.7471980074719801,0.062266500622665005
55,경기도,안산시단원구,초지동,초지동제3투,2355,1856,819,827,187,15,1,1849,7,499,44.29421308815576,44.72687939426717,10.113574905354247,0.8112493239588967,0.05408328826392645
56,경기도,안산시단원구,초지동,초지동제4투,1814,1447,642,657,120,15,1,1435,12,367,44.73867595818815,45.78397212543554,8.362369337979095,1.0452961672473868,0.06968641114982578
57,경기도,안산시단원구,초지동,초지동제5투,2041,1460,731,549,152,17,1,1450,10,581,50.41379310344828,37.862068965517246,10.482758620689655,1.1724137931034484,0.06896551724137931
58,경기도,안산시단원구,초지동,초지동제6투,2013,1535,769,602,150,11,0,1532,3,478,50.19582245430809,39.295039164490866,9.7911227154047,0.7180156657963447,0.0
59,경기도,안산시단원구,초지동,초지동제7투,3756,1909,857,793,235,11,0,1896,13,1847,45.20042194092827,41.824894514767934,12.39451476793249,0.580168776371308,0.0
60,경기도,안산시단원구,초지동,초지동제8투,2026,1376,654,586,108,18,0,1366,10,650,47.87701317715959,42.89897510980966,7.906295754026354,1.3177159590043925,0.0
61,경기도,안산시단원구,초지동,초지동제9투,2333,1591,713,724,120,16,2,1575,16,742,45.26984126984127,45.96825396825397,7.6190476190476195,1.0158730158730158,0.12698412698412698
62,경기도,안산시단원구,초지동,초지동제10투,2485,1718,823,692,170,17,0,1702,16,767,48.35487661574618,40.65804935370153,9.9882491186839,0.9988249118683901,0.0
63,경기도,안산시단원구,초지동,초지동제11투,2265,1641,758,674,167,23,2,1624,17,624,46.67487684729064,41.502463054187196,10.283251231527094,1.416256157635468,0.12315270935960591
64,경기도,안산시단원구,초지동,초지동제12투,1879,1086,432,495,139,16,2,1084,2,793,39.85239852398524,45.66420664206642,12.822878228782288,1.4760147601476015,0.18450184501845018
65,경기도,안산시단원구,선부1동,관내사전투표,3868,3868,2657,850,298,33,4,3842,26,0,69.15668922436231,22.123893805309734,7.756376887038001,0.8589276418532015,0.10411244143675169
66,경기도,안산시단원구,선부1동,선부1동제1투,970,583,269,249,52,6,0,576,7,387,46.70138888888889,43.22916666666667,9.027777777777777,1.0416666666666665,0.0
67,경기도,안산시단원구,선부1동,선부1동제2투,1406,990,452,434,79,11,3,979,11,416,46.16956077630235,44.330949948927476,8.069458631256383,1.1235955056179776,0.30643513789581206
68,경기도,안산시단원구,선부1동,선부1동제3투,1681,1166,561,473,102,14,4,1154,12,515,48.613518197573654,40.98786828422877,8.838821490467938,1.2131715771230502,0.34662045060658575
69,경기도,안산시단원구,선부1동,선부1동제4투,1863,1192,559,518,88,10,0,1175,17,671,47.57446808510638,44.08510638297872,7.48936170212766,0.851063829787234,0.0
70,경기도,안산시단원구,선부1동,선부1동제5투,1471,1028,437,446,118,16,3,1020,8,443,42.84313725490196,43.72549019607843,11.568627450980392,1.5686274509803921,0.29411764705882354
71,경기도,안산시단원구,선부1동,선부1동제6투,3206,2488,1121,1108,224,24,1,2478,10,718,45.23809523809524,44.7134786117837,9.03954802259887,0.9685230024213075,0.04035512510088781
72,경기도,안산시단원구,선부2동,관내사전투표,3481,3481,2455,742,234,22,3,3456,25,0,71.03587962962963,21.46990740740741,6.770833333333333,0.6365740740740741,0.08680555555555555
73,경기도,안산시단원구,선부2동,선부2동제1투,2043,1206,588,496,103,10,1,1198,8,837,49.08180300500835,41.40233722871452,8.597662771285476,0.8347245409015025,0.08347245409015025
74,경기도,안산시단원구,선부2동,선부2동제2투,1720,1049,540,434,59,6,0,1039,10,671,51.9730510105871,41.77093358999038,5.678537054860443,0.5774783445620789,0.0
75,경기도,안산시단원구,선부2동,선부2동제3투,2218,1304,639,553,89,10,7,1298,6,914,49.229583975346685,42.604006163328194,6.8567026194144844,0.7704160246533128,0.539291217257319
76,경기도,안산시단원구,선부2동,선부2동제4투,2412,1425,734,558,102,15,3,1412,13,987,51.98300283286119,39.51841359773371,7.223796033994335,1.0623229461756374,0.2124645892351275
77,경기도,안산시단원구,선부2동,선부2동제5투,2146,1399,699,520,142,24,2,1387,12,747,50.396539293439076,37.490987743330926,10.237923576063446,1.7303532804614274,0.14419610670511895
78,경기도,안산시단원구,선부3동,관내사전투표,4340,4340,3130,921,234,28,3,4316,24,0,72.52085264133457,21.33920296570899,5.421686746987952,0.6487488415199258,0.06950880444856349
79,경기도,안산시단원구,선부3동,선부3동제1투,2113,1164,606,420,104,17,2,1149,15,949,52.74151436031331,36.55352480417754,9.051348999129678,1.4795474325500435,0.17406440382941687
80,경기도,안산시단원구,선부3동,선부3동제2투,2228,1287,671,499,96,13,3,1282,5,941,52.34009360374415,38.92355694227769,7.48829953198128,1.014040561622465,0.234009360374415
81,경기도,안산시단원구,선부3동,선부3동제3투,2356,1269,644,503,99,14,3,1263,6,1087,50.98970704671417,39.82581155977831,7.8384798099762465,1.1084718923198733,0.23752969121140144
82,경기도,안산시단원구,선부3동,선부3동제4투,3313,2563,1218,1079,222,23,4,2546,17,750,47.83974862529458,42.38020424194816,8.719560094265514,0.9033778476040848,0.15710919088766695
83,경기도,안산시단원구,선부3동,선부3동제5투,2569,1820,927,732,142,10,0,1811,9,749,51.18718939812258,40.41965764770845,7.840971838763114,0.5521811154058531,0.0
84,경기도,안산시단원구,선부3동,선부3동제6투,3328,2527,1191,1102,177,27,4,2501,26,801,47.62095161935226,44.062375049980005,7.077169132347061,1.0795681727309077,0.1599360255897641
85,경기도,안산시단원구,선부3동,선부3동제7투,1699,1235,629,491,88,12,2,1222,13,464,51.47299509001637,40.18003273322422,7.201309328968904,0.9819967266775778,0.16366612111292964
86,경기도,안산시단원구,선부3동,선부3동제8투,2848,2148,1098,800,216,22,2,2138,10,700,51.356407857811035,37.418147801683816,10.102899906454631,1.028999064546305,0.09354536950420954
87,경기도,안산시단원구,대부동,관내사전투표,2267,2267,1241,910,85,14,1,2251,16,0,55.13105286539316,40.42647712127943,3.7760995113282987,0.6219458018658374,0.0444247001332741
88,경기도,안산시단원구,대부동,대부동제1투,1603,912,234,640,31,4,0,909,3,691,25.742574257425744,70.40704070407041,3.4103410341034106,0.44004400440044,0.0
89,경기도,안산시단원구,대부동,대부동제2투,1839,1114,266,788,51,8,1,1114,0,725,23.877917414721722,70.73608617594255,4.578096947935368,0.718132854578097,0.08976660682226212
90,경기도,안산시단원구,대부동,대부동제3투,1601,968,264,666,29,1,0,960,8,633,27.500000000000004,69.375,3.0208333333333335,0.10416666666666667,0.0
91,경기도,안산시단원구,잘못 투입·구분된 투표지,,0,0,0,0,0,0,0,0,0,0,0.0,0.0,0.0,0.0,0.0
0,경기도,고양시덕양구,거소·선상투표,,542,520,225,184,93,2,1,505,15,22,44.554455445544555,36.43564356435643,18.415841584158414,0.39603960396039606,0.19801980198019803
1,경기도,고양시덕양구,관외사전투표,,46638,46633,29570,10470,5531,627,51,46249,384,5,63.93651754632532,22.638327315185194,11.959177495729637,1.3557049882159615,0.11027265454388202
2,경기도,고양시덕양구,재외투표,,3164,2606,1800,497,246,46,1,2590,16,558,69.4980694980695,19.18918918918919,9.498069498069498,1.7760617760617758,0.03861003861003861
3,경기도,고양시덕양구,주교동,관내사전투표,3050,3050,2095,697,200,27,4,3023,27,0,69.30201786304994,23.056566324842873,6.615944426066821,0.8931524975190208,0.13231888852133644
4,경기도,고양시덕양구,주교동,주교동제1투,1537,907,353,489,42,16,3,903,4,630,39.09191583610188,54.15282392026578,4.651162790697675,1.7718715393133997,0.33222591362126247
5,경기도,고양시덕양구,주교동,주교동제2투,1509,853,368,412,62,4,0,846,7,656,43.498817966903076,48.69976359338061,7.328605200945626,0.4728132387706856,0.0
6,경기도,고양시덕양구,주교동,주교동제3투,2095,1259,498,644,97,12,0,1251,8,836,39.80815347721823,51.47881694644284,7.753796962430055,0.9592326139088728,0.0
7,경기도,고양시덕양구,주교동,주교동제4투,1175,753,337,340,61,6,2,746,7,422,45.17426273458445,45.57640750670242,8.176943699731904,0.8042895442359249,0.2680965147453083
8,경기도,고양시덕양구,원신동,관내사전투표,2218,2218,1594,472,127,19,1,2213,5,0,72.02892001807501,21.32851333032083,5.738816086760054,0.8585630366018979,0.045187528242205156
9,경기도,고양시덕양구,원신동,원신동제1투,2794,2167,1125,831,177,28,0,2161,6,627,52.05923183711245,38.45441925034706,8.190652475705692,1.2956964368347987,0.0
10,경기도,고양시덕양구,원신동,원신동제2투,729,418,119,263,34,1,0,417,1,311,28.53717026378897,63.06954436450839,8.15347721822542,0.2398081534772182,0.0
11,경기도,고양시덕양구,원신동,원신동제3투,2982,2157,1053,981,91,21,2,2148,9,825,49.022346368715084,45.67039106145251,4.236499068901304,0.9776536312849162,0.0931098696461825
12,경기도,고양시덕양구,원신동,원신동제4투,3395,2467,1218,1010,198,27,2,2455,12,928,49.61303462321792,41.14052953156823,8.065173116089614,1.0997963340122199,0.0814663951120163
13,경기도,고양시덕양구,원신동,원신동제5투,2749,2005,973,852,147,26,0,1998,7,744,48.6986986986987,42.64264264264264,7.3573573573573565,1.3013013013013013,0.0
14,경기도,고양시덕양구,흥도동,관내사전투표,3034,3034,2177,676,142,23,1,3019,15,0,72.10997018880424,22.39152037098377,4.703544219940378,0.7618416694269625,0.033123550844650546
15,경기도,고양시덕양구,흥도동,흥도동제1투,895,489,144,309,22,6,0,481,8,406,29.93762993762994,64.24116424116424,4.5738045738045745,1.2474012474012475,0.0
16,경기도,고양시덕양구,흥도동,흥도동제2투,2882,1897,828,862,176,19,3,1888,9,985,43.85593220338983,45.65677966101695,9.322033898305085,1.0063559322033897,0.15889830508474578
17,경기도,고양시덕양구,흥도동,흥도동제3투,2410,1867,988,720,125,26,1,1860,7,543,53.118279569892465,38.70967741935484,6.720430107526881,1.3978494623655915,0.053763440860215055
18,경기도,고양시덕양구,흥도동,흥도동제4투,2948,2246,1186,816,181,48,4,2235,11,702,53.06487695749441,36.51006711409396,8.098434004474273,2.1476510067114094,0.1789709172259508
19,경기도,고양시덕양구,흥도동,흥도동제5투,2887,2050,1053,763,182,37,0,2035,15,837,51.744471744471745,37.4938574938575,8.943488943488944,1.8181818181818181,0.0
20,경기도,고양시덕양구,흥도동,흥도동제6투,1795,1477,780,557,118,14,0,1469,8,318,53.09734513274337,37.91695030633084,8.032675289312458,0.9530292716133424,0.0
21,경기도,고양시덕양구,흥도동,흥도동제7투,2905,2238,1141,906,140,29,3,2219,19,667,51.419558359621455,40.829202343397924,6.309148264984227,1.3068949977467328,0.135196034249662
22,경기도,고양시덕양구,성사1동,관내사전투표,5170,5169,3500,1229,369,44,5,5147,22,1,68.00077715173887,23.87798717699631,7.16922479114047,0.8548669127647173,0.09714396735962696
23,경기도,고양시덕양구,성사1동,성사1동제1투,2502,1685,694,773,193,14,1,1675,10,817,41.43283582089553,46.14925373134328,11.522388059701493,0.835820895522388,0.05970149253731343
24,경기도,고양시덕양구,성사1동,성사1동제2투,3137,1842,786,927,102,12,3,1830,12,1295,42.950819672131146,50.65573770491804,5.573770491803279,0.6557377049180327,0.16393442622950818
25,경기도,고양시덕양구,성사1동,성사1동제3투,2981,1672,735,785,119,17,0,1656,16,1309,44.38405797101449,47.40338164251207,7.185990338164252,1.0265700483091789,0.0
26,경기도,고양시덕양구,성사1동,성사1동제4투,2873,2252,1003,1051,151,30,1,2236,16,621,44.856887298747765,47.00357781753131,6.753130590339892,1.3416815742397137,0.044722719141323794
27,경기도,고양시덕양구,성사1동,성사1동제5투,2544,1933,877,873,159,14,1,1924,9,611,45.58212058212058,45.37422037422038,8.264033264033264,0.7276507276507277,0.05197505197505198
28,경기도,고양시덕양구,성사2동,관내사전투표,2599,2599,1811,594,151,34,1,2591,8,0,69.89579313006561,22.925511385565418,5.827865688923196,1.3122346584330373,0.0385951370127364
29,경기도,고양시덕양구,성사2동,성사2동제1투,1844,1264,513,626,102,13,0,1254,10,580,40.909090909090914,49.920255183413076,8.133971291866029,1.036682615629984,0.0
30,경기도,고양시덕양구,성사2동,성사2동제2투,1953,1395,524,750,98,18,2,1392,3,558,37.64367816091954,53.879310344827594,7.040229885057471,1.293103448275862,0.14367816091954022
31,경기도,고양시덕양구,성사2동,성사2동제3투,2098,1538,661,745,109,10,0,1525,13,560,43.34426229508196,48.85245901639344,7.147540983606556,0.6557377049180327,0.0
32,경기도,고양시덕양구,효자동,관내사전투표,5318,5318,3807,897,504,81,1,5290,28,0,71.96597353497165,16.956521739130434,9.527410207939509,1.5311909262759926,0.01890359168241966
33,경기도,고양시덕양구,효자동,효자동제1투,914,629,173,411,39,3,0,626,3,285,27.635782747603834,65.65495207667732,6.230031948881789,0.4792332268370607,0.0
34,경기도,고양시덕양구,효자동,효자동제2투,2837,1989,822,882,238,21,5,1968,21,848,41.76829268292683,44.81707317073171,12.09349593495935,1.0670731707317074,0.25406504065040647
35,경기도,고양시덕양구,효자동,효자동제3투,2215,1793,816,777,159,27,1,1780,13,422,45.84269662921348,43.651685393258425,8.932584269662922,1.5168539325842696,0.05617977528089888
36,경기도,고양시덕양구,효자동,효자동제4투,3058,2405,1215,849,280,44,1,2389,16,653,50.85809962327333,35.53788195897865,11.720385098367519,1.8417748011720385,0.041858518208455424
37,경기도,고양시덕양구,효자동,효자동제5투,1810,1309,508,681,94,14,2,1299,10,501,39.107005388760584,52.42494226327945,7.236335642802155,1.077752117013087,0.15396458814472672
38,경기도,고양시덕양구,효자동,효자동제6투,1856,1463,748,503,180,18,0,1449,14,393,51.62180814354728,34.7135955831608,12.422360248447205,1.2422360248447204,0.0
39,경기도,고양시덕양구,삼송1동,관내사전투표,6621,6621,4445,1438,601,90,4,6578,43,0,67.57373061720888,21.86074794770447,9.136515658254789,1.3681970203709335,0.060808756460930376
40,경기도,고양시덕양구,삼송1동,삼송1동제1투,2279,1432,467,831,109,13,1,1421,11,847,32.86418015482055,58.47994370161857,7.670654468684026,0.9148486980999296,0.07037297677691766
41,경기도,고양시덕양구,삼송1동,삼송1동제2투,3286,2438,1224,946,214,39,0,2423,15,848,50.515889393314076,39.04250928600908,8.832026413536937,1.609574907139909,0.0
42,경기도,고양시덕양구,삼송1동,삼송1동제3투,1781,1346,530,667,113,21,1,1332,14,435,39.78978978978979,50.07507507507507,8.483483483483484,1.5765765765765765,0.07507507507507508
43,경기도,고양시덕양구,삼송1동,삼송1동제4투,1716,1451,682,626,125,12,0,1445,6,265,47.19723183391004,43.32179930795847,8.650519031141869,0.8304498269896194,0.0
44,경기도,고양시덕양구,삼송1동,삼송1동제5투,3109,2118,791,970,283,42,5,2091,27,991,37.82879005260641,46.38928742228599,13.534194165471067,2.008608321377331,0.23912003825920614
45,경기도,고양시덕양구,삼송2동,관내사전투표,5823,5823,4035,1184,491,71,4,5785,38,0,69.74935177182368,20.466724286949006,8.487467588591183,1.2273120138288678,0.06914433880726015
46,경기도,고양시덕양구,삼송2동,삼송2동제1투,2472,1768,753,863,116,20,2,1754,14,704,42.93044469783352,49.2018244013683,6.61345496009122,1.1402508551881414,0.11402508551881414
47,경기도,고양시덕양구,삼송2동,삼송2동제2투,3335,2242,987,1060,157,24,1,2229,13,1093,44.27994616419919,47.55495737999102,7.043517272319426,1.0767160161507403,0.04486316733961417
48,경기도,고양시덕양구,삼송2동,삼송2동제3투,1969,1369,559,660,128,13,0,1360,9,600,41.10294117647059,48.529411764705884,9.411764705882353,0.9558823529411765,0.0
49,경기도,고양시덕양구,삼송2동,삼송2동제4투,3406,2489,1041,1225,182,25,2,2475,14,917,42.06060606060606,49.494949494949495,7.353535353535354,1.0101010101010102,0.0808080808080808
50,경기도,고양시덕양구,삼송2동,삼송2동제5투,2231,1637,688,738,180,14,4,1624,13,594,42.364532019704434,45.44334975369458,11.083743842364532,0.8620689655172413,0.24630541871921183
51,경기도,고양시덕양구,삼송2동,삼송2동제6투,2373,1729,738,698,240,31,1,1708,21,644,43.20843091334894,40.866510538641684,14.05152224824356,1.8149882903981265,0.0585480093676815
52,경기도,고양시덕양구,창릉동,관내사전투표,4127,4127,2869,858,327,40,3,4097,30,0,70.02684891383939,20.94215279472785,7.9814498413473265,0.9763241396143519,0.0732243104710764
53,경기도,고양시덕양구,창릉동,창릉동제1투,1572,884,338,481,54,5,0,878,6,688,38.496583143507976,54.783599088838265,6.150341685649203,0.5694760820045558,0.0
54,경기도,고양시덕양구,창릉동,창릉동제2투,1275,852,265,507,63,10,1,846,6,423,31.32387706855792,59.9290780141844,7.446808510638298,1.1820330969267139,0.1182033096926714
55,경기도,고양시덕양구,창릉동,창릉동제3투,1725,1150,503,506,116,13,2,1140,10,575,44.122807017543856,44.3859649122807,10.175438596491228,1.1403508771929824,0.17543859649122806
56,경기도,고양시덕양구,창릉동,창릉동제4투,2258,1855,843,833,148,21,1,1846,9,403,45.66630552546045,45.12459371614301,8.017334777898158,1.1375947995666305,0.054171180931744306
57,경기도,고양시덕양구,창릉동,창릉동제5투,2194,1611,672,712,192,24,0,1600,11,583,42.0,44.5,12.0,1.5,0.0
58,경기도,고양시덕양구,창릉동,창릉동제6투,3192,2417,1083,968,310,36,1,2398,19,775,45.16263552960801,40.36697247706422,12.92743953294412,1.5012510425354462,0.041701417848206836
59,경기도,고양시덕양구,고양동,관내사전투표,6259,6259,4219,1594,341,50,8,6212,47,0,67.91693496458467,25.660012878300066,5.489375402446877,0.8048937540244688,0.128783000643915
60,경기도,고양시덕양구,고양동,고양동제1투,1844,1112,449,590,61,9,1,1110,2,732,40.45045045045045,53.153153153153156,5.495495495495495,0.8108108108108109,0.09009009009009009
61,경기도,고양시덕양구,고양동,고양동제2투,2081,1165,474,591,79,13,3,1160,5,916,40.86206896551724,50.94827586206897,6.810344827586206,1.1206896551724137,0.25862068965517243
62,경기도,고양시덕양구,고양동,고양동제3투,2267,1414,567,730,90,14,2,1403,11,853,40.413399857448326,52.03136136849608,6.414825374198147,0.9978617248752674,0.14255167498218105
63,경기도,고양시덕양구,고양동,고양동제4투,3022,1737,696,915,95,16,4,1726,11,1285,40.32444959443801,53.01274623406721,5.504055619930475,0.9269988412514484,0.2317497103128621
64,경기도,고양시덕양구,고양동,고양동제5투,1268,799,288,466,36,4,2,796,3,469,36.18090452261307,58.5427135678392,4.522613065326634,0.5025125628140703,0.25125628140703515
65,경기도,고양시덕양구,고양동,고양동제6투,2663,1765,818,811,111,15,1,1756,9,898,46.583143507972665,46.184510250569474,6.32118451025057,0.8542141230068337,0.05694760820045558
66,경기도,고양시덕양구,고양동,고양동제7투,2300,1589,744,718,102,13,3,1580,9,711,47.08860759493671,45.44303797468354,6.455696202531645,0.8227848101265823,0.18987341772151897
67,경기도,고양시덕양구,관산동,관내사전투표,5098,5098,3556,1234,235,43,6,5074,24,0,70.08277493102088,24.32006306661411,4.631454473787938,0.847457627118644,0.11824990145841545
68,경기도,고양시덕양구,관산동,관산동제1투,2071,1289,546,662,58,10,2,1278,11,782,42.72300469483568,51.79968701095462,4.538341158059469,0.7824726134585289,0.1564945226917058
69,경기도,고양시덕양구,관산동,관산동제2투,1377,815,298,459,43,9,0,809,6,562,36.83559950556242,56.736711990111246,5.315203955500618,1.1124845488257107,0.0
70,경기도,고양시덕양구,관산동,관산동제3투,3211,2141,936,1037,136,14,4,2127,14,1070,44.00564174894217,48.75411377527033,6.393982134461683,0.6582040432534085,0.18805829807240243
71,경기도,고양시덕양구,관산동,관산동제4투,2291,1465,627,753,76,5,0,1461,4,826,42.91581108829568,51.54004106776181,5.201916495550993,0.34223134839151265,0.0
72,경기도,고양시덕양구,관산동,관산동제5투,3698,2254,1071,1013,133,21,3,2241,13,1444,47.791164658634536,45.20303435966086,5.9348505131637665,0.9370816599732262,0.13386880856760375
73,경기도,고양시덕양구,관산동,관산동제6투,4054,2332,1156,1020,122,17,2,2317,15,1722,49.89210185584808,44.022442813983595,5.265429434613725,0.73370738023306,0.08631851532153648
74,경기도,고양시덕양구,관산동,관산동제7투,2591,1673,796,758,91,15,1,1661,12,918,47.92293798916315,45.635159542444306,5.478627332931969,0.9030704394942807,0.060204695966285374
75,경기도,고양시덕양구,관산동,관산동제8투,2435,1532,701,718,89,9,2,1519,13,903,46.14878209348255,47.26793943383805,5.859117840684661,0.5924950625411455,0.13166556945358787
76,경기도,고양시덕양구,능곡동,관내사전투표,4070,4070,2701,1025,274,38,3,4041,29,0,66.83989111606039,25.365008661222472,6.780499876268251,0.9403612967087355,0.07423904974016332
77,경기도,고양시덕양구,능곡동,능곡동제1투,2289,1557,608,828,103,7,2,1548,9,732,39.276485788113696,53.48837209302325,6.6537467700258395,0.45219638242894056,0.12919896640826875
78,경기도,고양시덕양구,능곡동,능곡동제2투,1562,1028,344,575,93,9,0,1021,7,534,33.692458374142994,56.31733594515181,9.10871694417238,0.881488736532811,0.0
79,경기도,고양시덕양구,능곡동,능곡동제3투,1620,1118,393,609,98,6,1,1107,11,502,35.50135501355013,55.013550135501355,8.85275519421861,0.5420054200542005,0.09033423667570009
80,경기도,고양시덕양구,능곡동,능곡동제4투,1539,1048,341,598,83,20,1,1043,5,491,32.694151486097795,57.3346116970278,7.957813998082454,1.9175455417066156,0.09587727708533077
81,경기도,고양시덕양구,능곡동,능곡동제5투,2510,1749,695,852,164,20,0,1731,18,761,40.15020219526285,49.220103986135186,9.474292316580012,1.1554015020219526,0.0
82,경기도,고양시덕양구,화정1동,관내사전투표,9629,9629,6441,2261,752,95,3,9552,77,0,67.43090452261306,23.67043551088777,7.872696817420436,0.9945561139028477,0.031407035175879394
83,경기도,고양시덕양구,화정1동,화정1동제1투,2337,1808,822,811,151,15,2,1801,7,529,45.641310383120484,45.0305385896724,8.38423098278734,0.8328706274292059,0.11104941699056081
84,경기도,고양시덕양구,화정1동,화정1동제2투,2324,1701,707,829,141,9,0,1686,15,623,41.93357058125741,49.16963226571768,8.362989323843415,0.5338078291814947,0.0
85,경기도,고양시덕양구,화정1동,화정1동제3투,2405,1691,741,787,128,21,0,1677,14,714,44.18604651162791,46.92903995229577,7.6326774001192605,1.2522361359570662,0.0
86,경기도,고양시덕양구,화정1동,화정1동제4투,2039,1480,593,742,124,12,0,1471,9,559,40.312712440516655,50.44187627464311,8.429639700883753,0.8157715839564922,0.0
87,경기도,고양시덕양구,화정1동,화정1동제5투,2725,2001,657,1149,159,24,2,1991,10,724,32.9984932194877,57.709693621295834,7.985936715218483,1.2054244098442994,0.10045203415369162
88,경기도,고양시덕양구,화정1동,화정1동제6투,2329,1391,499,719,146,16,1,1381,10,938,36.13323678493845,52.06372194062274,10.57204923968139,1.1585807385952207,0.0724112961622013
89,경기도,고양시덕양구,화정1동,화정1동제7투,1931,999,349,533,98,9,1,990,9,932,35.25252525252525,53.83838383838384,9.8989898989899,0.9090909090909091,0.10101010101010101
90,경기도,고양시덕양구,화정1동,화정1동제8투,2326,1741,592,992,133,15,0,1732,9,585,34.18013856812933,57.27482678983834,7.678983833718245,0.8660508083140877,0.0
91,경기도,고양시덕양구,화정1동,화정1동제9투,2135,1328,516,649,132,17,2,1316,12,807,39.209726443769,49.316109422492396,10.030395136778116,1.2917933130699089,0.1519756838905775
92,경기도,고양시덕양구,화정2동,관내사전투표,6289,6289,4373,1362,458,62,3,6258,31,0,69.87855544902524,21.764141898370088,7.318632150846915,0.9907318632150848,0.047938638542665384
93,경기도,고양시덕양구,화정2동,화정2동제1투,2541,1612,652,782,145,19,1,1599,13,929,40.7754846779237,48.90556597873671,9.06816760475297,1.188242651657286,0.06253908692933083
94,경기도,고양시덕양구,화정2동,화정2동제2투,2401,1694,733,789,135,29,1,1687,7,707,43.44991108476586,46.76941315945465,8.002371072910492,1.7190278601066984,0.05927682276229994
95,경기도,고양시덕양구,화정2동,화정2동제3투,2589,1988,910,855,196,18,2,1981,7,601,45.936395759717314,43.16002019182231,9.89399293286219,0.9086320040383644,0.10095911155981827
96,경기도,고양시덕양구,화정2동,화정2동제4투,3039,2227,959,1018,201,32,0,2210,17,812,43.39366515837104,46.06334841628959,9.095022624434389,1.4479638009049773,0.0
97,경기도,고양시덕양구,화정2동,화정2동제5투,2408,1848,899,778,146,18,1,1842,6,560,48.80564603691639,42.23669923995657,7.926167209554831,0.9771986970684038,0.05428881650380022
98,경기도,고양시덕양구,화정2동,화정2동제6투,1910,1521,652,718,122,21,1,1514,7,389,43.064729194187585,47.42404227212681,8.058124174372523,1.3870541611624834,0.06605019815059446
99,경기도,고양시덕양구,화정2동,화정2동제7투,2340,1730,780,750,163,27,2,1722,8,610,45.29616724738676,43.55400696864111,9.465737514518002,1.5679442508710801,0.11614401858304298
100,경기도,고양시덕양구,행주동,관내사전투표,2300,2300,1516,623,130,15,2,2286,14,0,66.3167104111986,27.252843394575677,5.68678915135608,0.6561679790026247,0.08748906386701663
101,경기도,고양시덕양구,행주동,행주동제1투,662,311,127,162,22,0,0,311,0,351,40.836012861736336,52.09003215434084,7.07395498392283,0.0,0.0
102,경기도,고양시덕양구,행주동,행주동제2투,879,473,197,229,31,6,2,465,8,406,42.365591397849464,49.24731182795699,6.666666666666667,1.2903225806451613,0.43010752688172044
103,경기도,고양시덕양구,행주동,행주동제3투,2232,1313,557,627,95,18,3,1300,13,919,42.84615384615385,48.23076923076923,7.307692307692308,1.3846153846153846,0.23076923076923078
104,경기도,고양시덕양구,행주동,행주동제4투,1008,633,250,325,50,4,1,630,3,375,39.682539682539684,51.587301587301596,7.936507936507936,0.6349206349206349,0.15873015873015872
105,경기도,고양시덕양구,행주동,행주동제5투,812,544,149,361,27,5,0,542,2,268,27.490774907749078,66.60516605166052,4.981549815498155,0.9225092250922509,0.0
106,경기도,고양시덕양구,행주동,행주동제6투,2127,1393,509,756,107,12,1,1385,8,734,36.750902527075816,54.584837545126355,7.725631768953069,0.8664259927797834,0.07220216606498195
107,경기도,고양시덕양구,행신1동,관내사전투표,4448,4448,3107,933,337,40,1,4418,30,0,70.32593933906746,21.11815301041195,7.627885921231327,0.9053870529651425,0.022634676324128564
108,경기도,고양시덕양구,행신1동,행신1동제1투,2104,1368,552,670,107,26,2,1357,11,736,40.67796610169492,49.37361827560796,7.885040530582168,1.915991156963891,0.14738393515106854
109,경기도,고양시덕양구,행신1동,행신1동제2투,2287,1762,778,818,132,25,0,1753,9,525,44.381061038220196,46.66286366229321,7.529948659440959,1.426126640045636,0.0
110,경기도,고양시덕양구,행신1동,행신1동제3투,2023,1447,627,685,108,13,0,1433,14,576,43.75436147941382,47.801814375436145,7.536636427076064,0.9071877180739707,0.0
111,경기도,고양시덕양구,행신1동,행신1동제4투,2518,1886,826,853,167,27,2,1875,11,632,44.053333333333335,45.49333333333333,8.906666666666666,1.44,0.10666666666666667
112,경기도,고양시덕양구,행신1동,행신1동제5투,2365,1802,713,892,157,28,2,1792,10,563,39.78794642857143,49.776785714285715,8.761160714285714,1.5625,0.11160714285714285
113,경기도,고양시덕양구,행신2동,관내사전투표,7115,7115,4834,1560,604,69,6,7073,42,0,68.34440831330411,22.055704792874312,8.539516471087232,0.9755407889155946,0.08482963381874735
114,경기도,고양시덕양구,행신2동,행신2동제1투,2626,1771,687,882,163,24,1,1757,14,855,39.10073989755264,50.199203187250994,9.277177006260672,1.3659647125782584,0.056915196357427436
115,경기도,고양시덕양구,행신2동,행신2동제2투,1855,1376,533,705,109,20,1,1368,8,479,38.96198830409357,51.53508771929825,7.9678362573099415,1.461988304093567,0.07309941520467836
116,경기도,고양시덕양구,행신2동,행신2동제3투,2794,2086,817,1026,190,28,5,2066,20,708,39.54501452081317,49.66118102613746,9.19651500484027,1.3552758954501452,0.24201355275895448
117,경기도,고양시덕양구,행신2동,행신2동제4투,2450,1858,860,759,193,30,1,1843,15,592,46.66304937601736,41.182854042322305,10.47205642973413,1.6277807921866523,0.05425935973955508
118,경기도,고양시덕양구,행신2동,행신2동제5투,2311,1695,744,756,157,26,0,1683,12,616,44.20677361853833,44.919786096256686,9.32857991681521,1.5448603683897801,0.0
119,경기도,고양시덕양구,행신2동,행신2동제6투,2090,1572,733,647,151,25,1,1557,15,518,47.07771355170199,41.55427103403982,9.698137443802183,1.605651894669236,0.06422607578676942
120,경기도,고양시덕양구,행신2동,행신2동제7투,2096,1543,667,709,129,22,4,1531,12,553,43.56629653821032,46.309601567602876,8.425865447419987,1.4369693011103852,0.2612671456564337
121,경기도,고양시덕양구,행신2동,행신2동제8투,323,230,73,139,11,6,0,229,1,93,31.877729257641924,60.698689956331876,4.8034934497816595,2.6200873362445414,0.0
122,경기도,고양시덕양구,행신3동,관내사전투표,5252,5251,3641,1163,365,49,2,5220,31,1,69.75095785440612,22.279693486590038,6.992337164750957,0.9386973180076629,0.03831417624521073
123,경기도,고양시덕양구,행신3동,행신3동제1투,2656,1758,762,817,128,27,2,1736,22,898,43.894009216589865,47.06221198156682,7.373271889400922,1.555299539170507,0.1152073732718894
124,경기도,고양시덕양구,행신3동,행신3동제2투,2613,1948,855,859,192,25,0,1931,17,665,44.27757638529259,44.484722941481095,9.943034697048162,1.294665976178146,0.0
125,경기도,고양시덕양구,행신3동,행신3동제3투,2699,2063,836,1006,183,23,1,2049,14,636,40.80039043435823,49.0971205466081,8.931185944363104,1.1224987798926307,0.04880429477794046
126,경기도,고양시덕양구,행신3동,행신3동제4투,2484,1913,863,854,167,15,1,1900,13,571,45.421052631578945,44.94736842105263,8.789473684210526,0.7894736842105263,0.05263157894736842
127,경기도,고양시덕양구,행신3동,행신3동제5투,1758,1408,550,733,104,12,2,1401,7,350,39.25767309064953,52.3197715917202,7.423269093504639,0.8565310492505354,0.14275517487508924
128,경기도,고양시덕양구,행신4동,관내사전투표,5158,5158,3510,1232,336,46,4,5128,30,0,68.44773790951638,24.024960998439937,6.5522620904836195,0.8970358814352575,0.078003120124805
129,경기도,고양시덕양구,행신4동,행신4동제1투,2413,1355,556,669,103,10,3,1341,14,1058,41.46159582401193,49.88814317673378,7.680835197613721,0.7457121551081283,0.22371364653243847
130,경기도,고양시덕양구,행신4동,행신4동제2투,1701,920,394,436,73,7,0,910,10,781,43.2967032967033,47.91208791208791,8.021978021978022,0.7692307692307693,0.0
131,경기도,고양시덕양구,행신4동,행신4동제3투,1997,1271,535,609,97,21,1,1263,8,726,42.35946159936659,48.218527315914486,7.68012668250198,1.66270783847981,0.0791765637371338
132,경기도,고양시덕양구,행신4동,행신4동제4투,1804,1403,659,600,121,15,0,1395,8,401,47.24014336917563,43.01075268817204,8.67383512544803,1.0752688172043012,0.0
133,경기도,고양시덕양구,행신4동,행신4동제5투,2586,1947,911,840,160,25,1,1937,10,639,47.03149199793495,43.36602994321115,8.260196179659268,1.2906556530717606,0.05162622612287042
134,경기도,고양시덕양구,화전동,관내사전투표,3100,3100,2112,646,294,25,2,3079,21,0,68.59369925300423,20.980837934394284,9.548554725560248,0.8119519324455992,0.06495615459564794
135,경기도,고양시덕양구,화전동,화전동제1투,1947,1117,411,571,115,9,2,1108,9,830,37.09386281588448,51.53429602888087,10.379061371841155,0.8122743682310468,0.18050541516245489
136,경기도,고양시덕양구,화전동,화전동제2투,703,484,217,232,23,4,0,476,8,219,45.588235294117645,48.739495798319325,4.831932773109244,0.8403361344537815,0.0
137,경기도,고양시덕양구,화전동,화전동제3투,2991,2298,1064,958,237,26,0,2285,13,693,46.564551422319475,41.925601750547045,10.37199124726477,1.1378555798687089,0.0
138,경기도,고양시덕양구,화전동,화전동제4투,2709,2224,1137,842,204,32,0,2215,9,485,51.331828442437924,38.013544018058695,9.209932279909706,1.4446952595936793,0.0
139,경기도,고양시덕양구,화전동,화전동제5투,2008,1647,951,526,144,22,1,1644,3,361,57.846715328467155,31.995133819951338,8.75912408759124,1.338199513381995,0.06082725060827251
140,경기도,고양시덕양구,화전동,화전동제6투,2769,2057,1139,722,148,34,3,2046,11,712,55.66959921798631,35.28836754643206,7.233626588465299,1.6617790811339197,0.1466275659824047
141,경기도,고양시덕양구,화전동,화전동제7투,2450,1895,1019,705,132,25,3,1884,11,555,54.08704883227177,37.42038216560509,7.006369426751593,1.3269639065817411,0.15923566878980894
142,경기도,고양시덕양구,대덕동,관내사전투표,2483,2482,1722,517,205,19,3,2466,16,1,69.82968369829685,20.965125709651257,8.313057583130576,0.7704785077047851,0.12165450121654502
143,경기도,고양시덕양구,대덕동,대덕동제1투,1184,729,204,465,55,2,0,726,3,455,28.09917355371901,64.0495867768595,7.575757575757576,0.27548209366391185,0.0
144,경기도,고양시덕양구,대덕동,대덕동제2투,3438,2643,1211,1104,268,37,1,2621,22,795,46.20373903090423,42.12132773750477,10.22510492178558,1.411674933231591,0.03815337657382679
145,경기도,고양시덕양구,대덕동,대덕동제3투,3752,2888,1312,1216,300,41,4,2873,15,864,45.66655064392621,42.32509571876088,10.442046641141664,1.427079707622694,0.13922728854855554
146,경기도,고양시덕양구,잘못 투입·구분된 투표지,,0,2,2,0,0,0,0,2,0,-2,100.0,0.0,0.0,0.0,0.0
0,경기도,고양시일산동구,거소·선상투표,,435,414,176,131,85,4,3,399,15,21,44.11027568922306,32.83208020050125,21.303258145363408,1.0025062656641603,0.7518796992481203
1,경기도,고양시일산동구,관외사전투표,,28814,28809,17818,6918,3463,338,25,28562,247,5,62.38358658357258,24.22099292766613,12.124501085358167,1.1833905188712275,0.08752888453189553
2,경기도,고양시일산동구,재외투표,,2357,1926,1311,379,189,34,1,1914,12,431,68.49529780564264,19.80146290491118,9.87460815047022,1.7763845350052248,0.052246603970741906
3,경기도,고양시일산동구,식사동,관내사전투표,6599,6599,4501,1478,539,43,5,6566,33,0,68.5501066098081,22.50989948218093,8.208955223880597,0.6548888212001219,0.07614986293024673
4,경기도,고양시일산동구,식사동,식사동제1투,2209,1515,566,724,197,11,2,1500,15,694,37.733333333333334,48.266666666666666,13.133333333333333,0.7333333333333333,0.13333333333333333
5,경기도,고양시일산동구,식사동,식사동제2투,2568,1919,771,981,133,19,1,1905,14,649,40.47244094488189,51.49606299212598,6.981627296587926,0.9973753280839894,0.05249343832020997
6,경기도,고양시일산동구,식사동,식사동제3투,2166,1528,570,828,106,14,1,1519,9,638,37.524687294272546,54.50954575378538,6.978275181040158,0.9216589861751152,0.06583278472679394
7,경기도,고양시일산동구,식사동,식사동제4투,2678,2064,923,944,158,22,2,2049,15,614,45.04636408003904,46.071254270375796,7.711078574914593,1.0736944851146901,0.09760858955588092
8,경기도,고양시일산동구,식사동,식사동제5투,2660,1798,559,1074,141,17,0,1791,7,862,31.211613623673923,59.96649916247906,7.872696817420436,0.9491903964265772,0.0
9,경기도,고양시일산동구,식사동,식사동제6투,3545,2655,1014,1408,202,18,4,2646,9,890,38.32199546485261,53.212396069538926,7.634164777021919,0.6802721088435374,0.15117157974300832
10,경기도,고양시일산동구,식사동,식사동제7투,3334,1961,814,929,196,12,1,1952,9,1373,41.700819672131146,47.5922131147541,10.040983606557377,0.6147540983606558,0.05122950819672131
11,경기도,고양시일산동구,식사동,식사동제8투,3260,2365,1035,1067,222,22,1,2347,18,895,44.098849595227954,45.462292288027264,9.45888368129527,0.9373668512995312,0.04260758414997869
12,경기도,고양시일산동구,중산1동,관내사전투표,4729,4729,3078,1303,284,27,3,4695,34,0,65.5591054313099,27.75292864749734,6.048988285410011,0.5750798722044729,0.06389776357827476
13,경기도,고양시일산동구,중산1동,중산1동제1투,2087,1187,459,609,94,13,0,1175,12,900,39.06382978723404,51.829787234042556,8.0,1.1063829787234043,0.0
14,경기도,고양시일산동구,중산1동,중산1동제2투,2232,1323,541,666,99,9,1,1316,7,909,41.109422492401215,50.607902735562305,7.522796352583587,0.6838905775075987,0.07598784194528875
15,경기도,고양시일산동구,중산1동,중산1동제3투,2621,1933,712,1043,150,16,1,1922,11,688,37.04474505723205,54.266389177939644,7.804370447450572,0.8324661810613945,0.052029136316337155
16,경기도,고양시일산동구,중산1동,중산1동제4투,2256,1448,528,773,116,17,0,1434,14,808,36.82008368200837,53.90516039051604,8.089260808926081,1.1854951185495117,0.0
17,경기도,고양시일산동구,중산1동,중산1동제5투,2343,1534,543,854,109,16,2,1524,10,809,35.62992125984252,56.03674540682415,7.152230971128609,1.0498687664041995,0.13123359580052493
18,경기도,고양시일산동구,중산2동,관내사전투표,4556,4556,3195,1009,294,36,0,4534,22,0,70.46757829730922,22.254080282311424,6.484340538156154,0.7940008822232024,0.0
19,경기도,고양시일산동구,중산2동,중산2동제1투,3177,2182,880,1091,176,16,2,2165,17,995,40.64665127020785,50.392609699769054,8.129330254041571,0.7390300230946882,0.09237875288683603
20,경기도,고양시일산동구,중산2동,중산2동제2투,3092,2295,1011,1065,177,24,3,2280,15,797,44.34210526315789,46.71052631578947,7.7631578947368425,1.0526315789473684,0.13157894736842105
21,경기도,고양시일산동구,중산2동,중산2동제3투,3543,2508,1161,1128,178,23,0,2490,18,1035,46.626506024096386,45.30120481927711,7.148594377510039,0.9236947791164659,0.0
22,경기도,고양시일산동구,중산2동,중산2동제4투,3109,2109,954,956,154,22,3,2089,20,1000,45.667783628530394,45.76352321685017,7.371948300622308,1.0531354715174726,0.14360938247965532
23,경기도,고양시일산동구,정발산동,관내사전투표,4325,4325,3026,947,279,54,1,4307,18,0,70.2577199907128,21.98746227072208,6.477826793591827,1.2537729277919665,0.023218017181332713
24,경기도,고양시일산동구,정발산동,정발산동제1투,2305,1488,585,771,108,15,1,1480,8,817,39.52702702702703,52.09459459459459,7.297297297297297,1.0135135135135136,0.06756756756756757
25,경기도,고양시일산동구,정발산동,정발산동제2투,2023,1362,486,726,114,20,1,1347,15,661,36.080178173719375,53.89755011135857,8.463251670378618,1.4847809948032664,0.07423904974016332
26,경기도,고양시일산동구,정발산동,정발산동제3투,2360,1588,613,815,121,18,1,1568,20,772,39.09438775510204,51.97704081632652,7.716836734693877,1.1479591836734695,0.06377551020408163
27,경기도,고양시일산동구,정발산동,정발산동제4투,1396,1027,400,533,75,14,0,1022,5,369,39.138943248532286,52.15264187866928,7.338551859099804,1.36986301369863,0.0
28,경기도,고양시일산동구,정발산동,정발산동제5투,2147,1442,519,765,122,18,3,1427,15,705,36.37000700770848,53.60896986685354,8.549404344779257,1.261387526278907,0.21023125437981782
29,경기도,고양시일산동구,정발산동,정발산동제6투,2403,1692,577,950,128,28,2,1685,7,711,34.2433234421365,56.37982195845698,7.596439169139465,1.661721068249258,0.11869436201780414
30,경기도,고양시일산동구,풍산동,관내사전투표,6573,6573,4626,1433,423,50,5,6537,36,0,70.76640660853603,21.92137065932385,6.470858191831115,0.764876854826373,0.07648768548263729
31,경기도,고양시일산동구,풍산동,풍산동제1투,2479,1717,777,757,147,21,2,1704,13,762,45.598591549295776,44.424882629107984,8.626760563380282,1.232394366197183,0.11737089201877934
32,경기도,고양시일산동구,풍산동,풍산동제2투,3036,1840,836,831,148,16,0,1831,9,1196,45.65811032222829,45.385035499726925,8.083014746040416,0.8738394320043691,0.0
33,경기도,고양시일산동구,풍산동,풍산동제3투,2399,1782,787,840,127,18,1,1773,9,617,44.38804286520023,47.377326565143825,7.1630005640157925,1.015228426395939,0.05640157924421885
34,경기도,고양시일산동구,풍산동,풍산동제4투,2183,1536,664,747,94,12,4,1521,15,647,43.65548980933596,49.112426035502956,6.180144641683103,0.7889546351084813,0.26298487836949375
35,경기도,고양시일산동구,풍산동,풍산동제5투,2760,1836,797,883,116,24,1,1821,15,924,43.76716090060406,48.4898407468424,6.370126304228446,1.3179571663920924,0.054914881933003847
36,경기도,고양시일산동구,풍산동,풍산동제6투,2313,1783,826,790,136,21,0,1773,10,530,46.58770445572476,44.55724760293288,7.670614777213762,1.1844331641285957,0.0
37,경기도,고양시일산동구,풍산동,풍산동제7투,2175,1529,662,717,124,17,2,1522,7,646,43.495400788436264,47.109067017082786,8.14717477003942,1.1169513797634691,0.1314060446780552
38,경기도,고양시일산동구,풍산동,풍산동제8투,2777,1948,828,967,119,25,3,1942,6,829,42.63645726055613,49.794026776519054,6.127703398558188,1.2873326467559219,0.15447991761071062
39,경기도,고양시일산동구,백석1동,관내사전투표,4579,4579,3084,998,433,34,4,4553,26,0,67.7355589721063,21.9196134416868,9.51021304634307,0.7467603777728969,0.08785416209092906
40,경기도,고양시일산동구,백석1동,백석1동제1투,1657,1079,424,550,85,13,1,1073,6,578,39.51537744641193,51.25815470643057,7.921714818266542,1.211556383970177,0.09319664492078285
41,경기도,고양시일산동구,백석1동,백석1동제2투,2289,1702,754,772,146,13,2,1687,15,587,44.69472436277416,45.761707172495555,8.65441612329579,0.7705986959098993,0.11855364552459988
42,경기도,고양시일산동구,백석1동,백석1동제3투,2437,1891,890,824,147,17,2,1880,11,546,47.340425531914896,43.829787234042556,7.819148936170213,0.9042553191489361,0.10638297872340426
43,경기도,고양시일산동구,백석1동,백석1동제4투,2722,2148,941,999,164,29,1,2134,14,574,44.095595126522966,46.81349578256795,7.6850984067478905,1.3589503280224928,0.046860356138706656
44,경기도,고양시일산동구,백석1동,백석1동제5투,2490,1601,624,785,157,16,0,1582,19,889,39.443742098609356,49.62073324905184,9.924146649810368,1.0113780025284451,0.0
45,경기도,고양시일산동구,백석1동,백석1동제6투,1837,1313,535,631,108,21,2,1297,16,524,41.24903623747109,48.650732459521976,8.326908249807248,1.6191210485736314,0.15420200462606012
46,경기도,고양시일산동구,백석1동,백석1동제7투,3628,2717,921,1523,234,26,1,2705,12,911,34.04805914972274,56.303142329020325,8.650646950092423,0.9611829944547136,0.03696857670979667
47,경기도,고양시일산동구,백석2동,관내사전투표,4643,4643,3267,974,327,37,5,4610,33,0,70.86767895878525,21.127982646420822,7.093275488069414,0.8026030368763558,0.10845986984815618
48,경기도,고양시일산동구,백석2동,백석2동제1투,2259,1479,565,768,124,13,0,1470,9,780,38.435374149659864,52.244897959183675,8.435374149659863,0.8843537414965987,0.0
49,경기도,고양시일산동구,백석2동,백석2동제2투,2359,1557,660,763,104,13,0,1540,17,802,42.857142857142854,49.54545454545455,6.753246753246753,0.8441558441558441,0.0
50,경기도,고양시일산동구,백석2동,백석2동제3투,3404,2010,727,1076,170,22,2,1997,13,1394,36.40460691036555,53.880821231847776,8.512769153730595,1.1016524787180773,0.10015022533800699
51,경기도,고양시일산동구,백석2동,백석2동제4투,3963,2494,1108,1096,243,28,1,2476,18,1469,44.74959612277868,44.26494345718901,9.81421647819063,1.1308562197092082,0.04038772213247173
52,경기도,고양시일산동구,마두1동,관내사전투표,5143,5143,3530,1031,474,54,2,5091,52,0,69.33804753486544,20.251424081712827,9.310548025928108,1.060695344725987,0.03928501276762915
53,경기도,고양시일산동구,마두1동,마두1동제1투,3023,2273,1045,1027,161,25,1,2259,14,750,46.259406817175744,45.46259406817176,7.127047366091191,1.1066843736166445,0.04426737494466578
54,경기도,고양시일산동구,마두1동,마두1동제2투,2807,2261,850,1155,224,21,0,2250,11,546,37.77777777777778,51.33333333333333,9.955555555555556,0.9333333333333335,0.0
55,경기도,고양시일산동구,마두1동,마두1동제3투,2619,1790,756,875,124,22,0,1777,13,829,42.54361283061339,49.24029262802476,6.978052898142938,1.2380416432189083,0.0
56,경기도,고양시일산동구,마두1동,마두1동제4투,2589,2039,860,964,191,15,1,2031,8,550,42.34367306745446,47.464303298867556,9.404234367306746,0.7385524372230428,0.04923682914820286
57,경기도,고양시일산동구,마두1동,마두1동제5투,2161,1500,529,832,108,24,1,1494,6,661,35.408299866131195,55.68942436412316,7.228915662650602,1.6064257028112447,0.06693440428380187
58,경기도,고양시일산동구,마두2동,관내사전투표,5046,5046,3539,1035,388,56,2,5020,26,0,70.49800796812748,20.617529880478088,7.729083665338646,1.1155378486055778,0.0398406374501992
59,경기도,고양시일산동구,마두2동,마두2동제1투,2178,1657,512,932,164,30,1,1639,18,521,31.2385600976205,56.863941427699814,10.006101281269068,1.8303843807199511,0.06101281269066504
60,경기도,고양시일산동구,마두2동,마두2동제2투,2239,1680,631,882,130,22,1,1666,14,559,37.87515006002401,52.94117647058824,7.803121248499399,1.3205282112845138,0.060024009603841535
61,경기도,고양시일산동구,마두2동,마두2동제3투,1278,806,298,420,76,8,0,802,4,472,37.1571072319202,52.36907730673317,9.476309226932669,0.997506234413965,0.0
62,경기도,고양시일산동구,마두2동,마두2동제4투,2519,2030,731,1098,171,18,1,2019,11,489,36.20604259534423,54.38335809806835,8.469539375928678,0.8915304606240713,0.04952947003467063
63,경기도,고양시일산동구,장항1동,관내사전투표,1502,1502,1040,341,106,8,0,1495,7,0,69.56521739130434,22.809364548494983,7.090301003344482,0.5351170568561873,0.0
64,경기도,고양시일산동구,장항1동,장항1동제1투,943,603,153,416,27,4,0,600,3,340,25.5,69.33333333333334,4.5,0.6666666666666667,0.0
65,경기도,고양시일산동구,장항1동,장항1동제2투,3934,3191,1207,1645,287,32,3,3174,17,743,38.02772526780088,51.827347195967235,9.04221802142407,1.0081915563957151,0.0945179584120983
66,경기도,고양시일산동구,장항1동,장항1동제3투,1621,1165,468,552,122,12,0,1154,11,456,40.55459272097054,47.83362218370884,10.571923743500866,1.0398613518197575,0.0
67,경기도,고양시일산동구,장항1동,장항1동제4투,3018,2413,1197,821,339,26,2,2385,28,605,50.18867924528302,34.42348008385744,14.213836477987421,1.090146750524109,0.08385744234800838
68,경기도,고양시일산동구,장항2동,관내사전투표,4543,4543,3001,1129,337,41,6,4514,29,0,66.48205582631812,25.01107665042091,7.465662383695171,0.9082853345148427,0.1329198050509526
69,경기도,고양시일산동구,장항2동,장항2동제1투,2853,1889,622,1053,175,25,2,1877,12,964,33.13798614810868,56.100159829515185,9.323388385721897,1.3319126265316994,0.10655301012253596
70,경기도,고양시일산동구,장항2동,장항2동제2투,2405,1877,603,1106,137,22,0,1868,9,528,32.28051391862955,59.20770877944326,7.334047109207709,1.177730192719486,0.0
71,경기도,고양시일산동구,장항2동,장항2동제3투,3378,1731,581,970,154,14,0,1719,12,1647,33.79872018615474,56.4281559045957,8.9586969168121,0.8144269924374636,0.0
72,경기도,고양시일산동구,장항2동,장항2동제4투,3798,2063,877,949,196,22,1,2045,18,1735,42.88508557457213,46.40586797066015,9.58435207823961,1.075794621026895,0.04889975550122249
73,경기도,고양시일산동구,장항2동,장항2동제5투,3959,1919,795,892,188,21,6,1902,17,2040,41.798107255520506,46.89800210304942,9.884332281808621,1.1041009463722398,0.31545741324921134
74,경기도,고양시일산동구,고봉동,관내사전투표,2615,2615,1738,731,110,18,6,2603,12,0,66.76911256242796,28.08298117556665,4.225893200153669,0.6915097963887822,0.23050326546292738
75,경기도,고양시일산동구,고봉동,고봉동제1투,2849,1706,752,846,86,15,0,1699,7,1143,44.2613301942319,49.79399646851089,5.061801059446734,0.8828722778104767,0.0
76,경기도,고양시일산동구,고봉동,고봉동제2투,3591,1921,761,1011,125,12,1,1910,11,1670,39.84293193717278,52.931937172774866,6.544502617801047,0.6282722513089005,0.052356020942408384
77,경기도,고양시일산동구,고봉동,고봉동제3투,2671,1321,430,812,65,7,1,1315,6,1350,32.69961977186312,61.7490494296578,4.942965779467681,0.532319391634981,0.07604562737642585
78,경기도,고양시일산동구,고봉동,고봉동제4투,1923,1159,507,556,71,11,2,1147,12,764,44.20226678291194,48.47428073234525,6.190061028770706,0.959023539668701,0.17436791630340018
79,경기도,고양시일산동구,고봉동,고봉동제5투,1952,1460,663,698,76,9,1,1447,13,492,45.818935729094676,48.23773324118867,5.25224602626123,0.6219765031098825,0.0691085003455425
80,경기도,고양시일산동구,잘못 투입·구분된 투표지,,0,2,1,0,1,0,0,2,0,-2,50.0,0.0,50.0,0.0,0.0
0,경기도,고양시일산서구,거소·선상투표,,334,320,138,105,67,0,0,310,10,14,44.516129032258064,33.87096774193548,21.612903225806452,0.0,0.0
1,경기도,고양시일산서구,관외사전투표,,26666,26661,16396,6324,3384,298,26,26428,233,5,62.04026032995308,23.9291660360224,12.804601180566067,1.1275919479340095,0.09838050552444376
2,경기도,고양시일산서구,재외투표,,2219,1804,1212,364,185,29,1,1791,13,415,67.67169179229481,20.323841429369068,10.329424902289224,1.619207146845338,0.05583472920156338
3,경기도,고양시일산서구,일산1동,관내사전투표,5526,5526,3734,1383,346,38,7,5508,18,0,67.79230210602759,25.10893246187364,6.281771968046478,0.6899055918663761,0.1270878721859114
4,경기도,고양시일산서구,일산1동,일산1동제1투,2247,1429,609,683,110,12,1,1415,14,818,43.03886925795053,48.26855123674912,7.773851590106007,0.8480565371024734,0.0706713780918728
5,경기도,고양시일산서구,일산1동,일산1동제2투,2592,1742,789,809,116,14,1,1729,13,850,45.633314054366686,46.79005205320995,6.70908039329092,0.8097165991902834,0.057836899942163095
6,경기도,고양시일산서구,일산1동,일산1동제3투,1914,1254,475,668,85,20,0,1248,6,660,38.06089743589743,53.52564102564102,6.810897435897435,1.6025641025641024,0.0
7,경기도,고양시일산서구,일산1동,일산1동제4투,2577,1728,773,790,140,13,1,1717,11,849,45.02038439138031,46.010483401281306,8.1537565521258,0.7571345369831101,0.05824111822947001
8,경기도,고양시일산서구,일산1동,일산1동제5투,2458,1761,670,924,122,24,1,1741,20,697,38.48363009764503,53.072946582423896,7.00746697300402,1.3785180930499714,0.05743825387708214
9,경기도,고양시일산서구,일산1동,일산1동제6투,2194,1561,626,761,143,17,1,1548,13,633,40.43927648578811,49.16020671834625,9.237726098191215,1.0981912144702841,0.06459948320413438
10,경기도,고양시일산서구,일산2동,관내사전투표,3628,3628,2454,887,237,34,2,3614,14,0,67.90260099612617,24.54344216934145,6.557830658550083,0.9407858328721639,0.05534034311012728
11,경기도,고양시일산서구,일산2동,일산2동제1투,1773,1157,486,563,86,9,1,1145,12,616,42.44541484716157,49.1703056768559,7.510917030567686,0.7860262008733625,0.08733624454148471
12,경기도,고양시일산서구,일산2동,일산2동제2투,2956,2338,980,1150,173,27,1,2331,7,618,42.04204204204204,49.335049335049334,7.4217074217074215,1.1583011583011582,0.0429000429000429
13,경기도,고양시일산서구,일산2동,일산2동제3투,2354,1740,641,936,135,15,1,1728,12,614,37.094907407407405,54.166666666666664,7.8125,0.8680555555555556,0.057870370370370364
14,경기도,고양시일산서구,일산2동,일산2동제4투,1854,1146,415,641,61,12,6,1135,11,708,36.56387665198238,56.47577092511013,5.3744493392070485,1.0572687224669604,0.5286343612334802
15,경기도,고양시일산서구,일산2동,일산2동제5투,2236,1284,482,697,81,14,3,1277,7,952,37.744714173844955,54.581049334377454,6.342991386061081,1.096319498825372,0.23492560689115116
16,경기도,고양시일산서구,일산3동,관내사전투표,6040,6039,4316,1178,441,60,6,6001,38,1,71.92134644225962,19.630061656390602,7.348775204132645,0.9998333611064822,0.09998333611064823
17,경기도,고양시일산서구,일산3동,일산3동제1투,1959,1381,576,652,132,12,4,1376,5,578,41.86046511627907,47.383720930232556,9.593023255813954,0.872093023255814,0.29069767441860467
18,경기도,고양시일산서구,일산3동,일산3동제2투,2770,2134,842,1047,201,32,1,2123,11,636,39.660857277437586,49.31700423928403,9.467734338200659,1.507300989166274,0.047103155911446065
19,경기도,고양시일산서구,일산3동,일산3동제3투,2616,1986,897,897,155,26,0,1975,11,630,45.41772151898734,45.41772151898734,7.848101265822785,1.3164556962025316,0.0
20,경기도,고양시일산서구,일산3동,일산3동제4투,1978,1502,713,674,96,12,0,1495,7,476,47.69230769230769,45.08361204013378,6.421404682274247,0.8026755852842808,0.0
21,경기도,고양시일산서구,일산3동,일산3동제5투,2536,1902,889,811,164,21,1,1886,16,634,47.13679745493107,43.00106044538706,8.695652173913043,1.1134676564156947,0.05302226935312832
22,경기도,고양시일산서구,일산3동,일산3동제6투,2022,1580,633,770,153,18,0,1574,6,442,40.216010165184244,48.91994917407878,9.720457433290978,1.1435832274459974,0.0
23,경기도,고양시일산서구,일산3동,일산3동제7투,1663,1231,570,534,102,11,3,1220,11,432,46.72131147540984,43.77049180327869,8.360655737704919,0.9016393442622952,0.24590163934426232
24,경기도,고양시일산서구,일산3동,일산3동제8투,2168,1641,660,807,149,16,2,1634,7,527,40.39167686658507,49.38800489596083,9.1187270501836,0.9791921664626682,0.12239902080783352
25,경기도,고양시일산서구,탄현1동,관내사전투표,6036,6036,4187,1329,409,59,6,5990,46,0,69.89983305509182,22.186978297161936,6.82804674457429,0.9849749582637729,0.10016694490818029
26,경기도,고양시일산서구,탄현1동,탄현1동제1투,2119,1256,509,623,96,16,0,1244,12,863,40.91639871382637,50.08038585209004,7.717041800643088,1.2861736334405145,0.0
27,경기도,고양시일산서구,탄현1동,탄현1동제2투,1856,1277,529,616,111,9,0,1265,12,579,41.81818181818181,48.69565217391305,8.774703557312254,0.7114624505928854,0.0
28,경기도,고양시일산서구,탄현1동,탄현1동제3투,2260,1603,713,737,129,10,2,1591,12,657,44.81458202388435,46.32306725329981,8.108108108108109,0.6285355122564426,0.1257071024512885
29,경기도,고양시일산서구,탄현1동,탄현1동제4투,2453,1540,691,694,128,21,1,1535,5,913,45.016286644951144,45.21172638436482,8.338762214983714,1.3680781758957654,0.06514657980456026
30,경기도,고양시일산서구,탄현1동,탄현1동제5투,2614,1750,810,781,124,22,2,1739,11,864,46.57849338700403,44.910868315123636,7.130534790109258,1.2650948821161587,0.11500862564692352
31,경기도,고양시일산서구,탄현1동,탄현1동제6투,2273,1762,784,783,169,15,2,1753,9,511,44.72333143183115,44.66628636622932,9.6406160867085,0.8556759840273817,0.11409013120365087
32,경기도,고양시일산서구,탄현1동,탄현1동제7투,2092,1604,716,751,118,10,0,1595,9,488,44.89028213166144,47.0846394984326,7.398119122257054,0.6269592476489028,0.0
33,경기도,고양시일산서구,탄현1동,탄현1동제8투,1174,865,352,434,72,3,0,861,4,309,40.88269454123113,50.40650406504065,8.362369337979095,0.34843205574912894,0.0
34,경기도,고양시일산서구,탄현2동,관내사전투표,3954,3954,2852,812,234,35,2,3935,19,0,72.47776365946633,20.63532401524778,5.946632782719187,0.8894536213468869,0.05082592121982211
35,경기도,고양시일산서구,탄현2동,탄현2동제1투,1593,985,404,490,65,15,2,976,9,608,41.39344262295082,50.204918032786885,6.659836065573771,1.5368852459016393,0.20491803278688525
36,경기도,고양시일산서구,탄현2동,탄현2동제2투,3206,2174,942,998,190,24,1,2155,19,1032,43.712296983758705,46.31090487238979,8.816705336426914,1.1136890951276102,0.04640371229698376
37,경기도,고양시일산서구,탄현2동,탄현2동제3투,2585,1810,735,923,122,24,0,1804,6,775,40.74279379157428,51.1640798226164,6.762749445676275,1.3303769401330376,0.0
38,경기도,고양시일산서구,탄현2동,탄현2동제4투,2448,1847,912,736,160,30,1,1839,8,601,49.59216965742252,40.02175095160413,8.700380641653073,1.631321370309951,0.0543773790103317
39,경기도,고양시일산서구,주엽1동,관내사전투표,5770,5770,3969,1291,422,53,1,5736,34,0,69.19456066945607,22.50697350069735,7.357043235704324,0.9239888423988842,0.017433751743375175
40,경기도,고양시일산서구,주엽1동,주엽1동제1투,2264,1550,582,837,114,11,0,1544,6,714,37.69430051813472,54.2098445595855,7.383419689119171,0.7124352331606217,0.0
41,경기도,고양시일산서구,주엽1동,주엽1동제2투,1896,1431,582,708,116,11,1,1418,13,465,41.04372355430183,49.92947813822285,8.180535966149506,0.7757404795486601,0.07052186177715092
42,경기도,고양시일산서구,주엽1동,주엽1동제3투,1894,1469,585,759,101,13,2,1460,9,425,40.06849315068493,51.98630136986301,6.917808219178082,0.8904109589041096,0.136986301369863
43,경기도,고양시일산서구,주엽1동,주엽1동제4투,2230,1643,699,765,142,24,2,1632,11,587,42.830882352941174,46.875,8.700980392156863,1.4705882352941175,0.12254901960784313
44,경기도,고양시일산서구,주엽1동,주엽1동제5투,1190,804,352,388,55,8,0,803,1,386,43.83561643835616,48.318804483188046,6.8493150684931505,0.9962640099626401,0.0
45,경기도,고양시일산서구,주엽1동,주엽1동제6투,1968,1514,564,799,121,21,1,1506,8,454,37.45019920318725,53.05444887118193,8.03452855245684,1.394422310756972,0.06640106241699867
46,경기도,고양시일산서구,주엽1동,주엽1동제7투,2285,1663,587,917,123,20,0,1647,16,622,35.640558591378266,55.67698846387371,7.468123861566485,1.214329083181542,0.0
47,경기도,고양시일산서구,주엽1동,주엽1동제8투,1608,1206,521,582,79,15,1,1198,8,402,43.489148580968276,48.580968280467445,6.59432387312187,1.2520868113522539,0.08347245409015025
48,경기도,고양시일산서구,주엽2동,관내사전투표,4920,4920,3398,1101,346,45,1,4891,29,0,69.47454508280515,22.510734001226744,7.074217951339194,0.9200572480065425,0.020445716622367615
49,경기도,고양시일산서구,주엽2동,주엽2동제1투,1901,1347,453,748,126,11,1,1339,8,554,33.83121732636295,55.86258401792382,9.410007468259895,0.8215085884988798,0.07468259895444362
50,경기도,고양시일산서구,주엽2동,주엽2동제2투,1897,1423,584,686,115,25,0,1410,13,474,41.41843971631206,48.652482269503544,8.156028368794328,1.773049645390071,0.0
51,경기도,고양시일산서구,주엽2동,주엽2동제3투,1550,1130,464,555,91,14,0,1124,6,420,41.281138790035584,49.37722419928826,8.09608540925267,1.2455516014234875,0.0
52,경기도,고양시일산서구,주엽2동,주엽2동제4투,2067,1438,572,742,103,11,1,1429,9,629,40.02799160251924,51.924422673198045,7.207837648705389,0.7697690692792162,0.06997900629811056
53,경기도,고양시일산서구,주엽2동,주엽2동제5투,1635,1215,445,662,79,12,1,1199,16,420,37.11426188490409,55.21267723102585,6.58882402001668,1.0008340283569641,0.08340283569641367
54,경기도,고양시일산서구,주엽2동,주엽2동제6투,1507,1018,402,517,75,17,0,1011,7,489,39.762611275964396,51.137487636003954,7.418397626112759,1.6815034619188922,0.0
55,경기도,고양시일산서구,주엽2동,주엽2동제7투,2477,1879,750,948,147,23,2,1870,9,598,40.106951871657756,50.6951871657754,7.86096256684492,1.2299465240641712,0.10695187165775401
56,경기도,고양시일산서구,주엽2동,주엽2동제8투,2297,1682,653,872,121,20,3,1669,13,615,39.12522468544039,52.24685440383463,7.249850209706412,1.1983223487118035,0.17974835230677053
57,경기도,고양시일산서구,대화동,관내사전투표,5628,5628,3903,1187,429,83,2,5604,24,0,69.64668094218416,21.181299072091363,7.655246252676659,1.4810849393290506,0.03568879371877231
58,경기도,고양시일산서구,대화동,대화동제1투,2606,1665,689,813,127,23,2,1654,11,941,41.65659008464329,49.15356711003628,7.678355501813784,1.3905683192261185,0.12091898428053204
59,경기도,고양시일산서구,대화동,대화동제2투,2421,1805,905,733,127,23,2,1790,15,616,50.5586592178771,40.94972067039106,7.094972067039105,1.2849162011173185,0.11173184357541899
60,경기도,고양시일산서구,대화동,대화동제3투,2881,2146,915,1023,163,25,1,2127,19,735,43.01833568406206,48.09590973201692,7.6633756464504,1.1753643629525155,0.04701457451810061
61,경기도,고양시일산서구,대화동,대화동제4투,1594,1052,384,555,89,16,0,1044,8,542,36.7816091954023,53.16091954022989,8.524904214559387,1.532567049808429,0.0
62,경기도,고양시일산서구,대화동,대화동제5투,2222,1449,561,740,115,16,4,1436,13,773,39.06685236768802,51.532033426183844,8.008356545961002,1.1142061281337048,0.2785515320334262
63,경기도,고양시일산서구,대화동,대화동제6투,3113,2148,793,1108,202,33,2,2138,10,965,37.090739008419085,51.82413470533208,9.448082319925163,1.5434985968194574,0.09354536950420954
64,경기도,고양시일산서구,대화동,대화동제7투,2285,1351,518,669,131,17,2,1337,14,934,38.7434554973822,50.03739715781601,9.798055347793568,1.2715033657442034,0.14958863126402394
65,경기도,고양시일산서구,대화동,대화동제8투,4148,3177,1261,1587,283,32,2,3165,12,971,39.842022116903635,50.142180094786724,8.941548183254344,1.0110584518167456,0.0631911532385466
66,경기도,고양시일산서구,송포동,관내사전투표,3720,3720,2598,832,247,26,2,3705,15,0,70.12145748987855,22.45614035087719,6.666666666666667,0.7017543859649122,0.053981106612685556
67,경기도,고양시일산서구,송포동,송포동제1투,3005,2089,644,1296,116,20,4,2080,9,916,30.961538461538463,62.30769230769231,5.5769230769230775,0.9615384615384616,0.19230769230769232
68,경기도,고양시일산서구,송포동,송포동제2투,2889,2124,784,1139,168,22,0,2113,11,765,37.103644107903456,53.904401325130145,7.950780880265026,1.0411736867013723,0.0
69,경기도,고양시일산서구,송포동,송포동제3투,2609,1855,720,962,150,15,0,1847,8,754,38.98213318895507,52.084461288576065,8.12127774769897,0.8121277747698972,0.0
70,경기도,고양시일산서구,송포동,송포동제4투,2838,2206,903,1021,239,25,1,2189,17,632,41.25171311100959,46.642302421196895,10.918227501142074,1.1420740063956145,0.04568296025582458
71,경기도,고양시일산서구,덕이동,관내사전투표,4724,4724,3435,999,242,22,1,4699,25,0,73.10065971483294,21.25984251968504,5.150031921685465,0.4681847201532241,0.02128112364332837
72,경기도,고양시일산서구,덕이동,덕이동제1투,2547,1659,674,840,125,12,1,1652,7,888,40.79903147699758,50.847457627118644,7.566585956416465,0.7263922518159807,0.06053268765133172
73,경기도,고양시일산서구,덕이동,덕이동제2투,3355,2053,844,1043,137,13,5,2042,11,1302,41.33202742409402,51.07737512242899,6.709108716944172,0.6366307541625857,0.2448579823702253
74,경기도,고양시일산서구,덕이동,덕이동제3투,2046,1435,675,633,101,19,3,1431,4,611,47.16981132075472,44.23480083857442,7.058001397624039,1.3277428371767994,0.20964360587002098
75,경기도,고양시일산서구,덕이동,덕이동제4투,2330,1758,812,801,122,12,3,1750,8,572,46.400000000000006,45.77142857142857,6.9714285714285715,0.6857142857142857,0.17142857142857143
76,경기도,고양시일산서구,덕이동,덕이동제5투,4305,3131,1285,1602,201,32,2,3122,9,1174,41.1595131326073,51.31326073030109,6.43818065342729,1.0249839846252402,0.06406149903907751
77,경기도,고양시일산서구,덕이동,덕이동제6투,2760,1659,728,792,115,15,2,1652,7,1101,44.06779661016949,47.94188861985472,6.961259079903148,0.9079903147699757,0.12106537530266344
78,경기도,고양시일산서구,가좌동,관내사전투표,4129,4129,2811,1005,248,39,6,4109,20,0,68.41080554879532,24.458505719153077,6.035531759552202,0.949136042832806,0.14602092966658553
79,경기도,고양시일산서구,가좌동,가좌동제1투,2097,1537,578,826,107,17,2,1530,7,560,37.77777777777778,53.98692810457516,6.993464052287582,1.1111111111111112,0.130718954248366
80,경기도,고양시일산서구,가좌동,가좌동제2투,2381,1468,394,979,78,6,0,1457,11,913,27.04186684969115,67.19286204529857,5.353466026080989,0.41180507892930684,0.0
81,경기도,고양시일산서구,가좌동,가좌동제3투,2594,1903,845,907,127,17,0,1896,7,691,44.56751054852321,47.83755274261603,6.69831223628692,0.8966244725738396,0.0
82,경기도,고양시일산서구,가좌동,가좌동제4투,3015,2196,977,1014,174,19,1,2185,11,819,44.71395881006865,46.40732265446224,7.963386727688787,0.8695652173913043,0.045766590389016024
83,경기도,고양시일산서구,잘못 투입·구분된 투표지,,0,2,1,1,0,0,0,2,0,-2,50.0,50.0,0.0,0.0,0.0
0,경기도,과천시,거소·선상투표,,92,90,28,35,21,2,1,87,3,2,32.18390804597701,40.229885057471265,24.137931034482758,2.2988505747126435,1.1494252873563218
1,경기도,과천시,관외사전투표,,7729,7729,4200,2273,1074,103,11,7661,68,0,54.82313013966845,29.66975590653962,14.019057564286646,1.3444720010442501,0.1435843884610364
2,경기도,과천시,재외투표,,867,708,432,181,70,20,0,703,5,159,61.45092460881935,25.746799431009958,9.95732574679943,2.844950213371266,0.0
3,경기도,과천시,중앙동,관내사전투표,2732,2732,1508,947,224,34,1,2714,18,0,55.56374355195284,34.89314664701548,8.253500368459838,1.2527634487840826,0.036845983787767135
4,경기도,과천시,중앙동,중앙동제1투,1935,1393,348,882,126,21,2,1379,14,542,25.2356780275562,63.95939086294417,9.137055837563452,1.5228426395939088,0.145032632342277
5,경기도,과천시,중앙동,중앙동제2투,2150,1743,430,1103,183,23,0,1739,4,407,24.726854514088554,63.42725704427832,10.523289246693503,1.3225991949396205,0.0
6,경기도,과천시,중앙동,중앙동제3투,2196,1703,410,1100,155,22,1,1688,15,493,24.28909952606635,65.16587677725119,9.182464454976303,1.3033175355450237,0.05924170616113744
7,경기도,과천시,원문동,관내사전투표,2806,2806,1756,762,234,40,3,2795,11,0,62.826475849731665,27.262969588550984,8.372093023255815,1.4311270125223614,0.1073345259391771
8,경기도,과천시,원문동,원문동제1투,1635,1232,333,756,116,18,1,1224,8,403,27.205882352941174,61.76470588235294,9.477124183006536,1.4705882352941175,0.08169934640522876
9,경기도,과천시,원문동,원문동제2투,2017,1692,456,1012,198,15,1,1682,10,325,27.110582639714625,60.166468489892985,11.771700356718192,0.89179548156956,0.05945303210463733
10,경기도,과천시,원문동,원문동제3투,2166,1762,511,1037,175,29,0,1752,10,404,29.166666666666668,59.18949771689498,9.988584474885846,1.6552511415525113,0.0
11,경기도,과천시,원문동,원문동제4투,2393,1937,624,1108,165,21,0,1918,19,456,32.53388946819604,57.76850886339937,8.602711157455683,1.094890510948905,0.0
12,경기도,과천시,갈현동,관내사전투표,1946,1946,1326,374,217,24,0,1941,5,0,68.31530139103555,19.26841834106131,11.179804224626482,1.2364760432766615,0.0
13,경기도,과천시,갈현동,갈현동제1투,1307,1004,397,467,120,13,1,998,6,303,39.77955911823648,46.7935871743487,12.024048096192384,1.3026052104208417,0.1002004008016032
14,경기도,과천시,갈현동,갈현동제2투,3979,3252,1500,1350,340,40,3,3233,19,727,46.39653572533251,41.75688215279926,10.516548097742035,1.2372409526755337,0.09279307145066501
15,경기도,과천시,갈현동,갈현동제3투,2687,2241,921,1058,220,27,3,2229,12,446,41.318977119784655,47.4652310453118,9.86989681471512,1.2113055181695829,0.13458950201884254
16,경기도,과천시,별양동,관내사전투표,2964,2964,1747,868,286,46,1,2948,16,0,59.26051560379919,29.443690637720486,9.701492537313433,1.5603799185888738,0.033921302578018994
17,경기도,과천시,별양동,별양동제1투,2948,2154,543,1351,222,28,2,2146,8,794,25.30288909599254,62.95433364398881,10.344827586206897,1.30475302889096,0.09319664492078285
18,경기도,과천시,별양동,별양동제2투,1419,1101,275,718,84,15,2,1094,7,318,25.13711151736746,65.63071297989032,7.678244972577697,1.3711151736745886,0.18281535648994515
19,경기도,과천시,별양동,별양동제3투,3642,3028,856,1807,307,40,2,3012,16,614,28.419654714475435,59.9933598937583,10.192563081009297,1.3280212483399734,0.06640106241699867
20,경기도,과천시,부림동,관내사전투표,2929,2929,1722,859,276,40,4,2901,28,0,59.358841778697006,29.61047914512237,9.513960703205791,1.3788348845225784,0.13788348845225784
21,경기도,과천시,부림동,부림동제1투,1157,806,189,527,76,9,0,801,5,351,23.595505617977526,65.79275905118602,9.488139825218477,1.1235955056179776,0.0
22,경기도,과천시,부림동,부림동제2투,1602,1170,301,759,90,7,1,1158,12,432,25.99309153713299,65.5440414507772,7.772020725388601,0.6044905008635579,0.08635578583765112
23,경기도,과천시,부림동,부림동제3투,2025,1666,442,1018,163,33,1,1657,9,359,26.67471333735667,61.43633071816536,9.837054918527459,1.9915509957754978,0.06035003017501509
24,경기도,과천시,부림동,부림동제4투,1182,870,193,573,84,11,1,862,8,312,22.389791183294662,66.47331786542924,9.744779582366588,1.2761020881670533,0.11600928074245939
25,경기도,과천시,과천동,관내사전투표,1153,1153,699,351,82,13,2,1147,6,0,60.941586748038354,30.601569311246728,7.149084568439407,1.1333914559721012,0.17436791630340018
26,경기도,과천시,과천동,과천동제1투,1300,921,265,552,79,21,0,917,4,379,28.898582333696837,60.19629225736096,8.615049073064341,2.2900763358778624,0.0
27,경기도,과천시,과천동,과천동제2투,1561,1082,282,712,65,12,0,1071,11,479,26.330532212885156,66.4799253034547,6.069094304388422,1.1204481792717087,0.0
28,경기도,과천시,과천동,과천동제3투,690,459,131,293,26,1,0,451,8,231,29.046563192904657,64.96674057649668,5.764966740576496,0.22172949002217296,0.0
29,경기도,과천시,문원동,관내사전투표,2048,2047,1290,572,158,18,0,2038,9,1,63.297350343473994,28.066732090284592,7.75269872423945,0.8832188420019628,0.0
30,경기도,과천시,문원동,문원동제1투,1755,1289,352,806,107,15,1,1281,8,466,27.478532396565186,62.91959406713505,8.352849336455893,1.1709601873536302,0.078064012490242
31,경기도,과천시,문원동,문원동제2투,1778,1319,404,782,100,18,1,1305,14,459,30.95785440613027,59.92337164750958,7.662835249042145,1.3793103448275863,0.07662835249042146
32,경기도,과천시,잘못 투입·구분된 투표지,,0,0,0,0,0,0,0,0,0,0,0.0,0.0,0.0,0.0,0.0
0,경기도,의왕시,거소·선상투표,,133,128,50,51,22,0,2,125,3,5,40.0,40.8,17.599999999999998,0.0,1.6
1,경기도,의왕시,관외사전투표,,17374,17374,10751,4028,2253,199,11,17242,132,0,62.35355527201021,23.36155898387658,13.06692959053474,1.1541584502957893,0.06379770328268183
2,경기도,의왕시,재외투표,,1032,872,592,164,94,16,0,866,6,160,68.36027713625866,18.937644341801384,10.854503464203233,1.8475750577367205,0.0
3,경기도,의왕시,고천동,관내사전투표,3699,3699,2300,987,356,35,6,3684,15,0,62.43213897937026,26.791530944625407,9.66340933767644,0.9500542888165039,0.16286644951140067
4,경기도,의왕시,고천동,고천동제1투,3060,2156,847,927,334,19,4,2131,25,904,39.74659784138902,43.50070389488503,15.673392773345848,0.8916001877053027,0.18770530267480057
5,경기도,의왕시,고천동,고천동제2투,1454,1070,375,596,86,9,0,1066,4,384,35.17823639774859,55.909943714821765,8.067542213883677,0.8442776735459663,0.0
6,경기도,의왕시,고천동,고천동제3투,2731,2020,725,1148,125,14,0,2012,8,711,36.0337972166998,57.057654075546715,6.21272365805169,0.6958250497017893,0.0
7,경기도,의왕시,부곡동,관내사전투표,5967,5967,3957,1490,430,46,6,5929,38,0,66.73975375274075,25.130713442401753,7.252487771968291,0.7758475290942823,0.10119750379490638
8,경기도,의왕시,부곡동,부곡동제1투,2720,1846,713,947,151,19,4,1834,12,874,38.87677208287895,51.63576881134133,8.233369683751363,1.0359869138495092,0.21810250817884408
9,경기도,의왕시,부곡동,부곡동제2투,1736,1127,427,602,78,9,1,1117,10,609,38.22739480752014,53.894359892569376,6.982990152193374,0.8057296329453895,0.08952551477170993
10,경기도,의왕시,부곡동,부곡동제3투,2121,1412,543,733,114,15,1,1406,6,709,38.62019914651494,52.13371266002845,8.108108108108109,1.0668563300142246,0.07112375533428165
11,경기도,의왕시,부곡동,부곡동제4투,1723,1388,639,607,121,13,1,1381,7,335,46.27081824764663,43.95365677045619,8.761766835626359,0.9413468501086171,0.0724112961622013
12,경기도,의왕시,부곡동,부곡동제5투,2581,1769,745,867,124,11,4,1751,18,812,42.547115933752146,49.51456310679612,7.081667618503712,0.6282124500285551,0.2284408909194746
13,경기도,의왕시,부곡동,부곡동제6투,2972,2123,940,853,280,25,4,2102,21,849,44.719314938154135,40.58039961941009,13.320647002854425,1.1893434823977165,0.19029495718363465
14,경기도,의왕시,부곡동,부곡동제7투,2451,1984,1023,752,173,20,4,1972,12,467,51.876267748478696,38.13387423935091,8.772819472616632,1.0141987829614605,0.2028397565922921
15,경기도,의왕시,오전동,관내사전투표,4418,4418,2965,1150,269,15,2,4401,17,0,67.37105203362871,26.130424903431038,6.112247216541695,0.34083162917518744,0.04544421722335833
16,경기도,의왕시,오전동,오전동제1투,1008,636,231,358,41,2,1,633,3,372,36.492890995260666,56.55608214849921,6.477093206951026,0.315955766192733,0.1579778830963665
17,경기도,의왕시,오전동,오전동제2투,2405,1668,618,894,129,12,2,1655,13,737,37.34138972809667,54.01812688821752,7.794561933534744,0.7250755287009063,0.12084592145015105
18,경기도,의왕시,오전동,오전동제3투,2229,1532,592,817,100,13,2,1524,8,697,38.84514435695538,53.60892388451444,6.561679790026247,0.8530183727034121,0.13123359580052493
19,경기도,의왕시,오전동,오전동제4투,1931,1577,599,821,130,11,2,1563,14,354,38.323736404350605,52.527191298784395,8.317338451695457,0.7037747920665387,0.12795905310300704
20,경기도,의왕시,오전동,오전동제5투,2367,1849,808,880,131,17,2,1838,11,518,43.96082698585419,47.87812840043525,7.127312295973885,0.9249183895538629,0.1088139281828074
21,경기도,의왕시,오전동,오전동제6투,1776,1342,579,621,122,11,1,1334,8,434,43.403298350824585,46.55172413793103,9.145427286356822,0.8245877061469266,0.07496251874062969
22,경기도,의왕시,오전동,오전동제7투,2976,2439,1116,1075,210,24,2,2427,12,537,45.982694684796044,44.29336629583848,8.65265760197775,0.9888751545117428,0.08240626287597858
23,경기도,의왕시,오전동,오전동제8투,2789,2230,1055,930,201,27,3,2216,14,559,47.608303249097474,41.96750902527076,9.070397111913357,1.2184115523465704,0.13537906137184114
24,경기도,의왕시,오전동,오전동제9투,2347,1822,774,868,157,19,0,1818,4,525,42.57425742574257,47.74477447744774,8.635863586358635,1.0451045104510452,0.0
25,경기도,의왕시,내손1동,관내사전투표,3328,3328,2188,829,252,34,0,3303,25,0,66.24280956706025,25.098395398122918,7.629427792915531,1.0293672419013018,0.0
26,경기도,의왕시,내손1동,내손1동제1투,2209,1448,539,775,113,13,2,1442,6,761,37.37864077669903,53.744798890429955,7.836338418862692,0.9015256588072121,0.13869625520110956
27,경기도,의왕시,내손1동,내손1동제2투,2050,1605,528,926,122,17,4,1597,8,445,33.061991233562935,57.983719474013775,7.639323731997496,1.0644959298685035,0.25046963055729493
28,경기도,의왕시,내손1동,내손1동제3투,1863,1333,494,712,93,25,0,1324,9,530,37.31117824773414,53.776435045317214,7.02416918429003,1.8882175226586102,0.0
29,경기도,의왕시,내손1동,내손1동제4투,2734,2188,864,1117,179,15,2,2177,11,546,39.687643546164445,51.30914101975195,8.222324299494717,0.6890215893431328,0.09186954524575103
30,경기도,의왕시,내손1동,내손1동제5투,2460,2030,769,1063,165,21,1,2019,11,430,38.08816245666171,52.64982664685488,8.172362555720653,1.040118870728083,0.04952947003467063
31,경기도,의왕시,내손2동,관내사전투표,4421,4421,2867,1166,328,39,2,4402,19,0,65.12948659700136,26.487960018173556,7.451158564288959,0.8859609268514312,0.045433893684688774
32,경기도,의왕시,내손2동,내손2동제1투,2465,1992,823,911,211,30,3,1978,14,473,41.60768452982811,46.05662285136501,10.667340748230536,1.5166835187057632,0.15166835187057634
33,경기도,의왕시,내손2동,내손2동제2투,2117,1555,617,780,132,13,3,1545,10,562,39.935275080906145,50.48543689320388,8.54368932038835,0.8414239482200648,0.1941747572815534
34,경기도,의왕시,내손2동,내손2동제3투,2437,1577,531,905,112,17,3,1568,9,860,33.86479591836735,57.71683673469388,7.142857142857142,1.0841836734693877,0.1913265306122449
35,경기도,의왕시,내손2동,내손2동제4투,2521,2041,811,1041,158,17,2,2029,12,480,39.97042878265155,51.30606209955643,7.787087235091178,0.8378511582060127,0.09857072449482504
36,경기도,의왕시,내손2동,내손2동제5투,1852,1511,526,856,106,15,1,1504,7,341,34.97340425531915,56.91489361702128,7.047872340425531,0.9973404255319149,0.06648936170212766
37,경기도,의왕시,청계동,관내사전투표,5548,5548,3756,1326,381,42,2,5507,41,0,68.2041038678046,24.078445614672237,6.918467405120755,0.7626656982022879,0.03631741420010895
38,경기도,의왕시,청계동,청계동제1투,2341,1524,511,866,108,22,5,1512,12,817,33.7962962962963,57.27513227513228,7.142857142857142,1.455026455026455,0.3306878306878307
39,경기도,의왕시,청계동,청계동제2투,1999,1522,643,718,130,21,0,1512,10,477,42.52645502645503,47.48677248677249,8.597883597883598,1.3888888888888888,0.0
40,경기도,의왕시,청계동,청계동제3투,1463,1091,467,541,71,6,1,1086,5,372,43.00184162062615,49.8158379373849,6.537753222836096,0.5524861878453038,0.09208103130755065
41,경기도,의왕시,청계동,청계동제4투,2898,2116,705,1135,240,15,2,2097,19,782,33.61945636623748,54.12494039103481,11.444921316165951,0.7153075822603719,0.09537434430138292
42,경기도,의왕시,청계동,청계동제5투,3040,2371,980,1161,185,29,2,2357,14,669,41.5782774713619,49.257530759439966,7.848960543063216,1.230377598642342,0.0848536274925753
43,경기도,의왕시,청계동,청계동제6투,3294,2579,975,1384,185,22,0,2566,13,715,37.99688230709275,53.9360872954014,7.20966484801247,0.857365549493375,0.0
44,경기도,의왕시,청계동,청계동제7투,2920,2185,692,1289,169,24,0,2174,11,735,31.830726770929164,59.29162833486661,7.773689052437903,1.1039558417663293,0.0
45,경기도,의왕시,청계동,청계동제8투,3156,2601,1055,1263,249,23,4,2594,7,555,40.670778720123366,48.68928296067849,9.599074787972244,0.8866615265998458,0.15420200462606012
46,경기도,의왕시,잘못 투입·구분된 투표지,,0,0,0,0,0,0,0,0,0,0,0.0,0.0,0.0,0.0,0.0
0,경기도,구리시,거소·선상투표,,215,206,91,60,48,1,0,200,6,9,45.5,30.0,24.0,0.5,0.0
1,경기도,구리시,관외사전투표,,16466,16466,10129,3949,2072,155,12,16317,149,0,62.07636207636208,24.201752773181344,12.698412698412698,0.9499295213580928,0.07354293068578784
2,경기도,구리시,재외투표,,1003,833,562,196,64,4,1,827,6,170,67.956469165659,23.70012091898428,7.73881499395405,0.48367593712212814,0.12091898428053204
3,경기도,구리시,갈매동,관내사전투표,6240,6240,4444,1294,407,59,7,6211,29,0,71.55047496377395,20.834004186121398,6.55289003381098,0.949927547898889,0.11270326839478344
4,경기도,구리시,갈매동,갈매동제1투,3590,2311,984,1056,237,23,1,2301,10,1279,42.76401564537158,45.89308996088657,10.29986962190352,0.9995654063450673,0.0434593654932638
5,경기도,구리시,갈매동,갈매동제2투,3099,2244,997,1013,187,31,1,2229,15,855,44.72857783759533,45.44638851502916,8.389412292507851,1.3907581875280395,0.04486316733961417
6,경기도,구리시,갈매동,갈매동제3투,2513,1909,885,851,141,24,2,1903,6,604,46.505517603783495,44.718864950078824,7.409353652128218,1.2611665790856543,0.10509721492380451
7,경기도,구리시,갈매동,갈매동제4투,1573,1092,420,609,43,7,0,1079,13,481,38.92493049119555,56.441149212233555,3.985171455050973,0.6487488415199258,0.0
8,경기도,구리시,갈매동,갈매동제5투,4224,3016,1294,1426,245,30,2,2997,19,1208,43.17650984317651,47.580914247580914,8.174841508174842,1.001001001001001,0.06673340006673341
9,경기도,구리시,동구동,관내사전투표,5700,5700,3961,1241,430,40,4,5676,24,0,69.78505990133897,21.86398872445384,7.575757575757576,0.7047216349541932,0.07047216349541931
10,경기도,구리시,동구동,동구동제1투,1328,849,329,443,64,8,0,844,5,479,38.981042654028435,52.48815165876777,7.5829383886255926,0.9478672985781991,0.0
11,경기도,구리시,동구동,동구동제2투,750,477,121,324,26,0,1,472,5,273,25.635593220338983,68.64406779661016,5.508474576271186,0.0,0.211864406779661
12,경기도,구리시,동구동,동구동제3투,2452,1859,792,877,162,15,1,1847,12,593,42.88034650785057,47.48240389821332,8.770979967514888,0.8121277747698972,0.05414185165132648
13,경기도,구리시,동구동,동구동제4투,2161,1678,768,730,146,24,1,1669,9,483,46.015578190533255,43.73876572798083,8.747753145596166,1.4379868184541642,0.05991611743559017
14,경기도,구리시,동구동,동구동제5투,2129,1588,656,779,130,11,0,1576,12,541,41.62436548223351,49.42893401015229,8.248730964467004,0.6979695431472082,0.0
15,경기도,구리시,동구동,동구동제6투,3836,2869,1182,1362,265,33,2,2844,25,967,41.561181434599156,47.89029535864979,9.317862165963433,1.160337552742616,0.07032348804500703
16,경기도,구리시,동구동,동구동제7투,1931,1594,680,771,121,13,0,1585,9,337,42.90220820189275,48.64353312302839,7.634069400630914,0.8201892744479496,0.0
17,경기도,구리시,동구동,동구동제8투,2092,1620,719,731,144,15,3,1612,8,472,44.602977667493796,45.34739454094293,8.933002481389577,0.9305210918114143,0.18610421836228289
18,경기도,구리시,동구동,동구동제9투,2555,1993,836,944,189,14,3,1986,7,562,42.09466263846928,47.53272910372608,9.516616314199396,0.7049345417925479,0.1510574018126888
19,경기도,구리시,동구동,동구동제10투,2116,1688,762,768,124,19,4,1677,11,428,45.43828264758497,45.796064400715565,7.394156231365534,1.132975551580203,0.2385211687537269
20,경기도,구리시,인창동,관내사전투표,4366,4366,2938,1068,302,34,2,4344,22,0,67.63351749539595,24.585635359116022,6.952117863720074,0.7826887661141806,0.04604051565377532
21,경기도,구리시,인창동,인창동제1투,1934,1239,466,647,99,12,1,1225,14,695,38.04081632653061,52.816326530612244,8.081632653061224,0.9795918367346939,0.0816326530612245
22,경기도,구리시,인창동,인창동제2투,2508,1800,822,813,145,10,0,1790,10,708,45.92178770949721,45.41899441340782,8.100558659217876,0.5586592178770949,0.0
23,경기도,구리시,인창동,인창동제3투,2681,1759,662,881,182,19,1,1745,14,922,37.93696275071633,50.48710601719198,10.429799426934098,1.0888252148997135,0.05730659025787965
24,경기도,구리시,인창동,인창동제4투,2429,1822,799,830,162,22,3,1816,6,607,43.997797356828194,45.70484581497797,8.920704845814978,1.2114537444933922,0.16519823788546256
25,경기도,구리시,인창동,인창동제5투,1957,1593,790,640,144,10,1,1585,8,364,49.8422712933754,40.37854889589905,9.085173501577287,0.6309148264984227,0.06309148264984228
26,경기도,구리시,인창동,인창동제6투,2194,1729,716,853,134,16,2,1721,8,465,41.603718768158046,49.56420685647879,7.78617083091226,0.9296920395119116,0.11621150493898895
27,경기도,구리시,교문1동,관내사전투표,2698,2698,1732,735,194,23,1,2685,13,0,64.50651769087523,27.37430167597765,7.225325884543761,0.8566108007448789,0.037243947858472994
28,경기도,구리시,교문1동,교문1동제1투,3868,2317,926,1173,166,27,3,2295,22,1551,40.348583877995644,51.11111111111111,7.2331154684095855,1.1764705882352942,0.130718954248366
29,경기도,구리시,교문1동,교문1동제2투,1745,1043,397,578,55,5,0,1035,8,702,38.35748792270531,55.84541062801932,5.314009661835748,0.4830917874396135,0.0
30,경기도,구리시,교문1동,교문1동제3투,1525,996,406,531,50,5,0,992,4,529,40.92741935483871,53.528225806451616,5.040322580645161,0.5040322580645161,0.0
31,경기도,구리시,교문1동,교문1동제4투,1290,850,271,499,68,5,1,844,6,440,32.10900473933649,59.12322274881517,8.056872037914692,0.5924170616113744,0.11848341232227488
32,경기도,구리시,교문1동,교문1동제5투,1188,880,305,507,53,11,0,876,4,308,34.817351598173516,57.87671232876712,6.050228310502283,1.2557077625570776,0.0
33,경기도,구리시,교문2동,관내사전투표,2854,2854,1917,686,215,20,0,2838,16,0,67.5475687103594,24.171952078928825,7.575757575757576,0.7047216349541932,0.0
34,경기도,구리시,교문2동,교문2동제1투,2026,1507,536,820,121,19,1,1497,10,519,35.80494321977288,54.776219104876425,8.082832331329326,1.2692050768203071,0.06680026720106881
35,경기도,구리시,교문2동,교문2동제2투,1593,1032,405,523,83,7,0,1018,14,561,39.783889980353635,51.37524557956779,8.153241650294696,0.68762278978389,0.0
36,경기도,구리시,교문2동,교문2동제3투,1799,1399,537,742,96,15,0,1390,9,400,38.63309352517986,53.38129496402878,6.906474820143885,1.079136690647482,0.0
37,경기도,구리시,교문2동,교문2동제4투,1973,1611,607,846,137,15,1,1606,5,362,37.79576587795766,52.6774595267746,8.530510585305105,0.933997509339975,0.062266500622665005
38,경기도,구리시,교문2동,교문2동제5투,2187,1694,595,937,141,9,1,1683,11,493,35.35353535353536,55.67439096850861,8.377896613190732,0.53475935828877,0.05941770647653001
39,경기도,구리시,교문2동,교문2동제6투,2227,1768,689,880,161,21,3,1754,14,459,39.28164196123147,50.17103762827823,9.179019384264537,1.1972633979475484,0.17103762827822122
40,경기도,구리시,수택1동,관내사전투표,4588,4588,2926,1212,374,36,1,4549,39,0,64.32182897340076,26.643218289734005,8.22158716201363,0.7913827214772478,0.02198285337436799
41,경기도,구리시,수택1동,수택1동제1투,2768,1935,784,957,157,24,1,1923,12,833,40.769630785231406,49.765990639625585,8.164326573062922,1.24804992199688,0.05200208008320333
42,경기도,구리시,수택1동,수택1동제2투,2168,1190,415,637,118,8,2,1180,10,978,35.16949152542373,53.983050847457626,10.0,0.6779661016949152,0.1694915254237288
43,경기도,구리시,수택1동,수택1동제3투,5168,3512,1427,1729,302,27,3,3488,24,1656,40.91169724770643,49.56995412844037,8.658256880733944,0.7740825688073395,0.08600917431192662
44,경기도,구리시,수택2동,관내사전투표,3980,3980,2691,1009,234,23,2,3959,21,0,67.9717100277848,25.48623389744885,5.910583480676938,0.5809547865622632,0.050517807527153326
45,경기도,구리시,수택2동,수택2동제1투,1938,1152,432,611,88,7,0,1138,14,786,37.96133567662566,53.69068541300527,7.732864674868189,0.6151142355008787,0.0
46,경기도,구리시,수택2동,수택2동제2투,3115,2207,866,1133,182,17,0,2198,9,908,39.39945404913558,51.54686078252957,8.280254777070063,0.7734303912647862,0.0
47,경기도,구리시,수택2동,수택2동제3투,2519,1519,581,770,139,10,2,1502,17,1000,38.68175765645805,51.26498002663116,9.254327563249001,0.6657789613848202,0.13315579227696406
48,경기도,구리시,수택2동,수택2동제4투,1539,969,399,488,66,8,1,962,7,570,41.476091476091476,50.72765072765073,6.860706860706861,0.8316008316008316,0.10395010395010396
49,경기도,구리시,수택2동,수택2동제5투,2254,1485,667,665,120,16,5,1473,12,769,45.28173794976239,45.1459606245757,8.146639511201629,1.0862186014935504,0.3394433129667346
50,경기도,구리시,수택2동,수택2동제6투,1999,1373,597,674,82,13,3,1369,4,626,43.60847333820307,49.233016800584366,5.989773557341125,0.9495982468955442,0.2191380569758948
51,경기도,구리시,수택2동,수택2동제7투,1684,1175,536,541,80,8,2,1167,8,509,45.92973436161097,46.35818337617824,6.8551842330762645,0.6855184233076265,0.17137960582690662
52,경기도,구리시,수택3동,관내사전투표,5791,5791,3826,1368,507,56,2,5759,32,0,66.43514499044973,23.754123979857614,8.803611738148984,0.9723910401111304,0.034728251432540366
53,경기도,구리시,수택3동,수택3동제1투,2261,1551,576,812,133,13,1,1535,16,710,37.52442996742671,52.899022801302934,8.664495114006515,0.8469055374592834,0.06514657980456026
54,경기도,구리시,수택3동,수택3동제2투,2650,2041,822,1029,157,19,2,2029,12,609,40.51256776737309,50.71463775258748,7.737801872843765,0.9364218827008379,0.09857072449482504
55,경기도,구리시,수택3동,수택3동제3투,3096,2361,872,1265,177,27,2,2343,18,735,37.21724285104567,53.990610328638496,7.554417413572343,1.1523687580025608,0.08536064874093044
56,경기도,구리시,수택3동,수택3동제4투,2239,1263,493,662,87,12,1,1255,8,976,39.28286852589641,52.74900398406375,6.932270916334661,0.9561752988047808,0.0796812749003984
57,경기도,구리시,수택3동,수택3동제5투,2004,1476,647,690,108,11,0,1456,20,528,44.43681318681318,47.39010989010989,7.417582417582418,0.7554945054945055,0.0
58,경기도,구리시,잘못 투입·구분된 투표지,,0,0,0,0,0,0,0,0,0,0,0.0,0.0,0.0,0.0,0.0
0,경기도,남양주시,거소·선상투표,,979,925,414,292,189,5,2,902,23,54,45.8980044345898,32.37250554323725,20.953436807095343,0.5543237250554324,0.22172949002217296
1,경기도,남양주시,관외사전투표,,61029,61025,38239,14381,7300,534,60,60514,511,4,63.19033612056714,23.76474865320422,12.063324189443765,0.8824404270086261,0.09915060977625013
2,경기도,남양주시,재외투표,,3505,2916,2037,547,277,31,5,2897,19,589,70.31411805315844,18.881601656886435,9.561615464273386,1.070072488781498,0.17259233690024164
3,경기도,남양주시,와부읍,관내사전투표,10364,10364,7147,2399,702,76,5,10329,35,0,69.19353277180753,23.22586891276987,6.796398489689224,0.7357924290831639,0.04840739665020815
4,경기도,남양주시,와부읍,와부읍제1투,2394,1700,687,878,108,15,0,1688,12,694,40.699052132701425,52.014218009478675,6.398104265402843,0.8886255924170616,0.0
5,경기도,남양주시,와부읍,와부읍제2투,1781,979,322,594,49,9,0,974,5,802,33.059548254620125,60.98562628336756,5.030800821355236,0.9240246406570842,0.0
6,경기도,남양주시,와부읍,와부읍제3투,2267,1685,631,878,138,22,2,1671,14,582,37.76181926989827,52.543387193297434,8.258527827648116,1.3165769000598444,0.11968880909634949
7,경기도,남양주시,와부읍,와부읍제4투,3056,2286,960,1123,155,29,2,2269,17,770,42.30938739532834,49.4931687968268,6.831203173204055,1.27809607756721,0.08814455707360071
8,경기도,남양주시,와부읍,와부읍제5투,720,523,154,344,21,1,0,520,3,197,29.615384615384617,66.15384615384615,4.038461538461538,0.19230769230769232,0.0
9,경기도,남양주시,와부읍,와부읍제6투,574,424,125,284,13,0,0,422,2,150,29.620853080568722,67.29857819905213,3.080568720379147,0.0,0.0
10,경기도,남양주시,와부읍,와부읍제7투,2941,2258,925,1115,181,18,0,2239,19,683,41.31308619919607,49.7990174184904,8.083966056275123,0.8039303260384101,0.0
11,경기도,남양주시,와부읍,와부읍제8투,2441,1882,722,982,148,14,0,1866,16,559,38.69239013933547,52.62593783494105,7.931404072883172,0.7502679528403001,0.0
12,경기도,남양주시,와부읍,와부읍제9투,959,665,208,417,36,3,0,664,1,294,31.32530120481928,62.80120481927711,5.421686746987952,0.4518072289156626,0.0
13,경기도,남양주시,와부읍,와부읍제10투,2720,2037,941,908,157,18,2,2026,11,683,46.4461994076999,44.81737413622902,7.749259624876605,0.8884501480750246,0.09871668311944717
14,경기도,남양주시,와부읍,와부읍제11투,3047,2474,1155,1130,159,21,1,2466,8,573,46.83698296836983,45.82319545823195,6.447688564476886,0.851581508515815,0.04055150040551501
15,경기도,남양주시,와부읍,와부읍제12투,518,325,97,211,16,0,1,325,0,193,29.846153846153843,64.92307692307693,4.923076923076923,0.0,0.3076923076923077
16,경기도,남양주시,와부읍,와부읍제13투,2232,1845,649,1047,123,13,2,1834,11,387,35.38713195201745,57.08833151581243,6.7066521264994545,0.7088331515812432,0.10905125408942204
17,경기도,남양주시,와부읍,와부읍제14투,2613,1986,832,995,122,25,1,1975,11,627,42.12658227848101,50.37974683544304,6.177215189873418,1.2658227848101267,0.05063291139240507
18,경기도,남양주시,와부읍,와부읍제15투,2004,1579,676,749,123,25,1,1574,5,425,42.94790343074968,47.58576874205845,7.814485387547649,1.588310038119441,0.06353240152477764
19,경기도,남양주시,와부읍,와부읍제16투,2417,1756,720,873,129,17,0,1739,17,661,41.403105232892464,50.20126509488212,7.418056354226567,0.9775733179988499,0.0
20,경기도,남양주시,와부읍,와부읍제17투,1718,1366,620,609,111,11,1,1352,14,352,45.857988165680474,45.044378698224854,8.210059171597633,0.8136094674556213,0.07396449704142012
21,경기도,남양주시,진접읍,관내사전투표,13493,13493,9647,2885,786,86,10,13414,79,0,71.91739973162368,21.50738034888922,5.8595497241687795,0.6411212166393321,0.0745489786789921
22,경기도,남양주시,진접읍,진접읍제1투,1625,718,308,364,45,0,0,717,1,907,42.95676429567643,50.767085076708504,6.2761506276150625,0.0,0.0
23,경기도,남양주시,진접읍,진접읍제2투,3874,2527,1154,1163,169,23,1,2510,17,1347,45.976095617529886,46.33466135458168,6.733067729083666,0.9163346613545816,0.0398406374501992
24,경기도,남양주시,진접읍,진접읍제3투,4498,3057,1463,1309,239,30,1,3042,15,1441,48.09335963182117,43.03090072320842,7.856673241288625,0.9861932938856016,0.03287310979618672
25,경기도,남양주시,진접읍,진접읍제4투,2916,1722,750,865,88,6,2,1711,11,1194,43.834015195791935,50.5552308591467,5.143191116306254,0.3506721215663355,0.11689070718877849
26,경기도,남양주시,진접읍,진접읍제5투,2503,1641,758,770,97,10,3,1638,3,862,46.275946275946275,47.008547008547005,5.921855921855921,0.6105006105006106,0.18315018315018314
27,경기도,남양주시,진접읍,진접읍제6투,3758,2312,1005,1113,150,22,4,2294,18,1446,43.80993897122929,48.5178727114211,6.538796861377507,0.959023539668701,0.17436791630340018
28,경기도,남양주시,진접읍,진접읍제7투,4009,2665,1194,1258,166,23,3,2644,21,1344,45.1588502269289,47.579425113464445,6.278366111951589,0.869894099848714,0.11346444780635401
29,경기도,남양주시,진접읍,진접읍제8투,3232,2127,967,999,121,16,2,2105,22,1105,45.93824228028504,47.458432304038006,5.748218527315915,0.7600950118764845,0.09501187648456057
30,경기도,남양주시,진접읍,진접읍제9투,2228,1399,562,758,60,11,1,1392,7,829,40.37356321839081,54.45402298850575,4.310344827586207,0.7902298850574714,0.07183908045977011
31,경기도,남양주시,진접읍,진접읍제10투,3336,2363,1188,987,147,27,1,2350,13,973,50.5531914893617,42.0,6.25531914893617,1.148936170212766,0.0425531914893617
32,경기도,남양주시,진접읍,진접읍제11투,2673,1748,837,768,122,10,3,1740,8,925,48.10344827586207,44.13793103448276,7.011494252873564,0.5747126436781609,0.1724137931034483
33,경기도,남양주시,진접읍,진접읍제12투,3358,2483,1343,903,210,18,1,2475,8,875,54.26262626262627,36.484848484848484,8.484848484848486,0.7272727272727273,0.0404040404040404
34,경기도,남양주시,진접읍,진접읍제13투,3989,2914,1598,1031,244,31,2,2906,8,1075,54.98967653131452,35.478320715760496,8.396421197522368,1.0667584308327598,0.06882312456985547
35,경기도,남양주시,진접읍,진접읍제14투,3562,2551,1318,952,235,29,4,2538,13,1011,51.93065405831363,37.50985027580772,9.25925925925926,1.1426319936958234,0.15760441292356187
36,경기도,남양주시,진접읍,진접읍제15투,3759,2453,1216,1059,145,10,4,2434,19,1306,49.95891536565325,43.508627773212815,5.957271980279375,0.4108463434675432,0.16433853738701726
37,경기도,남양주시,진접읍,진접읍제16투,2266,1478,658,684,108,15,1,1466,12,788,44.88403819918145,46.65757162346521,7.3669849931787175,1.023192360163711,0.06821282401091405
38,경기도,남양주시,진접읍,진접읍제17투,2582,1784,801,862,98,11,2,1774,10,798,45.152198421646,48.59075535512965,5.5242390078917705,0.6200676437429538,0.11273957158962795
39,경기도,남양주시,진접읍,진접읍제18투,3535,2556,1266,1039,218,22,0,2545,11,979,49.74459724950884,40.82514734774067,8.56581532416503,0.8644400785854618,0.0
40,경기도,남양주시,화도읍,관내사전투표,15169,15169,10907,3325,776,91,8,15107,62,0,72.19831866022373,22.009664393989542,5.1366915999205665,0.602369762361819,0.05295558350433574
41,경기도,남양주시,화도읍,화도읍제1투,2900,1710,721,855,109,15,0,1700,10,1190,42.411764705882355,50.294117647058826,6.411764705882353,0.8823529411764706,0.0
42,경기도,남양주시,화도읍,화도읍제2투,3587,2125,1105,853,140,15,4,2117,8,1462,52.19650448748229,40.29286726499764,6.613131790269248,0.7085498346717053,0.1889466225791214
43,경기도,남양주시,화도읍,화도읍제3투,4125,2613,1197,1251,128,22,1,2599,14,1512,46.05617545209696,48.13389765294344,4.924971142747211,0.8464794151596767,0.038476337052712584
44,경기도,남양주시,화도읍,화도읍제4투,3026,1862,798,934,103,18,0,1853,9,1164,43.06529951430113,50.40474905558554,5.5585536967080404,0.9713977334052887,0.0
45,경기도,남양주시,화도읍,화도읍제5투,2612,1672,710,831,112,10,0,1663,9,940,42.69392663860493,49.969933854479855,6.734816596512328,0.6013229104028863,0.0
46,경기도,남양주시,화도읍,화도읍제6투,2667,1718,751,836,103,15,3,1708,10,949,43.969555035128806,48.94613583138173,6.030444964871194,0.8782201405152225,0.1756440281030445
47,경기도,남양주시,화도읍,화도읍제7투,1867,1175,610,480,62,13,1,1166,9,692,52.315608919382505,41.1663807890223,5.317324185248713,1.1149228130360207,0.08576329331046312
48,경기도,남양주시,화도읍,화도읍제8투,2876,2080,1060,851,126,19,4,2060,20,796,51.45631067961165,41.310679611650485,6.116504854368932,0.9223300970873786,0.1941747572815534
49,경기도,남양주시,화도읍,화도읍제9투,2234,1464,668,703,82,8,0,1461,3,770,45.72210814510609,48.11772758384668,5.6125941136208075,0.5475701574264202,0.0
50,경기도,남양주시,화도읍,화도읍제10투,2794,1984,956,870,131,18,3,1978,6,810,48.33164812942366,43.98382204246714,6.622851365015167,0.910010111223458,0.15166835187057634
51,경기도,남양주시,화도읍,화도읍제11투,2311,1583,758,672,117,19,0,1566,17,728,48.40357598978289,42.911877394636015,7.471264367816093,1.2132822477650063,0.0
52,경기도,남양주시,화도읍,화도읍제12투,2287,1427,510,839,60,11,0,1420,7,860,35.91549295774648,59.08450704225352,4.225352112676056,0.7746478873239436,0.0
53,경기도,남양주시,화도읍,화도읍제13투,908,590,205,362,15,5,0,587,3,318,34.923339011925044,61.6695059625213,2.555366269165247,0.8517887563884157,0.0
54,경기도,남양주시,화도읍,화도읍제14투,2922,2007,1023,819,130,24,0,1996,11,915,51.252505010020045,41.032064128256515,6.513026052104208,1.2024048096192386,0.0
55,경기도,남양주시,화도읍,화도읍제15투,2170,1465,673,684,80,15,4,1456,9,705,46.222527472527474,46.97802197802198,5.4945054945054945,1.0302197802197801,0.27472527472527475
56,경기도,남양주시,화도읍,화도읍제16투,3368,2047,912,968,139,11,0,2030,17,1321,44.926108374384235,47.68472906403941,6.847290640394088,0.541871921182266,0.0
57,경기도,남양주시,화도읍,화도읍제17투,2608,1748,829,817,79,10,3,1738,10,860,47.69850402761795,47.00805523590334,4.545454545454546,0.5753739930955121,0.17261219792865362
58,경기도,남양주시,화도읍,화도읍제18투,3843,2117,1030,904,145,20,3,2102,15,1726,49.00095147478592,43.00666032350143,6.898192197906755,0.9514747859181731,0.142721217887726
59,경기도,남양주시,화도읍,화도읍제19투,2434,1721,929,655,111,12,1,1708,13,713,54.39110070257611,38.34894613583138,6.498829039812646,0.702576112412178,0.0585480093676815
60,경기도,남양주시,화도읍,화도읍제20투,1858,1083,485,513,69,5,1,1073,10,775,45.200372786579685,47.809878844361606,6.430568499534017,0.4659832246039142,0.09319664492078285
61,경기도,남양주시,화도읍,화도읍제21투,3450,2072,1094,843,109,13,5,2064,8,1378,53.003875968992254,40.843023255813954,5.2810077519379846,0.6298449612403101,0.24224806201550386
62,경기도,남양주시,화도읍,화도읍제22투,2359,1214,611,464,121,8,0,1204,10,1145,50.747508305647834,38.53820598006645,10.04983388704319,0.6644518272425249,0.0
63,경기도,남양주시,화도읍,화도읍제23투,4183,2941,1516,1198,177,25,5,2921,20,1242,51.90003423485108,41.013351591920575,6.059568640876412,0.8558712769599451,0.17117425539198905
64,경기도,남양주시,화도읍,화도읍제24투,2663,1798,968,706,99,12,3,1788,10,865,54.138702460850105,39.48545861297539,5.5369127516778525,0.6711409395973155,0.16778523489932887
65,경기도,남양주시,화도읍,화도읍제25투,2632,2046,1060,818,139,11,2,2030,16,586,52.21674876847291,40.29556650246305,6.847290640394088,0.541871921182266,0.09852216748768472
66,경기도,남양주시,진건읍,관내사전투표,4625,4625,3120,1199,257,25,2,4603,22,0,67.78188138170759,26.048229415598524,5.583315229198349,0.5431240495329133,0.043449923962633065
67,경기도,남양주시,진건읍,진건읍제1투,2106,1206,404,719,65,9,0,1197,9,900,33.751044277360066,60.06683375104428,5.430242272347535,0.7518796992481203,0.0
68,경기도,남양주시,진건읍,진건읍제2투,561,398,94,282,17,2,1,396,2,163,23.737373737373737,71.21212121212122,4.292929292929292,0.5050505050505051,0.25252525252525254
69,경기도,남양주시,진건읍,진건읍제3투,763,482,121,343,10,5,0,479,3,281,25.260960334029225,71.60751565762004,2.0876826722338206,1.0438413361169103,0.0
70,경기도,남양주시,진건읍,진건읍제4투,2175,1471,608,740,104,9,1,1462,9,704,41.58686730506156,50.6155950752394,7.113543091655266,0.615595075239398,0.06839945280437756
71,경기도,남양주시,진건읍,진건읍제5투,2459,1642,696,811,105,23,0,1635,7,817,42.56880733944954,49.60244648318043,6.422018348623854,1.4067278287461773,0.0
72,경기도,남양주시,진건읍,진건읍제6투,2999,2113,914,1036,134,15,2,2101,12,886,43.50309376487387,49.30985245121371,6.37791527843884,0.7139457401237506,0.09519276534983341
73,경기도,남양주시,진건읍,진건읍제7투,1504,976,379,539,46,9,1,974,2,528,38.91170431211499,55.3388090349076,4.722792607802875,0.9240246406570842,0.10266940451745381
74,경기도,남양주시,오남읍,관내사전투표,10255,10255,7403,2137,596,63,7,10206,49,0,72.53576327650401,20.938663531256125,5.839702135998432,0.6172839506172839,0.06858710562414265
75,경기도,남양주시,오남읍,오남읍제1투,3656,1887,810,921,127,14,3,1875,12,1769,43.2,49.120000000000005,6.773333333333334,0.7466666666666667,0.16
76,경기도,남양주시,오남읍,오남읍제2투,2238,1392,631,622,118,11,1,1383,9,846,45.62545191612436,44.97469269703543,8.532176428054953,0.7953723788864787,0.07230657989877079
77,경기도,남양주시,오남읍,오남읍제3투,2416,1427,572,745,92,8,0,1417,10,989,40.36697247706422,52.575864502470004,6.492589978828511,0.5645730416372619,0.0
78,경기도,남양주시,오남읍,오남읍제4투,2699,1738,792,807,107,14,5,1725,13,961,45.91304347826087,46.78260869565217,6.202898550724638,0.8115942028985508,0.2898550724637681
79,경기도,남양주시,오남읍,오남읍제5투,4063,2613,1304,1092,184,16,3,2599,14,1450,50.173143516737206,42.01616006156214,7.079646017699115,0.6156213928434013,0.11542901115813775
80,경기도,남양주시,오남읍,오남읍제6투,2930,1945,1005,792,112,15,4,1928,17,985,52.12655601659751,41.078838174273855,5.809128630705394,0.7780082987551867,0.2074688796680498
81,경기도,남양주시,오남읍,오남읍제7투,2495,1730,959,650,99,12,1,1721,9,765,55.7234166182452,37.76873910517141,5.7524694944799535,0.6972690296339338,0.058105752469494475
82,경기도,남양주시,오남읍,오남읍제8투,3751,2610,1405,1009,163,17,4,2598,12,1141,54.08006158583526,38.83756735950731,6.274056966897613,0.6543494996150885,0.15396458814472672
83,경기도,남양주시,오남읍,오남읍제9투,3741,2514,1277,1004,200,22,2,2505,9,1227,50.97804391217565,40.079840319361274,7.984031936127744,0.8782435129740519,0.07984031936127745
84,경기도,남양주시,오남읍,오남읍제10투,2283,1382,582,668,111,12,0,1373,9,901,42.38892935178441,48.652585579024034,8.08448652585579,0.8739985433357611,0.0
85,경기도,남양주시,퇴계원읍,관내사전투표,5857,5857,3900,1557,315,55,4,5831,26,0,66.88389641570915,26.70210941519465,5.402160864345738,0.9432344366317955,0.06859886811867605
86,경기도,남양주시,퇴계원읍,퇴계원읍제1투,2876,2083,830,1056,149,26,3,2064,19,793,40.213178294573645,51.162790697674424,7.2189922480620154,1.2596899224806202,0.14534883720930233
87,경기도,남양주시,퇴계원읍,퇴계원읍제2투,3249,2115,954,984,138,21,4,2101,14,1134,45.40694907187054,46.83484055211804,6.568300809138505,0.9995240361732507,0.19038553069966682
88,경기도,남양주시,퇴계원읍,퇴계원읍제3투,3224,2092,849,1043,150,23,7,2072,20,1132,40.97490347490347,50.33783783783784,7.2393822393822385,1.1100386100386102,0.33783783783783783
89,경기도,남양주시,퇴계원읍,퇴계원읍제4투,1515,996,374,530,79,8,0,991,5,519,37.73965691220989,53.481331987891025,7.971745711402624,0.8072653884964682,0.0
90,경기도,남양주시,퇴계원읍,퇴계원읍제5투,2760,2092,940,982,140,15,2,2079,13,668,45.214045214045214,47.234247234247235,6.7340067340067336,0.7215007215007215,0.0962000962000962
91,경기도,남양주시,퇴계원읍,퇴계원읍제6투,2139,1573,592,855,98,16,0,1561,12,566,37.924407431133886,54.77258167841127,6.278026905829597,1.0249839846252402,0.0
92,경기도,남양주시,별내면,관내사전투표,4096,4096,2862,954,236,32,1,4085,11,0,70.06119951040391,23.35373317013464,5.777233782129743,0.7833537331701347,0.02447980416156671
93,경기도,남양주시,별내면,별내면제1투,778,459,132,305,19,2,0,458,1,319,28.82096069868996,66.5938864628821,4.148471615720524,0.43668122270742354,0.0
94,경기도,남양주시,별내면,별내면제2투,2374,1668,792,737,109,15,4,1657,11,706,47.79722389861195,44.47797223898612,6.578153289076645,0.9052504526252263,0.24140012070006037
95,경기도,남양주시,별내면,별내면제3투,2464,1565,691,757,89,13,2,1552,13,899,44.52319587628865,48.77577319587629,5.734536082474227,0.8376288659793815,0.12886597938144329
96,경기도,남양주시,별내면,별내면제4투,2371,1727,811,759,126,19,2,1717,10,644,47.23354688410018,44.205008736167734,7.338380896913222,1.10658124635993,0.11648223645894001
97,경기도,남양주시,별내면,별내면제5투,2556,1720,740,849,105,18,0,1712,8,836,43.22429906542056,49.5911214953271,6.133177570093458,1.0514018691588785,0.0
98,경기도,남양주시,수동면,관내사전투표,3665,3665,2303,1095,180,28,13,3619,46,0,63.63636363636363,30.256977065487707,4.973749654600718,0.7736943907156674,0.35921525283227407
99,경기도,남양주시,수동면,수동면제1투,1846,1018,323,631,54,7,1,1016,2,828,31.791338582677163,62.10629921259843,5.31496062992126,0.6889763779527559,0.09842519685039369
100,경기도,남양주시,수동면,수동면제2투,1948,1153,316,764,55,9,2,1146,7,795,27.57417102966841,66.66666666666666,4.799301919720768,0.7853403141361256,0.17452006980802792
101,경기도,남양주시,수동면,수동면제3투,960,635,216,384,27,2,1,630,5,325,34.285714285714285,60.952380952380956,4.285714285714286,0.31746031746031744,0.15873015873015872
102,경기도,남양주시,조안면,관내사전투표,897,897,524,311,44,9,1,889,8,0,58.94263217097863,34.983127109111365,4.949381327334083,1.0123734533183353,0.11248593925759282
103,경기도,남양주시,조안면,조안면제1투,1016,657,160,461,30,5,0,656,1,359,24.390243902439025,70.27439024390245,4.573170731707317,0.7621951219512195,0.0
104,경기도,남양주시,조안면,조안면제2투,1176,772,228,493,37,12,0,770,2,404,29.61038961038961,64.02597402597404,4.805194805194805,1.5584415584415585,0.0
105,경기도,남양주시,호평동,관내사전투표,11408,11408,8197,2352,723,82,3,11357,51,0,72.1757506383728,20.709694461565554,6.366117812802677,0.7220216606498195,0.02641542660913974
106,경기도,남양주시,호평동,호평동제1투,3731,2227,864,1145,180,20,3,2212,15,1504,39.059674502712475,51.76311030741411,8.1374321880651,0.9041591320072333,0.13562386980108498
107,경기도,남양주시,호평동,호평동제2투,3859,2661,1247,1207,166,23,4,2647,14,1198,47.10993577635059,45.598791084246315,6.271250472232716,0.8689081979599547,0.1511144692104269
108,경기도,남양주시,호평동,호평동제3투,4024,2692,1154,1330,175,15,2,2676,16,1332,43.12406576980568,49.70104633781764,6.539611360239163,0.5605381165919282,0.07473841554559044
109,경기도,남양주시,호평동,호평동제4투,2426,1661,767,770,103,16,1,1657,4,765,46.288473144236576,46.46952323476162,6.216053108026554,0.9656004828002415,0.06035003017501509
110,경기도,남양주시,호평동,호평동제5투,2826,2021,918,956,123,12,1,2010,11,805,45.67164179104478,47.56218905472637,6.119402985074627,0.5970149253731344,0.04975124378109452
111,경기도,남양주시,호평동,호평동제6투,1987,1401,652,634,93,18,2,1399,2,586,46.60471765546819,45.3180843459614,6.647605432451751,1.2866333095067906,0.14295925661186562
112,경기도,남양주시,호평동,호평동제7투,3433,2488,1143,1131,183,14,2,2473,15,945,46.219167003639306,45.7339264051759,7.399919126566923,0.5661140315406389,0.08087343307723413
113,경기도,남양주시,호평동,호평동제8투,3315,2280,1142,943,168,11,2,2266,14,1035,50.39717563989409,41.615180935569285,7.413945278022947,0.48543689320388345,0.088261253309797
114,경기도,남양주시,호평동,호평동제9투,4231,3080,1548,1289,209,18,1,3065,15,1151,50.50570962479608,42.05546492659054,6.818923327895596,0.5872756933115824,0.03262642740619902
115,경기도,남양주시,평내동,관내사전투표,7504,7504,5349,1553,522,46,4,7474,30,0,71.56810275622156,20.77869949157078,6.984211934706984,0.6154669521006154,0.05351886540005352
116,경기도,남양주시,평내동,평내동제1투,2000,1467,665,705,77,12,2,1461,6,533,45.516769336071185,48.25462012320328,5.2703627652292955,0.8213552361396305,0.13689253935660506
117,경기도,남양주시,평내동,평내동제2투,3468,2081,839,1035,171,18,4,2067,14,1387,40.59022738268021,50.07256894049347,8.272859216255442,0.8708272859216255,0.1935171746492501
118,경기도,남양주시,평내동,평내동제3투,3299,2385,1139,1014,194,22,6,2375,10,914,47.95789473684211,42.694736842105264,8.16842105263158,0.9263157894736843,0.25263157894736843
119,경기도,남양주시,평내동,평내동제4투,2754,1990,976,821,153,21,3,1974,16,764,49.442755825734544,41.59067882472138,7.750759878419452,1.0638297872340425,0.1519756838905775
120,경기도,남양주시,평내동,평내동제5투,3619,2417,1145,1064,168,15,5,2397,20,1202,47.76804338756779,44.388819357530245,7.008760951188986,0.6257822277847309,0.20859407592824364
121,경기도,남양주시,평내동,평내동제6투,3027,2231,1078,924,186,26,1,2215,16,796,48.668171557562076,41.715575620767495,8.397291196388263,1.1738148984198644,0.04514672686230248
122,경기도,남양주시,평내동,평내동제7투,2529,1913,971,791,121,17,2,1902,11,616,51.05152471083071,41.587802313354366,6.361724500525763,0.8937960042060988,0.10515247108307045
123,경기도,남양주시,금곡동,관내사전투표,4390,4390,2847,1165,313,38,1,4364,26,0,65.23831347387717,26.69569202566453,7.172318973418881,0.8707607699358386,0.022914757103574702
124,경기도,남양주시,금곡동,금곡동제1투,1855,1087,380,620,74,7,0,1081,6,768,35.152636447733585,57.35430157261795,6.845513413506013,0.6475485661424607,0.0
125,경기도,남양주시,금곡동,금곡동제2투,2453,1612,615,871,103,13,0,1602,10,841,38.38951310861423,54.36953807740325,6.429463171036205,0.8114856429463172,0.0
126,경기도,남양주시,금곡동,금곡동제3투,1992,1295,521,675,87,4,2,1289,6,697,40.4189294026377,52.36617532971296,6.749418153607448,0.3103180760279286,0.1551590380139643
127,경기도,남양주시,금곡동,금곡동제4투,1707,1024,359,602,52,5,1,1019,5,683,35.2306182531894,59.07752698724239,5.103042198233562,0.49067713444553485,0.09813542688910697
128,경기도,남양주시,금곡동,금곡동제5투,3628,2583,974,1430,146,24,2,2576,7,1045,37.81055900621118,55.51242236024845,5.667701863354037,0.9316770186335404,0.07763975155279502
129,경기도,남양주시,양정동,관내사전투표,1299,1299,822,361,90,11,1,1285,14,0,63.96887159533073,28.09338521400778,7.003891050583658,0.8560311284046693,0.07782101167315175
130,경기도,남양주시,양정동,양정동투표소,1294,799,216,528,47,1,2,794,5,495,27.204030226700255,66.49874055415617,5.919395465994962,0.12594458438287154,0.2518891687657431
131,경기도,남양주시,다산1동,관내사전투표,13999,13999,9870,2883,1077,103,7,13940,59,0,70.80344332855093,20.68149210903874,7.725968436154949,0.7388809182209469,0.05021520803443328
132,경기도,남양주시,다산1동,다산1동제1투,2542,1543,618,795,98,12,2,1525,18,999,40.52459016393443,52.131147540983605,6.4262295081967205,0.7868852459016393,0.13114754098360656
133,경기도,남양주시,다산1동,다산1동제2투,3222,2330,938,1167,186,22,2,2315,15,892,40.518358531317496,50.410367170626344,8.034557235421167,0.9503239740820735,0.08639308855291576
134,경기도,남양주시,다산1동,다산1동제3투,2843,2016,824,985,177,18,2,2006,10,827,41.076769690927215,49.10269192422732,8.823529411764707,0.897308075772682,0.09970089730807577
135,경기도,남양주시,다산1동,다산1동제4투,2275,1818,634,1009,147,14,4,1808,10,457,35.06637168141593,55.807522123893804,8.130530973451327,0.7743362831858407,0.22123893805309736
136,경기도,남양주시,다산1동,다산1동제5투,2834,2283,897,1203,147,20,3,2270,13,551,39.51541850220264,52.99559471365639,6.475770925110131,0.881057268722467,0.13215859030837004
137,경기도,남양주시,다산1동,다산1동제6투,2240,1800,655,978,122,30,4,1789,11,440,36.61263275572946,54.66741196198994,6.8194522079373945,1.6769144773616547,0.22358859698155395
138,경기도,남양주시,다산1동,다산1동제7투,2779,2216,773,1271,154,11,0,2209,7,563,34.99320959710276,57.53734721593481,6.971480307831598,0.49796287913082843,0.0
139,경기도,남양주시,다산1동,다산1동제8투,2015,1461,549,771,122,10,3,1455,6,554,37.7319587628866,52.98969072164949,8.38487972508591,0.6872852233676976,0.2061855670103093
140,경기도,남양주시,다산1동,다산1동제9투,4463,3368,1724,1343,248,37,1,3353,15,1095,51.416641813301524,40.053683268714586,7.396361467342678,1.103489412466448,0.029824038174768867
141,경기도,남양주시,다산1동,다산1동제10투,2001,1256,577,543,117,11,2,1250,6,745,46.160000000000004,43.44,9.36,0.88,0.16
142,경기도,남양주시,다산1동,다산1동제11투,2982,2319,1084,1009,188,22,0,2303,16,663,47.06904038211029,43.81241858445506,8.16326530612245,0.9552757273122015,0.0
143,경기도,남양주시,다산1동,다산1동제12투,2979,2468,1425,812,194,21,0,2452,16,511,58.11582381729201,33.115823817292004,7.911908646003263,0.8564437194127243,0.0
144,경기도,남양주시,다산1동,다산1동제13투,3336,2367,1085,1050,193,21,1,2350,17,969,46.170212765957444,44.680851063829785,8.212765957446809,0.8936170212765958,0.0425531914893617
145,경기도,남양주시,다산1동,다산1동제14투,2004,1601,963,506,114,15,1,1599,2,403,60.22514071294559,31.6447779862414,7.129455909943714,0.9380863039399625,0.06253908692933083
146,경기도,남양주시,다산1동,다산1동제15투,3303,2122,969,866,251,21,1,2108,14,1181,45.96774193548387,41.08159392789374,11.907020872865274,0.9962049335863378,0.04743833017077799
147,경기도,남양주시,다산1동,다산1동제16투,4987,3773,1807,1519,376,45,1,3748,25,1214,48.21237993596585,40.52828175026681,10.032017075773746,1.200640341515475,0.026680896478121666
148,경기도,남양주시,다산1동,다산1동제17투,2760,2068,1046,811,181,19,1,2058,10,692,50.82604470359572,39.40719144800777,8.794946550048591,0.923226433430515,0.048590864917395525
149,경기도,남양주시,다산1동,다산1동제18투,3076,2303,1124,877,250,28,0,2279,24,773,49.3198771390961,38.48179025888548,10.969723562966212,1.228609039052216,0.0
150,경기도,남양주시,다산1동,다산1동제19투,2346,1533,651,752,109,9,0,1521,12,813,42.80078895463511,49.44115713346483,7.166337935568705,0.591715976331361,0.0
151,경기도,남양주시,다산1동,다산1동제20투,2825,2206,1197,769,200,28,2,2196,10,619,54.50819672131148,35.01821493624772,9.107468123861565,1.2750455373406193,0.09107468123861566
152,경기도,남양주시,다산2동,관내사전투표,7701,7701,5309,1701,579,60,4,7653,48,0,69.37148830523977,22.2265778126225,7.565660525284203,0.7840062720501764,0.05226708480334509
153,경기도,남양주시,다산2동,다산2동제1투,3113,2322,956,1148,177,26,1,2308,14,791,41.421143847487,49.74003466204506,7.668977469670711,1.1265164644714039,0.04332755632582322
154,경기도,남양주시,다산2동,다산2동제2투,3104,2132,904,1079,115,18,3,2119,13,972,42.66163284568192,50.920245398773,5.427088249174139,0.8494572911750826,0.14157621519584712
155,경기도,남양주시,다산2동,다산2동제3투,2830,2199,982,1024,159,19,3,2187,12,631,44.90169181527206,46.822130772748054,7.270233196159122,0.8687700045724738,0.1371742112482853
156,경기도,남양주시,다산2동,다산2동제4투,3165,2321,1024,1045,198,26,3,2296,25,844,44.599303135888505,45.51393728222997,8.623693379790941,1.132404181184669,0.13066202090592335
157,경기도,남양주시,다산2동,다산2동제5투,3399,2366,1029,1096,206,25,0,2356,10,1033,43.67572156196944,46.5195246179966,8.743633276740239,1.061120543293718,0.0
158,경기도,남양주시,다산2동,다산2동제6투,3766,2683,1326,1088,219,29,0,2662,21,1083,49.812171299774604,40.87152516904583,8.226897069872278,1.0894064613072878,0.0
159,경기도,남양주시,별내동,관내사전투표,14129,14127,9777,3073,1081,107,9,14047,80,2,69.60205025984196,21.876557272015376,7.695593365131345,0.7617284829500961,0.06407062006122304
160,경기도,남양주시,별내동,별내동제1투,3826,2903,1394,1125,308,55,1,2883,20,923,48.35241068331599,39.021852237252865,10.683315990287895,1.9077349982656957,0.0346860908775581
161,경기도,남양주시,별내동,별내동제2투,2855,2110,875,1031,161,27,2,2096,14,745,41.74618320610687,49.18893129770993,7.681297709923664,1.2881679389312977,0.09541984732824427
162,경기도,남양주시,별내동,별내동제3투,2196,1677,783,762,108,12,3,1668,9,519,46.94244604316547,45.68345323741007,6.474820143884892,0.7194244604316548,0.1798561151079137
163,경기도,남양주시,별내동,별내동제4투,4719,3501,1680,1494,288,20,1,3483,18,1218,48.23428079242033,42.89405684754522,8.2687338501292,0.5742176284811944,0.028710881424059722
164,경기도,남양주시,별내동,별내동제5투,3489,2437,1088,1164,153,15,1,2421,16,1052,44.94010739363899,48.07930607187112,6.319702602230483,0.6195786864931847,0.04130524576621231
165,경기도,남양주시,별내동,별내동제6투,4318,3017,1222,1502,244,24,4,2996,21,1301,40.78771695594126,50.13351134846462,8.144192256341789,0.801068090787717,0.13351134846461948
166,경기도,남양주시,별내동,별내동제7투,3657,2550,1085,1212,213,23,4,2537,13,1107,42.76704769412692,47.77296018919984,8.395743003547498,0.9065825778478518,0.15766653527788727
167,경기도,남양주시,별내동,별내동제8투,3542,2456,1031,1168,192,36,3,2430,26,1086,42.42798353909465,48.06584362139918,7.901234567901234,1.4814814814814816,0.12345679012345678
168,경기도,남양주시,별내동,별내동제9투,2601,1778,774,851,122,19,0,1766,12,823,43.82785956964892,48.18799546998868,6.908267270668176,1.0758776896942241,0.0
169,경기도,남양주시,별내동,별내동제10투,2226,1604,626,821,134,14,2,1597,7,622,39.198497182216656,51.40889167188478,8.39073262366938,0.8766437069505322,0.12523481527864747
170,경기도,남양주시,별내동,별내동제11투,3254,2378,1047,1142,153,18,6,2366,12,876,44.251901944209635,48.26711749788673,6.46661031276416,0.760777683854607,0.25359256128486896
171,경기도,남양주시,별내동,별내동제12투,2913,1673,646,828,155,21,3,1653,20,1240,39.08045977011494,50.09074410163339,9.376890502117362,1.2704174228675136,0.18148820326678766
172,경기도,남양주시,별내동,별내동제13투,4678,3085,1457,1239,322,40,2,3060,25,1593,47.61437908496732,40.490196078431374,10.522875816993464,1.3071895424836601,0.065359477124183
173,경기도,남양주시,별내동,별내동제14투,1787,1240,592,515,109,10,0,1226,14,547,48.28711256117455,42.00652528548124,8.890701468189233,0.8156606851549755,0.0
174,경기도,남양주시,잘못 투입·구분된 투표지,,0,3,1,2,0,0,0,3,0,-3,33.33333333333333,66.66666666666666,0.0,0.0,0.0
0,경기도,오산시,거소·선상투표,,315,301,122,85,65,3,5,280,21,14,43.57142857142857,30.357142857142854,23.214285714285715,1.0714285714285714,1.7857142857142856
1,경기도,오산시,관외사전투표,,19192,19186,11764,4309,2722,185,29,19009,177,6,61.88647482771319,22.66820979536009,14.31953285285917,0.9732232100583934,0.15255931400915357
2,경기도,오산시,재외투표,,753,625,437,111,68,4,1,621,4,128,70.37037037037037,17.874396135265698,10.950080515297907,0.644122383252818,0.1610305958132045
3,경기도,오산시,중앙동,관내사전투표,7228,7228,4616,1959,557,47,6,7185,43,0,64.24495476687544,27.265135699373694,7.752261656228253,0.6541405706332637,0.08350730688935282
4,경기도,오산시,중앙동,중앙동제1투,1190,642,230,364,38,4,0,636,6,548,36.16352201257861,57.23270440251572,5.9748427672955975,0.628930817610063,0.0
5,경기도,오산시,중앙동,중앙동제2투,1806,997,343,538,93,10,4,988,9,809,34.7165991902834,54.453441295546554,9.412955465587045,1.0121457489878543,0.4048582995951417
6,경기도,오산시,중앙동,중앙동제3투,2940,1997,935,826,195,27,2,1985,12,943,47.103274559193956,41.612090680100756,9.82367758186398,1.3602015113350125,0.10075566750629722
7,경기도,오산시,중앙동,중앙동제4투,2997,2169,1059,872,200,28,2,2161,8,828,49.005090236001855,40.35168903285516,9.254974548819991,1.2956964368347987,0.09254974548819991
8,경기도,오산시,중앙동,중앙동제5투,2766,1966,717,1051,167,18,3,1956,10,800,36.65644171779141,53.7321063394683,8.537832310838446,0.9202453987730062,0.15337423312883436
9,경기도,오산시,중앙동,중앙동제6투,2290,1670,826,648,161,28,0,1663,7,620,49.66927239927841,38.96572459410704,9.68129885748647,1.683704149128082,0.0
10,경기도,오산시,중앙동,중앙동제7투,3038,2379,1302,811,229,24,1,2367,12,659,55.0063371356147,34.26277989015632,9.674693705111956,1.0139416983523446,0.04224757076468103
11,경기도,오산시,중앙동,중앙동제8투,2169,1631,867,620,130,7,3,1627,4,538,53.28826060233559,38.10694529809465,7.990165949600492,0.43023970497848807,0.18438844499078058
12,경기도,오산시,대원1동,관내사전투표,7204,7204,4818,1706,568,51,4,7147,57,0,67.41290051769974,23.870155309920246,7.947390513502168,0.7135861200503708,0.05596753882748006
13,경기도,오산시,대원1동,대원1동제1투,3560,1526,570,733,193,14,3,1513,13,2034,37.67349636483807,48.44679444811633,12.756113681427628,0.9253139458030404,0.19828155981493722
14,경기도,오산시,대원1동,대원1동제2투,1722,1242,592,523,106,9,3,1233,9,480,48.012976480129765,42.416869424168695,8.59691808596918,0.7299270072992701,0.24330900243309003
15,경기도,오산시,대원1동,대원1동제3투,2626,1672,760,724,166,14,0,1664,8,954,45.67307692307692,43.50961538461539,9.975961538461538,0.8413461538461539,0.0
16,경기도,오산시,대원1동,대원1동제4투,3769,2073,897,889,246,19,3,2054,19,1696,43.67088607594937,43.28140214216163,11.976630963972736,0.9250243427458618,0.1460564751703992
17,경기도,오산시,대원1동,대원1동제5투,1530,1149,542,468,118,15,0,1143,6,381,47.41907261592301,40.94488188976378,10.32370953630796,1.3123359580052494,0.0
18,경기도,오산시,대원1동,대원1동제6투,1979,1510,646,691,147,13,0,1497,13,469,43.15297261189045,46.158984635938545,9.819639278557114,0.8684034736138945,0.0
19,경기도,오산시,대원1동,대원1동제7투,3374,2372,1137,973,207,33,5,2355,17,1002,48.28025477707006,41.31634819532909,8.789808917197451,1.4012738853503186,0.21231422505307856
20,경기도,오산시,대원1동,대원1동제8투,2549,1765,909,645,171,19,2,1746,19,784,52.0618556701031,36.94158075601375,9.793814432989691,1.088201603665521,0.11454753722794961
21,경기도,오산시,대원1동,대원1동제9투,4749,3082,1503,1277,252,27,6,3065,17,1667,49.037520391517134,41.66394779771615,8.221859706362153,0.8809135399673736,0.1957585644371941
22,경기도,오산시,대원1동,대원1동제10투,1583,1117,645,374,86,4,3,1112,5,466,58.00359712230215,33.63309352517986,7.7338129496402885,0.3597122302158274,0.2697841726618705
23,경기도,오산시,대원2동,관내사전투표,3649,3649,2550,699,347,27,4,3627,22,0,70.30603804797353,19.272125723738625,9.567135373586986,0.7444168734491315,0.11028398125172319
24,경기도,오산시,대원2동,대원2동제1투,2446,1789,854,762,140,19,5,1780,9,657,47.97752808988764,42.80898876404494,7.865168539325842,1.0674157303370786,0.2808988764044944
25,경기도,오산시,대원2동,대원2동제2투,3583,2820,1517,929,326,29,2,2803,17,763,54.12058508740635,33.143061006064926,11.630396004281128,1.0346057795219408,0.07135212272565108
26,경기도,오산시,대원2동,대원2동제3투,2286,1427,696,570,133,15,2,1416,11,859,49.152542372881356,40.25423728813559,9.392655367231638,1.059322033898305,0.14124293785310735
27,경기도,오산시,대원2동,대원2동제4투,3817,2527,1160,1072,255,22,4,2513,14,1290,46.1599681655392,42.65817747711898,10.147234381217668,0.8754476721050538,0.15917230401910068
28,경기도,오산시,대원2동,대원2동제5투,1873,1248,591,511,127,11,2,1242,6,625,47.58454106280193,41.14331723027375,10.225442834138486,0.8856682769726247,0.1610305958132045
29,경기도,오산시,남촌동,관내사전투표,3218,3218,2218,660,273,31,4,3186,32,0,69.61707470182047,20.715630885122412,8.56873822975518,0.973006905210295,0.12554927809165098
30,경기도,오산시,남촌동,남촌동제1투,1942,1178,475,581,98,13,1,1168,10,764,40.667808219178085,49.74315068493151,8.39041095890411,1.1130136986301369,0.08561643835616438
31,경기도,오산시,남촌동,남촌동제2투,2517,1194,416,615,139,13,1,1184,10,1323,35.13513513513514,51.942567567567565,11.739864864864865,1.097972972972973,0.08445945945945946
32,경기도,오산시,남촌동,남촌동제3투,2695,977,498,352,109,9,1,969,8,1718,51.39318885448917,36.326109391124874,11.248710010319918,0.9287925696594427,0.10319917440660474
33,경기도,오산시,남촌동,남촌동제4투,2310,1695,845,689,126,21,0,1681,14,615,50.26769779892921,40.98750743604997,7.495538370017847,1.2492563950029745,0.0
34,경기도,오산시,남촌동,남촌동제5투,2606,856,410,369,53,10,1,843,13,1750,48.63582443653618,43.77224199288256,6.287069988137604,1.1862396204033214,0.11862396204033215
35,경기도,오산시,남촌동,남촌동제6투,2203,694,348,260,73,6,0,687,7,1509,50.65502183406113,37.84570596797671,10.625909752547306,0.8733624454148471,0.0
36,경기도,오산시,남촌동,남촌동제7투,4558,3476,1906,1123,389,29,3,3450,26,1082,55.2463768115942,32.550724637681164,11.27536231884058,0.8405797101449276,0.08695652173913043
37,경기도,오산시,신장1동,관내사전투표,5824,5824,4142,1199,409,43,0,5793,31,0,71.50008631106508,20.697393405834628,7.0602451234248225,0.7422751596754704,0.0
38,경기도,오산시,신장1동,신장1동제1투,3083,2085,870,1020,160,19,3,2072,13,998,41.988416988416986,49.22779922779923,7.722007722007722,0.916988416988417,0.14478764478764478
39,경기도,오산시,신장1동,신장1동제2투,2751,1808,858,709,201,21,2,1791,17,943,47.90619765494137,39.586823003908435,11.222780569514237,1.1725293132328307,0.11166945840312675
40,경기도,오산시,신장1동,신장1동제3투,2274,1402,709,589,87,5,1,1391,11,872,50.970524802300496,42.34363767074048,6.2544931703810205,0.35945363048166784,0.07189072609633358
41,경기도,오산시,신장1동,신장1동제4투,2725,1750,855,751,115,14,6,1741,9,975,49.10970706490523,43.13612866168868,6.605399195864446,0.80413555427915,0.34462952326249285
42,경기도,오산시,신장1동,신장1동제5투,3783,2740,1413,1070,213,26,2,2724,16,1043,51.87224669603524,39.28046989720998,7.819383259911894,0.9544787077826725,0.07342143906020558
43,경기도,오산시,신장1동,신장1동제6투,2863,1817,931,676,173,20,3,1803,14,1046,51.63616195230172,37.493067110371605,9.595119245701609,1.1092623405435387,0.16638935108153077
44,경기도,오산시,신장1동,신장1동제7투,2611,1707,785,728,159,20,2,1694,13,904,46.34002361275088,42.97520661157025,9.386068476977567,1.1806375442739079,0.11806375442739078
45,경기도,오산시,신장2동,관내사전투표,3585,3585,2498,695,329,35,1,3558,27,0,70.2079820123665,19.53344575604272,9.246767847105115,0.983698707138842,0.028105677346824058
46,경기도,오산시,신장2동,신장2동제1투,1799,1190,475,615,76,11,2,1179,11,609,40.28837998303647,52.16284987277354,6.4461407972858344,0.9329940627650551,0.16963528413910092
47,경기도,오산시,신장2동,신장2동제2투,3152,2143,967,962,179,22,2,2132,11,1009,45.35647279549719,45.1219512195122,8.395872420262664,1.0318949343339587,0.09380863039399624
48,경기도,오산시,신장2동,신장2동제3투,2812,1811,872,794,118,11,1,1796,15,1001,48.55233853006681,44.20935412026726,6.570155902004454,0.6124721603563474,0.05567928730512249
49,경기도,오산시,신장2동,신장2동제4투,2632,1925,940,800,159,14,1,1914,11,707,49.11180773249739,41.79728317659352,8.307210031347962,0.7314524555903866,0.052246603970741906
50,경기도,오산시,신장2동,신장2동제5투,2636,1978,1106,657,189,20,1,1973,5,658,56.056766345666496,33.29954384186518,9.579320831221489,1.0136847440446022,0.05068423720223011
51,경기도,오산시,세마동,관내사전투표,4815,4815,3237,1116,394,38,1,4786,29,0,67.63476807354785,23.318010865022984,8.232344337651483,0.7939824488090262,0.020894274968658588
52,경기도,오산시,세마동,세마동제1투,3289,1814,621,956,202,16,1,1796,18,1475,34.57683741648107,53.229398663697104,11.247216035634743,0.8908685968819599,0.05567928730512249
53,경기도,오산시,세마동,세마동제2투,2851,1874,774,889,173,21,0,1857,17,977,41.68012924071082,47.872913301023154,9.316101238556811,1.1308562197092082,0.0
54,경기도,오산시,세마동,세마동제3투,2920,2337,1158,914,226,23,1,2322,15,583,49.87080103359173,39.36261843238588,9.732988802756244,0.9905254091300603,0.04306632213608958
55,경기도,오산시,세마동,세마동제4투,2642,2020,1003,788,189,26,1,2007,13,622,49.97508719481814,39.26258096661684,9.417040358744394,1.295465869456901,0.04982561036372695
56,경기도,오산시,세마동,세마동제5투,3082,2239,1209,779,206,28,5,2227,12,843,54.28828019757521,34.9797934440952,9.250112258643915,1.2572968118545127,0.224517287831163
57,경기도,오산시,세마동,세마동제6투,3836,3068,1512,1179,330,23,2,3046,22,768,49.63887065003283,38.70650032829941,10.833880499015102,0.7550886408404465,0.06565988181221273
58,경기도,오산시,초평동,관내사전투표,4340,4339,2982,963,335,29,3,4312,27,1,69.15584415584416,22.333024118738404,7.769016697588126,0.6725417439703154,0.06957328385899814
59,경기도,오산시,초평동,초평동제1투,4821,3080,1371,1374,273,31,5,3054,26,1741,44.89194499017682,44.9901768172888,8.93909626719057,1.015062213490504,0.16371971185330714
60,경기도,오산시,초평동,초평동제2투,2109,1346,609,561,150,11,1,1332,14,763,45.72072072072072,42.11711711711711,11.26126126126126,0.8258258258258258,0.07507507507507508
61,경기도,오산시,초평동,초평동제3투,4335,3056,1481,1178,339,37,2,3037,19,1279,48.765228844254196,38.788277905828124,11.162331247942047,1.2183075403358576,0.0658544616397761
62,경기도,오산시,초평동,초평동제4투,2846,1801,860,741,162,22,4,1789,12,1045,48.071548351034096,41.41978759083287,9.055338177752935,1.2297372833985467,0.22358859698155395
63,경기도,오산시,잘못 투입·구분된 투표지,,0,0,0,0,0,0,0,0,0,0,0.0,0.0,0.0,0.0,0.0
0,경기도,시흥시,거소·선상투표,,612,584,266,159,141,1,1,568,16,28,46.83098591549296,27.992957746478876,24.823943661971832,0.17605633802816903,0.17605633802816903
1,경기도,시흥시,관외사전투표,,36337,36330,22591,8250,4765,321,39,35966,364,7,62.812100316966024,22.938330645609742,13.248623700161263,0.8925095923928154,0.10843574487015514
2,경기도,시흥시,재외투표,,1644,1340,955,232,124,17,2,1330,10,304,71.80451127819549,17.44360902255639,9.323308270676693,1.2781954887218046,0.15037593984962408
3,경기도,시흥시,대야동,관내사전투표,9571,9571,6467,2332,613,102,9,9523,48,0,67.90927228814449,24.48808148692639,6.4370471490076655,1.0710910427386329,0.09450803318282054
4,경기도,시흥시,대야동,대야동제1투,3195,1803,729,946,105,2,1,1783,20,1392,40.88614694335389,53.056646102075156,5.888951205832866,0.11217049915872125,0.056085249579360626
5,경기도,시흥시,대야동,대야동제2투,1793,1143,468,589,71,12,0,1140,3,650,41.05263157894737,51.66666666666667,6.228070175438597,1.0526315789473684,0.0
6,경기도,시흥시,대야동,대야동제3투,2399,1571,694,755,89,17,3,1558,13,828,44.54428754813864,48.45956354300385,5.712451861360719,1.0911424903722722,0.19255455712451863
7,경기도,시흥시,대야동,대야동제4투,3277,2524,1162,1092,220,20,4,2498,26,753,46.51721377101681,43.71497197758207,8.807045636509207,0.8006405124099278,0.16012810248198558
8,경기도,시흥시,대야동,대야동제5투,298,222,49,160,9,1,0,219,3,76,22.37442922374429,73.0593607305936,4.10958904109589,0.45662100456621,0.0
9,경기도,시흥시,대야동,대야동제6투,1796,1312,601,546,132,15,0,1294,18,484,46.44513137557959,42.194744976816075,10.200927357032457,1.1591962905718702,0.0
10,경기도,시흥시,대야동,대야동제7투,2590,1973,887,898,145,22,3,1955,18,617,45.370843989769824,45.933503836317136,7.41687979539642,1.1253196930946292,0.1534526854219949
11,경기도,시흥시,대야동,대야동제8투,2937,2105,918,962,190,24,1,2095,10,832,43.81861575178998,45.91885441527446,9.069212410501192,1.1455847255369929,0.0477326968973747
12,경기도,시흥시,대야동,대야동제9투,2899,2279,1257,740,236,26,4,2263,16,620,55.54573574900574,32.69995581087052,10.428634555899249,1.1489173663278833,0.17675651789659744
13,경기도,시흥시,대야동,대야동제10투,3197,2547,1120,1147,244,12,3,2526,21,650,44.33887569279493,45.40775930324624,9.659540775930324,0.4750593824228029,0.11876484560570072
14,경기도,시흥시,신천동,관내사전투표,5224,5224,3589,1313,269,28,3,5202,22,0,68.9926951172626,25.240292195309493,5.171088043060362,0.5382545174932718,0.05767012687427912
15,경기도,시흥시,신천동,신천동제1투,1695,988,398,480,95,9,0,982,6,707,40.52953156822811,48.87983706720978,9.674134419551935,0.9164969450101833,0.0
16,경기도,시흥시,신천동,신천동제2투,3722,2300,975,1138,150,13,3,2279,21,1422,42.78192189556823,49.9341816586222,6.581834137779728,0.5704256252742431,0.13163668275559456
17,경기도,시흥시,신천동,신천동제3투,1850,1146,496,567,68,10,0,1141,5,704,43.47063978965819,49.693251533742334,5.959684487291849,0.8764241893076249,0.0
18,경기도,시흥시,신천동,신천동제4투,2674,1693,805,730,123,20,4,1682,11,981,47.85969084423306,43.40071343638526,7.312722948870393,1.1890606420927468,0.23781212841854932
19,경기도,시흥시,신천동,신천동제5투,2285,1418,626,662,114,7,2,1411,7,867,44.3656980864635,46.91708008504607,8.079376328844791,0.4961020552799433,0.14174344436569808
20,경기도,시흥시,신천동,신천동제6투,2172,1376,583,657,104,15,3,1362,14,796,42.80469897209985,48.23788546255506,7.63582966226138,1.1013215859030838,0.22026431718061676
21,경기도,시흥시,신천동,신천동제7투,3452,2520,1190,1092,189,22,7,2500,20,932,47.599999999999994,43.68,7.5600000000000005,0.88,0.27999999999999997
22,경기도,시흥시,신천동,신천동제8투,3187,2143,1009,946,145,28,2,2130,13,1044,47.370892018779344,44.413145539906104,6.807511737089202,1.3145539906103285,0.09389671361502347
23,경기도,시흥시,신현동,관내사전투표,2723,2723,1770,768,136,28,2,2704,19,0,65.4585798816568,28.402366863905325,5.029585798816568,1.0355029585798818,0.07396449704142012
24,경기도,시흥시,신현동,신현동제1투,3011,2039,745,1101,163,14,3,2026,13,972,36.77196446199408,54.343534057255674,8.045409674234946,0.6910167818361304,0.14807502467917077
25,경기도,시흥시,신현동,신현동제2투,2052,1413,571,741,80,11,2,1405,8,639,40.64056939501779,52.74021352313167,5.6939501779359425,0.7829181494661922,0.1423487544483986
26,경기도,시흥시,신현동,신현동제3투,239,172,35,130,6,0,0,171,1,67,20.46783625730994,76.0233918128655,3.508771929824561,0.0,0.0
27,경기도,시흥시,은행동,관내사전투표,10007,10007,7210,1990,686,65,8,9959,48,0,72.39682699066171,19.981925896174317,6.888241791344512,0.6526759714830807,0.08032935033637915
28,경기도,시흥시,은행동,은행동제1투,2209,1322,548,638,119,8,0,1313,9,887,41.73648134044174,48.59101294744859,9.063214013709063,0.6092916984006093,0.0
29,경기도,시흥시,은행동,은행동제2투,2850,1820,837,817,134,15,4,1807,13,1030,46.319867183176534,45.213060320973995,7.415605976757056,0.8301051466519093,0.22136137244050913
30,경기도,시흥시,은행동,은행동제3투,2737,2075,991,861,181,26,3,2062,13,662,48.06013579049467,41.75557710960233,8.77788554801164,1.2609117361784674,0.1454898157129001
31,경기도,시흥시,은행동,은행동제4투,3493,2653,1344,1043,225,24,1,2637,16,840,50.96700796359499,39.55252180508153,8.532423208191126,0.9101251422070534,0.037921880925293895
32,경기도,시흥시,은행동,은행동제5투,2831,2074,971,876,187,22,2,2058,16,757,47.18172983479106,42.565597667638485,9.086491739552963,1.0689990281827018,0.09718172983479105
33,경기도,시흥시,은행동,은행동제6투,2364,1855,975,692,162,17,1,1847,8,509,52.78830536004331,37.46616134271792,8.770979967514888,0.9204114780725501,0.05414185165132648
34,경기도,시흥시,은행동,은행동제7투,3297,2606,1533,856,186,16,1,2592,14,691,59.143518518518526,33.0246913580247,7.175925925925926,0.6172839506172839,0.038580246913580245
35,경기도,시흥시,은행동,은행동제8투,3284,2504,1319,964,190,18,3,2494,10,780,52.88692862870891,38.65276663993585,7.618283881315156,0.7217321571772253,0.12028869286287089
36,경기도,시흥시,은행동,은행동제9투,2211,1761,1073,506,156,14,1,1750,11,450,61.31428571428571,28.914285714285715,8.914285714285715,0.8,0.05714285714285715
37,경기도,시흥시,은행동,은행동제10투,2180,1508,722,668,91,11,3,1495,13,672,48.2943143812709,44.68227424749164,6.086956521739131,0.7357859531772575,0.2006688963210702
38,경기도,시흥시,은행동,은행동제11투,1459,1205,687,388,102,20,0,1197,8,254,57.393483709273184,32.414369256474515,8.521303258145362,1.670843776106934,0.0
39,경기도,시흥시,매화동,관내사전투표,3139,3139,2224,696,193,13,0,3126,13,0,71.1452335252719,22.264875239923224,6.17402431222009,0.41586692258477287,0.0
40,경기도,시흥시,매화동,매화동제1투,2722,1725,799,782,110,16,1,1708,17,997,46.77985948477752,45.78454332552693,6.440281030444965,0.936768149882904,0.0585480093676815
41,경기도,시흥시,매화동,매화동제2투,1818,1131,467,584,64,10,0,1125,6,687,41.51111111111111,51.91111111111111,5.688888888888889,0.8888888888888888,0.0
42,경기도,시흥시,매화동,매화동제3투,1817,1152,538,512,81,11,3,1145,7,665,46.98689956331878,44.71615720524017,7.074235807860261,0.9606986899563319,0.26200873362445415
43,경기도,시흥시,목감동,관내사전투표,8205,8204,5726,1840,543,56,3,8168,36,1,70.10284035259549,22.526934378060727,6.647894221351616,0.6856023506366308,0.03672869735553379
44,경기도,시흥시,목감동,목감동제1투,2680,1779,667,957,125,15,4,1768,11,901,37.7262443438914,54.128959276018094,7.070135746606335,0.8484162895927602,0.22624434389140274
45,경기도,시흥시,목감동,목감동제2투,1128,831,346,409,55,14,2,826,5,297,41.88861985472155,49.51573849878935,6.658595641646489,1.694915254237288,0.24213075060532688
46,경기도,시흥시,목감동,목감동제3투,2638,1796,760,858,151,13,2,1784,12,842,42.600896860986545,48.09417040358744,8.464125560538116,0.7286995515695067,0.11210762331838565
47,경기도,시흥시,목감동,목감동제4투,2172,1504,748,582,141,22,1,1494,10,668,50.0669344042838,38.95582329317269,9.437751004016064,1.4725568942436411,0.06693440428380187
48,경기도,시흥시,목감동,목감동제5투,2539,1933,1109,639,146,25,1,1920,13,606,57.76041666666667,33.28125,7.604166666666666,1.3020833333333335,0.052083333333333336
49,경기도,시흥시,목감동,목감동제6투,3302,2212,924,1067,186,19,2,2198,14,1090,42.038216560509554,48.54413102820746,8.46223839854413,0.8644222020018199,0.09099181073703368
50,경기도,시흥시,목감동,목감동제7투,3021,2351,1232,907,180,17,0,2336,15,670,52.73972602739726,38.82705479452055,7.705479452054795,0.7277397260273972,0.0
51,경기도,시흥시,목감동,목감동제8투,3402,2658,1389,1004,222,27,4,2646,12,744,52.49433106575964,37.94406651549509,8.390022675736962,1.0204081632653061,0.15117157974300832
52,경기도,시흥시,군자동,관내사전투표,3789,3788,2594,924,228,22,0,3768,20,1,68.84288747346072,24.522292993630572,6.050955414012739,0.583864118895966,0.0
53,경기도,시흥시,군자동,군자동제1투,2599,1511,726,649,98,21,3,1497,14,1088,48.49699398797595,43.35337341349366,6.5464261857047426,1.402805611222445,0.2004008016032064
54,경기도,시흥시,군자동,군자동제2투,2129,1291,616,553,93,20,1,1283,8,838,48.012470771629,43.10210444271239,7.2486360093530795,1.558846453624318,0.0779423226812159
55,경기도,시흥시,군자동,군자동제3투,2604,1692,850,682,116,12,3,1663,29,912,51.11244738424534,41.01022248947685,6.975345760673482,0.7215874924834637,0.1803968731208659
56,경기도,시흥시,군자동,군자동제4투,2694,1758,885,732,108,17,1,1743,15,936,50.77452667814114,41.996557659208264,6.196213425129088,0.9753298909925416,0.05737234652897303
57,경기도,시흥시,군자동,군자동제5투,3064,2037,1034,823,141,22,2,2022,15,1027,51.137487636003954,40.702274975272005,6.973293768545995,1.0880316518298714,0.09891196834817012
58,경기도,시흥시,정왕본동,관내사전투표,3633,3633,2572,715,288,25,4,3604,29,0,71.36514983351832,19.83906770255272,7.991120976692565,0.6936736958934517,0.11098779134295228
59,경기도,시흥시,정왕본동,정왕본동제1투,1976,831,374,382,60,7,2,825,6,1145,45.33333333333333,46.303030303030305,7.2727272727272725,0.8484848484848486,0.24242424242424243
60,경기도,시흥시,정왕본동,정왕본동제2투,3527,1397,590,577,201,14,4,1386,11,2130,42.56854256854257,41.63059163059163,14.502164502164502,1.0101010101010102,0.2886002886002886
61,경기도,시흥시,정왕본동,정왕본동제3투,1111,475,265,171,32,2,0,470,5,636,56.38297872340425,36.38297872340426,6.808510638297872,0.425531914893617,0.0
62,경기도,시흥시,정왕본동,정왕본동제4투,1050,490,279,180,29,0,0,488,2,560,57.17213114754098,36.885245901639344,5.942622950819672,0.0,0.0
63,경기도,시흥시,정왕본동,정왕본동제5투,1130,462,270,155,32,2,0,459,3,668,58.82352941176471,33.769063180827885,6.971677559912854,0.4357298474945534,0.0
64,경기도,시흥시,정왕본동,정왕본동제6투,3061,2269,1163,876,199,18,4,2260,9,792,51.46017699115044,38.76106194690265,8.805309734513274,0.7964601769911505,0.17699115044247787
65,경기도,시흥시,정왕1동,관내사전투표,4277,4277,3069,785,370,27,4,4255,22,0,72.12690951821386,18.44888366627497,8.695652173913043,0.6345475910693301,0.09400705052878966
66,경기도,시흥시,정왕1동,정왕1동제1투,2140,1228,642,467,99,13,3,1224,4,912,52.450980392156865,38.15359477124183,8.088235294117647,1.0620915032679739,0.24509803921568626
67,경기도,시흥시,정왕1동,정왕1동제2투,2801,1209,596,476,126,6,1,1205,4,1592,49.46058091286307,39.50207468879668,10.45643153526971,0.49792531120331945,0.08298755186721991
68,경기도,시흥시,정왕1동,정왕1동제3투,2023,1261,365,488,372,14,1,1240,21,762,29.435483870967744,39.35483870967742,30.0,1.129032258064516,0.08064516129032258
69,경기도,시흥시,정왕1동,정왕1동제4투,1629,725,394,263,61,3,1,722,3,904,54.57063711911358,36.42659279778393,8.448753462603879,0.41551246537396125,0.13850415512465375
70,경기도,시흥시,정왕1동,정왕1동제5투,1674,1102,603,411,73,10,0,1097,5,572,54.96809480401094,37.46581586144029,6.654512306289881,0.9115770282588878,0.0
71,경기도,시흥시,정왕1동,정왕1동제6투,3313,2164,1128,824,182,18,4,2156,8,1149,52.319109461966605,38.218923933209645,8.441558441558442,0.8348794063079777,0.1855287569573284
72,경기도,시흥시,정왕2동,관내사전투표,5441,5441,3944,1023,395,52,4,5418,23,0,72.79438907345885,18.88150609080842,7.2905131044665925,0.9597637504614249,0.07382798080472498
73,경기도,시흥시,정왕2동,정왕2동제1투,2407,1579,851,579,115,14,1,1560,19,828,54.551282051282044,37.11538461538461,7.371794871794872,0.8974358974358974,0.0641025641025641
74,경기도,시흥시,정왕2동,정왕2동제2투,3611,2554,1251,1049,209,21,8,2538,16,1057,49.29078014184397,41.3317572892041,8.234830575256106,0.8274231678486997,0.31520882584712373
75,경기도,시흥시,정왕2동,정왕2동제3투,2618,1676,791,699,151,20,3,1664,12,942,47.53605769230769,42.00721153846153,9.07451923076923,1.201923076923077,0.18028846153846154
76,경기도,시흥시,정왕2동,정왕2동제4투,2505,1775,910,693,144,13,2,1762,13,730,51.64585698070374,39.330306469920544,8.172531214528945,0.7377979568671964,0.11350737797956867
77,경기도,시흥시,정왕2동,정왕2동제5투,2740,1742,830,748,132,13,3,1726,16,998,48.08806488991888,43.337195828505216,7.6477404403244496,0.7531865585168018,0.17381228273464658
78,경기도,시흥시,정왕2동,정왕2동제6투,2047,1181,614,463,88,10,0,1175,6,866,52.255319148936174,39.40425531914894,7.48936170212766,0.851063829787234,0.0
79,경기도,시흥시,정왕3동,관내사전투표,4879,4879,3539,921,338,46,5,4849,30,0,72.98412043720354,18.993606929263766,6.970509383378016,0.9486492060218602,0.10311404413281089
80,경기도,시흥시,정왕3동,정왕3동제1투,2608,1731,814,739,157,11,1,1722,9,877,47.27061556329849,42.91521486643438,9.117305458768874,0.6387921022067364,0.05807200929152149
81,경기도,시흥시,정왕3동,정왕3동제2투,2634,1795,907,721,144,10,0,1782,13,839,50.897867564534224,40.460157126823795,8.080808080808081,0.5611672278338945,0.0
82,경기도,시흥시,정왕3동,정왕3동제3투,3394,2061,1041,840,143,26,0,2050,11,1333,50.78048780487805,40.97560975609756,6.975609756097562,1.2682926829268293,0.0
83,경기도,시흥시,정왕3동,정왕3동제4투,2143,1193,664,452,65,8,1,1190,3,950,55.79831932773109,37.983193277310924,5.46218487394958,0.6722689075630253,0.08403361344537816
84,경기도,시흥시,정왕3동,정왕3동제5투,2581,1450,741,613,80,5,2,1441,9,1131,51.42262317834837,42.53990284524636,5.551700208188757,0.3469812630117973,0.13879250520471895
85,경기도,시흥시,정왕4동,관내사전투표,5071,5070,3506,1024,455,43,6,5034,36,1,69.64640444974177,20.341676599125943,9.038537941994438,0.8541914978148589,0.11918951132300357
86,경기도,시흥시,정왕4동,정왕4동제1투,2501,1739,753,812,133,21,2,1721,18,762,43.75363160952934,47.18187100522952,7.728065078442765,1.220220801859384,0.11621150493898895
87,경기도,시흥시,정왕4동,정왕4동제2투,1762,1252,550,597,95,5,0,1247,5,510,44.105854049719326,47.87489975942261,7.618283881315156,0.40096230954290296,0.0
88,경기도,시흥시,정왕4동,정왕4동제3투,2372,1651,815,668,147,10,1,1641,10,721,49.66483851310176,40.70688604509446,8.957952468007313,0.6093845216331505,0.06093845216331505
89,경기도,시흥시,정왕4동,정왕4동제4투,2190,1506,758,586,136,9,1,1490,16,684,50.87248322147651,39.328859060402685,9.12751677852349,0.6040268456375839,0.06711409395973154
90,경기도,시흥시,정왕4동,정왕4동제5투,1975,1470,815,493,126,19,2,1455,15,505,56.013745704467354,33.88316151202749,8.65979381443299,1.3058419243986255,0.13745704467353953
91,경기도,시흥시,거북섬동,관내사전투표,2800,2800,2097,443,228,20,3,2791,9,0,75.13436044428519,15.87244715155858,8.169115012540308,0.7165890361877463,0.10748835542816196
92,경기도,시흥시,거북섬동,거북섬동제1투,3643,2447,1393,784,228,23,5,2433,14,1196,57.254418413481304,32.2235922729141,9.3711467324291,0.9453349773941636,0.2055076037813399
93,경기도,시흥시,거북섬동,거북섬동제2투,2293,1051,496,358,180,7,2,1043,8,1242,47.555129434324066,34.32406519654842,17.25790987535954,0.6711409395973155,0.19175455417066153
94,경기도,시흥시,배곧1동,관내사전투표,6633,6633,4882,1128,534,54,3,6601,32,0,73.9584911377064,17.088319951522497,8.089683381305862,0.818057870019694,0.04544765944553856
95,경기도,시흥시,배곧1동,배곧1동제1투,3831,2857,1579,1008,219,33,2,2841,16,974,55.57902147131292,35.480464625131994,7.708553326293559,1.1615628299894403,0.0703977472720873
96,경기도,시흥시,배곧1동,배곧1동제2투,2318,1896,1006,688,174,17,2,1887,9,422,53.312135665076845,36.45998940116587,9.220985691573928,0.9009009009009009,0.10598834128245893
97,경기도,시흥시,배곧1동,배곧1동제3투,2472,1823,1010,640,145,14,2,1811,12,649,55.77029265599116,35.3395913859746,8.00662617338487,0.7730535615681944,0.11043622308117064
98,경기도,시흥시,배곧1동,배곧1동제4투,1730,1330,727,465,117,12,3,1324,6,400,54.909365558912384,35.12084592145015,8.836858006042297,0.906344410876133,0.22658610271903326
99,경기도,시흥시,배곧1동,배곧1동제5투,1913,1462,793,557,84,19,0,1453,9,451,54.57673778389539,38.3344803854095,5.78114246386786,1.307639366827254,0.0
100,경기도,시흥시,배곧1동,배곧1동제6투,2321,1745,966,617,134,21,2,1740,5,576,55.51724137931034,35.45977011494253,7.7011494252873565,1.206896551724138,0.11494252873563218
101,경기도,시흥시,배곧1동,배곧1동제7투,2910,1999,1015,794,155,23,2,1989,10,911,51.0306686777275,39.91955756661639,7.7928607340372045,1.1563599798893918,0.10055304172951231
102,경기도,시흥시,배곧2동,관내사전투표,5157,5157,3711,963,404,47,4,5129,28,0,72.35328524078768,18.775589783583545,7.876779099239618,0.9163579645155,0.07798791187365958
103,경기도,시흥시,배곧2동,배곧2동제1투,3414,2116,993,803,281,18,1,2096,20,1298,47.37595419847328,38.31106870229007,13.40648854961832,0.8587786259541985,0.047709923664122134
104,경기도,시흥시,배곧2동,배곧2동제2투,4284,2561,1104,1059,346,25,6,2540,21,1723,43.46456692913386,41.69291338582678,13.622047244094487,0.984251968503937,0.23622047244094488
105,경기도,시흥시,배곧2동,배곧2동제3투,3671,2673,1283,1115,238,19,0,2655,18,998,48.32391713747646,41.99623352165725,8.964218455743879,0.7156308851224105,0.0
106,경기도,시흥시,배곧2동,배곧2동제4투,3930,3012,1582,1157,228,25,2,2994,18,918,52.83901135604543,38.6439545758183,7.615230460921844,0.8350033400133602,0.06680026720106881
107,경기도,시흥시,배곧2동,배곧2동제5투,2379,1843,1000,601,201,29,4,1835,8,536,54.495912806539515,32.752043596730246,10.95367847411444,1.5803814713896458,0.21798365122615804
108,경기도,시흥시,배곧2동,배곧2동제6투,1445,1078,592,402,70,6,3,1073,5,367,55.172413793103445,37.46505125815471,6.523765144454799,0.5591798695246971,0.27958993476234856
109,경기도,시흥시,과림동,관내사전투표,837,837,507,260,61,4,2,834,3,0,60.79136690647482,31.17505995203837,7.314148681055157,0.4796163069544364,0.2398081534772182
110,경기도,시흥시,과림동,과림동투표소,979,648,155,463,20,4,0,642,6,331,24.143302180685357,72.11838006230529,3.115264797507788,0.6230529595015576,0.0
111,경기도,시흥시,연성동,관내사전투표,4854,4854,3465,905,402,40,4,4816,38,0,71.94767441860465,18.791528239202655,8.34717607973422,0.8305647840531563,0.08305647840531562
112,경기도,시흥시,연성동,연성동제1투,2341,1582,716,680,163,8,3,1570,12,759,45.605095541401276,43.31210191082803,10.382165605095542,0.5095541401273885,0.1910828025477707
113,경기도,시흥시,연성동,연성동제2투,3081,2301,1094,996,188,9,1,2288,13,780,47.81468531468531,43.53146853146853,8.216783216783217,0.3933566433566434,0.043706293706293704
114,경기도,시흥시,연성동,연성동제3투,3060,2253,1182,859,173,24,0,2238,15,807,52.81501340482574,38.38248436103664,7.7301161751563905,1.0723860589812333,0.0
115,경기도,시흥시,연성동,연성동제4투,2174,1583,812,619,126,11,1,1569,14,591,51.75270873167622,39.451880178457614,8.030592734225621,0.7010834926704907,0.06373486297004462
116,경기도,시흥시,연성동,연성동제5투,1582,1185,513,548,100,17,2,1180,5,397,43.474576271186436,46.440677966101696,8.47457627118644,1.4406779661016949,0.1694915254237288
117,경기도,시흥시,연성동,연성동제6투,1785,1280,689,421,146,10,1,1267,13,505,54.38042620363063,33.22809786898185,11.523283346487766,0.7892659826361484,0.07892659826361484
118,경기도,시흥시,능곡동,관내사전투표,5671,5671,3948,1247,415,31,5,5646,25,0,69.92561105207227,22.086432872830322,7.350336521431101,0.549061282323769,0.08855827134254339
119,경기도,시흥시,능곡동,능곡동제1투,2628,1789,669,982,110,14,4,1779,10,839,37.60539629005059,55.19955030916245,6.183249016301293,0.7869589657110737,0.22484541877459246
120,경기도,시흥시,능곡동,능곡동제2투,2119,1460,622,683,131,17,2,1455,5,659,42.74914089347079,46.94158075601374,9.003436426116838,1.168384879725086,0.13745704467353953
121,경기도,시흥시,능곡동,능곡동제3투,2424,1631,737,732,137,15,2,1623,8,793,45.40973505853358,45.10166358595194,8.441158348736908,0.9242144177449169,0.12322858903265559
122,경기도,시흥시,능곡동,능곡동제4투,2283,1676,816,668,162,22,0,1668,8,607,48.92086330935252,40.04796163069545,9.712230215827338,1.3189448441247003,0.0
123,경기도,시흥시,능곡동,능곡동제5투,4167,3100,1450,1241,351,36,3,3081,19,1067,47.06264199935086,40.27913015254788,11.39240506329114,1.1684518013631937,0.09737098344693282
124,경기도,시흥시,월곶동,관내사전투표,3955,3955,2799,825,284,25,1,3934,21,0,71.14895780376207,20.971021860701576,7.219115404168786,0.6354855109303508,0.02541942043721403
125,경기도,시흥시,월곶동,월곶동제1투,1093,754,325,370,40,8,1,744,10,339,43.68279569892473,49.73118279569893,5.376344086021505,1.0752688172043012,0.13440860215053765
126,경기도,시흥시,월곶동,월곶동제2투,3377,2115,924,1001,162,15,3,2105,10,1262,43.895486935866984,47.55344418052256,7.695961995249406,0.7125890736342043,0.14251781472684086
127,경기도,시흥시,월곶동,월곶동제3투,2123,1445,711,593,116,15,1,1436,9,678,49.5125348189415,41.29526462395543,8.07799442896936,1.0445682451253482,0.06963788300835655
128,경기도,시흥시,월곶동,월곶동제4투,3397,2092,894,967,197,19,0,2077,15,1305,43.042850264805004,46.55753490611459,9.484833895040925,0.91478093403948,0.0
129,경기도,시흥시,장곡동,관내사전투표,9558,9558,6768,1888,759,78,7,9500,58,0,71.2421052631579,19.873684210526317,7.989473684210527,0.8210526315789474,0.0736842105263158
130,경기도,시흥시,장곡동,장곡동제1투,2527,1789,783,792,171,19,2,1767,22,738,44.312393887945674,44.821731748726656,9.67741935483871,1.0752688172043012,0.11318619128466327
131,경기도,시흥시,장곡동,장곡동제2투,2848,1966,998,762,166,23,3,1952,14,882,51.127049180327866,39.03688524590164,8.504098360655737,1.1782786885245902,0.15368852459016394
132,경기도,시흥시,장곡동,장곡동제3투,2922,1877,894,820,137,14,1,1866,11,1045,47.90996784565916,43.944265809217576,7.341907824222938,0.7502679528403001,0.05359056806002144
133,경기도,시흥시,장곡동,장곡동제4투,3634,2483,1175,1067,206,19,4,2471,12,1151,47.551598543099956,43.18089842169162,8.336705787130716,0.7689194658033185,0.16187778227438285
134,경기도,시흥시,장곡동,장곡동제5투,2490,1886,944,764,152,22,1,1883,3,604,50.132766861391396,40.573552841210834,8.07222517259692,1.168348380244291,0.05310674455655868
135,경기도,시흥시,장곡동,장곡동제6투,2424,1747,896,679,141,22,1,1739,8,677,51.523864289821745,39.04542840713054,8.108108108108109,1.2650948821161587,0.05750431282346176
136,경기도,시흥시,장곡동,장곡동제7투,3033,2101,1043,810,197,24,4,2078,23,932,50.19249278152069,38.97978825794033,9.480269489894129,1.1549566891241578,0.192492781520693
137,경기도,시흥시,장곡동,장곡동제8투,3350,2560,1194,971,341,33,1,2540,20,790,47.00787401574803,38.22834645669291,13.4251968503937,1.2992125984251968,0.03937007874015748
138,경기도,시흥시,잘못 투입·구분된 투표지,,0,1,1,0,0,0,0,1,0,-1,100.0,0.0,0.0,0.0,0.0
0,경기도,군포시,거소·선상투표,,320,298,127,89,63,5,3,287,11,22,44.25087108013937,31.010452961672474,21.951219512195124,1.7421602787456445,1.0452961672473868
1,경기도,군포시,관외사전투표,,21679,21677,13323,4883,2981,237,20,21444,233,2,62.129266927811976,22.770938257787726,13.901324379779892,1.1052042529378847,0.09326618168252192
2,경기도,군포시,재외투표,,1387,1140,819,208,92,13,0,1132,8,247,72.34982332155478,18.374558303886925,8.12720848056537,1.1484098939929328,0.0
3,경기도,군포시,군포1동,관내사전투표,4356,4356,2853,1167,284,28,6,4338,18,0,65.76763485477179,26.90179806362379,6.546795758414016,0.6454587367450437,0.13831258644536654
4,경기도,군포시,군포1동,군포1동제1투,2575,1629,656,809,135,13,1,1614,15,946,40.644361833952914,50.12391573729864,8.364312267657994,0.8054522924411399,0.061957868649318466
5,경기도,군포시,군포1동,군포1동제2투,3001,1668,652,826,153,18,0,1649,19,1333,39.539114614918134,50.09096422073984,9.278350515463918,1.0915706488781078,0.0
6,경기도,군포시,군포1동,군포1동제3투,2503,1648,661,840,116,12,0,1629,19,855,40.577041129527316,51.56537753222836,7.120933087783916,0.7366482504604052,0.0
7,경기도,군포시,군포1동,군포1동제4투,2671,1766,791,836,115,15,3,1760,6,905,44.94318181818181,47.5,6.534090909090909,0.8522727272727272,0.17045454545454544
8,경기도,군포시,군포1동,군포1동제5투,457,255,77,129,40,6,0,252,3,202,30.555555555555557,51.19047619047619,15.873015873015872,2.380952380952381,0.0
9,경기도,군포시,군포1동,군포1동제6투,115,79,29,45,3,0,0,77,2,36,37.66233766233766,58.44155844155844,3.896103896103896,0.0,0.0
10,경기도,군포시,군포1동,군포1동제7투,3417,2559,1103,1188,228,23,1,2543,16,858,43.37396775462053,46.716476602438064,8.96578843885175,0.9044435705859222,0.039323633503735744
11,경기도,군포시,군포1동,군포1동제8투,2388,1884,871,804,184,17,2,1878,6,504,46.37912673056443,42.81150159744409,9.79765708200213,0.9052183173588925,0.10649627263045794
12,경기도,군포시,군포1동,군포1동제9투,1971,1533,694,642,163,21,1,1521,12,438,45.627876397107165,42.209072978303745,10.71663379355687,1.3806706114398422,0.06574621959237344
13,경기도,군포시,군포2동,관내사전투표,9428,9428,6553,2053,696,72,2,9376,52,0,69.89121160409556,21.896331058020476,7.423208191126279,0.7679180887372014,0.021331058020477817
14,경기도,군포시,군포2동,군포2동제1투,2564,1849,701,909,199,29,1,1839,10,715,38.11854268624252,49.42903752039152,10.821098423056007,1.5769439912996193,0.0543773790103317
15,경기도,군포시,군포2동,군포2동제2투,2424,1618,743,726,123,15,1,1608,10,806,46.20646766169154,45.149253731343286,7.649253731343284,0.9328358208955223,0.06218905472636816
16,경기도,군포시,군포2동,군포2동제3투,2322,1683,706,808,137,19,2,1672,11,639,42.22488038277512,48.32535885167464,8.19377990430622,1.1363636363636365,0.11961722488038277
17,경기도,군포시,군포2동,군포2동제4투,2885,2190,899,1042,198,30,3,2172,18,695,41.39042357274402,47.974217311233886,9.116022099447514,1.3812154696132597,0.13812154696132595
18,경기도,군포시,군포2동,군포2동제5투,2252,1840,918,736,163,15,2,1834,6,412,50.05452562704471,40.13086150490731,8.887677208287895,0.8178844056706652,0.10905125408942204
19,경기도,군포시,군포2동,군포2동제6투,2011,1431,607,686,116,13,0,1422,9,580,42.686357243319264,48.24191279887483,8.157524613220815,0.9142053445850914,0.0
20,경기도,군포시,군포2동,군포2동제7투,3308,2479,1090,1103,236,30,1,2460,19,829,44.3089430894309,44.83739837398374,9.59349593495935,1.2195121951219512,0.04065040650406504
21,경기도,군포시,군포2동,군포2동제8투,3035,2325,1188,890,205,27,3,2313,12,710,51.36186770428015,38.47816688283615,8.862948551664505,1.1673151750972763,0.12970168612191957
22,경기도,군포시,군포2동,군포2동제9투,1479,1125,507,510,89,10,0,1116,9,354,45.43010752688172,45.69892473118279,7.974910394265233,0.8960573476702508,0.0
23,경기도,군포시,군포2동,군포2동제10투,1065,898,381,436,66,8,1,892,6,167,42.71300448430493,48.87892376681614,7.399103139013453,0.8968609865470852,0.11210762331838565
24,경기도,군포시,산본1동,관내사전투표,3148,3148,2048,820,235,13,5,3121,27,0,65.6199935917975,26.273630246715797,7.529637936558796,0.4165331624479333,0.16020506247997437
25,경기도,군포시,산본1동,산본1동제1투,1886,1218,449,652,101,9,1,1212,6,668,37.04620462046205,53.79537953795379,8.333333333333332,0.7425742574257426,0.08250825082508251
26,경기도,군포시,산본1동,산본1동제2투,1380,886,300,495,80,5,1,881,5,494,34.0522133938706,56.186152099886485,9.080590238365494,0.5675368898978433,0.11350737797956867
27,경기도,군포시,산본1동,산본1동제3투,1660,1067,431,534,85,9,0,1059,8,593,40.698772426817754,50.42492917847026,8.026440037771483,0.84985835694051,0.0
28,경기도,군포시,산본1동,산본1동제4투,1874,1276,517,601,135,13,0,1266,10,598,40.837282780410746,47.472353870458136,10.66350710900474,1.0268562401263823,0.0
29,경기도,군포시,산본1동,산본1동제5투,2150,1520,622,758,109,16,3,1508,12,630,41.246684350132625,50.265251989389924,7.228116710875332,1.0610079575596816,0.1989389920424403
30,경기도,군포시,산본2동,관내사전투표,4360,4360,2922,1096,298,28,2,4346,14,0,67.23423838011965,25.218591808559594,6.856879889553613,0.6442705936493327,0.04601932811780948
31,경기도,군포시,산본2동,산본2동제1투,2204,1601,630,804,138,19,1,1592,9,603,39.572864321608044,50.502512562814076,8.668341708542714,1.193467336683417,0.06281407035175879
32,경기도,군포시,산본2동,산본2동제2투,1531,1098,490,510,81,4,0,1085,13,433,45.16129032258064,47.004608294930875,7.465437788018433,0.3686635944700461,0.0
33,경기도,군포시,산본2동,산본2동제3투,2075,1615,688,774,129,15,0,1606,9,460,42.839352428393525,48.194271481942714,8.032378580323787,0.933997509339975,0.0
34,경기도,군포시,산본2동,산본2동제4투,1931,1526,614,745,142,18,1,1520,6,405,40.39473684210526,49.01315789473684,9.342105263157894,1.1842105263157896,0.06578947368421052
35,경기도,군포시,산본2동,산본2동제5투,1776,1330,577,617,109,14,1,1318,12,446,43.77845220030349,46.813353566009106,8.2701062215478,1.062215477996965,0.07587253414264036
36,경기도,군포시,산본2동,산본2동제6투,2284,1805,698,920,156,18,1,1793,12,479,38.92916899051868,51.310652537646405,8.700501952035694,1.003904071388734,0.055772448410485224
37,경기도,군포시,산본2동,산본2동제7투,2429,1986,689,1114,160,14,0,1977,9,443,34.85078401618614,56.348002023267576,8.093070308548306,0.7081436519979768,0.0
38,경기도,군포시,금정동,관내사전투표,4287,4287,2922,1006,286,43,5,4262,25,0,68.55936180197091,23.603941811356172,6.7104645706241195,1.008916001877053,0.11731581417175035
39,경기도,군포시,금정동,금정동제1투,2229,1443,548,750,120,12,1,1431,12,786,38.29489867225716,52.41090146750524,8.385744234800839,0.8385744234800839,0.06988120195667365
40,경기도,군포시,금정동,금정동제2투,2798,1762,702,859,169,10,7,1747,15,1036,40.18317115054379,49.17000572409845,9.673726388093876,0.5724098454493417,0.40068689181453926
41,경기도,군포시,금정동,금정동제3투,2906,1878,793,908,148,22,0,1871,7,1028,42.383752004275784,48.53019775521112,7.910208444681988,1.1758417958311065,0.0
42,경기도,군포시,금정동,금정동제4투,1840,1190,510,575,82,12,3,1182,8,650,43.14720812182741,48.646362098138745,6.937394247038917,1.015228426395939,0.25380710659898476
43,경기도,군포시,금정동,금정동제5투,1726,1289,556,541,166,17,1,1281,8,437,43.403590944574546,42.232630757220925,12.958626073380172,1.3270882123341141,0.078064012490242
44,경기도,군포시,재궁동,관내사전투표,5955,5955,4036,1245,559,56,7,5903,52,0,68.37201423005251,21.090970692868034,9.4697611384042,0.9486701677113333,0.11858377096391666
45,경기도,군포시,재궁동,재궁동제1투,2335,1701,685,864,121,15,3,1688,13,634,40.58056872037915,51.18483412322274,7.168246445497631,0.8886255924170616,0.17772511848341233
46,경기도,군포시,재궁동,재궁동제2투,2110,1489,666,690,107,20,1,1484,5,621,44.878706199460915,46.495956873315365,7.210242587601077,1.3477088948787064,0.06738544474393532
47,경기도,군포시,재궁동,재궁동제3투,2164,1464,553,730,150,17,2,1452,12,700,38.08539944903581,50.27548209366392,10.330578512396695,1.1707988980716253,0.13774104683195593
48,경기도,군포시,재궁동,재궁동제4투,2175,1592,681,715,159,22,1,1578,14,583,43.155893536121674,45.31051964512041,10.076045627376425,1.394169835234474,0.06337135614702154
49,경기도,군포시,재궁동,재궁동제5투,1685,1148,489,540,91,14,1,1135,13,537,43.08370044052863,47.57709251101321,8.01762114537445,1.2334801762114538,0.0881057268722467
50,경기도,군포시,오금동,관내사전투표,4081,4081,2851,827,324,51,1,4054,27,0,70.32560434139123,20.39960532807104,7.992106561420818,1.2580167735569807,0.024666995559940803
51,경기도,군포시,오금동,오금동제1투,2443,1867,748,938,153,16,2,1857,10,576,40.28002154011847,50.511577813677974,8.239095315024231,0.8616047388260636,0.10770059235325795
52,경기도,군포시,오금동,오금동제2투,2632,2061,879,931,213,21,4,2048,13,571,42.919921875,45.458984375,10.400390625,1.025390625,0.1953125
53,경기도,군포시,오금동,오금동제3투,1935,1329,521,629,150,20,0,1320,9,606,39.46969696969697,47.65151515151515,11.363636363636363,1.5151515151515151,0.0
54,경기도,군포시,오금동,오금동제4투,1596,1257,517,591,128,13,0,1249,8,339,41.39311449159327,47.31785428342674,10.248198558847077,1.0408326661329064,0.0
55,경기도,군포시,오금동,오금동제5투,2659,2141,1078,816,211,23,0,2128,13,518,50.6578947368421,38.34586466165413,9.915413533834586,1.080827067669173,0.0
56,경기도,군포시,수리동,관내사전투표,3042,3042,2071,726,197,35,1,3030,12,0,68.34983498349835,23.96039603960396,6.501650165016502,1.155115511551155,0.033003300330033
57,경기도,군포시,수리동,수리동제1투,1709,1266,425,705,98,24,2,1254,12,443,33.89154704944178,56.2200956937799,7.814992025518341,1.9138755980861244,0.1594896331738437
58,경기도,군포시,수리동,수리동제2투,1657,1235,426,682,99,17,2,1226,9,422,34.74714518760196,55.62805872756933,8.075040783034257,1.3866231647634584,0.1631321370309951
59,경기도,군포시,수리동,수리동제3투,1717,1302,568,625,83,15,1,1292,10,415,43.962848297213625,48.37461300309597,6.424148606811146,1.1609907120743035,0.07739938080495357
60,경기도,군포시,수리동,수리동제4투,1933,1445,631,644,141,10,2,1428,17,488,44.18767507002801,45.09803921568628,9.873949579831933,0.700280112044818,0.1400560224089636
61,경기도,군포시,수리동,수리동제5투,1703,1122,478,554,60,14,1,1107,15,581,43.17976513098464,50.04516711833785,5.420054200542006,1.2646793134598013,0.09033423667570009
62,경기도,군포시,궁내동,관내사전투표,3882,3882,2721,809,299,29,5,3863,19,0,70.43748382086461,20.942272844939165,7.740098369143153,0.7507118819570282,0.12943308309603935
63,경기도,군포시,궁내동,궁내동제1투,1529,1059,432,530,82,10,0,1054,5,470,40.98671726755218,50.284629981024665,7.7798861480075905,0.9487666034155597,0.0
64,경기도,군포시,궁내동,궁내동제2투,2074,1636,640,832,132,23,1,1628,8,438,39.31203931203931,51.105651105651106,8.108108108108109,1.4127764127764129,0.06142506142506143
65,경기도,군포시,궁내동,궁내동제3투,2300,1804,782,826,167,19,2,1796,8,496,43.54120267260579,45.99109131403118,9.298440979955457,1.0579064587973273,0.11135857461024498
66,경기도,군포시,궁내동,궁내동제4투,2390,1902,832,853,197,10,2,1894,8,488,43.92819429778247,45.036958817317846,10.401267159450898,0.5279831045406547,0.10559662090813093
67,경기도,군포시,궁내동,궁내동제5투,1790,1383,643,597,118,13,0,1371,12,407,46.900072939460244,43.544857768052516,8.60685630926331,0.9482129832239241,0.0
68,경기도,군포시,광정동,관내사전투표,3892,3892,2704,825,300,33,1,3863,29,0,69.99741133833808,21.356458710846493,7.765984985762361,0.8542583484338596,0.025886616619207874
69,경기도,군포시,광정동,광정동제1투,2994,1828,742,893,153,17,6,1811,17,1166,40.9718387631143,49.309773605742684,8.448371065709551,0.9387078961899503,0.3313086692435119
70,경기도,군포시,광정동,광정동제2투,1850,1203,438,603,131,15,1,1188,15,647,36.868686868686865,50.75757575757576,11.026936026936026,1.2626262626262625,0.08417508417508417
71,경기도,군포시,광정동,광정동제3투,3087,2407,948,1225,194,27,6,2400,7,680,39.5,51.041666666666664,8.083333333333332,1.125,0.25
72,경기도,군포시,광정동,광정동제4투,1462,1173,474,583,92,10,2,1161,12,289,40.82687338501292,50.215331610680444,7.924203273040482,0.8613264427217916,0.17226528854435832
73,경기도,군포시,광정동,광정동제5투,1561,1295,555,622,96,13,0,1286,9,266,43.157076205287716,48.367029548989116,7.4650077760497675,1.010886469673406,0.0
74,경기도,군포시,광정동,광정동제6투,2624,2088,964,869,221,22,1,2077,11,536,46.413095811266246,41.83919114106885,10.640346653827635,1.059220028887819,0.04814636494944632
75,경기도,군포시,대야동,관내사전투표,2683,2683,1864,629,151,24,2,2670,13,0,69.812734082397,23.55805243445693,5.655430711610487,0.8988764044943821,0.0749063670411985
76,경기도,군포시,대야동,대야동제1투,2204,1540,652,743,111,20,1,1527,13,664,42.6981008513425,48.65749836280288,7.269155206286837,1.309757694826457,0.06548788474132286
77,경기도,군포시,대야동,대야동제2투,2466,1802,761,847,146,34,0,1788,14,664,42.56152125279642,47.371364653243845,8.165548098434003,1.901565995525727,0.0
78,경기도,군포시,송부동,관내사전투표,3734,3734,2742,688,263,25,1,3719,15,0,73.7294971766604,18.49959666577037,7.071793492874429,0.6722237160527024,0.026888948642108095
79,경기도,군포시,송부동,송부동제1투,3443,2524,1223,1075,189,25,1,2513,11,919,48.666931953840034,42.77755670513331,7.520891364902507,0.9948269001193792,0.03979307600477517
80,경기도,군포시,송부동,송부동제2투,1644,1356,711,505,107,23,2,1348,8,288,52.74480712166172,37.46290801186943,7.937685459940654,1.7062314540059347,0.1483679525222552
81,경기도,군포시,송부동,송부동제3투,2504,1884,809,862,184,15,1,1871,13,620,43.238909673971136,46.071619454836984,9.834313201496526,0.8017103153393906,0.053447354355959376
82,경기도,군포시,송부동,송부동제4투,1620,1173,519,520,109,10,2,1160,13,447,44.741379310344826,44.827586206896555,9.39655172413793,0.8620689655172413,0.1724137931034483
83,경기도,군포시,송부동,송부동제5투,1585,1210,611,480,93,16,2,1202,8,375,50.83194675540766,39.93344425956739,7.737104825291182,1.3311148086522462,0.16638935108153077
84,경기도,군포시,잘못 투입·구분된 투표지,,0,0,0,0,0,0,0,0,0,0,0.0,0.0,0.0,0.0,0.0
0,경기도,하남시,거소·선상투표,,369,351,141,125,75,2,0,343,8,18,41.10787172011662,36.44314868804665,21.865889212827987,0.5830903790087464,0.0
1,경기도,하남시,관외사전투표,,34237,34234,20794,8539,4252,343,26,33954,280,3,61.241679919891624,25.148730635565762,12.522824998527419,1.0101902574070802,0.07657418860811686
2,경기도,하남시,재외투표,,1824,1516,998,328,160,20,1,1507,9,308,66.22428666224287,21.76509621765096,10.617120106171201,1.3271400132714002,0.06635700066357
3,경기도,하남시,천현동,관내사전투표,1649,1649,972,543,110,12,4,1641,8,0,59.23217550274224,33.089579524680076,6.703229737964655,0.7312614259597806,0.2437538086532602
4,경기도,하남시,천현동,천현동제1투,1533,920,211,642,59,2,0,914,6,613,23.085339168490155,70.24070021881839,6.455142231947483,0.2188183807439825,0.0
5,경기도,하남시,천현동,천현동제2투,1064,601,203,353,36,2,1,595,6,463,34.11764705882353,59.32773109243698,6.050420168067227,0.33613445378151263,0.16806722689075632
6,경기도,하남시,천현동,천현동제3투,836,500,126,343,25,1,0,495,5,336,25.454545454545453,69.2929292929293,5.05050505050505,0.20202020202020202,0.0
7,경기도,하남시,신장1동,관내사전투표,3468,3468,2138,1029,257,18,3,3445,23,0,62.060957910014515,29.869375907111756,7.460087082728592,0.5224963715529753,0.08708272859216255
8,경기도,하남시,신장1동,신장1동투표소,3957,2369,799,1327,197,25,0,2348,21,1588,34.028960817717206,56.51618398637138,8.390119250425894,1.0647359454855196,0.0
9,경기도,하남시,신장2동,관내사전투표,8601,8601,5330,2522,631,55,5,8543,58,0,62.39026103242421,29.521245464122675,7.386164110968044,0.6438019431113192,0.058527449373756285
10,경기도,하남시,신장2동,신장2동제1투,2214,1391,466,804,99,13,0,1382,9,823,33.71924746743849,58.17655571635311,7.163531114327062,0.9406657018813315,0.0
11,경기도,하남시,신장2동,신장2동제2투,1682,976,252,652,64,3,1,972,4,706,25.925925925925924,67.07818930041152,6.584362139917696,0.30864197530864196,0.102880658436214
12,경기도,하남시,신장2동,신장2동제3투,3145,2121,736,1200,152,16,4,2108,13,1024,34.9146110056926,56.92599620493358,7.2106261859582546,0.7590132827324478,0.18975332068311196
13,경기도,하남시,신장2동,신장2동제4투,2114,1657,546,998,94,8,1,1647,10,457,33.1511839708561,60.595021250758954,5.707346690953248,0.4857316332726169,0.060716454159077116
14,경기도,하남시,신장2동,신장2동제5투,2048,1612,641,857,89,18,3,1608,4,436,39.863184079601986,53.29601990049751,5.534825870646766,1.1194029850746268,0.18656716417910446
15,경기도,하남시,신장2동,신장2동제6투,1989,1545,618,792,113,11,0,1534,11,444,40.28683181225554,51.62972620599739,7.3663624511082135,0.7170795306388527,0.0
16,경기도,하남시,신장2동,신장2동제7투,2873,2143,824,1109,176,17,1,2127,16,730,38.74000940291491,52.13916314057357,8.274565115185707,0.7992477668077104,0.04701457451810061
17,경기도,하남시,신장2동,신장2동제8투,3261,2466,874,1368,183,29,1,2455,11,795,35.60081466395112,55.72301425661914,7.4541751527494915,1.1812627291242364,0.04073319755600815
18,경기도,하남시,신장2동,신장2동제9투,2583,1960,660,1158,117,11,1,1947,13,623,33.89830508474576,59.47611710323575,6.00924499229584,0.5649717514124294,0.05136106831022085
19,경기도,하남시,신장2동,신장2동제10투,3869,2857,1195,1382,239,27,3,2846,11,1012,41.988756148981025,48.55938158819396,8.397751229796205,0.9486999297259312,0.10541110330288123
20,경기도,하남시,덕풍1동,관내사전투표,3324,3324,2224,887,176,22,2,3311,13,0,67.17003926306252,26.789489580187254,5.3156146179401995,0.6644518272425249,0.06040471156750227
21,경기도,하남시,덕풍1동,덕풍1동제1투,2375,1561,606,818,106,15,0,1545,16,814,39.22330097087379,52.94498381877023,6.86084142394822,0.9708737864077669,0.0
22,경기도,하남시,덕풍1동,덕풍1동제2투,1652,1170,437,639,76,10,1,1163,7,482,37.57523645743766,54.94411006018917,6.534823731728288,0.8598452278589854,0.08598452278589853
23,경기도,하남시,덕풍1동,덕풍1동제3투,1526,944,343,535,53,6,3,940,4,582,36.48936170212766,56.91489361702128,5.638297872340425,0.6382978723404255,0.3191489361702127
24,경기도,하남시,덕풍1동,덕풍1동제4투,2374,1711,545,1039,98,16,2,1700,11,663,32.05882352941177,61.11764705882353,5.764705882352941,0.9411764705882352,0.1176470588235294
25,경기도,하남시,덕풍2동,관내사전투표,4251,4251,2745,1187,267,31,4,4234,17,0,64.83230987246102,28.034955125177135,6.306093528578177,0.7321681624940954,0.0944733112895607
26,경기도,하남시,덕풍2동,덕풍2동제1투,1725,1168,414,668,60,11,1,1154,14,557,35.875216637781634,57.885615251299825,5.1993067590987865,0.9532062391681109,0.08665511265164644
27,경기도,하남시,덕풍2동,덕풍2동제2투,1486,937,298,561,63,4,0,926,11,549,32.18142548596112,60.58315334773218,6.8034557235421165,0.4319654427645789,0.0
28,경기도,하남시,덕풍2동,덕풍2동제3투,3370,2271,820,1231,182,20,3,2256,15,1099,36.347517730496456,54.565602836879435,8.067375886524824,0.8865248226950355,0.13297872340425532
29,경기도,하남시,덕풍2동,덕풍2동제4투,1456,822,299,466,47,5,1,818,4,634,36.552567237163814,56.96821515892421,5.745721271393643,0.6112469437652812,0.12224938875305623
30,경기도,하남시,덕풍2동,덕풍2동제5투,1998,1304,476,739,80,3,2,1300,4,694,36.61538461538461,56.84615384615385,6.153846153846154,0.23076923076923078,0.15384615384615385
31,경기도,하남시,덕풍3동,관내사전투표,5618,5617,3693,1470,385,41,5,5594,23,1,66.0171612441902,26.27815516624955,6.882373972112978,0.7329281372899535,0.0893814801573114
32,경기도,하남시,덕풍3동,덕풍3동제1투,3858,3023,1169,1561,250,31,2,3013,10,835,38.798539661466975,51.808828410222375,8.29737802854298,1.0288748755393295,0.06637902422834385
33,경기도,하남시,덕풍3동,덕풍3동제2투,2953,2086,874,1019,153,20,2,2068,18,867,42.26305609284333,49.27466150870406,7.398452611218569,0.9671179883945842,0.09671179883945842
34,경기도,하남시,덕풍3동,덕풍3동제3투,2268,1407,482,813,90,11,3,1399,8,861,34.45318084345961,58.112937812723374,6.433166547533952,0.7862759113652609,0.21443888491779842
35,경기도,하남시,덕풍3동,덕풍3동제4투,3658,2411,803,1374,186,33,1,2397,14,1247,33.50020859407593,57.32165206508135,7.759699624530664,1.376720901126408,0.041718815185648725
36,경기도,하남시,덕풍3동,덕풍3동제5투,2319,1545,558,867,98,12,2,1537,8,774,36.30448926480156,56.40858815875082,6.376057254391672,0.7807417046193884,0.13012361743656475
37,경기도,하남시,미사1동,관내사전투표,9562,9561,6473,1973,953,95,5,9499,62,1,68.14401515949046,20.770607432361302,10.032635014212023,1.0001052742393937,0.05263711969681019
38,경기도,하남시,미사1동,미사1동제1투,3680,1948,695,900,307,21,0,1923,25,1732,36.14144565782632,46.80187207488299,15.964638585543423,1.0920436817472698,0.0
39,경기도,하남시,미사1동,미사1동제2투,2053,1342,552,696,67,12,3,1330,12,711,41.50375939849624,52.33082706766917,5.037593984962406,0.9022556390977444,0.2255639097744361
40,경기도,하남시,미사1동,미사1동제3투,2908,2223,1018,987,183,20,2,2210,13,685,46.06334841628959,44.6606334841629,8.280542986425338,0.904977375565611,0.09049773755656108
41,경기도,하남시,미사1동,미사1동제4투,2081,1621,730,724,140,21,0,1615,6,460,45.20123839009288,44.8297213622291,8.6687306501548,1.3003095975232197,0.0
42,경기도,하남시,미사1동,미사1동제5투,2992,2278,1010,1017,204,24,3,2258,20,714,44.72984942426926,45.03985828166519,9.03454384410983,1.0628875110717448,0.1328609388839681
43,경기도,하남시,미사1동,미사1동제6투,3484,2586,1216,1101,220,31,2,2570,16,898,47.31517509727626,42.840466926070036,8.560311284046692,1.2062256809338523,0.07782101167315175
44,경기도,하남시,미사1동,미사1동제7투,3864,2176,756,1019,345,19,5,2144,32,1688,35.26119402985074,47.52798507462687,16.09141791044776,0.8861940298507462,0.23320895522388058
45,경기도,하남시,미사1동,미사1동제8투,4693,3328,1307,1618,352,23,0,3300,28,1365,39.60606060606061,49.03030303030303,10.666666666666668,0.6969696969696969,0.0
46,경기도,하남시,미사1동,미사1동제9투,3079,1980,718,961,254,26,1,1960,20,1099,36.63265306122449,49.03061224489796,12.959183673469388,1.3265306122448979,0.05102040816326531
47,경기도,하남시,미사2동,관내사전투표,10343,10342,7116,2336,776,73,2,10303,39,1,69.06726196253518,22.673007861787827,7.531786858196641,0.7085314956808696,0.01941182179947588
48,경기도,하남시,미사2동,미사2동제1투,2220,1243,429,750,44,8,1,1232,11,977,34.82142857142857,60.87662337662337,3.571428571428571,0.6493506493506493,0.08116883116883117
49,경기도,하남시,미사2동,미사2동제2투,2615,1973,912,853,178,17,0,1960,13,642,46.53061224489796,43.52040816326531,9.081632653061225,0.8673469387755102,0.0
50,경기도,하남시,미사2동,미사2동제3투,4383,3034,1247,1519,228,23,2,3019,15,1349,41.30506790327923,50.314673733024186,7.552169592580324,0.7618416694269625,0.06624710168930109
51,경기도,하남시,미사2동,미사2동제4투,2613,2049,925,915,173,24,2,2039,10,564,45.365375183913685,44.87493869543894,8.484551250613045,1.177047572339382,0.0980872976949485
52,경기도,하남시,미사2동,미사2동제5투,3331,2600,1130,1248,193,12,1,2584,16,731,43.73065015479876,48.297213622291025,7.469040247678019,0.46439628482972134,0.03869969040247678
53,경기도,하남시,미사2동,미사2동제6투,3885,2950,1339,1327,239,30,0,2935,15,935,45.62180579216354,45.2129471890971,8.143100511073254,1.0221465076660987,0.0
54,경기도,하남시,미사2동,미사2동제7투,3947,2942,1311,1292,294,29,1,2927,15,1005,44.7898872565767,44.140758455756746,10.044414075845577,0.9907755380936112,0.0341646737273659
55,경기도,하남시,미사3동,관내사전투표,3897,3897,2716,822,303,34,1,3876,21,0,70.07223942208462,21.207430340557277,7.817337461300309,0.8771929824561403,0.025799793601651185
56,경기도,하남시,미사3동,미사3동제1투,3016,1884,623,1048,179,21,1,1872,12,1132,33.27991452991453,55.98290598290598,9.56196581196581,1.1217948717948718,0.05341880341880342
57,경기도,하남시,미사3동,미사3동제2투,2882,2251,935,1095,180,27,3,2240,11,631,41.74107142857143,48.88392857142857,8.035714285714286,1.205357142857143,0.13392857142857142
58,경기도,하남시,미사3동,미사3동제3투,2988,2280,847,1212,190,14,0,2263,17,708,37.42819266460451,53.55722492266902,8.395934600088378,0.6186478126380911,0.0
59,경기도,하남시,미사3동,미사3동제4투,2453,1843,944,723,146,19,1,1833,10,610,51.50027277686851,39.44353518821604,7.965084560829242,1.0365521003818876,0.05455537370430987
60,경기도,하남시,미사3동,미사3동제5투,2782,2083,888,990,175,22,0,2075,8,699,42.795180722891565,47.71084337349398,8.433734939759036,1.0602409638554215,0.0
61,경기도,하남시,감북동,관내사전투표,1065,1065,670,321,56,9,1,1057,8,0,63.386944181646165,30.368968779564803,5.298013245033113,0.8514664143803218,0.0946073793755913
62,경기도,하남시,감북동,감북동투표소,1751,1148,295,744,86,14,2,1141,7,603,25.854513584574935,65.2059596844873,7.537248028045573,1.2269938650306749,0.175284837861525
63,경기도,하남시,감일동,관내사전투표,7101,7101,5017,1427,560,58,2,7064,37,0,71.02208380520952,20.20101925254813,7.9275198187995475,0.8210645526613816,0.028312570781426957
64,경기도,하남시,감일동,감일동제1투,2250,1737,732,816,161,19,0,1728,9,513,42.36111111111111,47.22222222222222,9.31712962962963,1.099537037037037,0.0
65,경기도,하남시,감일동,감일동제2투,3058,2064,879,988,156,22,4,2049,15,994,42.89897510980966,48.218643240605175,7.613469985358712,1.0736944851146901,0.19521717911176184
66,경기도,하남시,감일동,감일동제3투,2867,2186,972,969,216,17,1,2175,11,681,44.689655172413794,44.55172413793104,9.931034482758621,0.7816091954022988,0.04597701149425287
67,경기도,하남시,감일동,감일동제4투,3107,2280,1031,989,213,25,2,2260,20,827,45.61946902654867,43.76106194690266,9.424778761061948,1.1061946902654867,0.08849557522123894
68,경기도,하남시,감일동,감일동제5투,2729,2076,794,1043,204,19,2,2062,14,653,38.506304558680895,50.581959262851605,9.893307468477207,0.921435499515034,0.09699321047526674
69,경기도,하남시,감일동,감일동제6투,4111,2868,1116,1419,289,26,3,2853,15,1243,39.11671924290221,49.737118822292324,10.12968804766912,0.9113214160532772,0.10515247108307045
70,경기도,하남시,위례동,관내사전투표,4148,4148,2759,1010,322,29,6,4126,22,0,66.86863790596219,24.478914202617545,7.804168686379059,0.7028599127484246,0.1454192922927775
71,경기도,하남시,위례동,위례동제1투,4072,3127,1412,1428,248,22,2,3112,15,945,45.37275064267352,45.88688946015424,7.969151670951156,0.7069408740359897,0.06426735218508997
72,경기도,하남시,위례동,위례동제2투,3847,2857,943,1669,224,11,0,2847,10,990,33.1225851773797,58.623112047769574,7.867931155602388,0.3863716192483316,0.0
73,경기도,하남시,위례동,위례동제3투,2678,2122,646,1252,190,17,2,2107,15,556,30.65970574276222,59.420977693402946,9.017560512577123,0.8068343616516375,0.09492168960607499
74,경기도,하남시,위례동,위례동제4투,2600,1843,596,1018,193,17,1,1825,18,757,32.657534246575345,55.78082191780822,10.575342465753424,0.9315068493150684,0.0547945205479452
75,경기도,하남시,위례동,위례동제5투,4205,3179,1294,1492,330,34,2,3152,27,1026,41.05329949238579,47.33502538071066,10.469543147208121,1.0786802030456852,0.06345177664974619
76,경기도,하남시,춘궁동,관내사전투표,743,743,422,285,31,4,0,742,1,0,56.8733153638814,38.40970350404312,4.177897574123989,0.5390835579514826,0.0
77,경기도,하남시,춘궁동,춘궁동투표소,572,315,72,224,9,4,0,309,6,257,23.300970873786408,72.49190938511327,2.912621359223301,1.2944983818770228,0.0
78,경기도,하남시,초이동,관내사전투표,989,989,636,274,72,4,0,986,3,0,64.50304259634888,27.789046653144016,7.302231237322515,0.4056795131845842,0.0
79,경기도,하남시,초이동,초이동투표소,1694,1057,269,706,71,7,1,1054,3,637,25.521821631878556,66.98292220113852,6.7362428842504745,0.6641366223908919,0.09487666034155598
80,경기도,하남시,잘못 투입·구분된 투표지,,0,0,0,0,0,0,0,0,0,0,0.0,0.0,0.0,0.0,0.0
0,경기도,파주시,거소·선상투표,,1032,981,368,318,257,6,2,951,30,51,38.69610935856993,33.4384858044164,27.024185068349105,0.6309148264984227,0.2103049421661409
1,경기도,파주시,관외사전투표,,37293,37283,22995,8893,4619,398,47,36952,331,10,62.22937865338818,24.06635635418922,12.5,1.0770729595150466,0.12719203290755576
2,경기도,파주시,재외투표,,2351,1938,1406,343,148,26,0,1923,15,413,73.11492459698388,17.836713468538743,7.696307852314092,1.3520540821632865,0.0
3,경기도,파주시,문산읍,관내사전투표,8901,8901,5890,2212,643,88,8,8841,60,0,66.62142291595974,25.01979414093428,7.272932926139577,0.9953625155525394,0.0904875014138672
4,경기도,파주시,문산읍,문산읍제1투,2159,1487,555,841,68,8,1,1473,14,672,37.67820773930753,57.09436524100475,4.61642905634759,0.5431093007467752,0.0678886625933469
5,경기도,파주시,문산읍,문산읍제2투,3985,2541,1215,1101,182,24,2,2524,17,1444,48.13787638668779,43.621236133122025,7.210776545166403,0.9508716323296356,0.07923930269413629
6,경기도,파주시,문산읍,문산읍제3투,2924,1762,738,821,170,18,2,1749,13,1162,42.19554030874786,46.94110920526015,9.719839908519154,1.0291595197255576,0.11435105774728416
7,경기도,파주시,문산읍,문산읍제4투,2430,1391,623,653,90,15,1,1382,9,1039,45.07959479015919,47.25036179450072,6.512301013024602,1.085383502170767,0.0723589001447178
8,경기도,파주시,문산읍,문산읍제5투,2980,1747,785,808,122,20,2,1737,10,1233,45.19286125503742,46.51698330454807,7.023603914795625,1.1514104778353482,0.11514104778353484
9,경기도,파주시,문산읍,문산읍제6투,746,489,180,286,15,4,0,485,4,257,37.11340206185567,58.96907216494846,3.0927835051546393,0.8247422680412372,0.0
10,경기도,파주시,문산읍,문산읍제7투,817,566,185,360,15,2,0,562,4,251,32.91814946619217,64.05693950177937,2.6690391459074734,0.3558718861209964,0.0
11,경기도,파주시,문산읍,문산읍제8투,519,312,93,198,16,3,0,310,2,207,30.0,63.87096774193548,5.161290322580645,0.967741935483871,0.0
12,경기도,파주시,문산읍,문산읍제9투,2329,1383,555,698,100,23,0,1376,7,946,40.3343023255814,50.72674418604651,7.267441860465117,1.6715116279069766,0.0
13,경기도,파주시,문산읍,문산읍제10투,1351,814,328,433,36,6,0,803,11,537,40.846824408468244,53.9227895392279,4.483188044831881,0.7471980074719801,0.0
14,경기도,파주시,문산읍,문산읍제11투,2884,1832,890,818,89,15,4,1816,16,1052,49.008810572687224,45.04405286343612,4.900881057268722,0.8259911894273128,0.22026431718061676
15,경기도,파주시,문산읍,문산읍제12투,3154,2056,956,910,156,17,3,2042,14,1098,46.81684622918707,44.564152791381,7.639569049951028,0.832517140058766,0.14691478942213515
16,경기도,파주시,문산읍,문산읍제13투,1979,1546,815,582,128,14,0,1539,7,433,52.956465237166995,37.8167641325536,8.317089018843404,0.9096816114359974,0.0
17,경기도,파주시,조리읍,관내사전투표,5450,5450,3643,1448,289,41,3,5424,26,0,67.16445427728614,26.696165191740413,5.328171091445428,0.7558997050147492,0.05530973451327434
18,경기도,파주시,조리읍,조리읍제1투,3196,2306,974,1195,104,15,5,2293,13,890,42.47710423026603,52.11513301351941,4.53554295682512,0.6541648495420846,0.2180549498473615
19,경기도,파주시,조리읍,조리읍제2투,3366,2083,872,1076,108,17,2,2075,8,1283,42.02409638554217,51.855421686746986,5.204819277108434,0.8192771084337349,0.09638554216867469
20,경기도,파주시,조리읍,조리읍제3투,1578,1067,458,553,45,8,0,1064,3,511,43.045112781954884,51.973684210526315,4.2293233082706765,0.7518796992481203,0.0
21,경기도,파주시,조리읍,조리읍제4투,2576,1820,815,888,92,17,2,1814,6,756,44.92833517089305,48.95259095920617,5.071664829106946,0.9371554575523704,0.11025358324145534
22,경기도,파주시,조리읍,조리읍제5투,2728,1819,835,829,123,17,0,1804,15,909,46.286031042128606,45.95343680709534,6.8181818181818175,0.9423503325942351,0.0
23,경기도,파주시,조리읍,조리읍제6투,1401,863,326,493,40,1,1,861,2,538,37.86295005807201,57.25900116144018,4.645760743321719,0.11614401858304298,0.11614401858304298
24,경기도,파주시,조리읍,조리읍제7투,1273,807,346,401,45,10,1,803,4,466,43.08841843088418,49.93773349937734,5.603985056039851,1.2453300124533,0.12453300124533001
25,경기도,파주시,조리읍,조리읍제8투,1032,635,248,351,22,7,2,630,5,397,39.36507936507937,55.714285714285715,3.492063492063492,1.1111111111111112,0.31746031746031744
26,경기도,파주시,법원읍,관내사전투표,2256,2256,1289,738,178,13,4,2222,34,0,58.01080108010801,33.21332133213321,8.010801080108012,0.585058505850585,0.18001800180018002
27,경기도,파주시,법원읍,법원읍제1투,1320,752,244,454,49,1,0,748,4,568,32.62032085561498,60.6951871657754,6.550802139037433,0.1336898395721925,0.0
28,경기도,파주시,법원읍,법원읍제2투,445,252,85,152,14,1,0,252,0,193,33.730158730158735,60.317460317460316,5.555555555555555,0.3968253968253968,0.0
29,경기도,파주시,법원읍,법원읍제3투,543,385,120,243,19,2,0,384,1,158,31.25,63.28125,4.947916666666666,0.5208333333333333,0.0
30,경기도,파주시,법원읍,법원읍제4투,1342,834,316,471,40,3,1,831,3,508,38.02647412755716,56.678700361010826,4.813477737665464,0.36101083032490977,0.12033694344163659
31,경기도,파주시,법원읍,법원읍제5투,1047,576,171,378,20,3,0,572,4,471,29.895104895104897,66.08391608391608,3.4965034965034967,0.5244755244755245,0.0
32,경기도,파주시,법원읍,법원읍제6투,1340,836,288,496,36,9,2,831,5,504,34.65703971119133,59.687123947051745,4.332129963898916,1.083032490974729,0.24067388688327318
33,경기도,파주시,파주읍,관내사전투표,2976,2976,1844,913,188,11,1,2957,19,0,62.36050050727088,30.875887724044638,6.35779506256341,0.37199864727764625,0.033818058843422386
34,경기도,파주시,파주읍,파주읍제1투,2178,1250,429,749,61,5,0,1244,6,928,34.48553054662379,60.20900321543409,4.903536977491962,0.40192926045016075,0.0
35,경기도,파주시,파주읍,파주읍제2투,1824,1117,503,527,66,7,1,1104,13,707,45.561594202898554,47.73550724637681,5.978260869565218,0.6340579710144928,0.09057971014492754
36,경기도,파주시,파주읍,파주읍제3투,1130,681,262,379,29,5,2,677,4,449,38.70014771048744,55.98227474150664,4.283604135893649,0.7385524372230428,0.29542097488921715
37,경기도,파주시,파주읍,파주읍제4투,975,585,202,341,32,1,2,578,7,390,34.94809688581315,58.99653979238755,5.536332179930796,0.17301038062283738,0.34602076124567477
38,경기도,파주시,파주읍,파주읍제5투,765,446,128,289,20,5,1,443,3,319,28.893905191873586,65.23702031602708,4.514672686230249,1.1286681715575622,0.2257336343115124
39,경기도,파주시,파주읍,파주읍제6투,1713,1053,454,526,54,10,1,1045,8,660,43.44497607655502,50.334928229665074,5.167464114832536,0.9569377990430622,0.09569377990430622
40,경기도,파주시,광탄면,관내사전투표,2893,2893,1811,881,163,18,0,2873,20,0,63.03515489035851,30.66481030281935,5.6735120083536374,0.6265227984684998,0.0
41,경기도,파주시,광탄면,광탄면제1투,2011,1141,412,661,57,5,1,1136,5,870,36.267605633802816,58.18661971830986,5.017605633802817,0.44014084507042256,0.08802816901408451
42,경기도,파주시,광탄면,광탄면제2투,1524,893,268,573,39,6,1,887,6,631,30.214205186020294,64.59977452085683,4.3968432919954905,0.6764374295377678,0.11273957158962795
43,경기도,파주시,광탄면,광탄면제3투,797,541,164,340,25,4,2,535,6,256,30.654205607476637,63.55140186915887,4.672897196261682,0.7476635514018692,0.3738317757009346
44,경기도,파주시,광탄면,광탄면제4투,1064,631,210,379,33,5,1,628,3,433,33.43949044585987,60.35031847133758,5.254777070063694,0.7961783439490446,0.15923566878980894
45,경기도,파주시,광탄면,광탄면제5투,1070,665,208,406,39,6,0,659,6,405,31.56297420333839,61.60849772382397,5.918057663125948,0.9104704097116844,0.0
46,경기도,파주시,탄현면,관내사전투표,2938,2938,2053,670,159,28,1,2911,27,0,70.52559257986945,23.01614565441429,5.462040535898317,0.9618687736173137,0.034352456200618345
47,경기도,파주시,탄현면,탄현면제1투,1322,687,201,442,30,4,0,677,10,635,29.68980797636632,65.28803545051699,4.431314623338257,0.5908419497784343,0.0
48,경기도,파주시,탄현면,탄현면제2투,982,602,221,342,28,5,0,596,6,380,37.080536912751676,57.38255033557047,4.697986577181208,0.8389261744966443,0.0
49,경기도,파주시,탄현면,탄현면제3투,892,581,171,377,22,5,1,576,5,311,29.6875,65.45138888888889,3.8194444444444446,0.8680555555555556,0.1736111111111111
50,경기도,파주시,탄현면,탄현면제4투,1779,1137,545,514,51,16,1,1127,10,642,48.358473824312334,45.607808340727594,4.525288376220053,1.419698314108252,0.08873114463176575
51,경기도,파주시,탄현면,탄현면제5투,3034,2019,939,925,101,31,2,1998,21,1015,46.996996996997,46.2962962962963,5.055055055055055,1.5515515515515517,0.10010010010010009
52,경기도,파주시,월롱면,관내사전투표,2763,2763,1806,668,262,10,2,2748,15,0,65.72052401746726,24.308588064046578,9.534206695778748,0.363901018922853,0.0727802037845706
53,경기도,파주시,월롱면,월롱면제1투,989,605,148,418,24,7,0,597,8,384,24.79061976549414,70.01675041876047,4.0201005025125625,1.1725293132328307,0.0
54,경기도,파주시,월롱면,월롱면제2투,1234,635,225,360,36,8,0,629,6,599,35.77106518282989,57.23370429252782,5.723370429252783,1.2718600953895072,0.0
55,경기도,파주시,월롱면,월롱면제3투,1249,764,303,416,32,7,1,759,5,485,39.920948616600796,54.80895915678524,4.216073781291173,0.922266139657444,0.13175230566534915
56,경기도,파주시,월롱면,월롱면제4투,1498,878,217,384,254,2,1,858,20,620,25.29137529137529,44.75524475524475,29.603729603729604,0.2331002331002331,0.11655011655011654
57,경기도,파주시,적성면,관내사전투표,1481,1481,810,516,140,3,0,1469,12,0,55.13955071477196,35.12593601089176,9.530292716133424,0.2042205582028591,0.0
58,경기도,파주시,적성면,적성면제1투,1838,1052,316,637,91,4,1,1049,3,786,30.123927550047664,60.72449952335558,8.674928503336512,0.3813155386081983,0.09532888465204957
59,경기도,파주시,적성면,적성면제2투,472,316,87,212,9,1,0,309,7,156,28.155339805825243,68.6084142394822,2.912621359223301,0.3236245954692557,0.0
60,경기도,파주시,적성면,적성면제3투,737,463,120,320,18,1,1,460,3,274,26.08695652173913,69.56521739130434,3.91304347826087,0.21739130434782608,0.21739130434782608
61,경기도,파주시,적성면,적성면제4투,439,261,96,154,9,2,0,261,0,178,36.7816091954023,59.00383141762452,3.4482758620689653,0.7662835249042145,0.0
62,경기도,파주시,적성면,적성면제5투,465,338,80,232,16,2,0,330,8,127,24.242424242424242,70.3030303030303,4.848484848484849,0.6060606060606061,0.0
63,경기도,파주시,파평면,관내사전투표,937,937,516,316,97,4,0,933,4,0,55.30546623794213,33.86923901393355,10.39657020364416,0.4287245444801715,0.0
64,경기도,파주시,파평면,파평면제1투,309,204,45,148,7,2,1,203,1,105,22.167487684729064,72.9064039408867,3.4482758620689653,0.9852216748768473,0.49261083743842365
65,경기도,파주시,파평면,파평면제2투,355,243,74,149,16,2,1,242,1,112,30.57851239669421,61.57024793388429,6.6115702479338845,0.8264462809917356,0.4132231404958678
66,경기도,파주시,파평면,파평면제3투,306,198,57,132,9,0,0,198,0,108,28.78787878787879,66.66666666666666,4.545454545454546,0.0,0.0
67,경기도,파주시,파평면,파평면제4투,610,429,172,236,18,0,0,426,3,181,40.375586854460096,55.39906103286385,4.225352112676056,0.0,0.0
68,경기도,파주시,파평면,파평면제5투,420,273,75,179,16,2,0,272,1,147,27.573529411764707,65.80882352941177,5.88235294117647,0.7352941176470588,0.0
69,경기도,파주시,파평면,파평면제6투,409,277,88,173,10,1,0,272,5,132,32.35294117647059,63.60294117647059,3.6764705882352944,0.3676470588235294,0.0
70,경기도,파주시,장단면,관내사전투표,385,385,207,104,64,4,0,379,6,0,54.61741424802111,27.440633245382585,16.886543535620053,1.0554089709762533,0.0
71,경기도,파주시,장단면,장단면제1투,330,230,97,126,5,0,0,228,2,100,42.54385964912281,55.26315789473685,2.1929824561403506,0.0,0.0
72,경기도,파주시,장단면,장단면제2투,96,81,22,57,2,0,0,81,0,15,27.160493827160494,70.37037037037037,2.4691358024691357,0.0,0.0
73,경기도,파주시,교하동,관내사전투표,1798,1798,1251,437,93,10,0,1791,7,0,69.84924623115577,24.399776661083195,5.192629815745393,0.5583472920156337,0.0
74,경기도,파주시,교하동,교하동제1투,2185,1272,442,736,79,7,0,1264,8,913,34.96835443037975,58.22784810126582,6.25,0.5537974683544303,0.0
75,경기도,파주시,교하동,교하동제2투,2105,1321,448,768,77,20,1,1314,7,784,34.09436834094368,58.44748858447488,5.859969558599695,1.5220700152207,0.076103500761035
76,경기도,파주시,운정1동,관내사전투표,10683,10683,7755,2089,687,88,8,10627,56,0,72.97449891785077,19.657476239766634,6.464665474734168,0.8280794203444057,0.07527994730403689
77,경기도,파주시,운정1동,운정1동제1투,3843,2558,1246,1063,211,20,3,2543,15,1285,48.997247345654735,41.80102241447109,8.297286669288242,0.7864726700747149,0.11797090051120723
78,경기도,파주시,운정1동,운정1동제2투,4316,3021,1481,1275,213,28,2,2999,22,1295,49.38312770923641,42.51417139046349,7.102367455818606,0.9336445481827277,0.06668889629876625
79,경기도,파주시,운정1동,운정1동제3투,3726,2432,1124,1034,234,30,3,2425,7,1294,46.350515463917525,42.63917525773196,9.649484536082474,1.2371134020618557,0.12371134020618556
80,경기도,파주시,운정1동,운정1동제4투,2399,1808,853,779,140,28,1,1801,7,591,47.362576346474185,43.25374791782343,7.773459189339256,1.5546918378678511,0.055524708495280406
81,경기도,파주시,운정1동,운정1동제5투,3672,2707,1509,965,189,20,1,2684,23,965,56.222056631892706,35.953800298062596,7.041728763040238,0.7451564828614009,0.037257824143070044
82,경기도,파주시,운정1동,운정1동제6투,3083,2349,1082,1054,182,27,1,2346,3,734,46.12105711849958,44.927536231884055,7.757885763000852,1.1508951406649617,0.042625745950554135
83,경기도,파주시,운정1동,운정1동제7투,2306,1715,803,738,153,9,1,1704,11,591,47.124413145539904,43.309859154929576,8.97887323943662,0.528169014084507,0.05868544600938967
84,경기도,파주시,운정1동,운정1동제8투,3326,2399,1301,874,184,24,4,2387,12,927,54.50356095517386,36.614997905320486,7.708420611646419,1.0054461667364893,0.1675743611227482
85,경기도,파주시,운정1동,운정1동제9투,2735,2097,1133,752,184,17,2,2088,9,638,54.26245210727969,36.015325670498086,8.812260536398467,0.814176245210728,0.09578544061302681
86,경기도,파주시,운정2동,관내사전투표,6674,6674,5106,1068,414,65,1,6654,20,0,76.73579801623085,16.05049594229035,6.221821460775474,0.9768560264502555,0.015028554253080853
87,경기도,파주시,운정2동,운정2동제1투,2780,1738,779,803,122,17,3,1724,14,1042,45.185614849187935,46.577726218097446,7.076566125290023,0.9860788863109048,0.17401392111368907
88,경기도,파주시,운정2동,운정2동제2투,2199,1642,824,658,128,21,2,1633,9,557,50.45927740355175,40.29393753827312,7.838334353949786,1.2859767299448868,0.1224739742804654
89,경기도,파주시,운정2동,운정2동제3투,2382,1792,912,730,126,14,2,1784,8,590,51.12107623318386,40.91928251121077,7.062780269058296,0.7847533632286996,0.11210762331838565
90,경기도,파주시,운정2동,운정2동제4투,1769,1176,500,570,85,9,0,1164,12,593,42.955326460481096,48.96907216494845,7.302405498281788,0.7731958762886598,0.0
91,경기도,파주시,운정2동,운정2동제5투,3633,2537,1249,1115,138,23,2,2527,10,1096,49.42619707162643,44.12346656113969,5.461020973486348,0.9101701622477245,0.07914523149980214
92,경기도,파주시,운정2동,운정2동제6투,3779,2613,1301,1083,202,15,1,2602,11,1166,50.0,41.6218293620292,7.763259031514219,0.5764796310530361,0.03843197540353574
93,경기도,파주시,운정2동,운정2동제7투,3589,2630,1337,1050,197,39,2,2625,5,959,50.93333333333333,40.0,7.504761904761905,1.4857142857142858,0.0761904761904762
94,경기도,파주시,운정2동,운정2동제8투,3491,2723,1536,936,192,44,1,2709,14,768,56.69988925802879,34.55149501661129,7.087486157253599,1.6242155777039495,0.03691399040236249
95,경기도,파주시,운정2동,운정2동제9투,2594,1906,945,700,228,22,0,1895,11,688,49.86807387862797,36.93931398416886,12.031662269129288,1.1609498680738786,0.0
96,경기도,파주시,운정2동,운정2동제10투,4066,3142,1607,1182,285,35,3,3112,30,924,51.63881748071979,37.98200514138818,9.15809768637532,1.1246786632390746,0.09640102827763496
97,경기도,파주시,운정2동,운정2동제11투,3154,2533,1413,858,220,30,0,2521,12,621,56.049186830622766,34.034113447044824,8.72669575565252,1.190003966679889,0.0
98,경기도,파주시,운정3동,관내사전투표,10997,10997,8171,1986,711,76,2,10946,51,0,74.64827334186003,18.143614105609355,6.4955234788964,0.694317558925635,0.01827151470856934
99,경기도,파주시,운정3동,운정3동제1투,3505,2693,1328,1133,190,27,1,2679,14,812,49.570735349010825,42.291899962672645,7.092198581560284,1.007838745800672,0.03732736095558044
100,경기도,파주시,운정3동,운정3동제2투,3612,2869,1413,1209,205,31,1,2859,10,743,49.422875131164744,42.28751311647429,7.1703392794683465,1.0842952081147255,0.03497726477789437
101,경기도,파주시,운정3동,운정3동제3투,3484,2292,1053,1059,140,16,4,2272,20,1192,46.346830985915496,46.610915492957744,6.161971830985916,0.7042253521126761,0.17605633802816903
102,경기도,파주시,운정3동,운정3동제4투,2214,1648,804,685,117,26,0,1632,16,566,49.26470588235294,41.97303921568628,7.169117647058823,1.5931372549019607,0.0
103,경기도,파주시,운정3동,운정3동제5투,2273,1568,734,725,67,20,3,1549,19,705,47.385409941898,46.804389928986446,4.325371207230471,1.2911555842479019,0.19367333763718528
104,경기도,파주시,운정3동,운정3동제6투,1880,1439,681,646,93,10,1,1431,8,441,47.58909853249476,45.14325646401118,6.498951781970649,0.6988120195667366,0.06988120195667365
105,경기도,파주시,운정3동,운정3동제7투,1997,1356,590,686,54,16,0,1346,10,641,43.83358098068351,50.965824665676074,4.011887072808321,1.188707280832095,0.0
106,경기도,파주시,운정3동,운정3동제8투,2340,1782,962,675,110,21,1,1769,13,558,54.38100621820238,38.15715093273035,6.218202374222725,1.1871113623516112,0.05652911249293386
107,경기도,파주시,운정3동,운정3동제9투,3426,2129,989,863,231,20,4,2107,22,1297,46.93877551020408,40.95870906502136,10.96345514950166,0.9492168960607499,0.18984337921214997
108,경기도,파주시,운정3동,운정3동제10투,2144,1264,648,503,93,12,1,1257,7,880,51.551312649164686,40.01591089896579,7.398568019093078,0.9546539379474941,0.07955449482895784
109,경기도,파주시,운정3동,운정3동제11투,3198,2449,1207,1001,203,22,2,2435,14,749,49.568788501026695,41.1088295687885,8.336755646817249,0.9034907597535934,0.08213552361396304
110,경기도,파주시,운정3동,운정3동제12투,2690,1676,676,851,129,14,0,1670,6,1014,40.47904191616766,50.95808383233533,7.724550898203593,0.8383233532934131,0.0
111,경기도,파주시,운정3동,운정3동제13투,1613,1257,666,457,102,24,1,1250,7,356,53.28000000000001,36.559999999999995,8.16,1.92,0.08
112,경기도,파주시,운정3동,운정3동제14투,2763,2116,1114,819,159,18,0,2110,6,647,52.796208530805686,38.81516587677725,7.535545023696683,0.8530805687203791,0.0
113,경기도,파주시,운정4동,관내사전투표,5422,5422,4100,909,341,43,2,5395,27,0,75.99629286376273,16.84893419833179,6.320667284522706,0.7970342910101947,0.03707136237256719
114,경기도,파주시,운정4동,운정4동제1투,1258,738,305,375,41,8,0,729,9,520,41.838134430727024,51.440329218106996,5.6241426611796985,1.0973936899862824,0.0
115,경기도,파주시,운정4동,운정4동제2투,2970,1679,732,792,135,12,1,1672,7,1291,43.7799043062201,47.368421052631575,8.074162679425838,0.7177033492822966,0.05980861244019139
116,경기도,파주시,운정4동,운정4동제3투,715,460,227,189,41,1,0,458,2,255,49.56331877729257,41.26637554585153,8.951965065502183,0.21834061135371177,0.0
117,경기도,파주시,운정4동,운정4동제4투,4260,2525,1278,996,200,35,3,2512,13,1735,50.87579617834395,39.64968152866242,7.961783439490445,1.393312101910828,0.11942675159235669
118,경기도,파주시,운정4동,운정4동제5투,1522,893,411,408,61,3,5,888,5,629,46.28378378378378,45.94594594594595,6.86936936936937,0.33783783783783783,0.5630630630630631
119,경기도,파주시,운정4동,운정4동제6투,2773,1612,739,736,107,23,1,1606,6,1161,46.01494396014944,45.82814445828144,6.662515566625156,1.432129514321295,0.062266500622665005
120,경기도,파주시,운정5동,관내사전투표,7718,7718,5788,1274,543,74,3,7682,36,0,75.34496224941421,16.584222858630564,7.068471752147879,0.9632908096849779,0.03905233012236397
121,경기도,파주시,운정5동,운정5동제1투,2181,1506,768,612,97,17,2,1496,10,675,51.33689839572193,40.909090909090914,6.483957219251336,1.1363636363636365,0.1336898395721925
122,경기도,파주시,운정5동,운정5동제2투,2248,1679,775,786,95,18,1,1675,4,569,46.26865671641791,46.92537313432836,5.6716417910447765,1.0746268656716418,0.05970149253731343
123,경기도,파주시,운정5동,운정5동제3투,3347,2486,1385,898,157,36,1,2477,9,861,55.91441259588211,36.253532498990715,6.338312474767864,1.4533710133225677,0.04037141703673799
124,경기도,파주시,운정5동,운정5동제4투,2854,2150,1069,824,211,30,2,2136,14,704,50.046816479400746,38.57677902621723,9.878277153558052,1.4044943820224718,0.09363295880149813
125,경기도,파주시,운정5동,운정5동제5투,2628,1745,817,785,108,23,0,1733,12,883,47.14368147720715,45.297172533179456,6.231967686093479,1.3271783035199076,0.0
126,경기도,파주시,운정5동,운정5동제6투,3432,2359,1129,951,225,35,1,2341,18,1073,48.22725331055105,40.62366510038445,9.611277231952158,1.49508756941478,0.042716787697565144
127,경기도,파주시,운정5동,운정5동제7투,2826,2069,1174,682,175,20,2,2053,16,757,57.18460789089138,33.219678519240134,8.52411105698977,0.974184120798831,0.0974184120798831
128,경기도,파주시,운정5동,운정5동제8투,2256,1596,796,636,139,12,0,1583,13,660,50.28427037271005,40.176879343019586,8.780795957043589,0.7580543272267846,0.0
129,경기도,파주시,운정5동,운정5동제9투,2221,1650,818,704,98,19,1,1640,10,571,49.8780487804878,42.926829268292686,5.975609756097561,1.1585365853658536,0.06097560975609756
130,경기도,파주시,운정5동,운정5동제10투,2204,1555,781,592,146,22,0,1541,14,649,50.68137573004543,38.416612589227775,9.474367293964958,1.427644386761843,0.0
131,경기도,파주시,운정5동,운정5동제11투,2215,1517,763,574,161,10,2,1510,7,698,50.52980132450331,38.01324503311258,10.662251655629138,0.6622516556291391,0.13245033112582782
132,경기도,파주시,운정5동,운정5동제12투,1880,1330,682,485,146,11,1,1325,5,550,51.471698113207545,36.60377358490566,11.018867924528301,0.8301886792452831,0.07547169811320754
133,경기도,파주시,운정6동,관내사전투표,6685,6685,4868,1098,608,58,4,6636,49,0,73.35744424352019,16.54611211573237,9.16214587100663,0.8740204942736588,0.06027727546714888
134,경기도,파주시,운정6동,운정6동제1투,2957,2143,1104,778,220,23,0,2125,18,814,51.95294117647059,36.61176470588236,10.352941176470589,1.0823529411764705,0.0
135,경기도,파주시,운정6동,운정6동제2투,2895,2123,1056,804,227,18,0,2105,18,772,50.16627078384798,38.194774346793345,10.783847980997626,0.8551068883610451,0.0
136,경기도,파주시,운정6동,운정6동제3투,3033,2143,1000,937,177,16,2,2132,11,890,46.90431519699813,43.949343339587244,8.302063789868667,0.7504690431519699,0.09380863039399624
137,경기도,파주시,운정6동,운정6동제4투,3688,2729,1375,1061,239,33,5,2713,16,959,50.68190195355695,39.1079985256174,8.809436048654625,1.2163656468853667,0.18429782528566163
138,경기도,파주시,운정6동,운정6동제5투,2048,1437,713,544,156,14,1,1428,9,611,49.929971988795515,38.095238095238095,10.92436974789916,0.9803921568627451,0.0700280112044818
139,경기도,파주시,금촌1동,관내사전투표,5030,5030,3243,1350,360,34,6,4993,37,0,64.95093130382536,27.03785299419187,7.210094131784499,0.6809533346685359,0.12016823552974164
140,경기도,파주시,금촌1동,금촌1동제1투,3344,1988,732,1061,156,15,3,1967,21,1356,37.21403152008134,53.94001016776817,7.930859176410777,0.762582613116421,0.1525165226232842
141,경기도,파주시,금촌1동,금촌1동제2투,1612,853,305,484,54,4,0,847,6,759,36.00944510035419,57.14285714285714,6.375442739079102,0.47225501770956313,0.0
142,경기도,파주시,금촌1동,금촌1동제3투,2542,1487,571,813,83,12,2,1481,6,1055,38.55503038487508,54.8953409858204,5.604321404456448,0.8102633355840648,0.1350438892640108
143,경기도,파주시,금촌1동,금촌1동제4투,2746,1476,664,645,129,15,0,1453,23,1270,45.69855471438403,44.39091534755678,8.878183069511355,1.032346868547832,0.0
144,경기도,파주시,금촌1동,금촌1동제5투,3249,1981,841,1010,93,18,2,1964,17,1268,42.82077393075356,51.425661914460285,4.7352342158859475,0.9164969450101833,0.10183299389002036
145,경기도,파주시,금촌2동,관내사전투표,7737,7737,5325,1753,539,75,9,7701,36,0,69.1468640436307,22.763277496429033,6.9990910271393325,0.9738994935722634,0.11686793922867161
146,경기도,파주시,금촌2동,금촌2동제1투,3222,2120,989,922,172,20,2,2105,15,1102,46.9833729216152,43.80047505938242,8.17102137767221,0.9501187648456058,0.09501187648456057
147,경기도,파주시,금촌2동,금촌2동제2투,4334,2954,1423,1286,200,22,8,2939,15,1380,48.41782919360327,43.756379720993536,6.805035726437564,0.748553929908132,0.27220142905750255
148,경기도,파주시,금촌2동,금촌2동제3투,3431,2179,921,1109,115,18,4,2167,12,1252,42.50115366866636,51.176742039686204,5.3068758652515005,0.8306414397784956,0.18458698661744347
149,경기도,파주시,금촌2동,금촌2동제4투,2791,2040,998,848,154,22,6,2028,12,751,49.21104536489152,41.81459566074951,7.593688362919132,1.0848126232741617,0.2958579881656805
150,경기도,파주시,금촌2동,금촌2동제5투,3236,2441,1139,1031,226,25,1,2422,19,795,47.027250206440954,42.5681255161024,9.331131296449216,1.032204789430223,0.041288191577208914
151,경기도,파주시,금촌3동,관내사전투표,5062,5062,3512,1191,291,39,0,5033,29,0,69.77945559308564,23.66381879594675,5.781839856944169,0.7748857540234453,0.0
152,경기도,파주시,금촌3동,금촌3동제1투,3441,2028,873,962,143,28,3,2009,19,1413,43.45445495271279,47.88451966152314,7.117969138875062,1.3937282229965158,0.14932802389248384
153,경기도,파주시,금촌3동,금촌3동제2투,2638,1586,631,789,138,14,2,1574,12,1052,40.08894536213469,50.12706480304956,8.767471410419315,0.8894536213468869,0.12706480304955528
154,경기도,파주시,금촌3동,금촌3동제3투,2787,1888,915,802,141,20,2,1880,8,899,48.67021276595745,42.659574468085104,7.5,1.0638297872340425,0.10638297872340426
155,경기도,파주시,금촌3동,금촌3동제4투,3095,2048,976,909,123,16,4,2028,20,1047,48.12623274161736,44.82248520710059,6.06508875739645,0.7889546351084813,0.19723865877712032
156,경기도,파주시,금촌3동,금촌3동제5투,2215,1411,628,679,78,14,2,1401,10,804,44.825124910778015,48.46538187009279,5.567451820128479,0.9992862241256246,0.14275517487508924
157,경기도,파주시,잘못 투입·구분된 투표지,,0,0,0,0,0,0,0,0,0,0,0.0,0.0,0.0,0.0,0.0
0,경기도,여주시,거소·선상투표,,163,150,45,47,28,3,0,123,27,13,36.58536585365854,38.21138211382114,22.76422764227642,2.4390243902439024,0.0
1,경기도,여주시,관외사전투표,,8413,8411,4392,2857,986,78,10,8323,88,2,52.76943409828186,34.326564940526254,11.846689895470384,0.9371620809804156,0.12014898474107893
2,경기도,여주시,재외투표,,462,390,283,67,33,7,0,390,0,72,72.56410256410255,17.17948717948718,8.461538461538462,1.7948717948717947,0.0
3,경기도,여주시,가남읍,관내사전투표,2916,2916,1819,876,184,19,5,2903,13,0,62.65931794695143,30.17568033069239,6.338270754392009,0.6544953496383052,0.17223561832586978
4,경기도,여주시,가남읍,가남읍제1투,2005,1076,369,630,61,5,1,1066,10,929,34.61538461538461,59.09943714821764,5.72232645403377,0.46904315196998125,0.09380863039399624
5,경기도,여주시,가남읍,가남읍제2투,1386,909,268,596,28,6,0,898,11,477,29.84409799554566,66.36971046770601,3.11804008908686,0.6681514476614699,0.0
6,경기도,여주시,가남읍,가남읍제3투,788,529,156,342,24,0,2,524,5,259,29.770992366412212,65.2671755725191,4.580152671755725,0.0,0.38167938931297707
7,경기도,여주시,가남읍,가남읍제4투,384,258,73,170,9,3,0,255,3,126,28.627450980392155,66.66666666666666,3.5294117647058822,1.1764705882352942,0.0
8,경기도,여주시,가남읍,가남읍제5투,2413,1453,596,754,89,10,2,1451,2,960,41.075120606478286,51.96416264645073,6.133700895933838,0.6891798759476223,0.13783597518952445
9,경기도,여주시,가남읍,가남읍제6투,1676,973,374,543,46,7,0,970,3,703,38.55670103092784,55.97938144329897,4.742268041237113,0.7216494845360825,0.0
10,경기도,여주시,점동면,관내사전투표,1721,1721,967,621,98,16,0,1702,19,0,56.81551116333725,36.486486486486484,5.7579318448883665,0.9400705052878966,0.0
11,경기도,여주시,점동면,점동면제1투,1817,1153,316,782,44,3,2,1147,6,664,27.550130775937227,68.17785527462948,3.836094158674804,0.26155187445510025,0.17436791630340018
12,경기도,여주시,점동면,점동면제2투,542,386,113,264,9,0,0,386,0,156,29.274611398963728,68.39378238341969,2.33160621761658,0.0,0.0
13,경기도,여주시,점동면,점동면제3투,460,337,90,233,11,0,1,335,2,123,26.865671641791046,69.55223880597015,3.2835820895522385,0.0,0.2985074626865672
14,경기도,여주시,세종대왕면,관내사전투표,1282,1282,708,479,74,8,4,1273,9,0,55.616653574234086,37.62765121759623,5.813040062843677,0.6284367635506678,0.3142183817753339
15,경기도,여주시,세종대왕면,세종대왕면제1투,1375,838,226,573,31,5,0,835,3,537,27.065868263473053,68.62275449101797,3.7125748502994016,0.5988023952095809,0.0
16,경기도,여주시,세종대왕면,세종대왕면제2투,1363,930,256,624,27,13,2,922,8,433,27.765726681127983,67.67895878524945,2.928416485900217,1.4099783080260302,0.21691973969631237
17,경기도,여주시,세종대왕면,세종대왕면제3투,831,564,168,384,9,1,1,563,1,267,29.84014209591474,68.20603907637656,1.5985790408525755,0.17761989342806395,0.17761989342806395
18,경기도,여주시,흥천면,관내사전투표,990,990,521,403,50,11,0,985,5,0,52.89340101522843,40.91370558375635,5.0761421319796955,1.116751269035533,0.0
19,경기도,여주시,흥천면,흥천면제1투,1595,1061,303,703,47,5,0,1058,3,534,28.638941398865786,66.4461247637051,4.44234404536862,0.4725897920604915,0.0
20,경기도,여주시,흥천면,흥천면제2투,1330,916,206,669,36,4,0,915,1,414,22.51366120218579,73.11475409836066,3.934426229508197,0.4371584699453552,0.0
21,경기도,여주시,금사면,관내사전투표,759,759,362,359,29,4,1,755,4,0,47.94701986754967,47.549668874172184,3.8410596026490067,0.5298013245033113,0.13245033112582782
22,경기도,여주시,금사면,금사면제1투,1055,686,135,525,23,3,0,686,0,369,19.67930029154519,76.53061224489795,3.3527696793002915,0.43731778425655976,0.0
23,경기도,여주시,금사면,금사면제2투,629,431,99,320,8,0,0,427,4,198,23.185011709601874,74.94145199063233,1.873536299765808,0.0,0.0
24,경기도,여주시,산북면,관내사전투표,652,652,361,260,23,6,0,650,2,0,55.53846153846153,40.0,3.5384615384615383,0.9230769230769231,0.0
25,경기도,여주시,산북면,산북면투표소,1387,884,223,611,40,5,0,879,5,503,25.369738339021612,69.51080773606371,4.550625711035267,0.5688282138794084,0.0
26,경기도,여주시,대신면,관내사전투표,1409,1409,701,604,80,7,4,1396,13,0,50.214899713467055,43.26647564469914,5.730659025787966,0.501432664756447,0.28653295128939826
27,경기도,여주시,대신면,대신면제1투,1371,871,195,638,20,7,1,861,10,500,22.64808362369338,74.09988385598142,2.3228803716608595,0.8130081300813009,0.11614401858304298
28,경기도,여주시,대신면,대신면제2투,1269,831,254,538,30,2,2,826,5,438,30.750605326876514,65.13317191283294,3.631961259079903,0.24213075060532688,0.24213075060532688
29,경기도,여주시,대신면,대신면제3투,835,559,150,385,20,2,0,557,2,276,26.929982046678635,69.12028725314184,3.5906642728904847,0.3590664272890485,0.0
30,경기도,여주시,대신면,대신면제4투,579,371,101,245,17,1,2,366,5,208,27.595628415300546,66.93989071038251,4.644808743169399,0.273224043715847,0.546448087431694
31,경기도,여주시,북내면,관내사전투표,1256,1256,702,479,65,6,0,1252,4,0,56.0702875399361,38.25878594249201,5.1916932907348246,0.4792332268370607,0.0
32,경기도,여주시,북내면,북내면제1투,1642,1056,266,730,45,5,2,1048,8,586,25.38167938931298,69.65648854961832,4.293893129770993,0.4770992366412214,0.19083969465648853
33,경기도,여주시,북내면,북내면제2투,721,473,114,344,11,1,1,471,2,248,24.203821656050955,73.03609341825901,2.335456475583864,0.21231422505307856,0.21231422505307856
34,경기도,여주시,북내면,북내면제3투,351,252,63,177,6,1,1,248,4,99,25.403225806451612,71.37096774193549,2.4193548387096775,0.4032258064516129,0.4032258064516129
35,경기도,여주시,강천면,관내사전투표,1230,1230,758,388,69,11,1,1227,3,0,61.77669111654441,31.62184189079055,5.623471882640587,0.8964955175224123,0.08149959250203749
36,경기도,여주시,강천면,강천면제1투,769,490,141,318,17,10,1,487,3,279,28.952772073921974,65.29774127310061,3.4907597535934287,2.0533880903490758,0.20533880903490762
37,경기도,여주시,강천면,강천면제2투,727,479,148,316,8,1,1,474,5,248,31.223628691983123,66.66666666666666,1.6877637130801686,0.21097046413502107,0.21097046413502107
38,경기도,여주시,강천면,강천면제3투,514,309,94,177,21,6,0,298,11,205,31.543624161073826,59.395973154362416,7.046979865771812,2.013422818791946,0.0
39,경기도,여주시,강천면,강천면제4투,597,399,104,261,24,4,0,393,6,198,26.463104325699742,66.41221374045801,6.106870229007633,1.0178117048346056,0.0
40,경기도,여주시,여흥동,관내사전투표,5001,5001,2952,1617,324,57,7,4957,44,0,59.55214847690136,32.62053661488803,6.53621141819649,1.149889045793827,0.14121444422029455
41,경기도,여주시,여흥동,여흥동제1투,1485,778,240,479,49,5,1,774,4,707,31.007751937984494,61.88630490956072,6.330749354005167,0.6459948320413437,0.12919896640826875
42,경기도,여주시,여흥동,여흥동제2투,1867,1280,516,686,69,5,0,1276,4,587,40.43887147335423,53.76175548589342,5.407523510971787,0.3918495297805642,0.0
43,경기도,여주시,여흥동,여흥동제3투,1770,1076,325,685,47,12,0,1069,7,694,30.402245088868103,64.07857811038353,4.396632366697848,1.1225444340505144,0.0
44,경기도,여주시,여흥동,여흥동제4투,1535,1086,369,644,55,13,2,1083,3,449,34.07202216066482,59.46445060018467,5.078485687903971,1.2003693444136658,0.18467220683287164
45,경기도,여주시,여흥동,여흥동제5투,4015,2264,920,1162,143,22,4,2251,13,1751,40.870724122612174,51.6215015548645,6.352732119058197,0.9773434029320303,0.1776988005330964
46,경기도,여주시,여흥동,여흥동제6투,1662,1109,394,645,60,7,0,1106,3,553,35.62386980108499,58.31826401446655,5.424954792043399,0.6329113924050633,0.0
47,경기도,여주시,중앙동,관내사전투표,4669,4669,2807,1519,269,40,5,4640,29,0,60.49568965517241,32.73706896551724,5.797413793103448,0.8620689655172413,0.10775862068965517
48,경기도,여주시,중앙동,중앙동제1투,1677,926,278,594,43,7,1,923,3,751,30.119176598049833,64.35536294691224,4.658721560130011,0.7583965330444203,0.10834236186348861
49,경기도,여주시,중앙동,중앙동제2투,3370,2096,825,1119,121,17,3,2085,11,1274,39.568345323741006,53.669064748201436,5.803357314148681,0.815347721822542,0.14388489208633093
50,경기도,여주시,중앙동,중앙동제3투,3637,2461,1088,1141,184,26,4,2443,18,1176,44.535407286123615,46.70487106017192,7.531723291035612,1.0642652476463363,0.1637331150225133
51,경기도,여주시,중앙동,중앙동제4투,2124,1229,416,706,88,10,3,1223,6,895,34.01471790678659,57.72690106295993,7.195421095666394,0.8176614881439084,0.24529844644317253
52,경기도,여주시,중앙동,중앙동제5투,2658,1886,847,844,159,20,2,1872,14,772,45.245726495726494,45.085470085470085,8.493589743589745,1.0683760683760684,0.10683760683760685
53,경기도,여주시,오학동,관내사전투표,5053,5053,3230,1457,293,43,6,5029,24,0,64.2274806124478,28.971962616822427,5.826207993636906,0.8550407635712866,0.11930801352157487
54,경기도,여주시,오학동,오학동제1투,2930,1761,656,978,107,10,1,1752,9,1169,37.44292237442922,55.821917808219176,6.107305936073059,0.5707762557077625,0.05707762557077625
55,경기도,여주시,오학동,오학동제2투,2999,1779,752,887,109,18,1,1767,12,1220,42.558007923033394,50.19807583474816,6.168647425014148,1.0186757215619695,0.056593095642331635
56,경기도,여주시,오학동,오학동제3투,3285,1913,728,1025,119,26,2,1900,13,1372,38.315789473684205,53.94736842105263,6.2631578947368425,1.368421052631579,0.10526315789473684
57,경기도,여주시,잘못 투입·구분된 투표지,,0,0,0,0,0,0,0,0,0,0,0.0,0.0,0.0,0.0,0.0
0,경기도,이천시,거소·선상투표,,455,432,142,111,63,11,12,339,93,23,41.88790560471977,32.743362831858406,18.58407079646018,3.2448377581120944,3.5398230088495577
1,경기도,이천시,관외사전투표,,14828,14827,7742,4438,2288,162,20,14650,177,1,52.846416382252556,30.293515358361773,15.617747440273039,1.10580204778157,0.13651877133105803
2,경기도,이천시,재외투표,,797,639,419,133,78,7,0,637,2,158,65.77708006279434,20.87912087912088,12.244897959183673,1.098901098901099,0.0
3,경기도,이천시,장호원읍,관내사전투표,3130,3130,1823,1043,219,21,7,3113,17,0,58.560873755220044,33.504657886283326,7.035014455509154,0.6745904272406039,0.22486347574686796
4,경기도,이천시,장호원읍,장호원읍제1투,1677,1035,356,615,52,5,2,1030,5,642,34.56310679611651,59.70873786407766,5.048543689320388,0.48543689320388345,0.1941747572815534
5,경기도,이천시,장호원읍,장호원읍제2투,1406,876,298,521,42,10,1,872,4,530,34.174311926605505,59.747706422018354,4.81651376146789,1.146788990825688,0.11467889908256881
6,경기도,이천시,장호원읍,장호원읍제3투,740,490,130,340,14,1,1,486,4,250,26.74897119341564,69.95884773662551,2.880658436213992,0.205761316872428,0.205761316872428
7,경기도,이천시,장호원읍,장호원읍제4투,717,489,128,340,15,3,0,486,3,228,26.337448559670783,69.95884773662551,3.0864197530864197,0.6172839506172839,0.0
8,경기도,이천시,장호원읍,장호원읍제5투,862,560,173,336,43,2,1,555,5,302,31.17117117117117,60.54054054054055,7.747747747747748,0.36036036036036034,0.18018018018018017
9,경기도,이천시,장호원읍,장호원읍제6투,405,249,76,156,11,3,2,248,1,156,30.64516129032258,62.903225806451616,4.435483870967742,1.2096774193548387,0.8064516129032258
10,경기도,이천시,장호원읍,장호원읍제7투,2445,1563,622,818,102,13,1,1556,7,882,39.97429305912596,52.5706940874036,6.555269922879177,0.8354755784061696,0.06426735218508997
11,경기도,이천시,부발읍,관내사전투표,5628,5628,3681,1479,393,42,8,5603,25,0,65.69694806353739,26.396573264322686,7.014099589505622,0.7495984294128145,0.14278065322148847
12,경기도,이천시,부발읍,부발읍제1투,3655,2182,858,1171,113,19,7,2168,14,1473,39.57564575645757,54.012915129151295,5.212177121771218,0.8763837638376383,0.32287822878228783
13,경기도,이천시,부발읍,부발읍제2투,2391,1432,510,787,112,10,3,1422,10,959,35.86497890295359,55.34458509142054,7.876230661040788,0.7032348804500703,0.21097046413502107
14,경기도,이천시,부발읍,부발읍제3투,398,270,72,179,18,1,0,270,0,128,26.666666666666668,66.2962962962963,6.666666666666667,0.3703703703703704,0.0
15,경기도,이천시,부발읍,부발읍제4투,2566,1745,785,822,113,12,0,1732,13,821,45.32332563510393,47.45958429561201,6.524249422632794,0.6928406466512702,0.0
16,경기도,이천시,부발읍,부발읍제5투,3284,2021,841,992,140,24,3,2000,21,1263,42.05,49.6,7.000000000000001,1.2,0.15
17,경기도,이천시,부발읍,부발읍제6투,3533,2409,1115,969,288,21,3,2396,13,1124,46.53589315525877,40.4424040066778,12.020033388981636,0.8764607679465776,0.12520868113522537
18,경기도,이천시,부발읍,부발읍제7투,1150,867,346,354,154,8,1,863,4,283,40.092699884125146,41.01969872537659,17.84472769409038,0.9269988412514484,0.11587485515643105
19,경기도,이천시,부발읍,부발읍제8투,2424,1550,655,777,96,8,2,1538,12,874,42.58777633289987,50.520156046814044,6.241872561768531,0.5201560468140443,0.13003901170351106
20,경기도,이천시,부발읍,부발읍제9투,2412,1927,1150,619,142,11,0,1922,5,485,59.833506763787724,32.2060353798127,7.388137356919875,0.5723204994797086,0.0
21,경기도,이천시,신둔면,관내사전투표,3404,3404,2211,909,245,19,4,3388,16,0,65.25974025974025,26.82998819362456,7.231404958677685,0.5608028335301062,0.11806375442739078
22,경기도,이천시,신둔면,신둔면제1투,2848,1710,639,944,96,18,1,1698,12,1138,37.63250883392226,55.59481743227326,5.6537102473498235,1.0600706713780919,0.058892815076560655
23,경기도,이천시,신둔면,신둔면제2투,3378,2267,844,1277,124,9,3,2257,10,1111,37.39477182100133,56.579530350022154,5.494018608772707,0.39875941515285773,0.1329198050509526
24,경기도,이천시,신둔면,신둔면제3투,1811,1215,409,721,69,7,1,1207,8,596,33.88566694283347,59.734879867439936,5.716652858326429,0.579950289975145,0.08285004142502071
25,경기도,이천시,백사면,관내사전투표,2220,2220,1410,679,101,17,1,2208,12,0,63.858695652173914,30.7518115942029,4.574275362318841,0.7699275362318841,0.04528985507246377
26,경기도,이천시,백사면,백사면제1투,2915,1825,585,1115,96,16,2,1814,11,1090,32.24917309812569,61.46637265711136,5.2921719955898565,0.8820286659316428,0.11025358324145534
27,경기도,이천시,백사면,백사면제2투,4292,2762,1141,1407,165,19,6,2738,24,1530,41.672753834916,51.38787436084733,6.026296566837107,0.6939371804236669,0.2191380569758948
28,경기도,이천시,호법면,관내사전투표,1681,1681,976,593,98,6,0,1673,8,0,58.338314405260014,35.44530783024507,5.857740585774058,0.35863717872086076,0.0
29,경기도,이천시,호법면,호법면제1투,2535,1511,455,962,70,13,2,1502,9,1024,30.29294274300932,64.0479360852197,4.660452729693742,0.8655126498002662,0.13315579227696406
30,경기도,이천시,호법면,호법면제2투,808,570,135,400,24,1,2,562,8,238,24.02135231316726,71.17437722419929,4.270462633451958,0.1779359430604982,0.3558718861209964
31,경기도,이천시,마장면,관내사전투표,4222,4222,2514,1209,418,39,6,4186,36,0,60.05733397037745,28.88198757763975,9.985666507405638,0.9316770186335404,0.1433349259436216
32,경기도,이천시,마장면,마장면제1투,3864,2405,783,1361,218,16,3,2381,24,1459,32.88534229315413,57.16085678286434,9.155816883662327,0.6719865602687947,0.125997480050399
33,경기도,이천시,마장면,마장면제2투,3163,1936,721,1021,157,24,1,1924,12,1227,37.474012474012476,53.066528066528065,8.160083160083161,1.2474012474012475,0.05197505197505198
34,경기도,이천시,마장면,마장면제3투,1321,810,232,520,45,7,0,804,6,511,28.855721393034827,64.6766169154229,5.597014925373134,0.8706467661691543,0.0
35,경기도,이천시,대월면,관내사전투표,4539,4539,2682,1172,627,23,5,4509,30,0,59.48103792415169,25.992459525393656,13.905522288755822,0.5100909292526059,0.11088933244621868
36,경기도,이천시,대월면,대월면제1투,2204,1343,513,745,69,10,1,1338,5,861,38.34080717488789,55.68011958146487,5.15695067264574,0.7473841554559043,0.07473841554559044
37,경기도,이천시,대월면,대월면제2투,788,508,133,352,15,3,1,504,4,280,26.38888888888889,69.84126984126983,2.976190476190476,0.5952380952380952,0.1984126984126984
38,경기도,이천시,대월면,대월면제3투,3911,2401,1022,1064,277,19,4,2386,15,1510,42.83319362950545,44.59346186085499,11.609388097233865,0.7963118189438391,0.16764459346186086
39,경기도,이천시,대월면,대월면제4투,1840,1063,480,441,122,9,1,1053,10,777,45.58404558404558,41.88034188034188,11.585944919278253,0.8547008547008548,0.0949667616334283
40,경기도,이천시,모가면,관내사전투표,1511,1511,823,550,110,13,1,1497,14,0,54.97661990647963,36.74014696058784,7.348029392117568,0.8684034736138945,0.06680026720106881
41,경기도,이천시,모가면,모가면제1투,1530,970,235,669,53,5,3,965,5,560,24.352331606217618,69.32642487046633,5.492227979274611,0.5181347150259068,0.31088082901554404
42,경기도,이천시,모가면,모가면제2투,1017,654,151,482,13,0,0,646,8,363,23.374613003095977,74.61300309597523,2.0123839009287927,0.0,0.0
43,경기도,이천시,설성면,관내사전투표,893,893,433,391,54,6,0,884,9,0,48.98190045248869,44.230769230769226,6.108597285067873,0.6787330316742082,0.0
44,경기도,이천시,설성면,설성면제1투,967,624,151,443,20,6,2,622,2,343,24.27652733118971,71.22186495176848,3.215434083601286,0.964630225080386,0.3215434083601286
45,경기도,이천시,설성면,설성면제2투,703,480,111,333,21,4,1,470,10,223,23.617021276595747,70.85106382978724,4.468085106382979,0.851063829787234,0.2127659574468085
46,경기도,이천시,설성면,설성면제3투,998,627,174,415,29,5,1,624,3,371,27.884615384615387,66.50641025641025,4.647435897435898,0.8012820512820512,0.16025641025641024
47,경기도,이천시,율면,관내사전투표,851,851,471,315,49,8,1,844,7,0,55.805687203791464,37.322274881516584,5.80568720379147,0.9478672985781991,0.11848341232227488
48,경기도,이천시,율면,율면투표소,1427,863,241,585,23,8,2,859,4,564,28.055878928987195,68.10244470314319,2.6775320139697323,0.9313154831199069,0.23282887077997672
49,경기도,이천시,창전동,관내사전투표,4854,4854,2924,1416,435,45,7,4827,27,0,60.57592707685934,29.334990677439404,9.01180857675575,0.9322560596643878,0.145017609281127
50,경기도,이천시,창전동,창전동제1투,2555,1498,501,851,124,9,3,1488,10,1057,33.66935483870967,57.19086021505376,8.333333333333332,0.6048387096774194,0.20161290322580644
51,경기도,이천시,창전동,창전동제2투,1972,1146,387,685,61,7,3,1143,3,826,33.85826771653544,59.93000874890638,5.336832895888014,0.6124234470691163,0.26246719160104987
52,경기도,이천시,창전동,창전동제3투,1701,891,253,551,62,12,2,880,11,810,28.749999999999996,62.61363636363636,7.045454545454545,1.3636363636363635,0.22727272727272727
53,경기도,이천시,창전동,창전동제4투,1849,1171,421,643,86,8,3,1161,10,678,36.261843238587424,55.3832902670112,7.4074074074074066,0.6890611541774333,0.2583979328165375
54,경기도,이천시,창전동,창전동제5투,1760,1096,385,611,85,7,4,1092,4,664,35.256410256410255,55.952380952380956,7.783882783882784,0.641025641025641,0.3663003663003663
55,경기도,이천시,증포동,관내사전투표,8411,8411,5697,2053,548,69,4,8371,40,0,68.05638513917096,24.525146338549757,6.546410225779477,0.8242742802532553,0.047784016246565524
56,경기도,이천시,증포동,증포동제1투,2982,1938,775,922,204,15,6,1922,16,1044,40.32258064516129,47.97086368366285,10.61394380853278,0.7804370447450572,0.31217481789802287
57,경기도,이천시,증포동,증포동제2투,2271,1412,551,757,80,10,3,1401,11,859,39.32905067808708,54.032833690221274,5.710206995003569,0.7137758743754461,0.21413276231263384
58,경기도,이천시,증포동,증포동제3투,3080,1956,866,880,178,14,1,1939,17,1124,44.66219700876741,45.38421866941722,9.179989685404848,0.7220216606498195,0.0515729757607014
59,경기도,이천시,증포동,증포동제4투,1943,1277,608,561,84,12,3,1268,9,666,47.94952681388013,44.2429022082019,6.624605678233439,0.9463722397476341,0.23659305993690852
60,경기도,이천시,증포동,증포동제5투,3590,2427,1066,1070,236,29,3,2404,23,1163,44.34276206322795,44.509151414309486,9.816971713810316,1.2063227953410982,0.12479201331114809
61,경기도,이천시,증포동,증포동제6투,2245,1549,596,822,106,12,1,1537,12,696,38.77683799609629,53.4808067664281,6.896551724137931,0.7807417046193884,0.06506180871828238
62,경기도,이천시,증포동,증포동제7투,3584,2454,1204,1041,169,27,2,2443,11,1130,49.28366762177651,42.61154318460908,6.9177241097011875,1.1051985264019648,0.08186655751125665
63,경기도,이천시,증포동,증포동제8투,3588,2382,1141,1010,200,22,2,2375,7,1206,48.0421052631579,42.526315789473685,8.421052631578947,0.9263157894736843,0.08421052631578947
64,경기도,이천시,증포동,증포동제9투,2817,2073,1004,869,162,24,2,2061,12,744,48.71421639980592,42.16399805919457,7.860262008733625,1.1644832605531297,0.09704027171276079
65,경기도,이천시,증포동,증포동제10투,2238,1622,745,714,135,16,1,1611,11,616,46.244568590937305,44.320297951582866,8.379888268156424,0.9931719428926132,0.06207324643078833
66,경기도,이천시,중리동,관내사전투표,4475,4475,2407,1570,422,33,2,4434,41,0,54.2850699142986,35.40820929183581,9.517365809652684,0.7442489851150204,0.04510599909788002
67,경기도,이천시,중리동,중리동제1투,1610,895,259,564,60,7,1,891,4,715,29.068462401795735,63.2996632996633,6.7340067340067336,0.7856341189674524,0.11223344556677892
68,경기도,이천시,중리동,중리동제2투,2483,1456,454,861,117,13,0,1445,11,1027,31.418685121107266,59.58477508650519,8.09688581314879,0.8996539792387545,0.0
69,경기도,이천시,중리동,중리동제3투,2502,1628,409,1010,195,8,0,1622,6,874,25.21578298397041,62.26880394574599,12.022194821208384,0.4932182490752158,0.0
70,경기도,이천시,중리동,중리동제4투,2243,1468,449,905,101,5,2,1462,6,775,30.71135430916553,61.90150478796169,6.908344733242135,0.3419972640218878,0.13679890560875513
71,경기도,이천시,관고동,관내사전투표,3652,3652,2226,1116,255,26,6,3629,23,0,61.33921190410582,30.75227335354092,7.026729126481124,0.7164508128961147,0.16533480297602646
72,경기도,이천시,관고동,관고동제1투,2620,1642,609,889,119,14,2,1633,9,978,37.293325168401715,54.439681567666874,7.287201469687692,0.8573178199632578,0.1224739742804654
73,경기도,이천시,관고동,관고동제2투,1758,1089,328,682,64,5,1,1080,9,669,30.37037037037037,63.14814814814815,5.9259259259259265,0.4629629629629629,0.0925925925925926
74,경기도,이천시,관고동,관고동제3투,2008,1074,385,601,80,2,1,1069,5,934,36.014967259120674,56.22076707202993,7.483629560336763,0.18709073900841908,0.09354536950420954
75,경기도,이천시,잘못 투입·구분된 투표지,,0,0,0,0,0,0,0,0,0,0,0.0,0.0,0.0,0.0,0.0
0,경기도,용인시처인구,거소·선상투표,,432,419,184,123,98,3,3,411,8,13,44.76885644768856,29.927007299270077,23.844282238442823,0.7299270072992701,0.7299270072992701
1,경기도,용인시처인구,관외사전투표,,23416,23415,13821,6193,2951,221,31,23217,198,1,59.5296549941853,26.674419606322953,12.710513847611665,0.9518887022440452,0.13352284963604255
2,경기도,용인시처인구,재외투표,,1171,981,638,219,96,19,0,972,9,190,65.63786008230453,22.530864197530864,9.876543209876543,1.954732510288066,0.0
3,경기도,용인시처인구,포곡읍,관내사전투표,6864,6864,4728,1513,531,43,10,6825,39,0,69.27472527472528,22.168498168498168,7.78021978021978,0.63003663003663,0.14652014652014653
4,경기도,용인시처인구,포곡읍,포곡읍제1투,2455,1398,557,720,92,17,2,1388,10,1057,40.12968299711815,51.873198847262245,6.628242074927954,1.2247838616714697,0.1440922190201729
5,경기도,용인시처인구,포곡읍,포곡읍제2투,1268,918,400,449,56,5,3,913,5,350,43.81161007667031,49.17853231106243,6.133625410733845,0.547645125958379,0.32858707557502737
6,경기도,용인시처인구,포곡읍,포곡읍제3투,1674,1128,413,616,79,10,1,1119,9,546,36.907953529937444,55.0491510277033,7.059874888293119,0.8936550491510277,0.08936550491510277
7,경기도,용인시처인구,포곡읍,포곡읍제4투,3600,2265,1019,1020,184,17,3,2243,22,1335,45.430227374052606,45.47481052162283,8.203299152920195,0.7579135086937138,0.13374944271065536
8,경기도,용인시처인구,포곡읍,포곡읍제5투,576,393,83,297,12,1,0,393,0,183,21.119592875318066,75.57251908396947,3.0534351145038165,0.2544529262086514,0.0
9,경기도,용인시처인구,포곡읍,포곡읍제6투,2793,1797,834,776,153,18,3,1784,13,996,46.74887892376682,43.49775784753363,8.576233183856502,1.0089686098654709,0.1681614349775785
10,경기도,용인시처인구,포곡읍,포곡읍제7투,3260,1953,962,849,113,17,2,1943,10,1307,49.51106536284097,43.69531652084406,5.815748841996912,0.8749356664951106,0.1029336078229542
11,경기도,용인시처인구,포곡읍,포곡읍제8투,3204,2322,1089,967,218,22,6,2302,20,882,47.30668983492615,42.00695047784535,9.47002606429192,0.9556907037358819,0.26064291920069504
12,경기도,용인시처인구,모현읍,관내사전투표,4889,4889,3298,1214,323,29,2,4866,23,0,67.7764077270859,24.948623099054664,6.63789560213728,0.5959720509658858,0.04110152075626798
13,경기도,용인시처인구,모현읍,모현읍제1투,2907,1858,857,833,145,11,2,1848,10,1049,46.374458874458874,45.07575757575758,7.846320346320345,0.5952380952380952,0.10822510822510822
14,경기도,용인시처인구,모현읍,모현읍제2투,1594,1013,319,636,46,6,0,1007,6,581,31.678252234359483,63.1578947368421,4.568023833167826,0.5958291956305859,0.0
15,경기도,용인시처인구,모현읍,모현읍제3투,3048,2060,935,976,119,21,2,2053,7,988,45.54310764734535,47.54018509498295,5.796395518753044,1.0228933268387725,0.0974184120798831
16,경기도,용인시처인구,모현읍,모현읍제4투,2475,1524,561,850,89,13,1,1514,10,951,37.05416116248349,56.14266842800528,5.878467635402906,0.8586525759577279,0.06605019815059446
17,경기도,용인시처인구,모현읍,모현읍제5투,2288,1402,567,700,122,6,1,1396,6,886,40.61604584527221,50.1432664756447,8.739255014326648,0.42979942693409745,0.07163323782234957
18,경기도,용인시처인구,모현읍,모현읍제6투,2683,1713,752,836,96,16,1,1701,12,970,44.2092886537331,49.14756025867137,5.64373897707231,0.940623162845385,0.058788947677836566
19,경기도,용인시처인구,모현읍,모현읍제7투,4019,3065,1501,1218,314,17,2,3052,13,954,49.180865006553084,39.908256880733944,10.288335517693316,0.5570117955439057,0.0655307994757536
20,경기도,용인시처인구,이동읍,관내사전투표,3694,3694,2472,945,228,31,1,3677,17,0,67.22871906445472,25.700299156921403,6.200707098177862,0.8430785966820777,0.027196083763937992
21,경기도,용인시처인구,이동읍,이동읍제1투,2601,1639,639,882,88,15,4,1628,11,962,39.250614250614255,54.17690417690417,5.405405405405405,0.9213759213759214,0.2457002457002457
22,경기도,용인시처인구,이동읍,이동읍제2투,555,363,89,257,11,2,0,359,4,192,24.79108635097493,71.58774373259052,3.064066852367688,0.5571030640668524,0.0
23,경기도,용인시처인구,이동읍,이동읍제3투,832,537,151,350,23,7,1,532,5,295,28.383458646616543,65.78947368421053,4.323308270676692,1.3157894736842104,0.18796992481203006
24,경기도,용인시처인구,이동읍,이동읍제4투,3982,2437,978,1270,154,11,3,2416,21,1545,40.480132450331126,52.56622516556292,6.3741721854304645,0.4552980132450331,0.12417218543046359
25,경기도,용인시처인구,이동읍,이동읍제5투,3780,2290,1047,1062,148,12,2,2271,19,1490,46.10303830911493,46.76354029062087,6.516952884191986,0.5284015852047557,0.08806693086745927
26,경기도,용인시처인구,남사읍,관내사전투표,2603,2603,1697,731,147,14,0,2589,14,0,65.54654306682116,28.234839706450366,5.677867902665121,0.5407493240633449,0.0
27,경기도,용인시처인구,남사읍,남사읍제1투,1067,671,167,465,31,5,1,669,2,396,24.962630792227205,69.50672645739911,4.633781763826607,0.7473841554559043,0.14947683109118087
28,경기도,용인시처인구,남사읍,남사읍제2투,591,389,115,251,19,1,0,386,3,202,29.792746113989637,65.02590673575129,4.922279792746114,0.2590673575129534,0.0
29,경기도,용인시처인구,남사읍,남사읍제3투,1004,719,237,446,27,2,2,714,5,285,33.193277310924366,62.46498599439776,3.7815126050420167,0.2801120448179272,0.2801120448179272
30,경기도,용인시처인구,남사읍,남사읍제4투,918,600,171,397,28,3,0,599,1,318,28.547579298831387,66.2771285475793,4.674457429048414,0.5008347245409015,0.0
31,경기도,용인시처인구,남사읍,남사읍제5투,3759,2721,1356,1168,164,22,0,2710,11,1038,50.03690036900369,43.09963099630996,6.051660516605166,0.8118081180811807,0.0
32,경기도,용인시처인구,남사읍,남사읍제6투,3214,2419,1106,1095,188,18,3,2410,9,795,45.892116182572614,45.43568464730291,7.800829875518672,0.7468879668049793,0.12448132780082986
33,경기도,용인시처인구,남사읍,남사읍제7투,2659,2104,1089,846,146,12,2,2095,9,555,51.98090692124106,40.381861575178995,6.968973747016706,0.5727923627684964,0.0954653937947494
34,경기도,용인시처인구,원삼면,관내사전투표,1941,1941,1137,650,118,11,2,1918,23,0,59.28050052137643,33.889468196037534,6.152241918665276,0.5735140771637122,0.10427528675703858
35,경기도,용인시처인구,원삼면,원삼면제1투,1353,808,171,607,24,3,0,805,3,545,21.242236024844722,75.40372670807454,2.981366459627329,0.37267080745341613,0.0
36,경기도,용인시처인구,원삼면,원삼면제2투,980,647,163,455,23,4,1,646,1,333,25.232198142414862,70.43343653250774,3.560371517027864,0.6191950464396285,0.15479876160990713
37,경기도,용인시처인구,원삼면,원삼면제3투,1567,1032,335,638,42,9,0,1024,8,535,32.71484375,62.3046875,4.1015625,0.87890625,0.0
38,경기도,용인시처인구,원삼면,원삼면제4투,608,362,89,265,3,3,0,360,2,246,24.72222222222222,73.61111111111111,0.8333333333333334,0.8333333333333334,0.0
39,경기도,용인시처인구,백암면,관내사전투표,2353,2353,1306,840,168,16,1,2331,22,0,56.027456027456026,36.03603603603604,7.207207207207207,0.6864006864006864,0.0429000429000429
40,경기도,용인시처인구,백암면,백암면제1투,1200,710,187,480,31,3,2,703,7,490,26.600284495021338,68.27880512091038,4.409672830725462,0.42674253200568996,0.2844950213371266
41,경기도,용인시처인구,백암면,백암면제2투,722,485,136,323,23,2,1,485,0,237,28.04123711340206,66.59793814432989,4.742268041237113,0.4123711340206186,0.2061855670103093
42,경기도,용인시처인구,백암면,백암면제3투,819,511,137,337,30,3,0,507,4,308,27.021696252465482,66.46942800788955,5.9171597633136095,0.591715976331361,0.0
43,경기도,용인시처인구,백암면,백암면제4투,1106,621,193,381,31,9,1,615,6,485,31.382113821138212,61.951219512195124,5.040650406504065,1.4634146341463417,0.16260162601626016
44,경기도,용인시처인구,백암면,백암면제5투,1025,601,221,339,32,3,1,596,5,424,37.080536912751676,56.87919463087249,5.369127516778524,0.5033557046979865,0.16778523489932887
45,경기도,용인시처인구,양지면,관내사전투표,4485,4485,2837,1265,299,38,5,4444,41,0,63.83888388838884,28.465346534653463,6.728172817281728,0.8550855085508551,0.11251125112511251
46,경기도,용인시처인구,양지면,양지면제1투,3507,2064,752,1115,163,22,1,2053,11,1443,36.62932294203605,54.31076473453482,7.9396005845104725,1.071602532878714,0.04870920603994155
47,경기도,용인시처인구,양지면,양지면제2투,2535,1622,562,946,96,10,0,1614,8,913,34.820322180916975,58.61214374225526,5.947955390334572,0.6195786864931847,0.0
48,경기도,용인시처인구,양지면,양지면제3투,1546,1067,372,615,64,5,2,1058,9,479,35.16068052930057,58.12854442344045,6.049149338374291,0.4725897920604915,0.1890359168241966
49,경기도,용인시처인구,양지면,양지면제4투,2359,1284,534,629,102,7,2,1274,10,1075,41.915227629513346,49.37205651491366,8.006279434850864,0.5494505494505495,0.15698587127158556
50,경기도,용인시처인구,양지면,양지면제5투,1730,1046,492,458,83,9,1,1043,3,684,47.171620325982744,43.9117929050815,7.957813998082454,0.862895493767977,0.09587727708533077
51,경기도,용인시처인구,중앙동,관내사전투표,6246,6246,3793,1832,529,43,11,6208,38,0,61.0985824742268,29.510309278350515,8.521262886597938,0.6926546391752577,0.17719072164948454
52,경기도,용인시처인구,중앙동,중앙동제1투,3215,2040,792,1029,179,15,5,2020,20,1175,39.20792079207921,50.94059405940594,8.861386138613861,0.7425742574257426,0.24752475247524752
53,경기도,용인시처인구,중앙동,중앙동제2투,1744,1187,515,493,151,14,1,1174,13,557,43.86712095400341,41.993185689948895,12.862010221465075,1.192504258943782,0.08517887563884156
54,경기도,용인시처인구,중앙동,중앙동제3투,2293,1509,530,856,97,17,2,1502,7,784,35.28628495339547,56.99067909454061,6.458055925432757,1.1318242343541944,0.13315579227696406
55,경기도,용인시처인구,중앙동,중앙동제4투,1667,1047,417,528,84,8,3,1040,7,620,40.09615384615385,50.76923076923077,8.076923076923077,0.7692307692307693,0.2884615384615385
56,경기도,용인시처인구,중앙동,중앙동제5투,4514,2635,896,1447,248,16,4,2611,24,1879,34.316353887399465,55.41937954806587,9.49827652240521,0.6127920337035618,0.15319800842589046
57,경기도,용인시처인구,중앙동,중앙동제6투,2344,1719,680,889,123,13,3,1708,11,625,39.812646370023415,52.04918032786885,7.201405152224824,0.7611241217798594,0.1756440281030445
58,경기도,용인시처인구,역북동,관내사전투표,8509,8509,5303,2049,1010,77,7,8446,63,0,62.787118162443754,24.26000473596969,11.958323466729812,0.9116741652853422,0.08287946957139473
59,경기도,용인시처인구,역북동,역북동제1투,1784,1065,379,524,139,12,2,1056,9,719,35.890151515151516,49.621212121212125,13.162878787878787,1.1363636363636365,0.1893939393939394
60,경기도,용인시처인구,역북동,역북동제2투,3922,2492,1130,1137,182,21,3,2473,19,1430,45.693489688637285,45.9765467044076,7.359482410028306,0.8491710473109584,0.1213101496158512
61,경기도,용인시처인구,역북동,역북동제3투,4726,2990,1124,1529,283,35,5,2976,14,1736,37.76881720430107,51.377688172043015,9.509408602150538,1.1760752688172043,0.16801075268817203
62,경기도,용인시처인구,역북동,역북동제4투,2623,1636,549,841,218,16,1,1625,11,987,33.784615384615385,51.75384615384615,13.415384615384616,0.9846153846153847,0.06153846153846154
63,경기도,용인시처인구,역북동,역북동제5투,2550,1943,932,795,193,11,3,1934,9,607,48.19027921406411,41.10651499482937,9.979317476732161,0.5687693898655636,0.15511892450879006
64,경기도,용인시처인구,역북동,역북동제6투,2590,1902,831,841,200,12,5,1889,13,688,43.9915299100053,44.52091053467443,10.587612493382743,0.6352567496029645,0.2646903123345686
65,경기도,용인시처인구,삼가동,관내사전투표,2244,2244,1467,567,163,25,4,2226,18,0,65.90296495956873,25.471698113207548,7.322551662174304,1.1230907457322552,0.17969451931716085
66,경기도,용인시처인구,삼가동,삼가동제1투,2277,1627,611,857,138,13,1,1620,7,650,37.71604938271605,52.901234567901234,8.518518518518519,0.8024691358024691,0.06172839506172839
67,경기도,용인시처인구,삼가동,삼가동제2투,2649,1929,773,985,134,23,1,1916,13,720,40.34446764091858,51.40918580375783,6.993736951983298,1.2004175365344467,0.052192066805845504
68,경기도,용인시처인구,삼가동,삼가동제3투,2229,1665,747,728,163,16,1,1655,10,564,45.13595166163142,43.987915407854985,9.848942598187312,0.9667673716012084,0.060422960725075525
69,경기도,용인시처인구,유림동,관내사전투표,6684,6684,4711,1411,474,54,2,6652,32,0,70.82080577269994,21.211665664461815,7.125676488274204,0.8117859290438966,0.03006614552014432
70,경기도,용인시처인구,유림동,유림동제1투,1926,1011,369,559,68,11,0,1007,4,915,36.64349553128103,55.51142005958292,6.752730883813307,1.0923535253227408,0.0
71,경기도,용인시처인구,유림동,유림동제2투,2960,2037,953,899,147,18,2,2019,18,923,47.201584943041105,44.526993561168894,7.280832095096583,0.8915304606240713,0.09905894006934125
72,경기도,용인시처인구,유림동,유림동제3투,4301,2908,1378,1238,235,31,9,2891,17,1393,47.66516776202006,42.82255274991352,8.128675198893117,1.0722933241093047,0.3113109650639917
73,경기도,용인시처인구,유림동,유림동제4투,3692,2188,1021,932,191,18,5,2167,21,1504,47.115828334102446,43.00876788186433,8.814028610982925,0.8306414397784956,0.23073373327180433
74,경기도,용인시처인구,유림동,유림동제5투,4113,3094,1605,1131,306,25,4,3071,23,1019,52.263106479973956,36.82839465971996,9.964181048518398,0.81406707912732,0.1302507326603712
75,경기도,용인시처인구,유림동,유림동제6투,3173,2196,1097,887,168,34,3,2189,7,977,50.114207400639565,40.5207857469164,7.67473732297853,1.5532206486980358,0.13704888076747374
76,경기도,용인시처인구,유림동,유림동제7투,5296,3929,2028,1427,417,33,4,3909,20,1367,51.88027628549501,36.505500127909954,10.667689946277822,0.844205679201842,0.10232796111537479
77,경기도,용인시처인구,유림동,유림동제8투,1760,1111,489,536,68,9,1,1103,8,649,44.3336355394379,48.5947416137806,6.165004533091569,0.8159564823209429,0.09066183136899365
78,경기도,용인시처인구,유림동,유림동제9투,2388,1711,836,692,155,12,3,1698,13,677,49.23439340400471,40.753828032979975,9.128386336866901,0.7067137809187279,0.17667844522968199
79,경기도,용인시처인구,동부동,관내사전투표,3465,3465,2164,1004,247,25,2,3442,23,0,62.87042417199302,29.169087739686226,7.176060429982568,0.7263219058686811,0.058105752469494475
80,경기도,용인시처인구,동부동,동부동제1투,2811,1715,614,946,135,8,6,1709,6,1096,35.927442949093034,55.3540081919251,7.899356348741954,0.4681100058513751,0.3510825043885313
81,경기도,용인시처인구,동부동,동부동제2투,3349,2116,789,1108,166,20,8,2091,25,1233,37.73314203730273,52.98900047824008,7.938785270205644,0.9564801530368245,0.38259206121472983
82,경기도,용인시처인구,동부동,동부동제3투,1259,880,291,525,41,11,2,870,10,379,33.44827586206897,60.3448275862069,4.712643678160919,1.264367816091954,0.22988505747126436
83,경기도,용인시처인구,잘못 투입·구분된 투표지,,0,3,2,1,0,0,0,3,0,-3,66.66666666666666,33.33333333333333,0.0,0.0,0.0
0,경기도,용인시수지구,거소·선상투표,,318,301,95,133,62,2,1,293,8,17,32.42320819112628,45.39249146757679,21.160409556313994,0.6825938566552902,0.3412969283276451
1,경기도,용인시수지구,관외사전투표,,35212,35203,20850,8639,5028,374,30,34921,282,9,59.7061939806993,24.73869591363363,14.39821310959022,1.0709888032988746,0.08590819277798459
2,경기도,용인시수지구,재외투표,,4030,3319,2222,738,301,41,1,3303,16,711,67.27217680896155,22.3433242506812,9.112927641537997,1.241295791704511,0.030275507114744173
3,경기도,용인시수지구,풍덕천1동,관내사전투표,7655,7655,4986,1824,726,61,4,7601,54,0,65.59663202210236,23.996842520720957,9.55137481910275,0.8025259834232338,0.05262465465070386
4,경기도,용인시수지구,풍덕천1동,풍덕천1동제1투,3238,1988,635,970,339,25,1,1970,18,1250,32.233502538071065,49.23857868020304,17.20812182741117,1.2690355329949239,0.050761421319796954
5,경기도,용인시수지구,풍덕천1동,풍덕천1동제2투,2239,1517,492,832,171,8,2,1505,12,722,32.691029900332225,55.28239202657807,11.362126245847175,0.53156146179402,0.132890365448505
6,경기도,용인시수지구,풍덕천1동,풍덕천1동제3투,2117,1608,696,710,171,23,0,1600,8,509,43.5,44.375,10.6875,1.4375,0.0
7,경기도,용인시수지구,풍덕천1동,풍덕천1동제4투,2567,1996,775,989,198,16,1,1979,17,571,39.16119252147549,49.974734714502276,10.005053057099547,0.808489135927236,0.05053057099545225
8,경기도,용인시수지구,풍덕천1동,풍덕천1동제5투,2284,1749,651,867,194,22,3,1737,12,535,37.47841105354059,49.91364421416235,11.16868163500288,1.266551525618883,0.17271157167530224
9,경기도,용인시수지구,풍덕천1동,풍덕천1동제6투,2755,2159,650,1324,153,21,2,2150,9,596,30.23255813953488,61.58139534883721,7.116279069767442,0.9767441860465116,0.09302325581395349
10,경기도,용인시수지구,풍덕천1동,풍덕천1동제7투,2363,1863,741,915,176,18,0,1850,13,500,40.054054054054056,49.45945945945946,9.513513513513514,0.9729729729729729,0.0
11,경기도,용인시수지구,풍덕천1동,풍덕천1동제8투,1746,1408,572,662,142,19,1,1396,12,338,40.97421203438395,47.421203438395416,10.17191977077364,1.361031518624642,0.07163323782234957
12,경기도,용인시수지구,풍덕천2동,관내사전투표,7624,7624,5172,1602,730,74,2,7580,44,0,68.23218997361478,21.13456464379947,9.630606860158311,0.9762532981530342,0.02638522427440633
13,경기도,용인시수지구,풍덕천2동,풍덕천2동제1투,2033,1628,702,741,152,20,1,1616,12,405,43.44059405940594,45.853960396039604,9.405940594059405,1.2376237623762376,0.06188118811881188
14,경기도,용인시수지구,풍덕천2동,풍덕천2동제2투,2269,1531,499,796,200,18,1,1514,17,738,32.95904887714663,52.57595772787318,13.210039630118892,1.1889035667107,0.06605019815059446
15,경기도,용인시수지구,풍덕천2동,풍덕천2동제3투,2572,2069,837,987,215,21,0,2060,9,503,40.631067961165044,47.9126213592233,10.436893203883495,1.0194174757281553,0.0
16,경기도,용인시수지구,풍덕천2동,풍덕천2동제4투,2167,1502,564,681,227,14,1,1487,15,665,37.92871553463349,45.79690652320107,15.265635507733691,0.941492938802959,0.06724949562878278
17,경기도,용인시수지구,풍덕천2동,풍덕천2동제5투,2413,1912,715,902,264,14,3,1898,14,501,37.67123287671233,47.52370916754479,13.909378292939936,0.7376185458377239,0.15806111696522657
18,경기도,용인시수지구,풍덕천2동,풍덕천2동제6투,2476,2061,998,832,199,19,0,2048,13,415,48.73046875,40.625,9.716796875,0.927734375,0.0
19,경기도,용인시수지구,풍덕천2동,풍덕천2동제7투,1889,1494,651,687,137,7,0,1482,12,395,43.92712550607287,46.35627530364373,9.244264507422402,0.47233468286099867,0.0
20,경기도,용인시수지구,풍덕천2동,풍덕천2동제8투,3275,2569,963,1379,195,19,1,2557,12,706,37.661321861556516,53.93038717246773,7.626124364489637,0.7430582714118107,0.03910833007430582
21,경기도,용인시수지구,풍덕천2동,풍덕천2동제9투,2379,1926,953,750,195,19,0,1917,9,453,49.713093375065206,39.123630672926446,10.172143974960877,0.99113197704747,0.0
22,경기도,용인시수지구,신봉동,관내사전투표,6877,6877,4657,1664,465,55,1,6842,35,0,68.06489330605086,24.320374159602455,6.796258403975446,0.8038585209003215,0.014615609470914937
23,경기도,용인시수지구,신봉동,신봉동제1투,1556,1200,460,574,141,15,2,1192,8,356,38.59060402684564,48.15436241610738,11.828859060402683,1.2583892617449663,0.16778523489932887
24,경기도,용인시수지구,신봉동,신봉동제2투,2103,1628,660,805,144,9,4,1622,6,475,40.6905055487053,49.63008631319359,8.877928483353884,0.5548705302096177,0.2466091245376079
25,경기도,용인시수지구,신봉동,신봉동제3투,3519,2767,1068,1433,220,27,3,2751,16,752,38.82224645583424,52.09014903671392,7.9970919665576155,0.9814612868047983,0.10905125408942204
26,경기도,용인시수지구,신봉동,신봉동제4투,2924,2209,746,1266,163,13,3,2191,18,715,34.04837973528069,57.7818347786399,7.439525330899133,0.5933363760839799,0.13692377909630307
27,경기도,용인시수지구,신봉동,신봉동제5투,4069,2971,954,1755,219,29,3,2960,11,1098,32.229729729729726,59.29054054054054,7.398648648648648,0.9797297297297298,0.10135135135135136
28,경기도,용인시수지구,신봉동,신봉동제6투,4538,3480,1362,1791,279,27,4,3463,17,1058,39.330060641062666,51.718163442102224,8.056598325151603,0.7796708056598325,0.11550678602367889
29,경기도,용인시수지구,신봉동,신봉동제7투,4305,3243,1064,1921,214,27,1,3227,16,1062,32.97180043383948,59.528974279516575,6.631546327858692,0.8366904245429191,0.030988534242330338
30,경기도,용인시수지구,죽전1동,관내사전투표,6870,6870,4550,1699,534,52,6,6841,29,0,66.51074404326853,24.835550358134775,7.805876333869318,0.760122789065926,0.08770647566145301
31,경기도,용인시수지구,죽전1동,죽전1동제1투,3498,2586,793,1552,190,38,0,2573,13,912,30.82005441119316,60.31869413136417,7.384376214535561,1.4768752429071124,0.0
32,경기도,용인시수지구,죽전1동,죽전1동제2투,2967,2251,938,1113,167,17,1,2236,15,716,41.94991055456171,49.77638640429338,7.468694096601074,0.7602862254025045,0.044722719141323794
33,경기도,용인시수지구,죽전1동,죽전1동제3투,2924,2206,799,1175,186,35,1,2196,10,718,36.38433515482696,53.506375227686696,8.469945355191257,1.5938069216757742,0.04553734061930783
34,경기도,용인시수지구,죽전1동,죽전1동제4투,3129,2309,820,1279,181,15,1,2296,13,820,35.714285714285715,55.70557491289199,7.883275261324043,0.6533101045296167,0.04355400696864112
35,경기도,용인시수지구,죽전1동,죽전1동제5투,2827,2070,848,1006,186,19,3,2062,8,757,41.1251212415131,48.78758486905917,9.020368574199807,0.921435499515034,0.1454898157129001
36,경기도,용인시수지구,죽전2동,관내사전투표,2400,2400,1518,567,265,30,3,2383,17,0,63.70121695342006,23.79353755770038,11.12043642467478,1.258917331095258,0.1258917331095258
37,경기도,용인시수지구,죽전2동,죽전2동제1투,2948,2111,748,1079,244,20,3,2094,17,837,35.72110792741165,51.52817574021012,11.652340019102196,0.9551098376313276,0.14326647564469913
38,경기도,용인시수지구,죽전2동,죽전2동제2투,2467,1831,635,968,198,19,1,1821,10,636,34.87095002745744,53.157605711147724,10.873146622734762,1.043382756727073,0.054914881933003847
39,경기도,용인시수지구,죽전2동,죽전2동제3투,2378,1856,686,966,183,15,1,1851,5,522,37.06104808211778,52.188006482982175,9.886547811993516,0.8103727714748784,0.05402485143165856
40,경기도,용인시수지구,죽전2동,죽전2동제4투,2311,1836,750,848,206,15,2,1821,15,475,41.18616144975288,46.56781987918726,11.312465678198793,0.8237232289950577,0.10982976386600769
41,경기도,용인시수지구,죽전3동,관내사전투표,3513,3513,2316,824,322,34,0,3496,17,0,66.2471395881007,23.569794050343248,9.210526315789473,0.9725400457665904,0.0
42,경기도,용인시수지구,죽전3동,죽전3동제1투,2581,1735,594,918,186,17,2,1717,18,846,34.595224228305185,53.46534653465347,10.83284799068142,0.9900990099009901,0.11648223645894001
43,경기도,용인시수지구,죽전3동,죽전3동제2투,2484,1840,631,1025,163,12,2,1833,7,644,34.42444080741953,55.91925804691762,8.89252591380251,0.6546644844517185,0.10911074740861974
44,경기도,용인시수지구,죽전3동,죽전3동제3투,2954,2239,946,1096,169,21,0,2232,7,715,42.38351254480286,49.10394265232975,7.571684587813621,0.9408602150537635,0.0
45,경기도,용인시수지구,죽전3동,죽전3동제4투,2898,2210,874,1130,186,10,0,2200,10,688,39.72727272727273,51.36363636363637,8.454545454545455,0.45454545454545453,0.0
46,경기도,용인시수지구,죽전3동,죽전3동제5투,2962,2164,812,1050,259,25,5,2151,13,798,37.749883774988376,48.81450488145049,12.04091120409112,1.1622501162250116,0.23245002324500233
47,경기도,용인시수지구,동천동,관내사전투표,9161,9161,6027,2214,784,90,10,9125,36,0,66.04931506849316,24.263013698630136,8.591780821917808,0.9863013698630136,0.1095890410958904
48,경기도,용인시수지구,동천동,동천동제1투,3236,2232,749,1159,286,25,0,2219,13,1004,33.753943217665615,52.23073456511942,12.888688598467779,1.1266336187471835,0.0
49,경기도,용인시수지구,동천동,동천동제2투,2372,1775,569,1041,133,22,0,1765,10,597,32.23796033994334,58.980169971671394,7.5354107648725215,1.246458923512748,0.0
50,경기도,용인시수지구,동천동,동천동제3투,2720,2173,840,1113,188,20,1,2162,11,547,38.85291396854764,51.48011100832562,8.695652173913043,0.9250693802035153,0.04625346901017577
51,경기도,용인시수지구,동천동,동천동제4투,2617,1923,791,874,212,27,4,1908,15,694,41.457023060796644,45.80712788259958,11.11111111111111,1.4150943396226416,0.20964360587002098
52,경기도,용인시수지구,동천동,동천동제5투,2369,1780,650,1001,96,24,1,1772,8,589,36.681715575620764,56.48984198645598,5.417607223476298,1.3544018058690745,0.0564334085778781
53,경기도,용인시수지구,동천동,동천동제6투,2406,1821,602,1055,136,18,0,1811,10,585,33.24130314743236,58.25510767531751,7.5096631695196026,0.9939260077305356,0.0
54,경기도,용인시수지구,동천동,동천동제7투,3319,2443,877,1360,170,25,1,2433,10,876,36.04603370324702,55.89806822852446,6.987258528565557,1.0275380189066996,0.04110152075626798
55,경기도,용인시수지구,동천동,동천동제8투,3261,2587,852,1493,201,22,1,2569,18,674,33.16465550797976,58.11599844297392,7.824056052938887,0.8563643441027637,0.038925652004671074
56,경기도,용인시수지구,동천동,동천동제9투,2075,1655,637,864,127,17,0,1645,10,420,38.72340425531915,52.52279635258359,7.720364741641338,1.033434650455927,0.0
57,경기도,용인시수지구,동천동,동천동제10투,2057,1635,737,741,127,17,3,1625,10,422,45.353846153846156,45.6,7.815384615384616,1.0461538461538462,0.1846153846153846
58,경기도,용인시수지구,상현1동,관내사전투표,3667,3667,2513,845,272,26,0,3656,11,0,68.7363238512035,23.112691466083152,7.439824945295405,0.7111597374179431,0.0
59,경기도,용인시수지구,상현1동,상현1동제1투,2688,2043,652,1195,159,24,2,2032,11,645,32.08661417322835,58.80905511811023,7.824803149606299,1.1811023622047243,0.09842519685039369
60,경기도,용인시수지구,상현1동,상현1동제2투,2868,2222,871,1068,247,20,1,2207,15,646,39.46533756230177,48.39148164929769,11.191662890801995,0.9062075215224286,0.045310376076121435
61,경기도,용인시수지구,상현1동,상현1동제3투,2696,2165,906,1028,196,21,1,2152,13,531,42.100371747211895,47.76951672862453,9.107806691449815,0.9758364312267658,0.046468401486988845
62,경기도,용인시수지구,상현1동,상현1동제4투,2548,1846,615,1066,146,11,0,1838,8,702,33.46028291621327,57.99782372143635,7.94341675734494,0.5984766050054406,0.0
63,경기도,용인시수지구,상현2동,관내사전투표,6927,6927,4582,1705,553,55,0,6895,32,0,66.45395213923133,24.72806381435823,8.020304568527918,0.7976794778825236,0.0
64,경기도,용인시수지구,상현2동,상현2동제1투,2784,2000,694,1107,175,15,0,1991,9,784,34.856855851330984,55.60020090406831,8.789552988448015,0.7533902561526872,0.0
65,경기도,용인시수지구,상현2동,상현2동제2투,2705,2069,718,1179,137,20,2,2056,13,636,34.92217898832685,57.34435797665369,6.663424124513619,0.9727626459143969,0.09727626459143969
66,경기도,용인시수지구,상현2동,상현2동제3투,2658,1886,661,1025,173,18,1,1878,8,772,35.19701810436634,54.57933972310969,9.211927582534612,0.9584664536741214,0.05324813631522897
67,경기도,용인시수지구,상현2동,상현2동제4투,3329,2557,1020,1303,196,18,3,2540,17,772,40.15748031496063,51.29921259842519,7.716535433070866,0.7086614173228346,0.11811023622047244
68,경기도,용인시수지구,상현2동,상현2동제5투,2615,2061,774,1090,170,15,0,2049,12,554,37.774524158125914,53.196681307955096,8.296730112249879,0.7320644216691069,0.0
69,경기도,용인시수지구,상현2동,상현2동제6투,2971,2391,1001,1152,201,20,0,2374,17,580,42.16512215669756,48.5256950294861,8.466722830665544,0.8424599831508003,0.0
70,경기도,용인시수지구,상현3동,관내사전투표,5404,5404,3589,1210,518,53,4,5374,30,0,66.78451804986975,22.51581689616673,9.63900260513584,0.9862299962783774,0.07443245254931151
71,경기도,용인시수지구,상현3동,상현3동제1투,1974,1479,512,809,137,13,0,1471,8,495,34.80625424881033,54.99660095173351,9.313392250169953,0.8837525492861998,0.0
72,경기도,용인시수지구,상현3동,상현3동제2투,3051,2385,763,1403,190,20,2,2378,7,666,32.08578637510513,58.999158957106815,7.9899074852817495,0.8410428931875525,0.08410428931875526
73,경기도,용인시수지구,상현3동,상현3동제3투,1973,1555,542,859,128,19,1,1549,6,418,34.990316333118145,55.45513234344739,8.26339573918657,1.2265978050355069,0.06455777921239508
74,경기도,용인시수지구,상현3동,상현3동제4투,2795,1947,710,861,313,33,3,1920,27,848,36.97916666666667,44.84375,16.302083333333332,1.7187500000000002,0.15625
75,경기도,용인시수지구,상현3동,상현3동제5투,2062,1469,595,745,110,13,0,1463,6,593,40.66985645933015,50.922761449077235,7.518796992481203,0.888585099111415,0.0
76,경기도,용인시수지구,상현3동,상현3동제6투,2126,1698,698,789,177,21,0,1685,13,428,41.424332344213646,46.824925816023736,10.504451038575667,1.2462908011869436,0.0
77,경기도,용인시수지구,성복동,관내사전투표,7153,7153,4515,2104,450,48,6,7123,30,0,63.38621367401376,29.538115962375404,6.3175628246525335,0.673873367962937,0.08423417099536712
78,경기도,용인시수지구,성복동,성복동제1투,2904,2293,602,1500,161,12,0,2275,18,611,26.461538461538463,65.93406593406593,7.076923076923077,0.5274725274725275,0.0
79,경기도,용인시수지구,성복동,성복동제2투,3302,2644,642,1801,171,19,1,2634,10,658,24.373576309794988,68.37509491268034,6.492027334851937,0.721336370539104,0.037965072133637055
80,경기도,용인시수지구,성복동,성복동제3투,2220,1578,305,1171,86,8,0,1570,8,642,19.426751592356688,74.58598726114649,5.477707006369427,0.5095541401273885,0.0
81,경기도,용인시수지구,성복동,성복동제4투,1594,1180,371,706,91,7,0,1175,5,414,31.574468085106382,60.08510638297872,7.74468085106383,0.5957446808510638,0.0
82,경기도,용인시수지구,성복동,성복동제5투,2394,1792,360,1334,85,7,0,1786,6,602,20.156774916013436,74.69204927211646,4.759238521836506,0.3919372900335946,0.0
83,경기도,용인시수지구,성복동,성복동제6투,3472,2617,773,1633,185,13,0,2604,13,855,29.685099846390166,62.71121351766513,7.104454685099847,0.49923195084485406,0.0
84,경기도,용인시수지구,성복동,성복동제7투,2898,2241,722,1303,186,17,1,2229,12,657,32.391206819201436,58.45670704351728,8.344549125168237,0.762673844773441,0.04486316733961417
85,경기도,용인시수지구,성복동,성복동제8투,3394,2193,608,1422,138,17,2,2187,6,1201,27.80064014631916,65.02057613168725,6.310013717421124,0.7773205304069501,0.09144947416552354
86,경기도,용인시수지구,성복동,성복동제9투,4479,3617,1516,1711,340,35,2,3604,13,862,42.06437291897892,47.47502774694784,9.433962264150944,0.9711431742508323,0.05549389567147614
87,경기도,용인시수지구,성복동,성복동제10투,2096,1565,385,1050,110,9,1,1555,10,531,24.758842443729904,67.52411575562701,7.07395498392283,0.5787781350482315,0.06430868167202572
88,경기도,용인시수지구,성복동,성복동제11투,2749,2277,939,1109,203,13,2,2266,11,472,41.438658428949694,48.94086496028244,8.958517210944397,0.5736981465136806,0.088261253309797
89,경기도,용인시수지구,잘못 투입·구분된 투표지,,0,0,0,0,0,0,0,0,0,0,0.0,0.0,0.0,0.0,0.0
0,경기도,용인시기흥구,거소·선상투표,,467,442,174,152,93,3,1,423,19,25,41.13475177304964,35.9338061465721,21.98581560283688,0.7092198581560284,0.2364066193853428
1,경기도,용인시기흥구,관외사전투표,,42479,42477,25337,10505,5854,421,28,42145,332,2,60.11863803535413,24.925851227903667,13.890141179262072,0.9989322576818128,0.06643729979831534
2,경기도,용인시기흥구,재외투표,,3451,2927,1983,608,276,43,0,2910,17,524,68.14432989690722,20.893470790378007,9.484536082474227,1.4776632302405497,0.0
3,경기도,용인시기흥구,신갈동,관내사전투표,7591,7591,4919,1883,674,64,9,7549,42,0,65.16094846999603,24.943701152470528,8.928334878791892,0.84779440985561,0.11922108888594515
4,경기도,용인시기흥구,신갈동,신갈동제1투,2466,1415,517,726,149,8,2,1402,13,1051,36.875891583452216,51.78316690442225,10.627674750356633,0.5706134094151213,0.14265335235378032
5,경기도,용인시기흥구,신갈동,신갈동제2투,1979,1308,505,669,116,11,1,1302,6,671,38.78648233486943,51.382488479262676,8.90937019969278,0.8448540706605223,0.07680491551459294
6,경기도,용인시기흥구,신갈동,신갈동제3투,2061,1363,533,692,120,8,1,1354,9,698,39.364844903988185,51.10782865583457,8.862629246676514,0.5908419497784343,0.07385524372230429
7,경기도,용인시기흥구,신갈동,신갈동제4투,2520,1896,903,789,172,21,3,1888,8,624,47.82838983050847,41.79025423728814,9.110169491525424,1.1122881355932204,0.15889830508474578
8,경기도,용인시기흥구,신갈동,신갈동제5투,2570,1970,769,1016,160,19,1,1965,5,600,39.13486005089059,51.70483460559796,8.142493638676845,0.9669211195928753,0.05089058524173028
9,경기도,용인시기흥구,신갈동,신갈동제6투,2184,1800,906,694,168,15,1,1784,16,384,50.784753363228695,38.90134529147982,9.417040358744394,0.8408071748878924,0.05605381165919283
10,경기도,용인시기흥구,신갈동,신갈동제7투,3354,2559,1116,1184,208,28,0,2536,23,795,44.00630914826498,46.68769716088328,8.201892744479496,1.1041009463722398,0.0
11,경기도,용인시기흥구,신갈동,신갈동제8투,2281,1878,920,806,127,10,2,1865,13,403,49.32975871313673,43.2171581769437,6.809651474530831,0.5361930294906166,0.10723860589812334
12,경기도,용인시기흥구,신갈동,신갈동제9투,2595,2036,874,883,249,16,0,2022,14,559,43.224530168150345,43.669634025717116,12.314540059347182,0.791295746785361,0.0
13,경기도,용인시기흥구,영덕1동,관내사전투표,6157,6156,4272,1294,510,47,2,6125,31,1,69.7469387755102,21.1265306122449,8.326530612244898,0.7673469387755102,0.0326530612244898
14,경기도,용인시기흥구,영덕1동,영덕1동제1투,4515,3193,1129,1710,295,25,2,3161,32,1322,35.71654539702626,54.09680480860487,9.332489718443531,0.7908889591901298,0.06327111673521038
15,경기도,용인시기흥구,영덕1동,영덕1동제2투,2129,1678,716,795,138,19,1,1669,9,451,42.89994008388256,47.633313361294185,8.268424206111444,1.1384062312762133,0.05991611743559017
16,경기도,용인시기흥구,영덕1동,영덕1동제3투,2934,2248,987,1014,213,20,1,2235,13,686,44.16107382550336,45.369127516778526,9.53020134228188,0.8948545861297539,0.0447427293064877
17,경기도,용인시기흥구,영덕1동,영덕1동제4투,2881,1906,771,966,126,26,1,1890,16,975,40.79365079365079,51.11111111111111,6.666666666666667,1.3756613756613756,0.052910052910052914
18,경기도,용인시기흥구,영덕1동,영덕1동제5투,2875,2071,878,928,225,19,4,2054,17,804,42.745861733203505,45.18013631937682,10.954235637779941,0.9250243427458618,0.19474196689386564
19,경기도,용인시기흥구,영덕1동,영덕1동제6투,2398,1557,543,804,184,16,1,1548,9,841,35.077519379844965,51.93798449612403,11.886304909560723,1.03359173126615,0.06459948320413438
20,경기도,용인시기흥구,영덕2동,관내사전투표,3436,3436,2358,730,307,20,4,3419,17,0,68.9675343667739,21.351272301842645,8.979233694062591,0.584966364434045,0.11699327288680901
21,경기도,용인시기흥구,영덕2동,영덕2동제1투,3286,2304,844,1288,142,19,0,2293,11,982,36.80767553423463,56.17095508068033,6.192760575665067,0.8286088094199738,0.0
22,경기도,용인시기흥구,영덕2동,영덕2동제2투,3555,2448,961,1173,266,19,1,2420,28,1107,39.710743801652896,48.47107438016529,10.991735537190083,0.7851239669421488,0.04132231404958678
23,경기도,용인시기흥구,영덕2동,영덕2동제3투,3679,2908,1304,1297,261,32,2,2896,12,771,45.027624309392266,44.78591160220994,9.012430939226519,1.1049723756906076,0.06906077348066297
24,경기도,용인시기흥구,구갈동,관내사전투표,5569,5568,3781,1153,559,45,5,5543,25,1,68.21215948042575,20.801010283240124,10.084791629081725,0.8118347465271514,0.09020386072523903
25,경기도,용인시기흥구,구갈동,구갈동제1투,2477,1393,459,716,192,9,2,1378,15,1084,33.30914368650218,51.959361393323654,13.933236574746008,0.6531204644412192,0.14513788098693758
26,경기도,용인시기흥구,구갈동,구갈동제2투,2286,1557,626,707,190,22,0,1545,12,729,40.517799352750814,45.760517799352755,12.297734627831716,1.423948220064725,0.0
27,경기도,용인시기흥구,구갈동,구갈동제3투,3819,2658,1099,1245,279,20,2,2645,13,1161,41.550094517958414,47.06994328922495,10.54820415879017,0.7561436672967864,0.07561436672967864
28,경기도,용인시기흥구,구갈동,구갈동제4투,2160,1726,752,808,141,16,1,1718,8,434,43.77182770663563,47.0314318975553,8.20721769499418,0.9313154831199069,0.05820721769499418
29,경기도,용인시기흥구,구갈동,구갈동제5투,2444,1788,645,904,201,21,2,1773,15,656,36.37901861252115,50.98702763677383,11.336717428087987,1.1844331641285957,0.1128031584884377
30,경기도,용인시기흥구,구갈동,구갈동제6투,1339,1062,499,456,82,11,2,1050,12,277,47.523809523809526,43.42857142857143,7.809523809523809,1.0476190476190477,0.19047619047619047
31,경기도,용인시기흥구,구갈동,구갈동제7투,1513,1126,459,543,105,12,1,1120,6,387,40.982142857142854,48.482142857142854,9.375,1.0714285714285714,0.08928571428571429
32,경기도,용인시기흥구,구갈동,구갈동제8투,3661,2875,1221,1269,340,24,1,2855,20,786,42.76707530647986,44.448336252189144,11.908931698774081,0.8406304728546411,0.03502626970227671
33,경기도,용인시기흥구,구갈동,구갈동제9투,3418,2672,1166,1190,272,22,1,2651,21,746,43.983402489626556,44.88872123726895,10.26027913994719,0.8298755186721992,0.03772161448509996
34,경기도,용인시기흥구,상갈동,관내사전투표,3548,3548,2384,801,313,24,2,3524,24,0,67.65039727582293,22.729852440408628,8.88195232690125,0.681044267877412,0.056753688989784334
35,경기도,용인시기흥구,상갈동,상갈동제1투,2333,1464,571,717,144,18,2,1452,12,869,39.32506887052342,49.3801652892562,9.917355371900827,1.2396694214876034,0.13774104683195593
36,경기도,용인시기흥구,상갈동,상갈동제2투,2304,1528,620,690,176,26,1,1513,15,776,40.97818902842036,45.60475875743556,11.63251817580965,1.7184401850627893,0.06609385327164573
37,경기도,용인시기흥구,상갈동,상갈동제3투,2167,1699,727,820,129,12,3,1691,8,468,42.992312241277354,48.49201655824956,7.6286221170904795,0.7096392667060911,0.17740981667652278
38,경기도,용인시기흥구,보라동,관내사전투표,6314,6314,4542,1266,437,48,3,6296,18,0,72.141041931385,20.108005082592122,6.940914866581957,0.7623888182973316,0.04764930114358323
39,경기도,용인시기흥구,보라동,보라동제1투,1910,1248,523,582,115,15,3,1238,10,662,42.24555735056543,47.011308562197094,9.289176090468496,1.2116316639741518,0.24232633279483037
40,경기도,용인시기흥구,보라동,보라동제2투,1763,1329,561,651,96,10,3,1321,8,434,42.46782740348221,49.28084784254353,7.267221801665405,0.757002271006813,0.22710068130204392
41,경기도,용인시기흥구,보라동,보라동제3투,2864,2223,892,1161,141,16,2,2212,11,641,40.3254972875226,52.48643761301989,6.374321880650995,0.7233273056057866,0.09041591320072333
42,경기도,용인시기흥구,보라동,보라동제4투,3200,2405,1097,1112,155,22,2,2388,17,795,45.938023450586265,46.56616415410385,6.490787269681741,0.9212730318257957,0.08375209380234507
43,경기도,용인시기흥구,보라동,보라동제5투,2992,1938,803,955,143,19,2,1922,16,1054,41.77939646201873,49.687825182101975,7.440166493236212,0.9885535900104058,0.10405827263267431
44,경기도,용인시기흥구,보라동,보라동제6투,3065,2263,1088,960,184,21,1,2254,9,802,48.26974267968057,42.59094942324756,8.16326530612245,0.9316770186335404,0.044365572315882874
45,경기도,용인시기흥구,보라동,보라동제7투,2601,1936,809,1000,98,21,1,1929,7,665,41.93882840850181,51.840331778123385,5.080352514256091,1.088646967340591,0.05184033177812338
46,경기도,용인시기흥구,기흥동,관내사전투표,3089,3089,2075,792,193,14,3,3077,12,0,67.43581410464739,25.7393565160871,6.272343191420214,0.45498862528436784,0.09749756256093597
47,경기도,용인시기흥구,기흥동,기흥동제1투,2227,1438,487,839,87,14,0,1427,11,789,34.12754029432376,58.79467414155572,6.0967063770147165,0.9810791871058164,0.0
48,경기도,용인시기흥구,기흥동,기흥동제2투,2144,1460,648,690,96,13,1,1448,12,684,44.751381215469614,47.651933701657455,6.629834254143646,0.8977900552486188,0.06906077348066297
49,경기도,용인시기흥구,기흥동,기흥동제3투,744,457,111,315,25,2,0,453,4,287,24.503311258278146,69.5364238410596,5.518763796909492,0.44150110375275936,0.0
50,경기도,용인시기흥구,기흥동,기흥동제4투,3449,2068,780,1096,163,16,2,2057,11,1381,37.91929995138552,53.28147788040836,7.92416140009723,0.7778317938745746,0.09722897423432182
51,경기도,용인시기흥구,기흥동,기흥동제5투,3422,2438,798,1453,159,12,2,2424,14,984,32.92079207920792,59.942244224422446,6.5594059405940595,0.49504950495049505,0.08250825082508251
52,경기도,용인시기흥구,서농동,관내사전투표,4716,4716,3148,1032,461,37,5,4683,33,0,67.22186632500534,22.037155669442665,9.84411701900491,0.790091821481956,0.10676916506512919
53,경기도,용인시기흥구,서농동,서농동제1투,832,559,73,307,170,5,0,555,4,273,13.153153153153152,55.31531531531532,30.630630630630627,0.9009009009009009,0.0
54,경기도,용인시기흥구,서농동,서농동제2투,2697,2162,834,1070,222,20,1,2147,15,535,38.84489986027015,49.83698183511877,10.340009315323707,0.9315323707498836,0.04657661853749418
55,경기도,용인시기흥구,서농동,서농동제3투,2803,2030,671,1022,299,20,2,2014,16,773,33.316782522343594,50.74478649453823,14.846077457795431,0.9930486593843099,0.09930486593843098
56,경기도,용인시기흥구,서농동,서농동제4투,2027,1261,441,693,109,8,6,1257,4,766,35.08353221957041,55.131264916467785,8.671439936356403,0.6364359586316627,0.47732696897374705
57,경기도,용인시기흥구,서농동,서농동제5투,2672,2140,1049,845,201,26,2,2123,17,532,49.411210551106926,39.802166745171924,9.467734338200659,1.2246820536975978,0.09420631182289213
58,경기도,용인시기흥구,서농동,서농동제6투,1789,1425,645,614,138,17,0,1414,11,364,45.61527581329561,43.42291371994342,9.759547383309759,1.2022630834512023,0.0
59,경기도,용인시기흥구,구성동,관내사전투표,7524,7524,4938,1966,528,54,1,7487,37,0,65.95432082275946,26.25884867102978,7.052223854681448,0.7212501669560571,0.013356484573260316
60,경기도,용인시기흥구,구성동,구성동제1투,3640,2539,703,1609,196,15,2,2525,14,1101,27.841584158415845,63.722772277227726,7.762376237623762,0.594059405940594,0.07920792079207921
61,경기도,용인시기흥구,구성동,구성동제2투,2807,2094,576,1380,118,12,0,2086,8,713,27.612655800575265,66.15532118887823,5.656759348034516,0.5752636625119847,0.0
62,경기도,용인시기흥구,구성동,구성동제3투,2883,2095,735,1191,149,10,0,2085,10,788,35.25179856115108,57.122302158273385,7.146282973621103,0.4796163069544364,0.0
63,경기도,용인시기흥구,구성동,구성동제4투,2825,2276,792,1308,150,15,1,2266,10,549,34.95145631067961,57.72285966460724,6.619593998234776,0.6619593998234775,0.0441306266548985
64,경기도,용인시기흥구,구성동,구성동제5투,1663,1356,650,614,78,9,1,1352,4,307,48.07692307692308,45.41420118343195,5.769230769230769,0.6656804733727811,0.07396449704142012
65,경기도,용인시기흥구,구성동,구성동제6투,3220,2233,1018,1009,176,21,2,2226,7,987,45.73225516621743,45.32794249775382,7.9065588499550765,0.9433962264150944,0.08984725965858043
66,경기도,용인시기흥구,구성동,구성동제7투,2933,2100,896,1065,109,15,1,2086,14,833,42.95302013422819,51.054650047938644,5.225311601150527,0.7190795781399808,0.047938638542665384
67,경기도,용인시기흥구,구성동,구성동제8투,2460,1738,735,863,106,22,2,1728,10,722,42.53472222222222,49.942129629629626,6.1342592592592595,1.2731481481481481,0.11574074074074073
68,경기도,용인시기흥구,마북동,관내사전투표,5127,5127,3365,1341,356,43,2,5107,20,0,65.88995496377521,26.25807714901116,6.970824358723321,0.8419815938907381,0.039161934599569216
69,경기도,용인시기흥구,마북동,마북동제1투,2847,1896,578,1151,146,13,0,1888,8,951,30.614406779661017,60.96398305084746,7.733050847457627,0.6885593220338982,0.0
70,경기도,용인시기흥구,마북동,마북동제2투,2566,1885,495,1255,120,10,0,1880,5,681,26.329787234042552,66.75531914893617,6.382978723404255,0.5319148936170213,0.0
71,경기도,용인시기흥구,마북동,마북동제3투,4202,3180,1216,1603,312,29,0,3160,20,1022,38.48101265822785,50.72784810126583,9.873417721518987,0.9177215189873418,0.0
72,경기도,용인시기흥구,마북동,마북동제4투,2536,2025,663,1199,139,14,1,2016,9,511,32.88690476190476,59.47420634920635,6.894841269841271,0.6944444444444444,0.0496031746031746
73,경기도,용인시기흥구,마북동,마북동제5투,2535,1921,783,946,163,15,0,1907,14,614,41.05925537493445,49.60671211326691,8.54745673833246,0.7865757734661771,0.0
74,경기도,용인시기흥구,마북동,마북동제6투,1903,1470,451,919,78,15,1,1464,6,433,30.806010928961747,62.77322404371585,5.327868852459016,1.0245901639344261,0.06830601092896176
75,경기도,용인시기흥구,마북동,마북동제7투,2779,2000,725,1136,114,13,3,1991,9,779,36.413862380713205,57.05675539929683,5.725765946760422,0.6529382219989954,0.15067805123053743
76,경기도,용인시기흥구,동백1동,관내사전투표,5348,5348,4014,905,350,49,3,5321,27,0,75.43694794211613,17.008081187746665,6.577710956587107,0.9208795339221951,0.05638037962788949
77,경기도,용인시기흥구,동백1동,동백1동제1투,3175,2407,1309,890,174,20,0,2393,14,768,54.70121186794819,37.19180944421229,7.271207689093188,0.8357709987463435,0.0
78,경기도,용인시기흥구,동백1동,동백1동제2투,2645,1923,813,979,112,7,1,1912,11,722,42.52092050209205,51.20292887029289,5.857740585774058,0.36610878661087864,0.05230125523012552
79,경기도,용인시기흥구,동백1동,동백1동제3투,2668,1998,964,895,112,14,2,1987,11,670,48.51534977352793,45.04277805737292,5.636638147961751,0.7045797684952189,0.10065425264217413
80,경기도,용인시기흥구,동백1동,동백1동제4투,2615,1918,910,853,121,16,3,1903,15,697,47.81923279033106,44.82396216500263,6.358381502890173,0.8407777193904361,0.1576458223857068
81,경기도,용인시기흥구,동백1동,동백1동제5투,2979,2167,1050,874,212,17,0,2153,14,812,48.76915931258709,40.59451927542963,9.846725499303298,0.7895959126799814,0.0
82,경기도,용인시기흥구,동백1동,동백1동제6투,2044,1561,759,658,116,14,3,1550,11,483,48.96774193548387,42.45161290322581,7.483870967741936,0.903225806451613,0.1935483870967742
83,경기도,용인시기흥구,동백2동,관내사전투표,7134,7132,5063,1444,527,63,6,7103,29,2,71.27974095452626,20.32943826552161,7.41940025341405,0.8869491764043361,0.0844713501337463
84,경기도,용인시기흥구,동백2동,동백2동제1투,2543,1954,843,934,154,9,1,1941,13,589,43.431221020092735,48.11952601751675,7.934054611025244,0.46367851622874806,0.05151983513652757
85,경기도,용인시기흥구,동백2동,동백2동제2투,3891,2713,1076,1368,218,31,1,2694,19,1178,39.940608760207866,50.779510022271715,8.092056421677803,1.1507052709725316,0.03711952487008166
86,경기도,용인시기흥구,동백2동,동백2동제3투,1746,1334,638,572,110,7,2,1329,5,412,48.006019563581646,43.03987960872836,8.276899924755456,0.5267118133935289,0.15048908954100826
87,경기도,용인시기흥구,동백2동,동백2동제4투,1932,1418,624,666,106,15,0,1411,7,514,44.2239546420978,47.20056697377746,7.5124025513819985,1.0630758327427356,0.0
88,경기도,용인시기흥구,동백2동,동백2동제5투,3195,2331,1064,1081,154,20,1,2320,11,864,45.86206896551724,46.5948275862069,6.637931034482758,0.8620689655172413,0.04310344827586207
89,경기도,용인시기흥구,동백3동,관내사전투표,4233,4233,2986,867,338,23,1,4215,18,0,70.84223013048636,20.569395017793592,8.018979833926453,0.5456702253855279,0.02372479240806643
90,경기도,용인시기흥구,동백3동,동백3동제1투,3419,2537,1148,1156,203,17,4,2528,9,882,45.41139240506329,45.72784810126582,8.030063291139241,0.6724683544303798,0.15822784810126583
91,경기도,용인시기흥구,동백3동,동백3동제2투,2836,2168,906,1073,164,18,2,2163,5,668,41.88626907073509,49.60702727693019,7.582061950993991,0.8321775312066574,0.09246417013407304
92,경기도,용인시기흥구,동백3동,동백3동제3투,4050,2850,1182,1402,238,13,1,2836,14,1200,41.6784203102962,49.4358251057828,8.392101551480959,0.4583921015514809,0.03526093088857546
93,경기도,용인시기흥구,동백3동,동백3동제4투,1964,1620,235,1345,24,4,0,1608,12,344,14.614427860696516,83.64427860696517,1.4925373134328357,0.24875621890547264,0.0
94,경기도,용인시기흥구,동백3동,동백3동제5투,1602,1199,528,552,101,12,0,1193,6,403,44.25817267393127,46.2699077954736,8.466051969823972,1.0058675607711651,0.0
95,경기도,용인시기흥구,상하동,관내사전투표,4117,4117,2789,1001,262,37,5,4094,23,0,68.12408402540304,24.450415241817293,6.3996091841719585,0.9037616023448949,0.12212994626282364
96,경기도,용인시기흥구,상하동,상하동제1투,3350,2231,848,1163,185,20,3,2219,12,1119,38.21541234790446,52.41099594411898,8.337088778729157,0.9013068949977467,0.135196034249662
97,경기도,용인시기흥구,상하동,상하동제2투,3023,2193,909,1084,171,11,2,2177,16,830,41.75470831419384,49.79329352319706,7.854846118511713,0.5052824988516307,0.09186954524575103
98,경기도,용인시기흥구,상하동,상하동제3투,2449,1858,822,881,128,16,1,1848,10,591,44.48051948051948,47.67316017316017,6.926406926406926,0.8658008658008658,0.05411255411255411
99,경기도,용인시기흥구,상하동,상하동제4투,2587,1768,716,906,119,9,1,1751,17,819,40.89091947458595,51.74186179326099,6.796116504854369,0.5139920045688178,0.05711022272986865
100,경기도,용인시기흥구,상하동,상하동제5투,1931,1495,643,730,97,15,1,1486,9,436,43.270524899057875,49.12516823687753,6.527590847913863,1.0094212651413188,0.06729475100942127
101,경기도,용인시기흥구,보정동,관내사전투표,5569,5569,3563,1426,507,46,2,5544,25,0,64.26767676767676,25.721500721500725,9.145021645021645,0.8297258297258298,0.03607503607503607
102,경기도,용인시기흥구,보정동,보정동제1투,3906,2562,856,1421,243,27,1,2548,14,1344,33.594976452119305,55.769230769230774,9.536891679748823,1.0596546310832025,0.03924646781789639
103,경기도,용인시기흥구,보정동,보정동제2투,3572,2726,709,1828,159,15,1,2712,14,846,26.14306784660767,67.40412979351032,5.8628318584070795,0.5530973451327433,0.03687315634218289
104,경기도,용인시기흥구,보정동,보정동제3투,3800,2891,950,1653,249,25,0,2877,14,909,33.02050747306222,57.45568300312826,8.654848800834202,0.8689607229753215,0.0
105,경기도,용인시기흥구,보정동,보정동제4투,2748,2123,742,1166,178,21,0,2107,16,625,35.21594684385382,55.33934504034171,8.448030374940673,0.9966777408637874,0.0
106,경기도,용인시기흥구,보정동,보정동제5투,2067,1623,576,940,95,6,0,1617,6,444,35.621521335807046,58.13234384662957,5.875077303648732,0.3710575139146568,0.0
107,경기도,용인시기흥구,보정동,보정동제6투,2014,1524,688,671,134,21,1,1515,9,490,45.41254125412541,44.290429042904286,8.844884488448844,1.3861386138613863,0.066006600660066
108,경기도,용인시기흥구,보정동,보정동제7투,1008,739,264,408,55,7,0,734,5,269,35.967302452316076,55.5858310626703,7.493188010899182,0.9536784741144414,0.0
109,경기도,용인시기흥구,잘못 투입·구분된 투표지,,0,3,2,0,0,0,0,2,1,-3,100.0,0.0,0.0,0.0,0.0
0,경기도,안성시,거소·선상투표,,241,229,104,73,42,1,0,220,9,12,47.27272727272727,33.18181818181819,19.090909090909093,0.45454545454545453,0.0
1,경기도,안성시,관외사전투표,,13470,13469,7544,3886,1757,128,15,13330,139,1,56.59414853713428,29.152288072018006,13.1807951987997,0.9602400600150038,0.11252813203300824
2,경기도,안성시,재외투표,,752,632,433,133,56,7,0,629,3,120,68.83942766295708,21.144674085850557,8.90302066772655,1.1128775834658187,0.0
3,경기도,안성시,공도읍,관내사전투표,9361,9361,6588,1987,637,81,9,9302,59,0,70.82347882175875,21.360997634917222,6.847989679638787,0.8707804773167062,0.09675338636852289
4,경기도,안성시,공도읍,공도읍제1투,3810,2484,1228,1044,170,20,4,2466,18,1326,49.79724249797243,42.33576642335766,6.89375506893755,0.8110300081103,0.16220600162206003
5,경기도,안성시,공도읍,공도읍제2투,2532,1563,755,664,120,15,1,1555,8,969,48.55305466237942,42.70096463022508,7.717041800643088,0.964630225080386,0.06430868167202572
6,경기도,안성시,공도읍,공도읍제3투,3626,2144,1063,936,111,19,4,2133,11,1482,49.83591186122832,43.88185654008439,5.20393811533052,0.8907641819034223,0.1875293014533521
7,경기도,안성시,공도읍,공도읍제4투,4020,2091,924,1005,130,18,3,2080,11,1929,44.42307692307692,48.31730769230769,6.25,0.8653846153846154,0.14423076923076925
8,경기도,안성시,공도읍,공도읍제5투,3397,2291,1114,976,161,21,5,2277,14,1106,48.92402283706632,42.863416776460255,7.07070707070707,0.922266139657444,0.21958717610891526
9,경기도,안성시,공도읍,공도읍제6투,2450,1580,787,649,112,19,2,1569,11,870,50.159337157425114,41.36392606755896,7.138304652644997,1.2109623964308476,0.12746972594008923
10,경기도,안성시,공도읍,공도읍제7투,4201,2432,1046,1208,136,21,2,2413,19,1769,43.348528802320764,50.062163282221306,5.63613758806465,0.870285951098218,0.08288437629506838
11,경기도,안성시,공도읍,공도읍제8투,2790,1729,884,675,144,11,2,1716,13,1061,51.515151515151516,39.33566433566433,8.391608391608392,0.641025641025641,0.11655011655011654
12,경기도,안성시,공도읍,공도읍제9투,1617,1078,559,437,63,11,1,1071,7,539,52.194211017740436,40.80298786181139,5.88235294117647,1.0270774976657329,0.09337068160597572
13,경기도,안성시,공도읍,공도읍제10투,2772,1746,903,695,121,13,4,1736,10,1026,52.016129032258064,40.034562211981566,6.970046082949309,0.748847926267281,0.2304147465437788
14,경기도,안성시,공도읍,공도읍제11투,3700,2638,1403,981,202,31,4,2621,17,1062,53.52918733307897,37.42846241892408,7.706982067913009,1.1827546737886303,0.15261350629530715
15,경기도,안성시,공도읍,공도읍제12투,3879,2421,1116,984,279,21,3,2403,18,1458,46.441947565543074,40.94881398252185,11.610486891385769,0.8739076154806492,0.12484394506866417
16,경기도,안성시,보개면,관내사전투표,2253,2253,1379,691,158,14,4,2246,7,0,61.39804096170971,30.76580587711487,7.034728406055208,0.6233303650934996,0.17809439002671415
17,경기도,안성시,보개면,보개면제1투,854,520,152,334,25,5,0,516,4,334,29.457364341085274,64.72868217054264,4.844961240310078,0.9689922480620154,0.0
18,경기도,안성시,보개면,보개면제2투,496,338,81,238,15,1,1,336,2,158,24.107142857142858,70.83333333333334,4.464285714285714,0.2976190476190476,0.2976190476190476
19,경기도,안성시,보개면,보개면제3투,992,660,208,417,27,2,1,655,5,332,31.755725190839694,63.664122137404576,4.122137404580153,0.3053435114503817,0.15267175572519084
20,경기도,안성시,보개면,보개면제4투,532,367,83,266,14,1,0,364,3,165,22.802197802197803,73.07692307692307,3.8461538461538463,0.27472527472527475,0.0
21,경기도,안성시,금광면,관내사전투표,1534,1534,999,427,91,11,1,1529,5,0,65.33682145192937,27.926749509483322,5.951602354480053,0.7194244604316548,0.06540222367560497
22,경기도,안성시,금광면,금광면제1투,994,638,197,401,25,9,1,633,5,356,31.121642969984205,63.34913112164296,3.949447077409163,1.4218009478672986,0.1579778830963665
23,경기도,안성시,금광면,금광면제2투,476,306,78,209,13,2,1,303,3,170,25.742574257425744,68.97689768976898,4.29042904290429,0.6600660066006601,0.33003300330033003
24,경기도,안성시,금광면,금광면제3투,525,345,135,190,14,3,0,342,3,180,39.473684210526315,55.55555555555556,4.093567251461988,0.8771929824561403,0.0
25,경기도,안성시,금광면,금광면제4투,424,293,70,214,5,1,0,290,3,131,24.137931034482758,73.79310344827587,1.7241379310344827,0.3448275862068966,0.0
26,경기도,안성시,금광면,금광면제5투,1869,1272,683,496,77,9,1,1266,6,597,53.94944707740916,39.178515007898895,6.082148499210111,0.7109004739336493,0.07898894154818326
27,경기도,안성시,서운면,관내사전투표,1214,1214,715,400,77,12,1,1205,9,0,59.33609958506224,33.19502074688796,6.390041493775933,0.9958506224066389,0.08298755186721991
28,경기도,안성시,서운면,서운면제1투,941,574,162,378,28,4,0,572,2,367,28.321678321678323,66.08391608391608,4.895104895104895,0.6993006993006993,0.0
29,경기도,안성시,서운면,서운면제2투,410,269,79,179,9,2,0,269,0,141,29.36802973977695,66.54275092936803,3.3457249070631967,0.7434944237918215,0.0
30,경기도,안성시,서운면,서운면제3투,500,322,83,218,16,2,0,319,3,178,26.01880877742947,68.3385579937304,5.015673981191222,0.6269592476489028,0.0
31,경기도,안성시,미양면,관내사전투표,1684,1684,1073,459,123,15,2,1672,12,0,64.17464114832536,27.452153110047846,7.35645933014354,0.8971291866028708,0.11961722488038277
32,경기도,안성시,미양면,미양면제1투,962,597,194,368,28,5,1,596,1,365,32.5503355704698,61.74496644295302,4.697986577181208,0.8389261744966443,0.16778523489932887
33,경기도,안성시,미양면,미양면제2투,1451,815,305,442,55,9,1,812,3,636,37.5615763546798,54.43349753694581,6.773399014778326,1.1083743842364533,0.12315270935960591
34,경기도,안성시,미양면,미양면제3투,863,554,195,333,19,4,0,551,3,309,35.39019963702359,60.435571687840294,3.4482758620689653,0.7259528130671506,0.0
35,경기도,안성시,대덕면,관내사전투표,3392,3392,2247,814,281,26,2,3370,22,0,66.67655786350149,24.154302670623146,8.338278931750743,0.771513353115727,0.05934718100890207
36,경기도,안성시,대덕면,대덕면제1투,1232,722,233,448,35,2,0,718,4,510,32.45125348189415,62.39554317548747,4.874651810584958,0.2785515320334262,0.0
37,경기도,안성시,대덕면,대덕면제2투,1116,660,260,374,18,3,1,656,4,456,39.63414634146341,57.012195121951216,2.7439024390243905,0.45731707317073167,0.1524390243902439
38,경기도,안성시,대덕면,대덕면제3투,3177,1533,596,738,164,18,2,1518,15,1644,39.26218708827404,48.616600790513836,10.80368906455863,1.185770750988142,0.13175230566534915
39,경기도,안성시,대덕면,대덕면제4투,3089,2166,1079,914,143,13,3,2152,14,923,50.139405204460964,42.47211895910781,6.644981412639406,0.604089219330855,0.13940520446096655
40,경기도,안성시,양성면,관내사전투표,1518,1518,910,508,82,9,1,1510,8,0,60.264900662251655,33.64238410596027,5.430463576158941,0.5960264900662252,0.06622516556291391
41,경기도,안성시,양성면,양성면제1투,1054,654,152,458,33,6,1,650,4,400,23.384615384615383,70.46153846153847,5.076923076923077,0.9230769230769231,0.15384615384615385
42,경기도,안성시,양성면,양성면제2투,848,587,133,431,16,3,1,584,3,261,22.773972602739725,73.8013698630137,2.73972602739726,0.5136986301369862,0.17123287671232876
43,경기도,안성시,양성면,양성면제3투,1040,628,174,417,27,3,1,622,6,412,27.974276527331188,67.04180064308682,4.340836012861737,0.482315112540193,0.1607717041800643
44,경기도,안성시,원곡면,관내사전투표,1480,1480,912,457,93,9,2,1473,7,0,61.91446028513238,31.02511880515954,6.313645621181263,0.6109979633401221,0.1357773251866938
45,경기도,안성시,원곡면,원곡면제1투,2517,1464,473,880,88,7,2,1450,14,1053,32.62068965517241,60.689655172413794,6.068965517241379,0.4827586206896552,0.13793103448275862
46,경기도,안성시,원곡면,원곡면제2투,783,522,268,220,27,5,0,520,2,261,51.53846153846153,42.30769230769231,5.1923076923076925,0.9615384615384616,0.0
47,경기도,안성시,원곡면,원곡면제3투,466,304,105,183,13,0,0,301,3,162,34.883720930232556,60.797342192691026,4.318936877076411,0.0,0.0
48,경기도,안성시,일죽면,관내사전투표,1899,1899,1007,780,91,10,1,1889,10,0,53.30862890418211,41.291688724192696,4.817363684489147,0.5293806246691372,0.05293806246691372
49,경기도,안성시,일죽면,일죽면제1투,1184,703,254,405,29,10,1,699,4,481,36.33762517882689,57.93991416309014,4.148783977110158,1.4306151645207439,0.14306151645207438
50,경기도,안성시,일죽면,일죽면제2투,1114,716,212,462,32,6,1,713,3,398,29.73352033660589,64.79663394109397,4.488078541374474,0.8415147265077139,0.1402524544179523
51,경기도,안성시,일죽면,일죽면제3투,1084,744,201,513,21,2,1,738,6,340,27.235772357723576,69.51219512195121,2.8455284552845526,0.27100271002710025,0.13550135501355012
52,경기도,안성시,일죽면,일죽면제4투,716,403,84,302,12,0,1,399,4,313,21.052631578947366,75.6892230576441,3.007518796992481,0.0,0.2506265664160401
53,경기도,안성시,죽산면,관내사전투표,2283,2283,1292,827,118,12,1,2250,33,0,57.42222222222222,36.75555555555556,5.2444444444444445,0.5333333333333333,0.044444444444444446
54,경기도,안성시,죽산면,죽산면제1투,1993,1201,362,767,57,4,2,1192,9,792,30.369127516778523,64.34563758389261,4.781879194630872,0.33557046979865773,0.16778523489932887
55,경기도,안성시,죽산면,죽산면제2투,1155,618,194,383,32,2,0,611,7,537,31.751227495908346,62.68412438625205,5.237315875613748,0.32733224222585927,0.0
56,경기도,안성시,죽산면,죽산면제3투,534,304,76,210,16,0,2,304,0,230,25.0,69.07894736842105,5.263157894736842,0.0,0.6578947368421052
57,경기도,안성시,삼죽면,관내사전투표,1116,1116,638,362,98,8,0,1106,10,0,57.68535262206148,32.730560578661844,8.860759493670885,0.7233273056057866,0.0
58,경기도,안성시,삼죽면,삼죽면제1투,1270,738,192,505,32,6,0,735,3,532,26.122448979591837,68.70748299319727,4.353741496598639,0.8163265306122449,0.0
59,경기도,안성시,삼죽면,삼죽면제2투,940,538,152,308,66,6,0,532,6,402,28.57142857142857,57.89473684210527,12.406015037593985,1.1278195488721803,0.0
60,경기도,안성시,고삼면,관내사전투표,1254,1254,738,410,70,9,3,1230,24,0,60.0,33.33333333333333,5.691056910569105,0.7317073170731708,0.24390243902439024
61,경기도,안성시,고삼면,고삼면제1투,624,411,130,246,24,4,0,404,7,213,32.17821782178218,60.89108910891089,5.9405940594059405,0.9900990099009901,0.0
62,경기도,안성시,고삼면,고삼면제2투,379,244,67,166,11,0,0,244,0,135,27.459016393442624,68.0327868852459,4.508196721311475,0.0,0.0
63,경기도,안성시,안성1동,관내사전투표,3859,3859,2283,1254,248,36,5,3826,33,0,59.67067433350758,32.77574490329326,6.4819654992158915,0.9409304756926294,0.13068478829064298
64,경기도,안성시,안성1동,안성1동제1투,1120,697,202,445,40,4,1,692,5,423,29.190751445086704,64.30635838150289,5.780346820809249,0.5780346820809248,0.1445086705202312
65,경기도,안성시,안성1동,안성1동제2투,1622,1099,415,587,73,9,3,1087,12,523,38.17847286108555,54.00183992640294,6.7157313707451705,0.8279668813247469,0.27598896044158233
66,경기도,안성시,안성1동,안성1동제3투,2510,1473,511,850,95,9,1,1466,7,1037,34.85675306957708,57.98090040927695,6.480218281036835,0.6139154160982265,0.06821282401091405
67,경기도,안성시,안성1동,안성1동제4투,1118,673,228,402,33,3,0,666,7,445,34.234234234234236,60.36036036036037,4.954954954954955,0.45045045045045046,0.0
68,경기도,안성시,안성2동,관내사전투표,5074,5074,3171,1438,401,32,2,5044,30,0,62.86677240285488,28.509119746233146,7.950039651070578,0.63441712926249,0.03965107057890563
69,경기도,안성시,안성2동,안성2동제1투,3874,2280,858,1199,183,25,0,2265,15,1594,37.88079470198675,52.93598233995584,8.079470198675496,1.1037527593818985,0.0
70,경기도,안성시,안성2동,안성2동제2투,2932,1747,758,819,140,13,5,1735,12,1185,43.68876080691643,47.20461095100865,8.069164265129682,0.7492795389048991,0.2881844380403458
71,경기도,안성시,안성2동,안성2동제3투,2399,1626,756,751,97,12,2,1618,8,773,46.72435105067985,46.41532756489493,5.995055624227441,0.7416563658838072,0.12360939431396785
72,경기도,안성시,안성2동,안성2동제4투,582,389,157,185,38,1,1,382,7,193,41.09947643979058,48.42931937172775,9.947643979057592,0.2617801047120419,0.2617801047120419
73,경기도,안성시,안성2동,안성2동제5투,4167,2580,1138,1200,200,16,3,2557,23,1587,44.50527962456003,46.92999608916699,7.821666014861166,0.6257332811888932,0.11732499022291748
74,경기도,안성시,안성3동,관내사전투표,6442,6442,4070,1751,509,58,4,6392,50,0,63.673341677096374,27.393617021276594,7.9630788485607,0.9073842302878597,0.0625782227784731
75,경기도,안성시,안성3동,안성3동제1투,3264,2135,882,1033,193,15,1,2124,11,1129,41.52542372881356,48.6346516007533,9.086629001883239,0.7062146892655368,0.047080979284369114
76,경기도,안성시,안성3동,안성3동제2투,1198,833,315,428,75,7,1,826,7,365,38.13559322033898,51.81598062953995,9.079903147699758,0.847457627118644,0.12106537530266344
77,경기도,안성시,안성3동,안성3동제3투,1069,641,218,379,37,4,1,639,2,428,34.11580594679186,59.31142410015649,5.790297339593114,0.6259780907668232,0.1564945226917058
78,경기도,안성시,안성3동,안성3동제4투,4114,2573,1088,1263,193,13,0,2557,16,1541,42.54986312084474,49.393820883848264,7.547907704341025,0.5084082909659757,0.0
79,경기도,안성시,안성3동,안성3동제5투,2047,1281,503,645,114,9,2,1273,8,766,39.51296150824823,50.667714061272584,8.955223880597014,0.7069913589945012,0.15710919088766695
80,경기도,안성시,안성3동,안성3동제6투,1024,642,224,373,34,6,1,638,4,382,35.10971786833856,58.46394984326019,5.329153605015674,0.9404388714733543,0.1567398119122257
81,경기도,안성시,안성3동,안성3동제7투,1134,782,279,445,49,3,2,778,4,352,35.861182519280206,57.19794344473008,6.298200514138817,0.3856041131105398,0.2570694087403599
82,경기도,안성시,잘못 투입·구분된 투표지,,0,1,0,1,0,0,0,1,0,-1,0.0,100.0,0.0,0.0,0.0
0,경기도,김포시,거소·선상투표,,492,455,189,142,100,5,2,438,17,37,43.15068493150685,32.42009132420091,22.831050228310502,1.141552511415525,0.45662100456621
1,경기도,김포시,관외사전투표,,34207,34185,20816,8546,4155,322,36,33875,310,22,61.449446494464944,25.228044280442802,12.265682656826568,0.9505535055350554,0.10627306273062731
2,경기도,김포시,재외투표,,2478,2080,1447,405,183,27,0,2062,18,398,70.17458777885548,19.64112512124151,8.874878758486906,1.3094083414161009,0.0
3,경기도,김포시,통진읍,관내사전투표,5708,5708,3804,1465,360,35,10,5674,34,0,67.04265068734578,25.81952767007402,6.3447303489601685,0.6168487839266831,0.17624250969333805
4,경기도,김포시,통진읍,통진읍제1투,1761,1245,521,649,67,7,0,1244,1,516,41.88102893890675,52.170418006430864,5.385852090032155,0.5627009646302251,0.0
5,경기도,김포시,통진읍,통진읍제2투,3160,1895,862,834,174,12,2,1884,11,1265,45.75371549893843,44.26751592356688,9.235668789808917,0.6369426751592357,0.10615711252653928
6,경기도,김포시,통진읍,통진읍제3투,2738,1725,770,840,85,9,6,1710,15,1013,45.02923976608187,49.122807017543856,4.970760233918129,0.5263157894736842,0.3508771929824561
7,경기도,김포시,통진읍,통진읍제4투,1104,763,208,512,32,6,0,758,5,341,27.440633245382585,67.54617414248021,4.221635883905013,0.79155672823219,0.0
8,경기도,김포시,통진읍,통진읍제5투,2267,1319,522,704,84,4,0,1314,5,948,39.726027397260275,53.57686453576864,6.392694063926941,0.30441400304414,0.0
9,경기도,김포시,통진읍,통진읍제6투,2592,1500,537,856,86,11,1,1491,9,1092,36.016096579476866,57.4111334674715,5.767940979208585,0.7377598926894702,0.0670690811535882
10,경기도,김포시,통진읍,통진읍제7투,1445,840,317,476,33,5,2,833,7,605,38.055222088835535,57.14285714285714,3.961584633853541,0.6002400960384154,0.24009603841536614
11,경기도,김포시,통진읍,통진읍제8투,3464,2121,1020,907,164,11,2,2104,17,1343,48.47908745247148,43.10836501901141,7.79467680608365,0.5228136882129277,0.09505703422053231
12,경기도,김포시,통진읍,통진읍제9투,3671,2392,1121,1083,163,11,4,2382,10,1279,47.061293031066334,45.46599496221663,6.842989084802687,0.4617968094038623,0.16792611251049538
13,경기도,김포시,고촌읍,관내사전투표,7819,7819,5250,1909,570,52,4,7785,34,0,67.4373795761079,24.52151573538857,7.321772639691715,0.6679511881824021,0.05138086062941554
14,경기도,김포시,고촌읍,고촌읍제1투,2680,1660,556,931,152,13,2,1654,6,1020,33.61547762998791,56.287787182587664,9.189842805320435,0.7859733978234582,0.12091898428053204
15,경기도,김포시,고촌읍,고촌읍제2투,1088,759,187,541,18,6,1,753,6,329,24.833997343957503,71.84594953519256,2.3904382470119523,0.796812749003984,0.13280212483399734
16,경기도,김포시,고촌읍,고촌읍제3투,2621,1946,738,1030,153,15,0,1936,10,675,38.1198347107438,53.20247933884298,7.902892561983471,0.7747933884297521,0.0
17,경기도,김포시,고촌읍,고촌읍제4투,3085,2095,712,1185,163,20,0,2080,15,990,34.23076923076923,56.97115384615385,7.836538461538462,0.9615384615384616,0.0
18,경기도,김포시,고촌읍,고촌읍제5투,2868,2131,936,990,162,26,4,2118,13,737,44.19263456090651,46.742209631728045,7.64872521246459,1.2275731822474032,0.18885741265344666
19,경기도,김포시,고촌읍,고촌읍제6투,2358,1901,766,920,169,31,0,1886,15,457,40.61505832449629,48.78048780487805,8.960763520678686,1.6436903499469777,0.0
20,경기도,김포시,고촌읍,고촌읍제7투,3689,2867,1462,1131,228,33,2,2856,11,822,51.19047619047619,39.60084033613445,7.9831932773109235,1.1554621848739497,0.0700280112044818
21,경기도,김포시,고촌읍,고촌읍제8투,3541,2815,1486,1008,286,23,3,2806,9,726,52.957947255880256,35.92302209550962,10.192444761225945,0.819672131147541,0.10691375623663579
22,경기도,김포시,고촌읍,고촌읍제9투,2605,2129,1016,886,181,28,2,2113,16,476,48.083293894936105,41.93090392806436,8.5660198769522,1.3251301467108376,0.09465215333648841
23,경기도,김포시,고촌읍,고촌읍제10투,3104,2495,1287,971,191,22,4,2475,20,609,52.0,39.23232323232323,7.717171717171717,0.8888888888888888,0.1616161616161616
24,경기도,김포시,양촌읍,관내사전투표,5745,5745,3809,1523,348,30,5,5715,30,0,66.64916885389326,26.64916885389326,6.089238845144357,0.5249343832020997,0.08748906386701663
25,경기도,김포시,양촌읍,양촌읍제1투,2442,1387,522,760,93,5,1,1381,6,1055,37.79869659666908,55.03258508327299,6.7342505430847215,0.3620564808110065,0.0724112961622013
26,경기도,김포시,양촌읍,양촌읍제2투,1614,1014,420,505,71,8,2,1006,8,600,41.74950298210736,50.19880715705766,7.057654075546719,0.7952286282306162,0.19880715705765406
27,경기도,김포시,양촌읍,양촌읍제3투,853,544,176,338,26,2,1,543,1,309,32.41252302025783,62.246777163904234,4.788213627992634,0.3683241252302026,0.1841620626151013
28,경기도,김포시,양촌읍,양촌읍제4투,2769,1825,914,772,112,16,2,1816,9,944,50.330396475770925,42.51101321585903,6.167400881057269,0.881057268722467,0.11013215859030838
29,경기도,김포시,양촌읍,양촌읍제5투,411,259,67,173,14,3,1,258,1,152,25.968992248062015,67.05426356589147,5.426356589147287,1.1627906976744187,0.3875968992248062
30,경기도,김포시,양촌읍,양촌읍제6투,198,130,39,79,7,4,0,129,1,68,30.23255813953488,61.240310077519375,5.426356589147287,3.10077519379845,0.0
31,경기도,김포시,양촌읍,양촌읍제7투,979,655,222,397,32,3,0,654,1,324,33.94495412844037,60.703363914373085,4.892966360856269,0.45871559633027525,0.0
32,경기도,김포시,양촌읍,양촌읍제8투,2379,1578,795,651,112,11,2,1571,7,801,50.60471037555697,41.43857415658816,7.129217059197964,0.7001909611712286,0.1273074474856779
33,경기도,김포시,양촌읍,양촌읍제9투,2925,2041,1024,856,131,13,2,2026,15,884,50.54294175715695,42.2507403751234,6.465942744323791,0.6416584402764067,0.09871668311944717
34,경기도,김포시,양촌읍,양촌읍제10투,3744,2030,775,984,232,16,2,2009,21,1714,38.576406172224985,48.97959183673469,11.548033847685415,0.7964161274265804,0.09955201592832255
35,경기도,김포시,대곶면,관내사전투표,2314,2314,1382,771,135,10,0,2298,16,0,60.13925152306353,33.5509138381201,5.87467362924282,0.4351610095735422,0.0
36,경기도,김포시,대곶면,대곶면제1투,2106,1151,402,686,46,8,3,1145,6,955,35.109170305676855,59.91266375545852,4.017467248908297,0.6986899563318777,0.26200873362445415
37,경기도,김포시,대곶면,대곶면제2투,1510,988,359,576,42,6,2,985,3,522,36.44670050761422,58.477157360406096,4.263959390862944,0.6091370558375634,0.20304568527918782
38,경기도,김포시,대곶면,대곶면제3투,745,448,140,280,22,4,0,446,2,297,31.390134529147986,62.78026905829597,4.932735426008969,0.8968609865470852,0.0
39,경기도,김포시,대곶면,대곶면제4투,703,466,138,310,16,0,0,464,2,237,29.74137931034483,66.8103448275862,3.4482758620689653,0.0,0.0
40,경기도,김포시,대곶면,대곶면제5투,928,600,166,401,27,4,0,598,2,328,27.759197324414714,67.05685618729098,4.51505016722408,0.6688963210702341,0.0
41,경기도,김포시,월곶면,관내사전투표,1845,1845,1023,648,129,17,2,1819,26,0,56.239692138537656,35.62396921385377,7.091808686091258,0.9345794392523363,0.10995052226498077
42,경기도,김포시,월곶면,월곶면제1투,1640,917,267,589,40,11,3,910,7,723,29.340659340659343,64.72527472527473,4.395604395604396,1.208791208791209,0.32967032967032966
43,경기도,김포시,월곶면,월곶면제2투,320,221,62,146,10,2,0,220,1,99,28.18181818181818,66.36363636363637,4.545454545454546,0.9090909090909091,0.0
44,경기도,김포시,월곶면,월곶면제3투,385,274,61,204,6,1,0,272,2,111,22.426470588235293,75.0,2.2058823529411766,0.3676470588235294,0.0
45,경기도,김포시,월곶면,월곶면제4투,758,456,116,319,17,1,0,453,3,302,25.607064017660043,70.41942604856513,3.7527593818984544,0.22075055187637968,0.0
46,경기도,김포시,하성면,관내사전투표,2575,2575,1477,896,166,15,4,2558,17,0,57.74042220484754,35.02736512900704,6.489444878811572,0.5863956215793589,0.1563721657544957
47,경기도,김포시,하성면,하성면제1투,1755,960,330,558,62,4,2,956,4,795,34.51882845188285,58.36820083682008,6.485355648535565,0.41841004184100417,0.20920502092050208
48,경기도,김포시,하성면,하성면제2투,817,537,168,338,26,1,0,533,4,280,31.51969981238274,63.41463414634146,4.878048780487805,0.18761726078799248,0.0
49,경기도,김포시,하성면,하성면제3투,685,442,122,299,16,2,0,439,3,243,27.790432801822323,68.10933940774487,3.644646924829157,0.45558086560364464,0.0
50,경기도,김포시,하성면,하성면제4투,984,644,171,441,25,4,0,641,3,340,26.67706708268331,68.79875195007801,3.9001560062402496,0.62402496099844,0.0
51,경기도,김포시,하성면,하성면제5투,456,294,98,176,13,5,1,293,1,162,33.44709897610921,60.068259385665534,4.436860068259386,1.7064846416382253,0.3412969283276451
52,경기도,김포시,김포본동,관내사전투표,6061,6061,4105,1530,367,38,2,6042,19,0,67.94107911287654,25.322740814299898,6.074147633234029,0.628930817610063,0.033101621979477
53,경기도,김포시,김포본동,김포본동제1투,1680,989,350,533,88,10,3,984,5,691,35.56910569105691,54.166666666666664,8.94308943089431,1.0162601626016259,0.3048780487804878
54,경기도,김포시,김포본동,김포본동제2투,1054,663,261,355,38,3,1,658,5,391,39.66565349544073,53.951367781155014,5.775075987841945,0.4559270516717325,0.1519756838905775
55,경기도,김포시,김포본동,김포본동제3투,2115,1662,702,827,109,13,2,1653,9,453,42.46823956442831,50.0302480338778,6.594071385359952,0.7864488808227466,0.12099213551119178
56,경기도,김포시,김포본동,김포본동제4투,3862,2705,1059,1398,201,27,5,2690,15,1157,39.36802973977695,51.97026022304833,7.4721189591078065,1.0037174721189592,0.18587360594795538
57,경기도,김포시,김포본동,김포본동제5투,2114,1566,667,770,105,12,1,1555,11,548,42.89389067524116,49.51768488745981,6.752411575562702,0.7717041800643086,0.06430868167202572
58,경기도,김포시,김포본동,김포본동제6투,2019,1492,625,740,103,13,0,1481,11,527,42.20121539500338,49.966239027684,6.954760297096556,0.8777852802160702,0.0
59,경기도,김포시,김포본동,김포본동제7투,2475,1764,902,695,135,18,2,1752,12,711,51.48401826484018,39.6689497716895,7.705479452054795,1.0273972602739725,0.1141552511415525
60,경기도,김포시,김포본동,김포본동제8투,2675,1980,987,851,117,15,2,1972,8,695,50.05070993914808,43.15415821501014,5.9330628803245435,0.7606490872210954,0.10141987829614604
61,경기도,김포시,김포본동,김포본동제9투,3130,2361,961,1157,197,26,1,2342,19,769,41.0333048676345,49.40222032450897,8.411614005123825,1.1101622544833476,0.04269854824935952
62,경기도,김포시,김포본동,김포본동제10투,2847,2225,1014,990,185,19,2,2210,15,622,45.88235294117647,44.79638009049774,8.3710407239819,0.8597285067873304,0.09049773755656108
63,경기도,김포시,김포본동,김포본동제11투,2343,1736,654,916,138,18,1,1727,9,607,37.869137232194554,53.03995367689636,7.990735379270411,1.0422698320787493,0.05790387955993051
64,경기도,김포시,김포본동,김포본동제12투,2033,1644,846,651,120,15,1,1633,11,389,51.80649112063686,39.86527862829149,7.348438456827925,0.9185548071034906,0.0612369871402327
65,경기도,김포시,김포본동,김포본동제13투,2807,2182,1043,913,195,22,0,2173,9,625,47.99815922687529,42.015646571560055,8.97376898297285,1.0124252185918086,0.0
66,경기도,김포시,김포본동,김포본동제14투,3927,3121,1503,1326,259,14,2,3104,17,806,48.42139175257732,42.71907216494845,8.344072164948454,0.4510309278350515,0.06443298969072164
67,경기도,김포시,장기본동,관내사전투표,6278,6278,4415,1410,387,36,3,6251,27,0,70.6286994080947,22.55639097744361,6.191009438489842,0.5759078547432411,0.047992321228603425
68,경기도,김포시,장기본동,장기본동제1투,2743,2058,709,1170,144,21,2,2046,12,685,34.65298142717498,57.18475073313783,7.038123167155426,1.0263929618768328,0.09775171065493646
69,경기도,김포시,장기본동,장기본동제2투,2618,1596,542,923,111,7,0,1583,13,1022,34.238787113076434,58.30701200252685,7.012002526847757,0.4421983575489577,0.0
70,경기도,김포시,장기본동,장기본동제3투,3254,2216,1023,997,168,12,1,2201,15,1038,46.478873239436616,45.29759200363471,7.632894139027714,0.5452067242162654,0.045433893684688774
71,경기도,김포시,장기본동,장기본동제4투,3044,2241,1179,859,179,18,0,2235,6,803,52.75167785234899,38.43400447427293,8.008948545861298,0.8053691275167786,0.0
72,경기도,김포시,장기본동,장기본동제5투,2824,2024,1060,740,191,19,1,2011,13,800,52.71009448035803,36.79761312779712,9.497762307309795,0.9448035803083044,0.04972650422675286
73,경기도,김포시,장기본동,장기본동제6투,3193,2387,1274,888,200,21,0,2383,4,806,53.462022660511956,37.26395300041964,8.392782207301721,0.8812421317666806,0.0
74,경기도,김포시,장기본동,장기본동제7투,2837,2151,1027,929,165,18,1,2140,11,686,47.99065420560748,43.41121495327103,7.710280373831775,0.8411214953271028,0.04672897196261683
75,경기도,김포시,사우동,관내사전투표,7648,7647,5078,1928,529,63,6,7604,43,1,66.78064176749079,25.3550762756444,6.9568648079957915,0.828511309836928,0.07890583903208837
76,경기도,김포시,사우동,사우동제1투,2302,1260,481,663,94,6,3,1247,13,1042,38.57257417802727,53.167602245388935,7.538091419406576,0.48115477145148355,0.24057738572574178
77,경기도,김포시,사우동,사우동제2투,2281,1356,538,717,85,9,0,1349,7,925,39.88139362490734,53.15048183839881,6.300963676797627,0.6671608598962194,0.0
78,경기도,김포시,사우동,사우동제3투,2526,1882,832,867,146,19,4,1868,14,644,44.53961456102783,46.41327623126338,7.815845824411134,1.0171306209850108,0.21413276231263384
79,경기도,김포시,사우동,사우동제4투,564,346,113,192,34,2,1,342,4,218,33.04093567251462,56.14035087719298,9.941520467836257,0.5847953216374269,0.29239766081871343
80,경기도,김포시,사우동,사우동제5투,2654,1807,760,875,152,13,3,1803,4,847,42.15196894065446,48.530227398779815,8.430393788130893,0.7210205213533,0.16638935108153077
81,경기도,김포시,사우동,사우동제6투,2198,1838,930,718,156,25,0,1829,9,360,50.847457627118644,39.25642427556041,8.529250956806997,1.366867140513942,0.0
82,경기도,김포시,풍무동,관내사전투표,8652,8652,6124,1857,579,50,7,8617,35,0,71.06881745387025,21.550423581292794,6.719275850063827,0.5802483462922131,0.08123476848090982
83,경기도,김포시,풍무동,풍무동제1투,3644,2244,958,1065,167,32,2,2224,20,1400,43.07553956834532,47.88669064748202,7.508992805755396,1.4388489208633095,0.08992805755395684
84,경기도,김포시,풍무동,풍무동제2투,2365,1442,574,724,116,16,1,1431,11,923,40.11180992313068,50.593990216631724,8.106219426974144,1.1180992313067784,0.06988120195667365
85,경기도,김포시,풍무동,풍무동제3투,2658,1958,775,1005,144,18,6,1948,10,700,39.78439425051335,51.591375770020534,7.392197125256674,0.9240246406570842,0.3080082135523614
86,경기도,김포시,풍무동,풍무동제4투,2161,1521,711,679,106,16,1,1513,8,640,46.99272967614012,44.87772637144746,7.005948446794448,1.0575016523463316,0.06609385327164573
87,경기도,김포시,풍무동,풍무동제5투,2993,2222,1015,1000,179,12,1,2207,15,771,45.99003171726325,45.310376076121436,8.110557317625736,0.5437245129134572,0.045310376076121435
88,경기도,김포시,풍무동,풍무동제6투,2331,1720,754,790,145,18,3,1710,10,611,44.09356725146199,46.198830409356724,8.47953216374269,1.0526315789473684,0.17543859649122806
89,경기도,김포시,풍무동,풍무동제7투,3002,2235,1010,1019,170,22,0,2221,14,767,45.4750112561909,45.88023412877082,7.654209815398469,0.9905447996398019,0.0
90,경기도,김포시,풍무동,풍무동제8투,2809,2069,837,1070,135,14,1,2057,12,740,40.690325717063686,52.01750121536218,6.562955760816723,0.6806028196402528,0.04861448711716091
91,경기도,김포시,풍무동,풍무동제9투,2604,2006,973,832,180,13,0,1998,8,598,48.6986986986987,41.64164164164164,9.00900900900901,0.6506506506506506,0.0
92,경기도,김포시,풍무동,풍무동제10투,1165,837,348,438,34,10,1,831,6,328,41.87725631768953,52.707581227436826,4.0914560770156445,1.203369434416366,0.12033694344163659
93,경기도,김포시,풍무동,풍무동제11투,2116,1691,802,735,131,11,0,1679,12,425,47.76652769505658,43.77605717689101,7.802263251935676,0.6551518761167362,0.0
94,경기도,김포시,풍무동,풍무동제12투,2538,2111,1040,838,196,19,3,2096,15,427,49.61832061068702,39.98091603053435,9.351145038167939,0.9064885496183206,0.1431297709923664
95,경기도,김포시,풍무동,풍무동제13투,4067,3274,1565,1354,304,29,1,3253,21,793,48.1094374423609,41.62311712265601,9.34521979711036,0.8914847832769751,0.03074085459575776
96,경기도,김포시,장기동,관내사전투표,8258,8258,5937,1643,573,62,8,8223,35,0,72.19992703392923,19.98054238112611,6.968259759211966,0.7539827313632494,0.09728809436945154
97,경기도,김포시,장기동,장기동제1투,3005,2216,1060,958,168,21,1,2208,8,789,48.007246376811594,43.38768115942029,7.608695652173914,0.9510869565217392,0.04528985507246377
98,경기도,김포시,장기동,장기동제2투,2773,2067,904,972,161,18,0,2055,12,706,43.990267639902676,47.2992700729927,7.8345498783454985,0.8759124087591241,0.0
99,경기도,김포시,장기동,장기동제3투,2231,1346,511,703,114,8,3,1339,7,885,38.16280806572069,52.501867064973865,8.513816280806571,0.597460791635549,0.22404779686333084
100,경기도,김포시,장기동,장기동제4투,3485,2649,1320,1058,224,33,3,2638,11,836,50.03790750568613,40.10614101592115,8.491281273692191,1.250947687642153,0.11372251705837756
101,경기도,김포시,장기동,장기동제5투,3390,2001,824,963,170,24,3,1984,17,1389,41.53225806451613,48.538306451612904,8.568548387096774,1.2096774193548387,0.15120967741935484
102,경기도,김포시,장기동,장기동제6투,2923,2179,993,1003,158,16,1,2171,8,744,45.73929064947029,46.19990787655458,7.277752187931828,0.7369875633348687,0.046061722708429294
103,경기도,김포시,장기동,장기동제7투,3722,2920,1531,1134,209,27,3,2904,16,802,52.72038567493112,39.0495867768595,7.196969696969697,0.9297520661157025,0.10330578512396695
104,경기도,김포시,구래동,관내사전투표,8322,8322,5882,1563,755,73,6,8279,43,0,71.04722792607802,18.879091677738856,9.119458871844426,0.8817490035028386,0.07247252083584974
105,경기도,김포시,구래동,구래동제1투,3753,1646,589,729,285,17,2,1622,24,2107,36.31319358816276,44.94451294697904,17.57090012330456,1.0480887792848335,0.12330456226880394
106,경기도,김포시,구래동,구래동제2투,3300,2181,1010,939,193,27,1,2170,11,1119,46.54377880184332,43.27188940092166,8.894009216589861,1.2442396313364055,0.04608294930875576
107,경기도,김포시,구래동,구래동제3투,2238,1735,945,673,97,13,1,1729,6,503,54.655870445344135,38.92423366107577,5.6101792943898205,0.7518796992481203,0.057836899942163095
108,경기도,김포시,구래동,구래동제4투,2832,1981,941,830,170,17,2,1960,21,851,48.01020408163265,42.3469387755102,8.673469387755102,0.8673469387755102,0.10204081632653061
109,경기도,김포시,구래동,구래동제5투,3355,2308,1043,1031,196,20,2,2292,16,1047,45.50610820244328,44.982547993019196,8.55148342059337,0.8726003490401396,0.08726003490401396
110,경기도,김포시,구래동,구래동제6투,2806,2107,1151,764,159,13,7,2094,13,699,54.96657115568291,36.48519579751671,7.593123209169055,0.620821394460363,0.3342884431709647
111,경기도,김포시,구래동,구래동제7투,1925,1053,427,449,157,8,1,1042,11,872,40.978886756238005,43.090211132437624,15.067178502879077,0.7677543186180422,0.09596928982725528
112,경기도,김포시,구래동,구래동제8투,2261,1571,739,720,97,9,0,1565,6,690,47.22044728434505,46.00638977635783,6.198083067092652,0.5750798722044729,0.0
113,경기도,김포시,구래동,구래동제9투,2665,2030,1105,743,156,14,1,2019,11,635,54.73006438831105,36.80039623576028,7.726597325408618,0.6934125804853888,0.04952947003467063
114,경기도,김포시,마산동,관내사전투표,6172,6172,4477,1168,444,50,5,6144,28,0,72.86783854166666,19.010416666666664,7.2265625,0.8138020833333334,0.08138020833333334
115,경기도,김포시,마산동,마산동제1투,1710,1065,493,465,91,9,1,1059,6,645,46.553352219074604,43.90934844192634,8.593012275731821,0.84985835694051,0.09442870632672333
116,경기도,김포시,마산동,마산동제2투,2657,1818,872,771,153,18,0,1814,4,839,48.070562293274534,42.50275633958104,8.434399117971333,0.9922822491730982,0.0
117,경기도,김포시,마산동,마산동제3투,2585,1817,818,868,103,12,0,1801,16,768,45.41921154913936,48.19544697390339,5.7190449750138805,0.6662965019433648,0.0
118,경기도,김포시,마산동,마산동제4투,2282,1593,738,737,76,19,3,1573,20,689,46.91671964399237,46.85314685314685,4.831532104259377,1.2078830260648443,0.19071837253655435
119,경기도,김포시,마산동,마산동제5투,2730,2095,1205,722,134,20,1,2082,13,635,57.87704130643612,34.67819404418828,6.43611911623439,0.9606147934678195,0.04803073967339097
120,경기도,김포시,마산동,마산동제6투,3642,2550,1299,1024,187,22,1,2533,17,1092,51.28306356099487,40.42637189103829,7.38255033557047,0.8685353335965259,0.03947887879984208
121,경기도,김포시,마산동,마산동제7투,3527,2537,1242,992,245,38,3,2520,17,990,49.28571428571429,39.36507936507937,9.722222222222223,1.507936507936508,0.11904761904761905
122,경기도,김포시,운양동,관내사전투표,8941,8941,6434,1763,617,84,8,8906,35,0,72.24343139456546,19.795643386481025,6.927913766000449,0.9431843700875815,0.08982708286548395
123,경기도,김포시,운양동,운양동제1투,2920,2170,1064,915,164,17,1,2161,9,750,49.23646459972235,42.34150856085146,7.589079130032392,0.7866728366496992,0.04627487274409996
124,경기도,김포시,운양동,운양동제2투,2739,1698,769,703,195,17,3,1687,11,1041,45.583876704208656,41.67160640189686,11.558980438648488,1.007705986959099,0.17783046828689983
125,경기도,김포시,운양동,운양동제3투,1940,1445,638,665,126,10,0,1439,6,495,44.3363446838082,46.21264767199444,8.756080611535788,0.6949270326615705,0.0
126,경기도,김포시,운양동,운양동제4투,2038,1600,751,645,177,17,2,1592,8,438,47.17336683417086,40.515075376884425,11.118090452261306,1.0678391959798994,0.12562814070351758
127,경기도,김포시,운양동,운양동제5투,3141,2272,1083,1001,163,12,1,2260,12,869,47.92035398230088,44.29203539823009,7.212389380530973,0.5309734513274336,0.04424778761061947
128,경기도,김포시,운양동,운양동제6투,2972,2217,1029,1004,154,17,0,2204,13,755,46.687840290381125,45.5535390199637,6.987295825771326,0.7713248638838476,0.0
129,경기도,김포시,운양동,운양동제7투,3035,2282,969,1119,154,24,1,2267,15,753,42.7437141596824,49.360388178209085,6.793118659020732,1.05866784296427,0.044111160123511246
130,경기도,김포시,운양동,운양동제8투,3034,2183,1013,963,178,18,2,2174,9,851,46.59613615455382,44.296228150873965,8.187672493100276,0.8279668813247469,0.09199632014719411
131,경기도,김포시,운양동,운양동제9투,3184,2206,968,1038,164,18,2,2190,16,978,44.20091324200913,47.397260273972606,7.488584474885844,0.821917808219178,0.091324200913242
132,경기도,김포시,잘못 투입·구분된 투표지,,0,0,0,0,0,0,0,0,0,0,0.0,0.0,0.0,0.0,0.0
0,경기도,광주시,거소·선상투표,,499,457,207,138,84,2,3,434,23,42,47.69585253456221,31.797235023041477,19.35483870967742,0.4608294930875576,0.6912442396313364
1,경기도,광주시,관외사전투표,,36002,35997,22866,8701,3798,312,43,35720,277,5,64.01455767077267,24.35890257558791,10.632698768197088,0.8734602463605823,0.12038073908174692
2,경기도,광주시,재외투표,,1741,1461,1061,252,115,25,1,1454,7,280,72.97111416781293,17.33149931224209,7.909215955983494,1.71939477303989,0.0687757909215956
3,경기도,광주시,초월읍,관내사전투표,8137,8136,5803,1794,449,57,1,8104,32,1,71.606614017769,22.137216189536034,5.540473840078974,0.7033563672260612,0.012339585389930897
4,경기도,광주시,초월읍,초월읍제1투,2498,1511,657,742,98,10,1,1508,3,987,43.567639257294424,49.20424403183024,6.49867374005305,0.6631299734748011,0.0663129973474801
5,경기도,광주시,초월읍,초월읍제2투,4501,3223,1612,1327,240,30,0,3209,14,1278,50.23371766905578,41.35244624493612,7.47896540978498,0.9348706762231225,0.0
6,경기도,광주시,초월읍,초월읍제3투,1305,803,376,342,72,4,1,795,8,502,47.29559748427673,43.0188679245283,9.056603773584905,0.5031446540880503,0.12578616352201258
7,경기도,광주시,초월읍,초월읍제4투,4601,3097,1476,1363,207,31,2,3079,18,1504,47.93764209158818,44.26761935693407,6.722962000649561,1.006820396232543,0.06495615459564794
8,경기도,광주시,초월읍,초월읍제5투,2168,1327,548,709,55,4,1,1317,10,841,41.60971905846621,53.83447228549735,4.176157934700076,0.30372057706909644,0.07593014426727411
9,경기도,광주시,초월읍,초월읍제6투,4043,2459,1123,1189,110,15,1,2438,21,1584,46.06234618539787,48.76948318293684,4.5118949958982775,0.6152584085315832,0.04101722723543889
10,경기도,광주시,초월읍,초월읍제7투,1391,902,300,558,34,2,3,897,5,489,33.44481605351171,62.207357859531776,3.79041248606466,0.2229654403567447,0.33444816053511706
11,경기도,광주시,초월읍,초월읍제8투,3552,2503,1233,1060,173,19,3,2488,15,1049,49.557877813504824,42.60450160771704,6.953376205787781,0.7636655948553055,0.12057877813504825
12,경기도,광주시,초월읍,초월읍제9투,2805,1818,840,825,137,6,0,1808,10,987,46.46017699115044,45.63053097345133,7.577433628318585,0.33185840707964603,0.0
13,경기도,광주시,초월읍,초월읍제10투,3878,2956,1373,1268,271,23,2,2937,19,922,46.748382703438885,43.17330609465441,9.227102485529452,0.7831120190670752,0.06809669731018045
14,경기도,광주시,곤지암읍,관내사전투표,5011,5011,3339,1307,288,25,3,4962,49,0,67.29141475211608,26.34018540910923,5.804111245465538,0.5038291011688835,0.06045949214026602
15,경기도,광주시,곤지암읍,곤지암읍제1투,2732,1864,763,940,127,14,4,1848,16,868,41.28787878787879,50.86580086580087,6.872294372294372,0.7575757575757576,0.21645021645021645
16,경기도,광주시,곤지암읍,곤지암읍제2투,3009,1681,592,989,77,9,3,1670,11,1328,35.449101796407184,59.221556886227546,4.610778443113772,0.5389221556886228,0.17964071856287425
17,경기도,광주시,곤지암읍,곤지암읍제3투,1783,1101,337,699,54,2,0,1092,9,682,30.86080586080586,64.01098901098901,4.945054945054945,0.18315018315018314,0.0
18,경기도,광주시,곤지암읍,곤지암읍제4투,1861,1196,355,768,49,7,3,1182,14,665,30.03384094754653,64.9746192893401,4.145516074450085,0.5922165820642978,0.25380710659898476
19,경기도,광주시,곤지암읍,곤지암읍제5투,3879,2608,1252,1133,189,17,2,2593,15,1271,48.28384111068261,43.69456228306981,7.288854608561511,0.6556112610875434,0.07713073659853452
20,경기도,광주시,도척면,관내사전투표,2316,2316,1544,648,100,10,2,2304,12,0,67.01388888888889,28.125,4.340277777777778,0.4340277777777778,0.08680555555555555
21,경기도,광주시,도척면,도척면제1투,2487,1500,632,771,76,15,0,1494,6,987,42.302543507362785,51.606425702811244,5.087014725568943,1.0040160642570282,0.0
22,경기도,광주시,도척면,도척면제2투,1970,1290,438,762,74,9,0,1283,7,680,34.138737334372564,59.392049883086514,5.767731878409977,0.7014809041309431,0.0
23,경기도,광주시,도척면,도척면제3투,933,612,188,402,15,3,0,608,4,321,30.92105263157895,66.11842105263158,2.4671052631578947,0.4934210526315789,0.0
24,경기도,광주시,퇴촌면,관내사전투표,3833,3833,2543,1140,119,20,0,3822,11,0,66.53584510727369,29.82731554160126,3.1135531135531136,0.5232862375719518,0.0
25,경기도,광주시,퇴촌면,퇴촌면제1투,2684,1585,493,1011,64,11,1,1580,5,1099,31.20253164556962,63.98734177215189,4.050632911392405,0.6962025316455696,0.06329113924050633
26,경기도,광주시,퇴촌면,퇴촌면제2투,2526,1574,616,868,73,8,5,1570,4,952,39.23566878980892,55.28662420382165,4.64968152866242,0.5095541401273885,0.3184713375796179
27,경기도,광주시,퇴촌면,퇴촌면제3투,3439,2174,808,1252,92,14,1,2167,7,1265,37.28657129672358,57.77572681125981,4.2455006922012,0.6460544531610521,0.046146746654360866
28,경기도,광주시,남종면,관내사전투표,313,313,156,139,14,4,0,313,0,0,49.84025559105431,44.40894568690096,4.472843450479233,1.2779552715654952,0.0
29,경기도,광주시,남종면,남종면제1투,459,323,69,244,7,2,0,322,1,136,21.428571428571427,75.77639751552795,2.1739130434782608,0.6211180124223602,0.0
30,경기도,광주시,남종면,남종면제2투,266,186,36,143,6,0,0,185,1,80,19.45945945945946,77.29729729729729,3.2432432432432434,0.0,0.0
31,경기도,광주시,남종면,남종면제3투,176,138,35,100,3,0,0,138,0,38,25.36231884057971,72.46376811594203,2.1739130434782608,0.0,0.0
32,경기도,광주시,남한산성면,관내사전투표,685,685,424,208,37,8,0,677,8,0,62.62924667651403,30.72378138847858,5.465288035450517,1.1816838995568686,0.0
33,경기도,광주시,남한산성면,남한산성면제1투,467,297,64,219,12,1,0,296,1,170,21.62162162162162,73.98648648648648,4.054054054054054,0.33783783783783783,0.0
34,경기도,광주시,남한산성면,남한산성면제2투,478,355,121,210,18,5,0,354,1,123,34.18079096045198,59.32203389830508,5.084745762711865,1.4124293785310735,0.0
35,경기도,광주시,남한산성면,남한산성면제3투,454,331,93,225,9,3,1,331,0,123,28.09667673716012,67.97583081570997,2.719033232628399,0.906344410876133,0.3021148036253776
36,경기도,광주시,오포1동,관내사전투표,5435,5435,3988,1121,282,26,6,5423,12,0,73.5386317536419,20.671215194541766,5.200073759911488,0.4794394246726904,0.11063986723215931
37,경기도,광주시,오포1동,오포1동제1투,2117,1497,701,670,101,18,0,1490,7,620,47.04697986577181,44.966442953020135,6.778523489932886,1.2080536912751678,0.0
38,경기도,광주시,오포1동,오포1동제2투,3995,2520,1103,1258,118,20,1,2500,20,1475,44.12,50.32,4.72,0.8,0.04
39,경기도,광주시,오포1동,오포1동제3투,4360,2731,1222,1269,195,23,3,2712,19,1629,45.05899705014749,46.792035398230084,7.1902654867256635,0.8480825958702065,0.11061946902654868
40,경기도,광주시,오포1동,오포1동제4투,1400,949,418,490,32,6,1,947,2,451,44.13938753959874,51.74234424498416,3.37909186906019,0.6335797254487857,0.10559662090813093
41,경기도,광주시,오포1동,오포1동제5투,4010,3067,1698,1096,238,20,2,3054,13,943,55.5992141453831,35.88736083824492,7.7930582842174205,0.6548788474132285,0.06548788474132286
42,경기도,광주시,오포2동,관내사전투표,5012,5012,3613,1037,310,30,5,4995,17,0,72.33233233233233,20.76076076076076,6.206206206206207,0.6006006006006006,0.10010010010010009
43,경기도,광주시,오포2동,오포2동제1투,4622,3022,1617,1196,159,27,2,3001,21,1600,53.882039320226596,39.853382205931354,5.298233922025991,0.8997000999666778,0.06664445184938354
44,경기도,광주시,오포2동,오포2동제2투,3540,2180,1151,838,167,11,0,2167,13,1360,53.11490539916935,38.6709736963544,7.706506691278264,0.5076142131979695,0.0
45,경기도,광주시,오포2동,오포2동제3투,2890,1951,801,963,156,13,0,1933,18,939,41.43817899637869,49.81893429901707,8.070356958096223,0.6725297465080186,0.0
46,경기도,광주시,오포2동,오포2동제4투,3389,2190,1066,975,114,15,5,2175,15,1199,49.01149425287356,44.827586206896555,5.241379310344827,0.6896551724137931,0.22988505747126436
47,경기도,광주시,오포2동,오포2동제5투,2036,1484,694,685,85,12,3,1479,5,552,46.9235970250169,46.315077755240026,5.747126436781609,0.8113590263691683,0.2028397565922921
48,경기도,광주시,오포2동,오포2동제6투,1943,1385,673,591,106,7,1,1378,7,558,48.8388969521045,42.88824383164006,7.6923076923076925,0.5079825834542816,0.07256894049346879
49,경기도,광주시,신현동,관내사전투표,6717,6717,4719,1530,412,29,2,6692,25,0,70.51703526598924,22.86312014345487,6.1566049013747755,0.4333532576210401,0.029886431560071723
50,경기도,광주시,신현동,신현동제1투,3349,1906,734,979,165,15,4,1897,9,1443,38.69267264101212,51.60780179230364,8.697944122298367,0.790722192936215,0.21085925144965736
51,경기도,광주시,신현동,신현동제2투,3542,2457,996,1255,182,13,1,2447,10,1085,40.702901512055575,51.28729055986923,7.437678790355537,0.5312627707396812,0.04086636697997548
52,경기도,광주시,신현동,신현동제3투,4857,2809,1292,1291,199,12,1,2795,14,2048,46.22540250447227,46.189624329159216,7.119856887298748,0.4293381037567084,0.03577817531305903
53,경기도,광주시,신현동,신현동제4투,4239,2778,1317,1260,167,15,3,2762,16,1461,47.682838522809554,45.61911658218682,6.046343229543809,0.5430847212165097,0.10861694424330195
54,경기도,광주시,신현동,신현동제5투,3427,2114,719,1197,170,12,2,2100,14,1313,34.23809523809524,56.99999999999999,8.095238095238095,0.5714285714285714,0.09523809523809523
55,경기도,광주시,능평동,관내사전투표,4442,4442,3197,958,231,31,2,4419,23,0,72.34668477031002,21.679112921475447,5.227427019687712,0.7015161801312514,0.04525910839556461
56,경기도,광주시,능평동,능평동제1투,1915,1251,567,592,78,8,0,1245,6,664,45.54216867469879,47.55020080321285,6.265060240963856,0.642570281124498,0.0
57,경기도,광주시,능평동,능평동제2투,3394,2165,932,1032,170,16,0,2150,15,1229,43.348837209302324,48.0,7.906976744186046,0.7441860465116279,0.0
58,경기도,광주시,능평동,능평동제3투,3311,2072,930,999,112,18,1,2060,12,1239,45.14563106796117,48.495145631067956,5.436893203883495,0.8737864077669903,0.04854368932038835
59,경기도,광주시,능평동,능평동제4투,3758,2381,988,1217,147,10,1,2363,18,1377,41.81125687685146,51.502327549724924,6.220905628438426,0.4231908590774439,0.04231908590774439
60,경기도,광주시,경안동,관내사전투표,7597,7597,4922,2001,569,56,5,7553,44,0,65.16615914206275,26.492784324109625,7.5334304249966895,0.7414272474513438,0.06619886137958426
61,경기도,광주시,경안동,경안동제1투,1821,986,305,599,59,18,1,982,4,835,31.05906313645621,60.9979633401222,6.008146639511202,1.8329938900203666,0.10183299389002036
62,경기도,광주시,경안동,경안동제2투,2756,1761,791,797,141,18,0,1747,14,995,45.27761877504293,45.621064682312536,8.070978820835718,1.030337721808815,0.0
63,경기도,광주시,경안동,경안동제3투,3302,2080,904,982,160,18,2,2066,14,1222,43.75605033881897,47.531461761858665,7.744433688286543,0.8712487899322363,0.0968054211035818
64,경기도,광주시,경안동,경안동제4투,3283,2242,1066,979,167,13,0,2225,17,1041,47.91011235955056,44.0,7.50561797752809,0.5842696629213483,0.0
65,경기도,광주시,경안동,경안동제5투,1937,1231,581,553,77,9,1,1221,10,706,47.583947583947584,45.29074529074529,6.306306306306306,0.7371007371007371,0.08190008190008191
66,경기도,광주시,경안동,경안동제6투,3134,2535,1180,1098,224,21,0,2523,12,599,46.76971858898138,43.51961950059453,8.878319460959176,0.8323424494649228,0.0
67,경기도,광주시,쌍령동,관내사전투표,4052,4051,2888,883,232,29,3,4035,16,1,71.57372986369269,21.88351920693928,5.749690210656754,0.7187112763320942,0.07434944237918216
68,경기도,광주시,쌍령동,쌍령동제1투,2145,1332,622,609,80,9,2,1322,10,813,47.0499243570348,46.066565809379725,6.051437216338881,0.680786686838124,0.15128593040847202
69,경기도,광주시,쌍령동,쌍령동제2투,2353,1548,764,657,104,4,2,1531,17,805,49.902024820378834,42.913128674069235,6.792945787067277,0.2612671456564337,0.13063357282821686
70,경기도,광주시,쌍령동,쌍령동제3투,2904,2103,881,1033,152,21,3,2090,13,801,42.153110047846894,49.42583732057416,7.2727272727272725,1.0047846889952152,0.14354066985645933
71,경기도,광주시,쌍령동,쌍령동제4투,1778,1343,692,519,113,12,2,1338,5,435,51.71898355754858,38.789237668161434,8.44544095665172,0.8968609865470852,0.14947683109118087
72,경기도,광주시,송정동,관내사전투표,3429,3429,2309,867,209,23,2,3410,19,0,67.71260997067449,25.425219941348974,6.129032258064516,0.6744868035190617,0.05865102639296188
73,경기도,광주시,송정동,송정동제1투,2073,1265,449,723,74,12,1,1259,6,808,35.66322478157268,57.426528991262906,5.877680698967434,0.9531374106433679,0.07942811755361398
74,경기도,광주시,송정동,송정동제2투,1426,984,446,472,56,7,0,981,3,442,45.4638124362895,48.11416921508665,5.708460754332314,0.7135575942915392,0.0
75,경기도,광주시,송정동,송정동제3투,2535,1831,789,882,131,17,4,1823,8,704,43.28030718595721,48.38178826110806,7.185957213384531,0.9325287986834888,0.21941854086670326
76,경기도,광주시,송정동,송정동제4투,1973,1486,664,695,93,20,1,1473,13,487,45.078071961982346,47.1826205023761,6.313645621181263,1.3577732518669383,0.0678886625933469
77,경기도,광주시,송정동,송정동제5투,1941,1221,548,591,63,8,2,1212,9,720,45.21452145214521,48.76237623762376,5.198019801980198,0.6600660066006601,0.16501650165016502
78,경기도,광주시,송정동,송정동제6투,3522,2228,1030,1015,145,25,3,2218,10,1294,46.43823264201984,45.7619477006312,6.537421100090171,1.127141568981064,0.1352569882777277
79,경기도,광주시,탄벌동,관내사전투표,7222,7222,5012,1761,381,43,4,7201,21,0,69.60144424385501,24.454936814331344,5.290931815025691,0.5971392862102486,0.05554784057769754
80,경기도,광주시,탄벌동,탄벌동제1투,2184,1254,599,547,88,12,1,1247,7,930,48.03528468323977,43.86527666399358,7.056936647955093,0.9623095429029671,0.08019246190858059
81,경기도,광주시,탄벌동,탄벌동제2투,2625,1951,757,1030,122,23,0,1932,19,674,39.18219461697723,53.31262939958592,6.3146997929606625,1.1904761904761905,0.0
82,경기도,광주시,탄벌동,탄벌동제3투,1442,881,369,446,56,7,0,878,3,561,42.027334851936224,50.79726651480638,6.378132118451026,0.7972665148063782,0.0
83,경기도,광주시,탄벌동,탄벌동제4투,5391,3872,1829,1674,316,32,2,3853,19,1519,47.469504282377365,43.446664936413185,8.20140150532053,0.8305216714248637,0.05190760446405398
84,경기도,광주시,탄벌동,탄벌동제5투,5183,3265,1676,1362,190,17,5,3250,15,1918,51.56923076923077,41.90769230769231,5.846153846153846,0.5230769230769231,0.15384615384615385
85,경기도,광주시,탄벌동,탄벌동제6투,3691,2289,1148,971,143,16,3,2281,8,1402,50.328803156510304,42.56904866286717,6.269180184129768,0.7014467338886453,0.131521262604121
86,경기도,광주시,탄벌동,탄벌동제7투,4059,2503,1169,1153,142,24,4,2492,11,1556,46.91011235955056,46.26805778491171,5.698234349919743,0.9630818619582664,0.16051364365971107
87,경기도,광주시,광남1동,관내사전투표,7960,7960,5703,1710,463,50,2,7928,32,0,71.93491422805248,21.56912209889001,5.840060544904137,0.6306760847628659,0.025227043390514632
88,경기도,광주시,광남1동,광남1동제1투,3230,1880,814,905,132,13,1,1865,15,1350,43.64611260053619,48.525469168900806,7.07774798927614,0.6970509383378015,0.05361930294906167
89,경기도,광주시,광남1동,광남1동제2투,3818,2419,1143,1088,161,14,3,2409,10,1399,47.447073474470734,45.16396845163968,6.68327106683271,0.5811540058115401,0.12453300124533001
90,경기도,광주시,광남1동,광남1동제3투,2502,1629,711,771,129,13,0,1624,5,873,43.7807881773399,47.47536945812808,7.943349753694581,0.8004926108374385,0.0
91,경기도,광주시,광남1동,광남1동제4투,2152,1338,599,657,67,6,4,1333,5,814,44.93623405851463,49.287321830457614,5.026256564141035,0.45011252813203295,0.30007501875468867
92,경기도,광주시,광남1동,광남1동제5투,3548,2398,1078,1091,191,17,2,2379,19,1150,45.31315678856662,45.859604875998315,8.028583438419505,0.7145859604875998,0.08406893652795291
93,경기도,광주시,광남1동,광남1동제6투,2110,1397,612,669,93,11,0,1385,12,713,44.187725631768956,48.30324909747292,6.714801444043321,0.7942238267148014,0.0
94,경기도,광주시,광남2동,관내사전투표,5838,5838,4332,1056,378,36,2,5804,34,0,74.6381805651275,18.194348725017228,6.51274982770503,0.6202618883528601,0.03445899379738111
95,경기도,광주시,광남2동,광남2동제1투,3159,2166,1140,859,131,21,1,2152,14,993,52.973977695167285,39.91635687732342,6.087360594795539,0.9758364312267658,0.046468401486988845
96,경기도,광주시,광남2동,광남2동제2투,3153,2342,1078,1065,172,18,2,2335,7,811,46.16702355460385,45.610278372591004,7.366167023554604,0.7708779443254818,0.08565310492505353
97,경기도,광주시,광남2동,광남2동제3투,3147,2397,1241,963,160,16,0,2380,17,750,52.142857142857146,40.46218487394958,6.722689075630252,0.6722689075630253,0.0
98,경기도,광주시,광남2동,광남2동제4투,2155,1636,782,734,96,15,2,1629,7,519,48.004910988336405,45.058317986494785,5.893186003683241,0.9208103130755065,0.12277470841006752
99,경기도,광주시,광남2동,광남2동제5투,2403,1776,887,734,137,12,1,1771,5,627,50.08469791078487,41.4455110107284,7.7357425183512145,0.6775832862789385,0.0564652738565782
100,경기도,광주시,광남2동,광남2동제6투,2115,1579,784,678,99,14,0,1575,4,536,49.77777777777778,43.047619047619044,6.2857142857142865,0.8888888888888888,0.0
101,경기도,광주시,잘못 투입·구분된 투표지,,0,1,1,0,0,0,0,1,0,-1,100.0,0.0,0.0,0.0,0.0
0,경기도,포천시,거소·선상투표,,246,233,92,69,49,3,3,216,17,13,42.592592592592595,31.944444444444443,22.685185185185187,1.3888888888888888,1.3888888888888888
1,경기도,포천시,관외사전투표,,9466,9466,5087,3077,1119,81,9,9373,93,0,54.272911554464955,32.82833671183186,11.9385468900032,0.8641843593299904,0.09602048436999894
2,경기도,포천시,재외투표,,422,339,218,77,38,4,0,337,2,83,64.68842729970326,22.8486646884273,11.275964391691394,1.1869436201780417,0.0
3,경기도,포천시,소흘읍,관내사전투표,8476,8476,5597,2298,478,45,8,8426,50,0,66.42535010681226,27.27272727272727,5.672917161167814,0.5340612390220745,0.09494422027059103
4,경기도,포천시,소흘읍,소흘읍제1투,2881,1508,670,730,87,8,2,1497,11,1373,44.7561790247161,48.76419505678023,5.811623246492986,0.5344021376085505,0.13360053440213762
5,경기도,포천시,소흘읍,소흘읍제2투,1289,724,242,440,32,7,0,721,3,565,33.56449375866852,61.026352288488205,4.438280166435506,0.9708737864077669,0.0
6,경기도,포천시,소흘읍,소흘읍제3투,2007,1445,513,863,55,6,0,1437,8,562,35.699373695198325,60.05567153792624,3.8274182324286707,0.41753653444676403,0.0
7,경기도,포천시,소흘읍,소흘읍제4투,3476,2024,850,1021,124,13,0,2008,16,1452,42.330677290836654,50.84661354581673,6.175298804780876,0.647410358565737,0.0
8,경기도,포천시,소흘읍,소흘읍제5투,2788,2038,926,932,143,25,1,2027,11,750,45.683275777010365,45.97927972372965,7.054760730143069,1.23334977799704,0.049333991119881605
9,경기도,포천시,소흘읍,소흘읍제6투,2386,1463,614,713,112,12,3,1454,9,923,42.2283356258597,49.037138927097665,7.702888583218708,0.8253094910591471,0.20632737276478677
10,경기도,포천시,소흘읍,소흘읍제7투,2413,1442,582,741,93,13,0,1429,13,971,40.72778166550035,51.85444366689993,6.508047585724283,0.9097270818754375,0.0
11,경기도,포천시,소흘읍,소흘읍제8투,2744,1836,905,724,152,26,4,1811,25,908,49.97239094422971,39.97791275538376,8.393152954168967,1.4356709000552181,0.22087244616234128
12,경기도,포천시,소흘읍,소흘읍제9투,2089,1341,635,571,105,19,0,1330,11,748,47.744360902255636,42.93233082706767,7.894736842105263,1.4285714285714286,0.0
13,경기도,포천시,소흘읍,소흘읍제10투,1640,1098,499,491,92,6,0,1088,10,542,45.86397058823529,45.12867647058824,8.455882352941178,0.5514705882352942,0.0
14,경기도,포천시,소흘읍,소흘읍제11투,1628,1189,585,493,91,11,3,1183,6,439,49.45054945054945,41.67371090448014,7.6923076923076925,0.9298393913778529,0.25359256128486896
15,경기도,포천시,군내면,관내사전투표,2228,2228,1304,763,128,14,2,2211,17,0,58.97783808231569,34.509271822704655,5.789235639981909,0.6331976481230213,0.09045680687471733
16,경기도,포천시,군내면,군내면제1투,2940,1819,673,1008,109,15,4,1809,10,1121,37.202874516307354,55.72139303482587,6.0254284134881155,0.8291873963515755,0.22111663902708678
17,경기도,포천시,군내면,군내면제2투,1065,674,267,359,40,4,1,671,3,391,39.79135618479881,53.50223546944859,5.961251862891207,0.5961251862891207,0.14903129657228018
18,경기도,포천시,군내면,군내면제3투,1155,740,207,494,30,3,2,736,4,415,28.125,67.11956521739131,4.076086956521739,0.4076086956521739,0.2717391304347826
19,경기도,포천시,내촌면,관내사전투표,1277,1277,711,494,52,5,0,1262,15,0,56.3391442155309,39.144215530903324,4.120443740095087,0.39619651347068147,0.0
20,경기도,포천시,내촌면,내촌면제1투,1398,899,318,524,50,3,1,896,3,499,35.49107142857143,58.48214285714286,5.580357142857143,0.33482142857142855,0.11160714285714285
21,경기도,포천시,내촌면,내촌면제2투,439,241,67,161,9,0,0,237,4,198,28.270042194092827,67.9324894514768,3.79746835443038,0.0,0.0
22,경기도,포천시,내촌면,내촌면제3투,656,405,118,259,22,1,1,401,4,251,29.42643391521197,64.58852867830423,5.486284289276807,0.24937655860349126,0.24937655860349126
23,경기도,포천시,가산면,관내사전투표,2244,2244,1379,723,115,10,1,2228,16,0,61.894075403949735,32.450628366247756,5.161579892280072,0.4488330341113106,0.04488330341113106
24,경기도,포천시,가산면,가산면제1투,1890,1127,397,658,53,4,4,1116,11,763,35.57347670250896,58.96057347670251,4.749103942652329,0.35842293906810035,0.35842293906810035
25,경기도,포천시,가산면,가산면제2투,1293,803,298,466,30,4,2,800,3,490,37.25,58.25,3.75,0.5,0.25
26,경기도,포천시,가산면,가산면제3투,966,589,162,404,19,2,0,587,2,377,27.597955706984667,68.82453151618398,3.2367972742759794,0.34071550255536626,0.0
27,경기도,포천시,신북면,관내사전투표,2109,2109,1214,737,127,10,2,2090,19,0,58.08612440191388,35.26315789473684,6.076555023923445,0.4784688995215311,0.09569377990430622
28,경기도,포천시,신북면,신북면제1투,1681,1032,432,536,48,8,3,1027,5,649,42.06426484907498,52.19084712755598,4.673807205452775,0.7789678675754625,0.2921129503407984
29,경기도,포천시,신북면,신북면제2투,2023,1094,402,616,60,7,1,1086,8,929,37.01657458563536,56.721915285451196,5.524861878453039,0.6445672191528545,0.09208103130755065
30,경기도,포천시,신북면,신북면제3투,1157,777,216,519,32,4,0,771,6,380,28.01556420233463,67.31517509727627,4.150453955901426,0.5188067444876783,0.0
31,경기도,포천시,신북면,신북면제4투,695,458,97,347,10,1,0,455,3,237,21.318681318681318,76.26373626373626,2.197802197802198,0.21978021978021978,0.0
32,경기도,포천시,신북면,신북면제5투,1313,798,315,426,43,3,0,787,11,515,40.02541296060991,54.129606099110546,5.463786531130877,0.3811944091486658,0.0
33,경기도,포천시,창수면,관내사전투표,635,635,321,272,36,3,0,632,3,0,50.79113924050633,43.037974683544306,5.69620253164557,0.4746835443037975,0.0
34,경기도,포천시,창수면,창수면제1투,607,393,92,280,13,3,0,388,5,214,23.711340206185564,72.16494845360825,3.350515463917526,0.7731958762886598,0.0
35,경기도,포천시,창수면,창수면제2투,546,365,124,221,12,3,0,360,5,181,34.44444444444444,61.38888888888889,3.3333333333333335,0.8333333333333334,0.0
36,경기도,포천시,영중면,관내사전투표,1494,1494,823,562,92,7,3,1487,7,0,55.34633490248824,37.794216543375924,6.186953597848016,0.4707464694014795,0.20174848688634836
37,경기도,포천시,영중면,영중면제1투,510,324,102,202,16,1,0,321,3,186,31.775700934579437,62.928348909657316,4.984423676012461,0.3115264797507788,0.0
38,경기도,포천시,영중면,영중면제2투,1703,1047,309,687,35,9,0,1040,7,656,29.71153846153846,66.0576923076923,3.3653846153846154,0.8653846153846154,0.0
39,경기도,포천시,영중면,영중면제3투,406,267,98,153,12,1,2,266,1,139,36.84210526315789,57.5187969924812,4.511278195488721,0.37593984962406013,0.7518796992481203
40,경기도,포천시,일동면,관내사전투표,2204,2204,1184,817,174,16,1,2192,12,0,54.01459854014598,37.27189781021898,7.937956204379562,0.7299270072992701,0.04562043795620438
41,경기도,포천시,일동면,일동면제1투,1472,836,285,508,34,3,2,832,4,636,34.25480769230769,61.057692307692314,4.086538461538462,0.3605769230769231,0.2403846153846154
42,경기도,포천시,일동면,일동면제2투,322,242,73,157,9,0,0,239,3,80,30.543933054393307,65.69037656903765,3.765690376569038,0.0,0.0
43,경기도,포천시,일동면,일동면제3투,932,650,210,404,28,1,2,645,5,282,32.55813953488372,62.63565891472869,4.341085271317829,0.15503875968992248,0.31007751937984496
44,경기도,포천시,일동면,일동면제4투,1577,950,337,541,57,8,1,944,6,627,35.69915254237288,57.309322033898304,6.038135593220339,0.847457627118644,0.1059322033898305
45,경기도,포천시,일동면,일동면제5투,304,218,72,136,6,1,0,215,3,86,33.48837209302326,63.25581395348837,2.7906976744186047,0.46511627906976744,0.0
46,경기도,포천시,일동면,일동면제6투,657,362,95,254,9,1,1,360,2,295,26.38888888888889,70.55555555555556,2.5,0.2777777777777778,0.2777777777777778
47,경기도,포천시,이동면,관내사전투표,1281,1281,613,516,133,7,1,1270,11,0,48.26771653543307,40.62992125984252,10.47244094488189,0.5511811023622047,0.07874015748031496
48,경기도,포천시,이동면,이동면제1투,1008,653,199,389,56,5,1,650,3,355,30.615384615384617,59.84615384615385,8.615384615384615,0.7692307692307693,0.15384615384615385
49,경기도,포천시,이동면,이동면제2투,571,357,86,252,9,1,1,349,8,214,24.641833810888254,72.20630372492836,2.5787965616045847,0.28653295128939826,0.28653295128939826
50,경기도,포천시,이동면,이동면제3투,572,388,118,247,18,3,0,386,2,184,30.569948186528496,63.98963730569949,4.66321243523316,0.7772020725388601,0.0
51,경기도,포천시,이동면,이동면제4투,1071,707,244,383,65,5,1,698,9,364,34.95702005730659,54.87106017191977,9.312320916905444,0.7163323782234957,0.14326647564469913
52,경기도,포천시,영북면,관내사전투표,1675,1675,897,597,143,19,1,1657,18,0,54.133977066988535,36.02896801448401,8.630054315027158,1.1466505733252867,0.06035003017501509
53,경기도,포천시,영북면,영북면제1투,1145,658,198,426,27,3,0,654,4,487,30.275229357798167,65.13761467889908,4.128440366972478,0.45871559633027525,0.0
54,경기도,포천시,영북면,영북면제2투,491,350,86,245,13,4,0,348,2,141,24.71264367816092,70.40229885057471,3.7356321839080464,1.1494252873563218,0.0
55,경기도,포천시,영북면,영북면제3투,1179,721,246,385,73,4,1,709,12,458,34.696755994358256,54.30183356840621,10.296191819464035,0.5641748942172073,0.14104372355430184
56,경기도,포천시,영북면,영북면제4투,164,112,35,73,3,0,0,111,1,52,31.53153153153153,65.76576576576578,2.7027027027027026,0.0,0.0
57,경기도,포천시,영북면,영북면제5투,763,483,151,290,33,1,2,477,6,280,31.656184486373167,60.79664570230609,6.918238993710692,0.20964360587002098,0.41928721174004197
58,경기도,포천시,영북면,영북면제6투,325,214,62,140,8,1,1,212,2,111,29.245283018867923,66.0377358490566,3.7735849056603774,0.4716981132075472,0.4716981132075472
59,경기도,포천시,영북면,영북면제7투,361,216,49,158,6,0,0,213,3,145,23.004694835680752,74.17840375586854,2.8169014084507045,0.0,0.0
60,경기도,포천시,관인면,관내사전투표,675,675,358,262,48,4,0,672,3,0,53.273809523809526,38.98809523809524,7.142857142857142,0.5952380952380952,0.0
61,경기도,포천시,관인면,관인면제1투,890,541,166,347,21,5,0,539,2,349,30.79777365491651,64.37847866419295,3.896103896103896,0.927643784786642,0.0
62,경기도,포천시,관인면,관인면제2투,309,210,61,140,6,1,0,208,2,99,29.326923076923077,67.3076923076923,2.8846153846153846,0.4807692307692308,0.0
63,경기도,포천시,관인면,관인면제3투,309,219,72,132,12,1,0,217,2,90,33.17972350230415,60.82949308755761,5.529953917050691,0.4608294930875576,0.0
64,경기도,포천시,화현면,관내사전투표,598,598,312,238,38,4,0,592,6,0,52.702702702702695,40.2027027027027,6.418918918918918,0.6756756756756757,0.0
65,경기도,포천시,화현면,화현면제1투,1010,640,164,436,31,3,0,634,6,370,25.86750788643533,68.76971608832808,4.889589905362776,0.47318611987381703,0.0
66,경기도,포천시,화현면,화현면제2투,346,235,66,154,8,3,0,231,4,111,28.57142857142857,66.66666666666666,3.463203463203463,1.2987012987012987,0.0
67,경기도,포천시,포천동,관내사전투표,5470,5470,3365,1663,354,42,4,5428,42,0,61.9933677229182,30.63743551952837,6.521739130434782,0.7737656595431098,0.07369196757553427
68,경기도,포천시,포천동,포천동제1투,2444,1583,617,853,87,14,3,1574,9,861,39.1994917407878,54.19313850063533,5.527318932655654,0.8894536213468869,0.1905972045743329
69,경기도,포천시,포천동,포천동제2투,1111,646,215,392,30,3,2,642,4,465,33.48909657320872,61.059190031152646,4.672897196261682,0.46728971962616817,0.3115264797507788
70,경기도,포천시,포천동,포천동제3투,2490,1569,632,824,93,11,3,1563,6,921,40.435060780550224,52.7191298784389,5.950095969289827,0.7037747920665387,0.19193857965451055
71,경기도,포천시,포천동,포천동제4투,3064,1938,748,1028,129,12,3,1920,18,1126,38.958333333333336,53.541666666666664,6.71875,0.625,0.15625
72,경기도,포천시,포천동,포천동제5투,2207,1326,570,634,95,16,2,1317,9,881,43.28018223234624,48.13971146545178,7.213363705391041,1.2148823082763858,0.15186028853454822
73,경기도,포천시,선단동,관내사전투표,3419,3419,2175,969,205,27,10,3386,33,0,64.23508564678086,28.617838157117543,6.0543414057885405,0.7974010632014176,0.29533372711163614
74,경기도,포천시,선단동,선단동제1투,3244,1906,893,860,122,11,0,1886,20,1338,47.348886532343585,45.59915164369035,6.468716861081654,0.5832449628844115,0.0
75,경기도,포천시,선단동,선단동제2투,831,538,195,321,14,3,0,533,5,293,36.58536585365854,60.22514071294559,2.6266416510318953,0.5628517823639775,0.0
76,경기도,포천시,선단동,선단동제3투,884,491,147,320,15,4,0,486,5,393,30.246913580246915,65.84362139917695,3.0864197530864197,0.823045267489712,0.0
77,경기도,포천시,선단동,선단동제4투,3551,1926,871,895,125,14,5,1910,16,1625,45.6020942408377,46.8586387434555,6.544502617801047,0.7329842931937173,0.2617801047120419
78,경기도,포천시,잘못 투입·구분된 투표지,,0,0,0,0,0,0,0,0,0,0,0.0,0.0,0.0,0.0,0.0
0,경기도,연천군,거소·선상투표,,253,249,85,75,67,2,3,232,17,4,36.637931034482754,32.327586206896555,28.879310344827587,0.8620689655172413,1.293103448275862
1,경기도,연천군,관외사전투표,,3322,3321,1712,1182,359,33,6,3292,29,1,52.0048602673147,35.9052247873633,10.905224787363304,1.0024301336573511,0.18226002430133656
2,경기도,연천군,재외투표,,128,108,76,19,12,0,0,107,1,20,71.02803738317756,17.75700934579439,11.214953271028037,0.0,0.0
3,경기도,연천군,연천읍,관내사전투표,1973,1973,1087,657,176,22,2,1944,29,0,55.9156378600823,33.7962962962963,9.053497942386832,1.131687242798354,0.102880658436214
4,경기도,연천군,연천읍,연천읍제1투,1419,942,309,552,65,6,2,934,8,477,33.08351177730193,59.100642398286936,6.9593147751606,0.6423982869379015,0.21413276231263384
5,경기도,연천군,연천읍,연천읍제2투,786,535,180,327,19,5,0,531,4,251,33.89830508474576,61.5819209039548,3.5781544256120528,0.9416195856873822,0.0
6,경기도,연천군,연천읍,연천읍제3투,1146,707,251,345,99,4,0,699,8,439,35.908440629470675,49.35622317596567,14.163090128755366,0.5722460658082975,0.0
7,경기도,연천군,연천읍,연천읍제4투,175,121,44,73,3,0,0,120,1,54,36.666666666666664,60.83333333333333,2.5,0.0,0.0
8,경기도,연천군,연천읍,연천읍제5투,687,467,126,309,17,9,1,462,5,220,27.27272727272727,66.88311688311688,3.67965367965368,1.948051948051948,0.21645021645021645
9,경기도,연천군,전곡읍,관내사전투표,4044,4043,2328,1359,276,38,6,4007,36,1,58.09832792612928,33.915647616670825,6.887946094334914,0.9483404042924881,0.1497379585724981
10,경기도,연천군,전곡읍,전곡읍제1투,1883,1091,352,640,80,7,2,1081,10,792,32.56244218316374,59.204440333024976,7.400555041628122,0.6475485661424607,0.18501387604070307
11,경기도,연천군,전곡읍,전곡읍제2투,536,319,98,200,18,2,0,318,1,217,30.81761006289308,62.893081761006286,5.660377358490567,0.628930817610063,0.0
12,경기도,연천군,전곡읍,전곡읍제3투,2925,1827,661,1044,99,16,0,1820,7,1098,36.318681318681314,57.36263736263736,5.43956043956044,0.8791208791208791,0.0
13,경기도,연천군,전곡읍,전곡읍제4투,886,585,200,319,51,7,1,578,7,301,34.602076124567475,55.19031141868512,8.823529411764707,1.2110726643598615,0.17301038062283738
14,경기도,연천군,전곡읍,전곡읍제5투,1470,933,323,548,51,6,0,928,5,537,34.80603448275862,59.05172413793104,5.495689655172414,0.646551724137931,0.0
15,경기도,연천군,전곡읍,전곡읍제6투,233,172,63,100,8,0,0,171,1,61,36.84210526315789,58.47953216374269,4.678362573099415,0.0,0.0
16,경기도,연천군,전곡읍,전곡읍제7투,188,132,39,88,4,0,0,131,1,56,29.770992366412212,67.17557251908397,3.0534351145038165,0.0,0.0
17,경기도,연천군,전곡읍,전곡읍제8투,284,197,70,122,3,1,0,196,1,87,35.714285714285715,62.244897959183675,1.530612244897959,0.5102040816326531,0.0
18,경기도,연천군,전곡읍,전곡읍제9투,1562,978,354,538,65,7,2,966,12,584,36.64596273291926,55.6935817805383,6.728778467908903,0.7246376811594203,0.2070393374741201
19,경기도,연천군,군남면,관내사전투표,419,419,205,189,23,2,0,419,0,0,48.92601431980907,45.10739856801909,5.4892601431980905,0.47732696897374705,0.0
20,경기도,연천군,군남면,군남면제1투,437,312,104,198,9,0,0,311,1,125,33.440514469453376,63.665594855305464,2.8938906752411575,0.0,0.0
21,경기도,연천군,군남면,군남면제2투,324,238,78,148,9,2,0,237,1,86,32.91139240506329,62.447257383966246,3.79746835443038,0.8438818565400843,0.0
22,경기도,연천군,군남면,군남면제3투,303,215,70,142,2,0,1,215,0,88,32.55813953488372,66.04651162790698,0.9302325581395349,0.0,0.46511627906976744
23,경기도,연천군,군남면,군남면제4투,698,481,197,256,20,3,1,477,4,217,41.299790356394126,53.66876310272537,4.1928721174004195,0.628930817610063,0.20964360587002098
24,경기도,연천군,군남면,군남면제5투,170,111,21,71,16,1,0,109,2,59,19.26605504587156,65.13761467889908,14.678899082568808,0.9174311926605505,0.0
25,경기도,연천군,청산면,관내사전투표,964,964,482,354,110,9,2,957,7,0,50.36572622779519,36.990595611285265,11.494252873563218,0.9404388714733543,0.20898641588296762
26,경기도,연천군,청산면,청산면제1투,1242,847,213,593,25,6,1,838,9,395,25.41766109785203,70.76372315035799,2.983293556085919,0.7159904534606205,0.11933174224343676
27,경기도,연천군,청산면,청산면제2투,694,452,136,289,21,2,0,448,4,242,30.357142857142854,64.50892857142857,4.6875,0.4464285714285714,0.0
28,경기도,연천군,청산면,청산면제3투,564,345,114,205,22,4,0,345,0,219,33.04347826086956,59.42028985507246,6.3768115942028984,1.1594202898550725,0.0
29,경기도,연천군,백학면,관내사전투표,638,638,325,270,36,4,0,635,3,0,51.181102362204726,42.51968503937008,5.669291338582677,0.6299212598425197,0.0
30,경기도,연천군,백학면,백학면제1투,838,528,136,359,26,1,1,523,5,310,26.003824091778206,68.64244741873804,4.97131931166348,0.19120458891013384,0.19120458891013384
31,경기도,연천군,백학면,백학면제2투,607,376,107,246,16,4,1,374,2,231,28.609625668449194,65.77540106951871,4.27807486631016,1.06951871657754,0.267379679144385
32,경기도,연천군,미산면,관내사전투표,343,343,172,149,17,1,1,340,3,0,50.588235294117645,43.8235294117647,5.0,0.29411764705882354,0.29411764705882354
33,경기도,연천군,미산면,미산면투표소,917,585,167,390,19,7,0,583,2,332,28.644939965694682,66.89536878216124,3.2590051457975986,1.2006861063464835,0.0
34,경기도,연천군,왕징면,관내사전투표,365,365,196,142,22,4,0,364,1,0,53.84615384615385,39.010989010989015,6.043956043956044,1.098901098901099,0.0
35,경기도,연천군,왕징면,왕징면제1투,267,179,53,119,3,2,1,178,1,88,29.775280898876407,66.85393258426966,1.6853932584269662,1.1235955056179776,0.5617977528089888
36,경기도,연천군,왕징면,왕징면제2투,120,80,24,49,2,4,0,79,1,40,30.37974683544304,62.0253164556962,2.5316455696202533,5.063291139240507,0.0
37,경기도,연천군,왕징면,왕징면제3투,221,156,51,97,5,2,0,155,1,65,32.903225806451616,62.58064516129033,3.225806451612903,1.2903225806451613,0.0
38,경기도,연천군,신서면,관내사전투표,761,761,401,289,57,4,2,753,8,0,53.253652058432934,38.37981407702523,7.569721115537849,0.5312084993359893,0.2656042496679947
39,경기도,연천군,신서면,신서면제1투,807,513,167,325,16,2,1,511,2,294,32.68101761252446,63.600782778864975,3.131115459882583,0.3913894324853229,0.19569471624266144
40,경기도,연천군,신서면,신서면제2투,113,86,31,52,2,1,0,86,0,27,36.04651162790697,60.46511627906976,2.3255813953488373,1.1627906976744187,0.0
41,경기도,연천군,신서면,신서면제3투,145,108,35,68,4,0,0,107,1,37,32.71028037383177,63.55140186915887,3.7383177570093453,0.0,0.0
42,경기도,연천군,신서면,신서면제4투,324,205,71,122,10,2,0,205,0,119,34.63414634146341,59.512195121951216,4.878048780487805,0.975609756097561,0.0
43,경기도,연천군,중면,관내사전투표,82,82,31,31,19,0,0,81,1,0,38.2716049382716,38.2716049382716,23.456790123456788,0.0,0.0
44,경기도,연천군,중면,중면투표소,104,73,21,48,1,1,0,71,2,31,29.577464788732392,67.6056338028169,1.4084507042253522,1.4084507042253522,0.0
45,경기도,연천군,장남면,관내사전투표,181,181,92,74,12,2,0,180,1,0,51.11111111111111,41.11111111111111,6.666666666666667,1.1111111111111112,0.0
46,경기도,연천군,장남면,장남면투표소,426,317,94,201,15,2,0,312,5,109,30.128205128205128,64.42307692307693,4.807692307692308,0.641025641025641,0.0
47,경기도,연천군,잘못 투입·구분된 투표지,,0,0,0,0,0,0,0,0,0,0,0.0,0.0,0.0,0.0,0.0
0,경기도,양평군,거소·선상투표,,240,221,87,87,39,2,0,215,6,19,40.46511627906977,40.46511627906977,18.13953488372093,0.9302325581395349,0.0
1,경기도,양평군,관외사전투표,,12344,12342,6530,4383,1187,130,17,12247,95,2,53.31918020739773,35.78835633216298,9.69216951090063,1.0614844451702459,0.13880950436841677
2,경기도,양평군,재외투표,,884,731,524,134,56,13,2,729,2,153,71.87928669410151,18.381344307270233,7.681755829903978,1.7832647462277091,0.2743484224965706
3,경기도,양평군,양평읍,관내사전투표,8004,8003,4767,2576,539,68,5,7955,48,1,59.92457573852923,32.38214959145192,6.775612822124449,0.8548082966687618,0.06285355122564425
4,경기도,양평군,양평읍,양평읍제1투,2611,1524,441,990,71,9,3,1514,10,1087,29.12813738441215,65.38969616908851,4.689564068692206,0.59445178335535,0.19815059445178335
5,경기도,양평군,양평읍,양평읍제2투,4120,2798,1008,1567,181,26,0,2782,16,1322,36.23292595255212,56.32638389647735,6.506110711718188,0.9345794392523363,0.0
6,경기도,양평군,양평읍,양평읍제3투,926,631,141,463,18,6,1,629,2,295,22.416534181240063,73.60890302066773,2.8616852146263914,0.9538950715421303,0.1589825119236884
7,경기도,양평군,양평읍,양평읍제4투,1039,679,189,464,17,3,3,676,3,360,27.958579881656803,68.63905325443787,2.514792899408284,0.4437869822485207,0.4437869822485207
8,경기도,양평군,양평읍,양평읍제5투,3646,2274,732,1379,135,16,1,2263,11,1372,32.346442775077335,60.93680954485197,5.965532479010164,0.7070260715863897,0.04418912947414936
9,경기도,양평군,양평읍,양평읍제6투,1616,1064,356,646,50,8,0,1060,4,552,33.58490566037736,60.94339622641509,4.716981132075472,0.7547169811320755,0.0
10,경기도,양평군,양평읍,양평읍제7투,2767,1828,675,1018,103,19,0,1815,13,939,37.1900826446281,56.088154269972456,5.674931129476584,1.046831955922865,0.0
11,경기도,양평군,양평읍,양평읍제8투,2795,1742,611,998,107,15,0,1731,11,1053,35.297515886770654,57.65453495089543,6.1813980358174465,0.8665511265164645,0.0
12,경기도,양평군,강상면,관내사전투표,3154,3153,1844,1061,202,30,1,3138,15,1,58.76354365838113,33.81134480560867,6.437221159974506,0.9560229445506693,0.03186743148502231
13,경기도,양평군,강상면,강상면제1투,2782,1836,558,1167,89,12,1,1827,9,946,30.541871921182267,63.8752052545156,4.871373836891078,0.6568144499178982,0.05473453749315819
14,경기도,양평군,강상면,강상면제2투,1453,943,287,594,41,13,1,936,7,510,30.662393162393165,63.46153846153846,4.38034188034188,1.3888888888888888,0.10683760683760685
15,경기도,양평군,강상면,강상면제3투,909,618,181,408,23,5,0,617,1,291,29.3354943273906,66.12641815235008,3.727714748784441,0.8103727714748784,0.0
16,경기도,양평군,강하면,관내사전투표,1251,1250,709,464,58,7,1,1239,11,1,57.223567393058914,37.44955609362389,4.681194511702986,0.5649717514124294,0.08071025020177562
17,경기도,양평군,강하면,강하면제1투,1432,901,185,677,30,6,1,899,2,531,20.57842046718576,75.3058954393771,3.337041156840934,0.6674082313681869,0.11123470522803114
18,경기도,양평군,강하면,강하면제2투,1240,826,174,630,16,2,0,822,4,414,21.16788321167883,76.64233576642336,1.9464720194647203,0.24330900243309003,0.0
19,경기도,양평군,양서면,관내사전투표,2749,2749,1723,835,152,28,3,2741,8,0,62.86026997446188,30.463334549434514,5.545421379058737,1.0215249908792412,0.10944910616563297
20,경기도,양평군,양서면,양서면제1투,2820,2033,658,1245,97,21,2,2023,10,787,32.52595155709342,61.542263964409294,4.794859120118636,1.0380622837370241,0.09886307464162135
21,경기도,양평군,양서면,양서면제2투,949,650,208,394,39,4,0,645,5,299,32.248062015503876,61.08527131782946,6.046511627906977,0.6201550387596899,0.0
22,경기도,양평군,양서면,양서면제3투,2960,1796,544,1136,85,22,0,1787,9,1164,30.442081701175155,63.57022943480693,4.756575265808618,1.2311135982092893,0.0
23,경기도,양평군,양서면,양서면제4투,1008,698,223,434,30,6,0,693,5,310,32.17893217893218,62.62626262626263,4.329004329004329,0.8658008658008658,0.0
24,경기도,양평군,옥천면,관내사전투표,2935,2935,1770,956,172,20,4,2922,13,0,60.57494866529775,32.71731690622861,5.886379192334018,0.6844626967830253,0.13689253935660506
25,경기도,양평군,옥천면,옥천면제1투,1338,863,292,505,52,9,0,858,5,475,34.032634032634036,58.857808857808855,6.0606060606060606,1.048951048951049,0.0
26,경기도,양평군,옥천면,옥천면제2투,1045,666,165,465,28,2,0,660,6,379,25.0,70.45454545454545,4.242424242424243,0.30303030303030304,0.0
27,경기도,양평군,옥천면,옥천면제3투,935,633,149,464,14,5,1,633,0,302,23.538704581358612,73.30173775671406,2.211690363349131,0.7898894154818324,0.1579778830963665
28,경기도,양평군,옥천면,옥천면제4투,847,535,165,346,20,2,0,533,2,312,30.95684803001876,64.9155722326454,3.75234521575985,0.37523452157598497,0.0
29,경기도,양평군,서종면,관내사전투표,2085,2085,1385,599,77,19,0,2080,5,0,66.58653846153845,28.79807692307692,3.701923076923077,0.9134615384615385,0.0
30,경기도,양평군,서종면,서종면제1투,2269,1489,464,932,74,12,0,1482,7,780,31.309041835357625,62.88798920377868,4.993252361673414,0.8097165991902834,0.0
31,경기도,양평군,서종면,서종면제2투,596,423,145,256,19,3,0,423,0,173,34.2789598108747,60.520094562647756,4.491725768321513,0.7092198581560284,0.0
32,경기도,양평군,서종면,서종면제3투,735,479,132,319,23,2,0,476,3,256,27.73109243697479,67.01680672268907,4.831932773109244,0.42016806722689076,0.0
33,경기도,양평군,서종면,서종면제4투,412,257,54,193,6,2,0,255,2,155,21.176470588235293,75.68627450980392,2.3529411764705883,0.7843137254901961,0.0
34,경기도,양평군,서종면,서종면제5투,1080,724,201,477,38,4,1,721,3,356,27.877947295423024,66.15811373092927,5.270457697642163,0.5547850208044383,0.13869625520110956
35,경기도,양평군,단월면,관내사전투표,1165,1165,606,488,47,10,2,1153,12,0,52.55854293148309,42.32437120555074,4.076322636600174,0.8673026886383347,0.17346053772766695
36,경기도,양평군,단월면,단월면제1투,739,471,133,320,14,3,0,470,1,268,28.297872340425535,68.08510638297872,2.9787234042553195,0.6382978723404255,0.0
37,경기도,양평군,단월면,단월면제2투,828,488,104,367,13,0,0,484,4,340,21.487603305785125,75.82644628099173,2.6859504132231407,0.0,0.0
38,경기도,양평군,단월면,단월면제3투,347,241,62,170,8,0,0,240,1,106,25.833333333333336,70.83333333333334,3.3333333333333335,0.0,0.0
39,경기도,양평군,단월면,단월면제4투,184,116,24,83,2,1,0,110,6,68,21.818181818181817,75.45454545454545,1.8181818181818181,0.9090909090909091,0.0
40,경기도,양평군,청운면,관내사전투표,1116,1116,577,467,53,9,1,1107,9,0,52.12285456187895,42.18608852755194,4.787714543812105,0.8130081300813009,0.09033423667570009
41,경기도,양평군,청운면,청운면제1투,788,495,118,345,20,9,0,492,3,293,23.983739837398375,70.1219512195122,4.0650406504065035,1.8292682926829267,0.0
42,경기도,양평군,청운면,청운면제2투,395,244,62,175,3,3,0,243,1,151,25.514403292181072,72.0164609053498,1.2345679012345678,1.2345679012345678,0.0
43,경기도,양평군,청운면,청운면제3투,466,250,61,177,7,3,0,248,2,216,24.596774193548388,71.37096774193549,2.82258064516129,1.2096774193548387,0.0
44,경기도,양평군,청운면,청운면제4투,458,274,63,194,7,4,1,269,5,184,23.42007434944238,72.11895910780669,2.6022304832713754,1.486988847583643,0.37174721189591076
45,경기도,양평군,양동면,관내사전투표,1170,1170,582,506,43,21,2,1154,16,0,50.43327556325823,43.84748700173311,3.726169844020797,1.8197573656845754,0.17331022530329288
46,경기도,양평군,양동면,양동면제1투,1136,713,172,503,21,6,0,702,11,423,24.501424501424502,71.65242165242165,2.9914529914529915,0.8547008547008548,0.0
47,경기도,양평군,양동면,양동면제2투,485,307,76,216,9,4,0,305,2,178,24.91803278688525,70.81967213114754,2.9508196721311477,1.3114754098360655,0.0
48,경기도,양평군,양동면,양동면제3투,562,365,74,274,12,0,1,361,4,197,20.498614958448755,75.90027700831024,3.32409972299169,0.0,0.2770083102493075
49,경기도,양평군,양동면,양동면제4투,360,243,63,172,6,1,0,242,1,117,26.033057851239672,71.07438016528926,2.479338842975207,0.4132231404958678,0.0
50,경기도,양평군,지평면,관내사전투표,1806,1806,934,720,99,16,2,1771,35,0,52.73856578204404,40.65499717673631,5.590062111801243,0.9034443817052512,0.1129305477131564
51,경기도,양평군,지평면,지평면제1투,680,428,109,300,15,1,0,425,3,252,25.647058823529413,70.58823529411765,3.5294117647058822,0.2352941176470588,0.0
52,경기도,양평군,지평면,지평면제2투,633,419,112,284,14,5,1,416,3,214,26.923076923076923,68.26923076923077,3.3653846153846154,1.201923076923077,0.2403846153846154
53,경기도,양평군,지평면,지평면제3투,546,353,81,251,16,2,0,350,3,193,23.142857142857142,71.71428571428572,4.571428571428571,0.5714285714285714,0.0
54,경기도,양평군,지평면,지평면제4투,631,397,93,294,7,1,0,395,2,234,23.544303797468356,74.43037974683544,1.7721518987341773,0.25316455696202533,0.0
55,경기도,양평군,지평면,지평면제5투,654,416,105,285,20,1,1,412,4,238,25.485436893203882,69.1747572815534,4.854368932038835,0.24271844660194172,0.24271844660194172
56,경기도,양평군,지평면,지평면제6투,572,399,114,273,8,3,0,398,1,173,28.643216080402013,68.5929648241206,2.0100502512562812,0.7537688442211055,0.0
57,경기도,양평군,용문면,관내사전투표,4778,4778,2839,1615,240,43,7,4744,34,0,59.844013490725125,34.04300168634064,5.059021922428331,0.906408094435076,0.1475548060708263
58,경기도,양평군,용문면,용문면제1투,2405,1540,492,955,80,9,1,1537,3,865,32.01040988939493,62.134027325959664,5.204944697462589,0.5855562784645413,0.06506180871828238
59,경기도,양평군,용문면,용문면제2투,2234,1422,460,896,48,6,2,1412,10,812,32.577903682719544,63.45609065155807,3.39943342776204,0.424929178470255,0.141643059490085
60,경기도,양평군,용문면,용문면제3투,1544,871,271,508,76,9,3,867,4,673,31.257208765859286,58.59284890426759,8.765859284890427,1.0380622837370241,0.34602076124567477
61,경기도,양평군,용문면,용문면제4투,1046,680,194,446,29,3,2,674,6,366,28.783382789317507,66.17210682492582,4.302670623145401,0.44510385756676557,0.2967359050445104
62,경기도,양평군,용문면,용문면제5투,1463,967,307,604,32,14,3,960,7,496,31.979166666666664,62.916666666666664,3.3333333333333335,1.4583333333333333,0.3125
63,경기도,양평군,용문면,용문면제6투,553,398,100,282,11,1,0,394,4,155,25.380710659898476,71.57360406091371,2.7918781725888326,0.25380710659898476,0.0
64,경기도,양평군,용문면,용문면제7투,615,424,125,285,11,2,0,423,1,191,29.550827423167846,67.37588652482269,2.6004728132387704,0.4728132387706856,0.0
65,경기도,양평군,개군면,관내사전투표,1350,1350,738,516,74,15,2,1345,5,0,54.869888475836426,38.36431226765799,5.5018587360594795,1.1152416356877324,0.14869888475836432
66,경기도,양평군,개군면,개군면제1투,1228,821,213,563,36,3,0,815,6,407,26.134969325153374,69.079754601227,4.41717791411043,0.36809815950920244,0.0
67,경기도,양평군,개군면,개군면제2투,1041,715,235,444,23,7,0,709,6,326,33.14527503526093,62.62341325811002,3.244005641748942,0.9873060648801129,0.0
68,경기도,양평군,개군면,개군면제3투,726,491,103,371,12,2,0,488,3,235,21.10655737704918,76.02459016393442,2.459016393442623,0.4098360655737705,0.0
69,경기도,양평군,잘못 투입·구분된 투표지,,0,0,0,0,0,0,0,0,0,0,0.0,0.0,0.0,0.0,0.0
0,경기도,가평군,거소·선상투표,,326,316,162,91,36,4,4,297,19,10,54.54545454545454,30.63973063973064,12.121212121212121,1.3468013468013467,1.3468013468013467
1,경기도,가평군,관외사전투표,,5481,5480,2739,2042,588,51,6,5426,54,1,50.47917434574272,37.6336159233321,10.836712126796904,0.9399189089568744,0.11057869517139698
2,경기도,가평군,재외투표,,310,246,172,43,26,3,0,244,2,64,70.49180327868852,17.62295081967213,10.655737704918032,1.2295081967213115,0.0
3,경기도,가평군,가평읍,관내사전투표,5290,5290,3017,1810,364,59,2,5252,38,0,57.444782939832436,34.463061690784464,6.9306930693069315,1.1233815689261235,0.03808073115003808
4,경기도,가평군,가평읍,가평읍제1투,2821,1781,604,1025,124,12,3,1768,13,1040,34.16289592760181,57.97511312217195,7.013574660633484,0.6787330316742082,0.16968325791855204
5,경기도,가평군,가평읍,가평읍제2투,1578,1021,359,603,44,6,4,1016,5,557,35.33464566929133,59.35039370078739,4.330708661417323,0.5905511811023622,0.39370078740157477
6,경기도,가평군,가평읍,가평읍제3투,3353,2205,737,1290,144,18,2,2191,14,1148,33.637608397991784,58.87722501141032,6.572341396622547,0.8215426745778184,0.09128251939753537
7,경기도,가평군,가평읍,가평읍제4투,1144,717,244,431,30,5,2,712,5,427,34.26966292134831,60.53370786516854,4.213483146067416,0.7022471910112359,0.2808988764044944
8,경기도,가평군,가평읍,가평읍제5투,794,519,140,349,23,3,1,516,3,275,27.131782945736433,67.63565891472868,4.457364341085271,0.5813953488372093,0.1937984496124031
9,경기도,가평군,가평읍,가평읍제6투,730,496,161,318,13,2,1,495,1,234,32.525252525252526,64.24242424242425,2.6262626262626263,0.40404040404040403,0.20202020202020202
10,경기도,가평군,가평읍,가평읍제7투,756,517,130,355,23,2,2,512,5,239,25.390625,69.3359375,4.4921875,0.390625,0.390625
11,경기도,가평군,가평읍,가평읍제8투,523,356,99,249,3,1,2,354,2,167,27.966101694915253,70.33898305084746,0.847457627118644,0.2824858757062147,0.5649717514124294
12,경기도,가평군,설악면,관내사전투표,2481,2481,1264,1059,123,23,1,2470,11,0,51.174089068825914,42.874493927125506,4.979757085020243,0.931174089068826,0.04048582995951417
13,경기도,가평군,설악면,설악면제1투,1573,958,198,717,32,5,0,952,6,615,20.798319327731093,75.31512605042016,3.361344537815126,0.5252100840336135,0.0
14,경기도,가평군,설악면,설악면제2투,740,468,98,347,17,4,0,466,2,272,21.030042918454935,74.46351931330472,3.648068669527897,0.8583690987124464,0.0
15,경기도,가평군,설악면,설악면제3투,851,571,146,400,18,1,1,566,5,280,25.795053003533567,70.6713780918728,3.180212014134275,0.17667844522968199,0.17667844522968199
16,경기도,가평군,설악면,설악면제4투,520,361,90,252,13,2,0,357,4,159,25.210084033613445,70.58823529411765,3.6414565826330536,0.5602240896358543,0.0
17,경기도,가평군,설악면,설악면제5투,1541,919,191,664,59,3,0,917,2,622,20.828789531079607,72.41003271537623,6.4340239912759,0.3271537622682661,0.0
18,경기도,가평군,청평면,관내사전투표,3117,3117,1815,1118,152,15,2,3102,15,0,58.51063829787234,36.041263700838165,4.9000644745325594,0.4835589941972921,0.06447453255963895
19,경기도,가평군,청평면,청평면제1투,2318,1503,445,976,67,12,0,1500,3,815,29.666666666666668,65.06666666666666,4.466666666666667,0.8,0.0
20,경기도,가평군,청평면,청평면제2투,1133,792,145,629,14,1,0,789,3,341,18.377693282636248,79.72116603295311,1.7743979721166032,0.12674271229404308,0.0
21,경기도,가평군,청평면,청평면제3투,275,175,36,128,11,0,0,175,0,100,20.57142857142857,73.14285714285714,6.2857142857142865,0.0,0.0
22,경기도,가평군,청평면,청평면제4투,2795,1753,538,1115,73,10,1,1737,16,1042,30.97294185377087,64.19113413932067,4.202648244099021,0.5757052389176741,0.05757052389176742
23,경기도,가평군,청평면,청평면제5투,347,238,66,166,4,1,0,237,1,109,27.848101265822784,70.042194092827,1.6877637130801686,0.42194092827004215,0.0
24,경기도,가평군,청평면,청평면제6투,659,458,157,273,23,3,0,456,2,201,34.42982456140351,59.86842105263158,5.0438596491228065,0.6578947368421052,0.0
25,경기도,가평군,청평면,청평면제7투,348,236,55,175,5,1,0,236,0,112,23.30508474576271,74.15254237288136,2.11864406779661,0.423728813559322,0.0
26,경기도,가평군,상면,관내사전투표,1229,1229,681,458,73,9,3,1224,5,0,55.63725490196079,37.41830065359477,5.9640522875816995,0.7352941176470588,0.24509803921568626
27,경기도,가평군,상면,상면제1투,984,663,178,455,23,4,0,660,3,321,26.969696969696972,68.93939393939394,3.4848484848484853,0.6060606060606061,0.0
28,경기도,가평군,상면,상면제2투,797,487,133,331,19,4,0,487,0,310,27.31006160164271,67.96714579055441,3.9014373716632447,0.8213552361396305,0.0
29,경기도,가평군,상면,상면제3투,329,218,43,166,8,0,0,217,1,111,19.81566820276498,76.49769585253456,3.686635944700461,0.0,0.0
30,경기도,가평군,상면,상면제4투,675,447,110,312,19,4,1,446,1,228,24.663677130044842,69.95515695067265,4.260089686098654,0.8968609865470852,0.2242152466367713
31,경기도,가평군,상면,상면제5투,380,256,79,166,9,1,0,255,1,124,30.980392156862745,65.09803921568627,3.5294117647058822,0.39215686274509803,0.0
32,경기도,가평군,조종면,관내사전투표,2068,2068,1103,749,153,19,4,2028,40,0,54.38856015779092,36.93293885601578,7.544378698224852,0.9368836291913214,0.19723865877712032
33,경기도,가평군,조종면,조종면제1투,1384,830,260,509,45,7,0,821,9,554,31.668696711327648,61.99756394640682,5.481120584652863,0.8526187576126675,0.0
34,경기도,가평군,조종면,조종면제2투,975,594,193,346,45,2,1,587,7,381,32.87904599659284,58.94378194207837,7.666098807495741,0.34071550255536626,0.17035775127768313
35,경기도,가평군,조종면,조종면제3투,951,601,229,299,58,8,0,594,7,350,38.552188552188554,50.33670033670033,9.764309764309765,1.3468013468013467,0.0
36,경기도,가평군,조종면,조종면제4투,926,513,179,288,21,12,2,502,11,413,35.657370517928285,57.37051792828686,4.183266932270916,2.3904382470119523,0.398406374501992
37,경기도,가평군,조종면,조종면제5투,431,282,79,185,12,2,0,278,4,149,28.41726618705036,66.54676258992805,4.316546762589928,0.7194244604316548,0.0
38,경기도,가평군,조종면,조종면제6투,455,317,75,223,13,1,0,312,5,138,24.03846153846154,71.47435897435898,4.166666666666666,0.3205128205128205,0.0
39,경기도,가평군,북면,관내사전투표,873,873,434,389,44,0,0,867,6,0,50.05767012687428,44.86735870818916,5.074971164936563,0.0,0.0
40,경기도,가평군,북면,북면제1투,809,516,133,358,23,0,0,514,2,293,25.87548638132296,69.64980544747081,4.474708171206226,0.0,0.0
41,경기도,가평군,북면,북면제2투,456,305,88,206,8,2,0,304,1,151,28.947368421052634,67.76315789473685,2.631578947368421,0.6578947368421052,0.0
42,경기도,가평군,북면,북면제3투,433,283,90,178,8,7,0,283,0,150,31.802120141342755,62.89752650176679,2.8268551236749118,2.4734982332155475,0.0
43,경기도,가평군,북면,북면제4투,307,196,50,135,9,0,0,194,2,111,25.773195876288657,69.58762886597938,4.639175257731959,0.0,0.0
44,경기도,가평군,잘못 투입·구분된 투표지,,0,0,0,0,0,0,0,0,0,0,0.0,0.0,0.0,0.0,0.0
0,경기도,화성시갑,거소·선상투표,,601,573,244,168,132,6,2,552,21,28,44.20289855072464,30.434782608695656,23.91304347826087,1.0869565217391304,0.36231884057971014
1,경기도,화성시갑,관외사전투표,,42291,42282,24627,11001,5812,397,54,41891,391,9,58.78828387959227,26.26101071829271,13.874101835716502,0.9476975961423695,0.12890597025614095
2,경기도,화성시갑,재외투표,,1710,1418,980,243,160,20,2,1405,13,292,69.7508896797153,17.295373665480426,11.387900355871885,1.4234875444839856,0.1423487544483986
3,경기도,화성시갑,봉담읍,관내사전투표,13668,13668,9605,2793,1088,94,8,13588,80,0,70.68737120989108,20.554901383573743,8.00706505740359,0.691786870768325,0.05887547836326171
4,경기도,화성시갑,봉담읍,봉담읍제1투,2290,1543,568,861,91,10,1,1531,12,747,37.09993468321359,56.23775310254735,5.943827563683867,0.6531678641410843,0.06531678641410843
5,경기도,화성시갑,봉담읍,봉담읍제2투,1692,968,347,551,60,4,2,964,4,724,35.995850622406635,57.15767634854772,6.224066390041494,0.4149377593360996,0.2074688796680498
6,경기도,화성시갑,봉담읍,봉담읍제3투,2905,1988,861,889,203,20,3,1976,12,917,43.57287449392713,44.98987854251012,10.273279352226721,1.0121457489878543,0.15182186234817813
7,경기도,화성시갑,봉담읍,봉담읍제4투,3837,2736,1430,1031,242,17,4,2724,12,1101,52.496328928046985,37.84875183553598,8.883994126284875,0.6240822320117474,0.14684287812041116
8,경기도,화성시갑,봉담읍,봉담읍제5투,3604,2498,1152,1038,268,25,2,2485,13,1106,46.358148893360166,41.770623742454724,10.784708249496981,1.0060362173038229,0.08048289738430583
9,경기도,화성시갑,봉담읍,봉담읍제6투,3282,2040,937,890,169,23,4,2023,17,1242,46.3173504695996,43.9940682155215,8.353929807217005,1.1369253583786456,0.1977261492832427
10,경기도,화성시갑,봉담읍,봉담읍제7투,2142,1468,674,617,151,15,1,1458,10,674,46.22770919067216,42.31824417009602,10.356652949245541,1.02880658436214,0.06858710562414265
11,경기도,화성시갑,봉담읍,봉담읍제8투,2674,1766,887,740,104,15,0,1746,20,908,50.801832760595644,42.38258877434135,5.956471935853378,0.859106529209622,0.0
12,경기도,화성시갑,봉담읍,봉담읍제9투,2776,2151,1226,714,181,18,5,2144,7,625,57.18283582089553,33.30223880597015,8.442164179104477,0.8395522388059702,0.23320895522388058
13,경기도,화성시갑,봉담읍,봉담읍제10투,4431,3404,1611,1461,291,18,6,3387,17,1027,47.564216120460586,43.13551815766164,8.591674047829938,0.5314437555358724,0.1771479185119575
14,경기도,화성시갑,봉담읍,봉담읍제11투,2783,1964,916,861,147,19,2,1945,19,819,47.095115681233935,44.267352185089976,7.557840616966581,0.9768637532133676,0.10282776349614395
15,경기도,화성시갑,봉담읍,봉담읍제12투,2788,2163,1186,758,182,22,3,2151,12,625,55.13714551371455,35.23942352394236,8.461180846118085,1.0227801022780103,0.1394700139470014
16,경기도,화성시갑,봉담읍,봉담읍제13투,3084,2109,1125,775,165,25,2,2092,17,975,53.77629063097514,37.04588910133843,7.88718929254302,1.1950286806883366,0.09560229445506692
17,경기도,화성시갑,봉담읍,봉담읍제14투,3705,2872,1646,922,264,24,2,2858,14,833,57.592722183345,32.260321903428974,9.237228831350595,0.8397480755773268,0.06997900629811056
18,경기도,화성시갑,봉담읍,봉담읍제15투,4360,2602,1121,1196,237,24,4,2582,20,1758,43.415956622773045,46.32068164213788,9.178931061192873,0.9295120061967467,0.1549186676994578
19,경기도,화성시갑,봉담읍,봉담읍제16투,2444,1874,938,711,196,15,3,1863,11,570,50.348899624261946,38.164251207729464,10.52066559312936,0.8051529790660225,0.1610305958132045
20,경기도,화성시갑,봉담읍,봉담읍제17투,3303,2260,1194,787,236,26,1,2244,16,1043,53.20855614973262,35.071301247771835,10.51693404634581,1.1586452762923352,0.044563279857397504
21,경기도,화성시갑,봉담읍,봉담읍제18투,2247,1663,886,636,121,10,2,1655,8,584,53.53474320241693,38.429003021148034,7.311178247734139,0.6042296072507553,0.12084592145015105
22,경기도,화성시갑,봉담읍,봉담읍제19투,3862,2774,1415,994,317,25,5,2756,18,1088,51.342525399129165,36.06676342525399,11.502177068214804,0.9071117561683599,0.18142235123367198
23,경기도,화성시갑,봉담읍,봉담읍제20투,3172,2560,1267,910,328,30,1,2536,24,612,49.96056782334385,35.88328075709779,12.933753943217665,1.1829652996845426,0.03943217665615142
24,경기도,화성시갑,우정읍,관내사전투표,4872,4872,3181,1282,331,51,4,4849,23,0,65.60115487729429,26.438440915652713,6.826149721592081,1.0517632501546712,0.08249123530624872
25,경기도,화성시갑,우정읍,우정읍제1투,2636,1540,689,726,96,17,2,1530,10,1096,45.032679738562095,47.45098039215686,6.2745098039215685,1.1111111111111112,0.130718954248366
26,경기도,화성시갑,우정읍,우정읍제2투,1802,1020,305,670,29,5,2,1011,9,782,30.16815034619189,66.27101879327398,2.868447082096934,0.4945598417408506,0.19782393669634024
27,경기도,화성시갑,우정읍,우정읍제3투,2288,1303,514,687,79,11,0,1291,12,985,39.814097598760654,53.21456235476375,6.119287374128582,0.8520526723470179,0.0
28,경기도,화성시갑,우정읍,우정읍제4투,961,604,290,251,43,13,2,599,5,357,48.41402337228715,41.90317195325542,7.178631051752922,2.1702838063439067,0.333889816360601
29,경기도,화성시갑,우정읍,우정읍제5투,1058,668,230,387,37,3,0,657,11,390,35.0076103500761,58.9041095890411,5.6316590563165905,0.45662100456621,0.0
30,경기도,화성시갑,우정읍,우정읍제6투,914,592,204,346,27,7,1,585,7,322,34.87179487179487,59.14529914529915,4.615384615384616,1.1965811965811968,0.17094017094017094
31,경기도,화성시갑,향남읍,관내사전투표,12043,12043,8675,2206,974,110,4,11969,74,0,72.47890383490684,18.430946612081208,8.137689029994151,0.9190408555434874,0.033419667474308634
32,경기도,화성시갑,향남읍,향남읍제1투,2157,1189,487,582,95,9,1,1174,15,968,41.48211243611584,49.57410562180579,8.091993185689947,0.7666098807495741,0.08517887563884156
33,경기도,화성시갑,향남읍,향남읍제2투,4712,2562,1070,1089,354,26,2,2541,21,2150,42.109405745769386,42.857142857142854,13.931523022432113,1.023219205037387,0.07870916961826052
34,경기도,화성시갑,향남읍,향남읍제3투,750,482,153,302,23,3,0,481,1,268,31.80873180873181,62.78586278586279,4.781704781704782,0.6237006237006237,0.0
35,경기도,화성시갑,향남읍,향남읍제4투,1093,639,198,403,29,3,1,634,5,454,31.230283911671926,63.56466876971609,4.574132492113565,0.47318611987381703,0.15772870662460567
36,경기도,화성시갑,향남읍,향남읍제5투,2305,1523,696,707,95,10,4,1512,11,782,46.03174603174603,46.75925925925926,6.283068783068783,0.6613756613756614,0.26455026455026454
37,경기도,화성시갑,향남읍,향남읍제6투,3686,2564,1283,1074,163,28,1,2549,15,1122,50.33346410357002,42.13417026284817,6.3946645743428805,1.0984699882306788,0.03923107100823853
38,경기도,화성시갑,향남읍,향남읍제7투,1897,1324,680,552,77,7,2,1318,6,573,51.593323216995444,41.88163884673748,5.842185128983308,0.5311077389984825,0.15174506828528073
39,경기도,화성시갑,향남읍,향남읍제8투,2530,1820,857,808,127,14,2,1808,12,710,47.400442477876105,44.690265486725664,7.024336283185841,0.7743362831858407,0.11061946902654868
40,경기도,화성시갑,향남읍,향남읍제9투,2635,1956,1105,667,152,17,0,1941,15,679,56.92941782586296,34.363730036063885,7.8310149407521905,0.8758371973209685,0.0
41,경기도,화성시갑,향남읍,향남읍제10투,1972,1472,886,444,115,10,4,1459,13,500,60.726525017135025,30.431802604523643,7.882111034955449,0.6854009595613434,0.2741603838245374
42,경기도,화성시갑,향남읍,향남읍제11투,2060,1344,732,452,135,14,3,1336,8,716,54.79041916167665,33.83233532934132,10.104790419161677,1.0479041916167664,0.2245508982035928
43,경기도,화성시갑,향남읍,향남읍제12투,2016,1176,581,504,68,8,3,1164,12,840,49.91408934707904,43.29896907216495,5.841924398625429,0.6872852233676976,0.25773195876288657
44,경기도,화성시갑,향남읍,향남읍제13투,1572,1235,731,407,82,10,0,1230,5,337,59.430894308943095,33.08943089430894,6.666666666666667,0.8130081300813009,0.0
45,경기도,화성시갑,향남읍,향남읍제14투,2920,2134,1314,630,165,15,1,2125,9,786,61.83529411764705,29.64705882352941,7.764705882352942,0.7058823529411765,0.047058823529411764
46,경기도,화성시갑,향남읍,향남읍제15투,4273,2937,1555,1128,206,30,4,2923,14,1336,53.1987683886418,38.59048922340062,7.047553882996921,1.0263427984946971,0.13684570646595962
47,경기도,화성시갑,향남읍,향남읍제16투,3707,2642,1564,825,215,21,1,2626,16,1065,59.55826351865956,31.416603198781416,8.187357197258187,0.7996953541507997,0.03808073115003808
48,경기도,화성시갑,향남읍,향남읍제17투,3526,2031,1009,802,189,18,1,2019,12,1495,49.975235264982665,39.722634967805845,9.36106983655275,0.8915304606240713,0.04952947003467063
49,경기도,화성시갑,향남읍,향남읍제18투,3714,2063,1022,798,213,13,2,2048,15,1651,49.90234375,38.96484375,10.400390625,0.634765625,0.09765625
50,경기도,화성시갑,향남읍,향남읍제19투,1950,1448,735,443,233,22,1,1434,14,502,51.25523012552301,30.892608089260808,16.248256624825665,1.5341701534170153,0.0697350069735007
51,경기도,화성시갑,남양읍,관내사전투표,11151,11151,7294,2606,1111,74,9,11094,57,0,65.74725076617992,23.49017486929872,10.014422210203714,0.6670272219217596,0.08112493239588967
52,경기도,화성시갑,남양읍,남양읍제1투,3598,2201,913,1071,184,16,3,2187,14,1397,41.746684956561495,48.971193415637856,8.413351623228166,0.7315957933241883,0.1371742112482853
53,경기도,화성시갑,남양읍,남양읍제2투,3972,2350,939,1213,163,17,2,2334,16,1622,40.23136246786632,51.97086546700943,6.983718937446444,0.7283633247643531,0.08568980291345331
54,경기도,화성시갑,남양읍,남양읍제3투,3193,1930,698,1102,103,15,5,1923,7,1263,36.29745189807592,57.306292251690074,5.356214248569943,0.7800312012480499,0.26001040041601664
55,경기도,화성시갑,남양읍,남양읍제4투,778,524,150,348,17,5,1,521,3,254,28.79078694817658,66.79462571976967,3.262955854126679,0.9596928982725527,0.19193857965451055
56,경기도,화성시갑,남양읍,남양읍제5투,3972,2144,980,869,257,18,3,2127,17,1828,46.0742830277386,40.85566525622943,12.082745651151857,0.846262341325811,0.14104372355430184
57,경기도,화성시갑,남양읍,남양읍제6투,2392,1349,487,685,163,6,0,1341,8,1043,36.31618195376585,51.08128262490679,12.15510812826249,0.44742729306487694,0.0
58,경기도,화성시갑,남양읍,남양읍제7투,4086,3030,1395,1193,392,36,4,3020,10,1056,46.19205298013245,39.503311258278146,12.980132450331125,1.1920529801324504,0.13245033112582782
59,경기도,화성시갑,남양읍,남양읍제8투,3602,2319,1020,961,300,21,2,2304,15,1283,44.27083333333333,41.71006944444444,13.020833333333334,0.9114583333333334,0.08680555555555555
60,경기도,화성시갑,남양읍,남양읍제9투,4061,2996,1508,1210,235,25,1,2979,17,1065,50.62101376300772,40.61765693185633,7.888553205773749,0.8392077878482713,0.033568311513930846
61,경기도,화성시갑,남양읍,남양읍제10투,4039,2932,1441,1171,267,28,6,2913,19,1107,49.467902506007555,40.19910744936492,9.165808444902163,0.9612083762444216,0.20597322348094746
62,경기도,화성시갑,매송면,관내사전투표,1538,1538,909,500,111,6,1,1527,11,0,59.52848722986247,32.74394237066143,7.269155206286837,0.3929273084479371,0.06548788474132286
63,경기도,화성시갑,매송면,매송면제1투,1663,1048,360,609,69,5,1,1044,4,615,34.48275862068966,58.333333333333336,6.609195402298851,0.4789272030651341,0.09578544061302681
64,경기도,화성시갑,매송면,매송면제2투,1140,791,309,418,40,12,3,782,9,349,39.514066496163686,53.452685421994886,5.115089514066496,1.5345268542199488,0.3836317135549872
65,경기도,화성시갑,매송면,매송면제3투,1223,815,279,470,55,2,1,807,8,408,34.572490706319705,58.24039653035935,6.815365551425032,0.24783147459727387,0.12391573729863693
66,경기도,화성시갑,비봉면,관내사전투표,2979,2979,1865,844,235,17,1,2962,17,0,62.96421336934503,28.49426063470628,7.933828494260635,0.5739365293720459,0.0337609723160027
67,경기도,화성시갑,비봉면,비봉면제1투,2839,1793,546,1115,106,10,1,1778,15,1046,30.708661417322837,62.71091113610798,5.961754780652419,0.562429696287964,0.05624296962879641
68,경기도,화성시갑,비봉면,비봉면제2투,4447,3124,1437,1243,392,25,4,3101,23,1323,46.339890357949045,40.083843921315705,12.641083521444695,0.8061915511125444,0.1289906481780071
69,경기도,화성시갑,비봉면,비봉면제3투,518,366,109,240,13,2,0,364,2,152,29.945054945054945,65.93406593406593,3.571428571428571,0.5494505494505495,0.0
70,경기도,화성시갑,마도면,관내사전투표,2461,2461,1555,715,147,20,3,2440,21,0,63.729508196721305,29.303278688524593,6.024590163934426,0.819672131147541,0.12295081967213116
71,경기도,화성시갑,마도면,마도면제1투,2564,1436,468,854,89,12,6,1429,7,1128,32.750174947515745,59.76207137858643,6.22813156053184,0.8397480755773268,0.4198740377886634
72,경기도,화성시갑,마도면,마도면제2투,1411,837,273,525,32,1,1,832,5,574,32.8125,63.10096153846154,3.8461538461538463,0.1201923076923077,0.1201923076923077
73,경기도,화성시갑,송산면,관내사전투표,2769,2769,1596,989,146,17,3,2751,18,0,58.01526717557252,35.95056343147946,5.307161032351872,0.6179571065067249,0.10905125408942204
74,경기도,화성시갑,송산면,송산면제1투,3679,2052,644,1269,119,14,1,2047,5,1627,31.46067415730337,61.993160723009275,5.813385442110405,0.6839276990718124,0.048851978505129456
75,경기도,화성시갑,송산면,송산면제2투,1052,714,158,515,32,5,0,710,4,338,22.253521126760564,72.53521126760563,4.507042253521127,0.7042253521126761,0.0
76,경기도,화성시갑,송산면,송산면제3투,1513,978,267,670,30,3,2,972,6,535,27.469135802469136,68.93004115226337,3.0864197530864197,0.30864197530864196,0.205761316872428
77,경기도,화성시갑,서신면,관내사전투표,2132,2132,1204,782,118,13,2,2119,13,0,56.81925436526664,36.904200094384144,5.568664464369986,0.6134969325153374,0.09438414346389806
78,경기도,화성시갑,서신면,서신면제1투,1422,809,216,542,40,7,0,805,4,613,26.83229813664596,67.32919254658385,4.968944099378882,0.8695652173913043,0.0
79,경기도,화성시갑,서신면,서신면제2투,1583,919,240,636,34,2,3,915,4,664,26.229508196721312,69.50819672131148,3.715846994535519,0.2185792349726776,0.32786885245901637
80,경기도,화성시갑,서신면,서신면제3투,1152,684,185,470,20,6,1,682,2,468,27.126099706744867,68.91495601173021,2.932551319648094,0.8797653958944283,0.1466275659824047
81,경기도,화성시갑,팔탄면,관내사전투표,4344,4344,2813,1228,255,27,4,4327,17,0,65.0103998151144,28.379939912179342,5.893228564825515,0.623988906863878,0.09244280101687082
82,경기도,화성시갑,팔탄면,팔탄면제1투,3019,1765,632,1001,106,13,2,1754,11,1254,36.03192702394527,57.06955530216648,6.043329532497149,0.7411630558722919,0.11402508551881414
83,경기도,화성시갑,팔탄면,팔탄면제2투,1285,801,280,470,43,4,0,797,4,484,35.131744040150565,58.971141781681304,5.395232120451694,0.5018820577164366,0.0
84,경기도,화성시갑,팔탄면,팔탄면제3투,1380,817,267,512,31,2,1,813,4,563,32.84132841328413,62.97662976629766,3.8130381303813037,0.24600246002460024,0.12300123001230012
85,경기도,화성시갑,장안면,관내사전투표,1990,1990,1245,610,121,9,1,1986,4,0,62.688821752265866,30.71500503524673,6.092648539778449,0.4531722054380665,0.050352467270896276
86,경기도,화성시갑,장안면,장안면제1투,1561,852,290,503,50,5,0,848,4,709,34.19811320754717,59.31603773584906,5.89622641509434,0.589622641509434,0.0
87,경기도,화성시갑,장안면,장안면제2투,1458,761,253,456,44,5,0,758,3,697,33.37730870712401,60.15831134564644,5.804749340369393,0.6596306068601583,0.0
88,경기도,화성시갑,장안면,장안면제3투,954,583,196,351,29,2,0,578,5,371,33.910034602076124,60.726643598615915,5.017301038062284,0.34602076124567477,0.0
89,경기도,화성시갑,장안면,장안면제4투,626,426,135,272,12,7,0,426,0,200,31.690140845070424,63.84976525821596,2.8169014084507045,1.643192488262911,0.0
90,경기도,화성시갑,장안면,장안면제5투,1399,833,375,404,46,2,0,827,6,566,45.34461910519952,48.851269649334945,5.562273276904474,0.24183796856106407,0.0
91,경기도,화성시갑,양감면,관내사전투표,2425,2425,1561,624,209,16,1,2411,14,0,64.7449191206968,25.881377021982583,8.66860223973455,0.6636250518457071,0.04147656574035669
92,경기도,화성시갑,양감면,양감면제1투,1237,711,242,423,40,2,0,707,4,526,34.22913719943423,59.830268741159834,5.657708628005658,0.2828854314002829,0.0
93,경기도,화성시갑,양감면,양감면제2투,1084,657,180,434,35,3,0,652,5,427,27.607361963190186,66.56441717791411,5.368098159509203,0.4601226993865031,0.0
94,경기도,화성시갑,정남면,관내사전투표,2763,2763,1739,806,189,12,3,2749,14,0,63.25936704256093,29.31975263732266,6.875227355401964,0.43652237177155323,0.10913059294288831
95,경기도,화성시갑,정남면,정남면제1투,1946,1174,351,750,68,2,1,1172,2,772,29.948805460750854,63.99317406143344,5.802047781569966,0.17064846416382254,0.08532423208191127
96,경기도,화성시갑,정남면,정남면제2투,1607,956,259,632,58,0,0,949,7,651,27.291886195995787,66.59641728134879,6.111696522655427,0.0,0.0
97,경기도,화성시갑,정남면,정남면제3투,1854,1180,397,700,65,11,2,1175,5,674,33.787234042553195,59.57446808510638,5.531914893617021,0.9361702127659575,0.1702127659574468
98,경기도,화성시갑,정남면,정남면제4투,1376,925,445,404,67,6,0,922,3,451,48.264642082429496,43.817787418655094,7.266811279826464,0.6507592190889371,0.0
99,경기도,화성시갑,새솔동,관내사전투표,5389,5389,3916,991,414,28,4,5353,36,0,73.15524005230711,18.512983373809078,7.733980945264338,0.5230711750420325,0.07472445357743321
100,경기도,화성시갑,새솔동,새솔동제1투,2616,1981,1018,756,182,13,3,1972,9,635,51.622718052738335,38.33671399594321,9.22920892494929,0.6592292089249493,0.15212981744421905
101,경기도,화성시갑,새솔동,새솔동제2투,3817,2783,1373,1132,243,25,2,2775,8,1034,49.47747747747748,40.792792792792795,8.756756756756756,0.9009009009009009,0.07207207207207207
102,경기도,화성시갑,새솔동,새솔동제3투,3273,2448,1288,901,223,22,0,2434,14,825,52.917009038619554,37.01725554642564,9.16187345932621,0.903861955628595,0.0
103,경기도,화성시갑,새솔동,새솔동제4투,2640,1900,943,768,161,17,2,1891,9,740,49.86779481755685,40.613432046536225,8.514013749338973,0.8989952406134322,0.10576414595452141
104,경기도,화성시갑,진안동,관내사전투표,4297,4297,2809,1005,434,27,1,4276,21,0,65.69223573433115,23.503274087932645,10.149672591206734,0.6314312441534145,0.023386342376052385
105,경기도,화성시갑,진안동,진안동제1투,2901,1581,526,782,227,23,1,1559,22,1320,33.73957665169981,50.160359204618345,14.560615779345735,1.475304682488775,0.06414368184733803
106,경기도,화성시갑,진안동,진안동제2투,2670,1564,654,668,208,14,1,1545,19,1106,42.33009708737864,43.236245954692556,13.462783171521037,0.9061488673139159,0.06472491909385113
107,경기도,화성시갑,진안동,진안동제3투,2039,1642,737,727,156,12,0,1632,10,397,45.15931372549019,44.54656862745098,9.558823529411764,0.7352941176470588,0.0
108,경기도,화성시갑,진안동,진안동제4투,3623,2365,1104,1041,180,30,1,2356,9,1258,46.859083191850594,44.18505942275042,7.6400679117147705,1.2733446519524618,0.042444821731748725
109,경기도,화성시갑,진안동,진안동제5투,3682,2942,1466,1018,393,36,6,2919,23,740,50.22267899965742,34.87495717711545,13.463514902363825,1.2332990750256936,0.20554984583761562
110,경기도,화성시갑,진안동,진안동제6투,3954,2904,1479,1091,296,21,4,2891,13,1050,51.15876859218263,37.73780698720166,10.238671739882394,0.7263922518159807,0.13836042891732964
111,경기도,화성시갑,진안동,진안동제7투,2829,1401,463,588,311,13,3,1378,23,1428,33.599419448476056,42.670537010159656,22.568940493468794,0.9433962264150944,0.21770682148040638
112,경기도,화성시갑,진안동,진안동제8투,3008,2474,1248,897,291,27,1,2464,10,534,50.649350649350644,36.40422077922078,11.810064935064934,1.0957792207792207,0.040584415584415584
113,경기도,화성시갑,진안동,진안동제9투,4352,3015,1437,1266,278,17,1,2999,16,1337,47.91597199066355,42.21407135711904,9.269756585528508,0.5668556185395132,0.03334444814938312
114,경기도,화성시갑,병점1동,관내사전투표,6542,6541,4206,1493,741,62,3,6505,36,1,64.65795541890853,22.951575710991545,11.391237509607993,0.9531129900076865,0.04611837048424289
115,경기도,화성시갑,병점1동,병점1동제1투,2993,2156,1027,871,210,29,2,2139,17,837,48.01309022907901,40.719962599345486,9.817671809256662,1.3557737260402059,0.09350163627863488
116,경기도,화성시갑,병점1동,병점1동제2투,2247,1557,673,702,156,12,1,1544,13,690,43.5880829015544,45.46632124352332,10.103626943005182,0.7772020725388601,0.06476683937823835
117,경기도,화성시갑,병점1동,병점1동제3투,3972,2467,816,1165,412,32,0,2425,42,1505,33.649484536082475,48.04123711340206,16.989690721649485,1.3195876288659794,0.0
118,경기도,화성시갑,병점1동,병점1동제4투,3157,2344,1126,981,207,18,2,2334,10,813,48.24335904027421,42.030848329048844,8.868894601542417,0.7712082262210797,0.08568980291345331
119,경기도,화성시갑,병점1동,병점1동제5투,3118,2102,882,925,240,26,5,2078,24,1016,42.4446583253128,44.51395572666025,11.549566891241577,1.2512030798845042,0.2406159769008662
120,경기도,화성시갑,병점1동,병점1동제6투,4879,3752,1748,1489,439,40,4,3720,32,1127,46.98924731182796,40.026881720430104,11.801075268817204,1.0752688172043012,0.10752688172043011
121,경기도,화성시갑,병점2동,관내사전투표,5616,5615,3948,1097,485,52,4,5586,29,1,70.67669172932331,19.638381668456855,8.682420336555676,0.9308986752595776,0.0716075904045829
122,경기도,화성시갑,병점2동,병점2동제1투,2929,2089,977,883,194,24,0,2078,11,840,47.01636188642926,42.49278152069297,9.33589990375361,1.1549566891241578,0.0
123,경기도,화성시갑,병점2동,병점2동제2투,3287,2519,1197,1065,223,21,1,2507,12,768,47.74631033107299,42.48105305145592,8.895093737534902,0.8376545672118069,0.03988831272437176
124,경기도,화성시갑,병점2동,병점2동제3투,3035,1953,902,795,196,32,3,1928,25,1082,46.78423236514523,41.2344398340249,10.16597510373444,1.6597510373443984,0.15560165975103735
125,경기도,화성시갑,병점2동,병점2동제4투,2641,1853,895,769,162,17,3,1846,7,788,48.48320693391116,41.65763813651138,8.775731310942579,0.9209100758396532,0.16251354279523295
126,경기도,화성시갑,기배동,관내사전투표,6189,6189,4298,1354,473,36,1,6162,27,0,69.75008114248621,21.973385264524506,7.676079195066538,0.5842259006815969,0.01622849724115547
127,경기도,화성시갑,기배동,기배동제1투,3236,2219,1043,907,233,21,3,2207,12,1017,47.25872224739465,41.09651110104214,10.557317625736294,0.95151789759855,0.1359311282283643
128,경기도,화성시갑,기배동,기배동제2투,3294,2320,1160,926,197,17,3,2303,17,974,50.36908380373426,40.20842379504994,8.554059921841077,0.7381676074685193,0.13026487190620928
129,경기도,화성시갑,기배동,기배동제3투,2098,1468,689,634,121,14,2,1460,8,630,47.1917808219178,43.42465753424658,8.287671232876713,0.9589041095890412,0.136986301369863
130,경기도,화성시갑,화산동,관내사전투표,5833,5833,3946,1430,389,40,5,5810,23,0,67.91738382099828,24.612736660929432,6.695352839931153,0.6884681583476765,0.08605851979345956
131,경기도,화성시갑,화산동,화산동제1투,2612,1629,666,804,141,4,3,1618,11,983,41.161928306551296,49.69097651421508,8.714462299134734,0.2472187886279357,0.1854140914709518
132,경기도,화성시갑,화산동,화산동제2투,2556,1550,629,761,130,18,2,1540,10,1006,40.84415584415584,49.41558441558442,8.441558441558442,1.1688311688311688,0.12987012987012986
133,경기도,화성시갑,화산동,화산동제3투,2866,1864,789,906,135,18,1,1849,15,1002,42.67171444023797,48.99945916711736,7.301243915630071,0.9734991887506761,0.05408328826392645
134,경기도,화성시갑,화산동,화산동제4투,2442,1350,543,667,121,8,0,1339,11,1092,40.55265123226288,49.813293502613895,9.036594473487677,0.597460791635549,0.0
135,경기도,화성시갑,화산동,화산동제5투,2429,1807,908,725,153,9,2,1797,10,622,50.528658875904284,40.345019476905954,8.514190317195327,0.5008347245409015,0.11129660545353368
136,경기도,화성시갑,화산동,화산동제6투,3087,2275,1133,845,258,16,3,2255,20,812,50.24390243902439,37.472283813747225,11.441241685144124,0.7095343680709534,0.13303769401330376
137,경기도,화성시갑,잘못 투입·구분된 투표지,,0,1,1,0,0,0,0,1,0,-1,100.0,0.0,0.0,0.0,0.0
0,경기도,화성시을,거소·선상투표,,330,314,126,80,101,0,1,308,6,16,40.909090909090914,25.97402597402597,32.7922077922078,0.0,0.3246753246753247
1,경기도,화성시을,관외사전투표,,38801,38800,22654,8630,6842,346,35,38507,293,1,58.830861921209134,22.411509595657932,17.76819798997585,0.8985379281689043,0.09089256498818396
2,경기도,화성시을,재외투표,,2454,2056,1459,302,267,20,1,2049,7,398,71.20546608101513,14.73889702293802,13.030746705710103,0.9760858955588092,0.04880429477794046
3,경기도,화성시을,반월동,관내사전투표,4994,4994,3302,1119,503,37,1,4962,32,0,66.54574768238614,22.551390568319228,10.137041515517936,0.7456670697299477,0.02015316404675534
4,경기도,화성시을,반월동,반월동제1투,2365,1738,657,887,164,12,4,1724,14,627,38.10904872389791,51.45011600928074,9.51276102088167,0.6960556844547563,0.23201856148491878
5,경기도,화성시을,반월동,반월동제2투,3037,2077,809,1020,213,21,0,2063,14,960,39.214735821619,49.442559379544356,10.324769752787203,1.0179350460494425,0.0
6,경기도,화성시을,반월동,반월동제3투,4101,3200,1380,1400,360,31,0,3171,29,901,43.519394512771996,44.150110375275936,11.352885525070956,0.9776095868811101,0.0
7,경기도,화성시을,반월동,반월동제4투,4420,3554,1903,1202,386,40,1,3532,22,866,53.8788221970555,34.03171007927519,10.928652321630803,1.1325028312570782,0.028312570781426957
8,경기도,화성시을,반월동,반월동제5투,3781,2865,1307,1199,322,17,2,2847,18,916,45.90797330523358,42.114506498068145,11.310151036178434,0.597119775201967,0.07024938531787847
9,경기도,화성시을,반월동,반월동제6투,1182,888,432,361,85,3,0,881,7,294,49.03518728717366,40.97616345062429,9.648127128263337,0.340522133938706,0.0
10,경기도,화성시을,동탄1동,관내사전투표,9139,9139,5678,1913,1404,81,4,9080,59,0,62.53303964757709,21.068281938325992,15.462555066079295,0.8920704845814978,0.04405286343612335
11,경기도,화성시을,동탄1동,동탄1동제1투,1894,1451,615,636,167,22,0,1440,11,443,42.70833333333333,44.166666666666664,11.597222222222223,1.5277777777777777,0.0
12,경기도,화성시을,동탄1동,동탄1동제2투,2942,2141,886,909,310,23,2,2130,11,801,41.5962441314554,42.67605633802817,14.553990610328638,1.07981220657277,0.09389671361502347
13,경기도,화성시을,동탄1동,동탄1동제3투,2136,1597,676,669,230,11,2,1588,9,539,42.56926952141058,42.12846347607053,14.483627204030228,0.6926952141057935,0.12594458438287154
14,경기도,화성시을,동탄1동,동탄1동제4투,3034,2470,1159,920,348,23,2,2452,18,564,47.26753670473084,37.52039151712888,14.192495921696574,0.9380097879282219,0.08156606851549755
15,경기도,화성시을,동탄1동,동탄1동제5투,2182,1731,748,750,194,28,3,1723,8,451,43.41265235055136,43.52872896111434,11.259431224608242,1.625072547881602,0.17411491584445735
16,경기도,화성시을,동탄1동,동탄1동제6투,3135,2201,945,854,359,24,2,2184,17,934,43.269230769230774,39.1025641025641,16.437728937728938,1.098901098901099,0.09157509157509157
17,경기도,화성시을,동탄1동,동탄1동제7투,2300,1809,768,757,254,15,3,1797,12,491,42.73789649415693,42.125765164162495,14.134668892598775,0.8347245409015025,0.1669449081803005
18,경기도,화성시을,동탄1동,동탄1동제8투,2842,2237,880,1074,250,21,0,2225,12,605,39.550561797752806,48.26966292134831,11.235955056179774,0.943820224719101,0.0
19,경기도,화성시을,동탄1동,동탄1동제9투,1970,1571,713,654,181,13,2,1563,8,399,45.61740243122201,41.8426103646833,11.580294305822136,0.8317338451695457,0.12795905310300704
20,경기도,화성시을,동탄1동,동탄1동제10투,3947,2555,769,1220,516,27,0,2532,23,1392,30.371248025276458,48.183254344391784,20.379146919431278,1.066350710900474,0.0
21,경기도,화성시을,동탄2동,관내사전투표,7417,7417,5240,1380,687,66,5,7378,39,0,71.02195716996475,18.704255895906748,9.311466522092708,0.8945513689346707,0.06776904310111141
22,경기도,화성시을,동탄2동,동탄2동제1투,2949,2264,1129,880,227,18,2,2256,8,685,50.044326241134755,39.00709219858156,10.062056737588652,0.7978723404255319,0.08865248226950355
23,경기도,화성시을,동탄2동,동탄2동제2투,1934,1500,722,594,168,13,0,1497,3,434,48.22979291917168,39.67935871743487,11.22244488977956,0.8684034736138945,0.0
24,경기도,화성시을,동탄2동,동탄2동제3투,2791,2139,1011,848,243,22,2,2126,13,652,47.55409219190969,39.88711194731891,11.429915333960489,1.03480714957667,0.09407337723424271
25,경기도,화성시을,동탄2동,동탄2동제4투,2710,2181,1017,928,196,23,1,2165,16,529,46.97459584295612,42.86374133949192,9.053117782909931,1.0623556581986142,0.046189376443418015
26,경기도,화성시을,동탄2동,동탄2동제5투,2862,1861,808,869,151,18,1,1847,14,1001,43.74661613427179,47.049269085002706,8.175419599350297,0.9745533297238765,0.05414185165132648
27,경기도,화성시을,동탄2동,동탄2동제6투,3579,2801,1497,966,297,27,3,2790,11,778,53.65591397849462,34.623655913978496,10.64516129032258,0.967741935483871,0.10752688172043011
28,경기도,화성시을,동탄3동,관내사전투표,8040,8040,5565,1458,922,54,4,8003,37,0,69.5364238410596,18.2181681869299,11.52067974509559,0.6747469698862927,0.04998125702861427
29,경기도,화성시을,동탄3동,동탄3동제1투,2891,2115,1033,802,245,18,1,2099,16,776,49.21391138637446,38.20867079561696,11.672224868985232,0.857551214864221,0.04764173415912339
30,경기도,화성시을,동탄3동,동탄3동제2투,3206,2209,981,904,280,25,2,2192,17,997,44.753649635036496,41.24087591240876,12.773722627737227,1.1405109489051095,0.09124087591240876
31,경기도,화성시을,동탄3동,동탄3동제3투,4684,3081,954,1407,649,25,4,3039,42,1603,31.391905231984207,46.29812438302073,21.35570911484041,0.8226390259953932,0.1316222441592629
32,경기도,화성시을,동탄3동,동탄3동제4투,3296,2479,1201,987,250,19,2,2459,20,817,48.84099227328182,40.13826758845059,10.1667344448963,0.7726718178121188,0.08133387555917039
33,경기도,화성시을,동탄3동,동탄3동제5투,3704,2860,1465,998,338,40,2,2843,17,844,51.5300738656349,35.10376362996834,11.888849806542384,1.4069644741470277,0.07034822370735139
34,경기도,화성시을,동탄3동,동탄3동제6투,3169,2528,1300,895,290,25,0,2510,18,641,51.79282868525896,35.657370517928285,11.553784860557768,0.9960159362549801,0.0
35,경기도,화성시을,동탄4동,관내사전투표,9999,9999,6633,1995,1251,76,3,9958,41,0,66.60976099618398,20.034143402289615,12.562763607150028,0.7632054629443663,0.03012653143201446
36,경기도,화성시을,동탄4동,동탄4동제1투,3367,2722,1273,1030,375,32,2,2712,10,645,46.93952802359882,37.97935103244838,13.827433628318584,1.1799410029498525,0.07374631268436578
37,경기도,화성시을,동탄4동,동탄4동제2투,2539,1990,922,753,291,18,0,1984,6,549,46.471774193548384,37.953629032258064,14.667338709677418,0.9072580645161291,0.0
38,경기도,화성시을,동탄4동,동탄4동제3투,3389,2783,1170,1195,371,30,1,2767,16,606,42.284062161185396,43.18756776292013,13.408023129743404,1.084206722081677,0.03614022406938923
39,경기도,화성시을,동탄4동,동탄4동제4투,2292,1842,862,727,226,20,2,1837,5,450,46.92433315187806,39.57539466521502,12.30266739248775,1.0887316276537833,0.10887316276537834
40,경기도,화성시을,동탄4동,동탄4동제5투,2369,2019,838,821,326,23,0,2008,11,350,41.733067729083665,40.886454183266935,16.235059760956176,1.1454183266932272,0.0
41,경기도,화성시을,동탄4동,동탄4동제6투,2541,2060,1020,686,316,24,1,2047,13,481,49.82901807523204,33.51245725451881,15.437225207620909,1.172447484123107,0.048851978505129456
42,경기도,화성시을,동탄4동,동탄4동제7투,3380,2687,1240,1114,288,27,2,2671,16,693,46.42456008985399,41.70722575814302,10.782478472482216,1.010857356795208,0.07487832272557095
43,경기도,화성시을,동탄4동,동탄4동제8투,3342,2511,1099,1010,353,31,1,2494,17,831,44.065757818765036,40.497193263833196,14.153969526864474,1.2429831595829992,0.040096230954290296
44,경기도,화성시을,동탄4동,동탄4동제9투,2440,1960,839,857,236,16,0,1948,12,480,43.06981519507187,43.993839835728956,12.114989733059549,0.8213552361396305,0.0
45,경기도,화성시을,동탄5동,관내사전투표,8991,8990,5848,1686,1311,74,3,8922,68,1,65.54584173952028,18.897108271687962,14.694014794889037,0.829410446088321,0.03362474781439139
46,경기도,화성시을,동탄5동,동탄5동제1투,2749,2062,904,770,352,22,1,2049,13,687,44.119082479258175,37.579306979014156,17.179111761835042,1.0736944851146901,0.04880429477794046
47,경기도,화성시을,동탄5동,동탄5동제2투,2852,2266,1063,837,320,22,1,2243,23,586,47.39188586714222,37.31609451627285,14.266607222469908,0.980829246544806,0.04458314757021846
48,경기도,화성시을,동탄5동,동탄5동제3투,2385,1799,592,848,315,20,1,1776,23,586,33.33333333333333,47.74774774774775,17.736486486486484,1.1261261261261262,0.05630630630630631
49,경기도,화성시을,동탄5동,동탄5동제4투,3143,2264,996,948,288,19,0,2251,13,879,44.24700133274101,42.11461572634384,12.79431363838294,0.8440693025322079,0.0
50,경기도,화성시을,동탄5동,동탄5동제5투,2908,2201,1089,830,247,22,0,2188,13,707,49.77148080438757,37.93418647166362,11.288848263254113,1.0054844606946984,0.0
51,경기도,화성시을,동탄5동,동탄5동제6투,2418,1633,688,778,143,11,0,1620,13,785,42.46913580246914,48.02469135802469,8.82716049382716,0.6790123456790124,0.0
52,경기도,화성시을,동탄5동,동탄5동제7투,3135,2428,1115,992,275,19,3,2404,24,707,46.3810316139767,41.26455906821963,11.43926788685524,0.7903494176372712,0.12479201331114809
53,경기도,화성시을,동탄5동,동탄5동제8투,3531,2629,1213,1078,298,22,1,2612,17,902,46.439509954058195,41.27105666156202,11.408882082695254,0.8422664624808576,0.03828483920367535
54,경기도,화성시을,동탄5동,동탄5동제9투,2484,1567,548,695,295,14,2,1554,13,917,35.26383526383526,44.72329472329472,18.98326898326898,0.9009009009009009,0.1287001287001287
55,경기도,화성시을,동탄6동,관내사전투표,6627,6627,4277,1292,969,50,5,6593,34,0,64.87183376308205,19.596541786743515,14.697406340057636,0.7583801001061733,0.07583801001061732
56,경기도,화성시을,동탄6동,동탄6동제1투,4143,2813,1077,1182,513,26,1,2799,14,1330,38.47802786709539,42.229367631296896,18.327974276527332,0.9289031797070382,0.03572704537334762
57,경기도,화성시을,동탄6동,동탄6동제2투,3452,2223,763,1069,357,17,2,2208,15,1229,34.55615942028986,48.414855072463766,16.168478260869566,0.7699275362318841,0.09057971014492754
58,경기도,화성시을,동탄6동,동탄6동제3투,2911,2256,1019,904,300,20,1,2244,12,655,45.409982174688054,40.28520499108734,13.368983957219251,0.8912655971479502,0.044563279857397504
59,경기도,화성시을,동탄6동,동탄6동제4투,4414,3412,1325,1408,623,35,5,3396,16,1002,39.01648998822144,41.46054181389871,18.345111896348644,1.0306242638398115,0.14723203769140164
60,경기도,화성시을,동탄6동,동탄6동제5투,3954,3005,1362,1255,338,30,2,2987,18,949,45.5975895547372,42.015400066956815,11.315701372614663,1.0043521928356212,0.06695681285570808
61,경기도,화성시을,동탄6동,동탄6동제6투,4633,3323,1170,1503,593,25,6,3297,26,1310,35.48680618744313,45.58689717925387,17.986047922353656,0.7582650894752806,0.18198362147406735
62,경기도,화성시을,동탄7동,관내사전투표,8835,8835,5823,1856,1052,63,2,8796,39,0,66.20054570259208,21.100500227376077,11.959981809913597,0.7162346521145976,0.022737608003638016
63,경기도,화성시을,동탄7동,동탄7동제1투,3300,2591,1229,954,371,25,0,2579,12,709,47.65412950756107,36.991081814656845,14.385420705699884,0.9693679720822024,0.0
64,경기도,화성시을,동탄7동,동탄7동제2투,2722,1899,734,865,268,22,2,1891,8,823,38.815441565309364,45.742993125330514,14.17239555790587,1.1634056054997355,0.10576414595452141
65,경기도,화성시을,동탄7동,동탄7동제3투,2410,1963,940,721,273,20,0,1954,9,447,48.106448311156605,36.89866939611054,13.971340839303991,1.023541453428864,0.0
66,경기도,화성시을,동탄7동,동탄7동제4투,3741,2483,991,1121,333,26,2,2473,10,1258,40.072786089769515,45.32955923978973,13.465426607359483,1.0513546300040437,0.08087343307723413
67,경기도,화성시을,동탄7동,동탄7동제5투,4774,3619,1502,1546,532,20,4,3604,15,1155,41.67591564927858,42.89678135405106,14.761376248612654,0.5549389567147613,0.11098779134295228
68,경기도,화성시을,동탄7동,동탄7동제6투,4151,3134,1460,1265,369,22,2,3118,16,1017,46.82488774855676,40.57087876844131,11.834509300833867,0.7055805003207184,0.06414368184733803
69,경기도,화성시을,동탄7동,동탄7동제7투,4093,2888,1410,1106,329,29,2,2876,12,1205,49.02642559109875,38.456189151599446,11.439499304589708,1.0083449235048678,0.06954102920723226
70,경기도,화성시을,동탄7동,동탄7동제8투,3521,2337,980,915,400,19,1,2315,22,1184,42.33261339092873,39.524838012958966,17.278617710583152,0.8207343412526997,0.04319654427645788
71,경기도,화성시을,동탄8동,관내사전투표,6776,6776,4616,1225,849,50,6,6746,30,0,68.42573376815892,18.158908983101096,12.585235695226801,0.7411799584939223,0.08894159501927068
72,경기도,화성시을,동탄8동,동탄8동제1투,3553,2718,1388,843,422,33,4,2690,28,835,51.59851301115241,31.33828996282528,15.687732342007434,1.2267657992565055,0.14869888475836432
73,경기도,화성시을,동탄8동,동탄8동제2투,3045,2253,1077,781,347,27,2,2234,19,792,48.2094897045658,34.95971351835273,15.532676812891674,1.2085944494180842,0.08952551477170993
74,경기도,화성시을,동탄8동,동탄8동제3투,4091,3168,1435,1225,459,24,1,3144,24,923,45.64249363867685,38.963104325699746,14.599236641221374,0.7633587786259541,0.031806615776081425
75,경기도,화성시을,동탄8동,동탄8동제4투,2504,1825,741,803,252,16,3,1815,10,679,40.82644628099173,44.24242424242424,13.884297520661157,0.8815426997245178,0.1652892561983471
76,경기도,화성시을,동탄8동,동탄8동제5투,2153,1578,733,622,199,17,0,1571,7,575,46.65817950350096,39.59261616804583,12.667091024824954,1.0821133036282622,0.0
77,경기도,화성시을,동탄8동,동탄8동제6투,2664,2094,949,866,236,24,1,2076,18,570,45.71290944123314,41.714836223506744,11.368015414258188,1.1560693641618496,0.04816955684007707
78,경기도,화성시을,동탄9동,관내사전투표,6563,6563,4377,1200,910,48,1,6536,27,0,66.96756425948593,18.35985312117503,13.922888616891067,0.7343941248470013,0.01529987760097919
79,경기도,화성시을,동탄9동,동탄9동제1투,2656,2115,1050,784,250,18,2,2104,11,541,49.90494296577947,37.26235741444867,11.88212927756654,0.8555133079847909,0.09505703422053231
80,경기도,화성시을,동탄9동,동탄9동제2투,3700,2886,1373,1061,403,36,0,2873,13,814,47.78976679429168,36.93003828750435,14.027149321266968,1.2530455969369996,0.0
81,경기도,화성시을,동탄9동,동탄9동제3투,3306,2526,1194,931,373,17,1,2516,10,780,47.45627980922099,37.00317965023847,14.825119236883943,0.6756756756756757,0.0397456279809221
82,경기도,화성시을,동탄9동,동탄9동제4투,3061,2355,1264,799,255,20,3,2341,14,706,53.99401964972233,34.13071337035455,10.892780862879112,0.8543357539513029,0.12815036309269542
83,경기도,화성시을,동탄9동,동탄9동제5투,3452,2736,1309,1041,349,20,0,2719,17,716,48.142699521883046,38.286134608311876,12.835601324016183,0.735564545788893,0.0
84,경기도,화성시을,동탄9동,동탄9동제6투,3346,2213,804,922,441,26,2,2195,18,1133,36.628701594533034,42.004555808656036,20.091116173120728,1.184510250569476,0.09111617312072894
85,경기도,화성시을,동탄9동,동탄9동제7투,4496,3404,1441,1219,680,31,3,3374,30,1092,42.708950800237105,36.12922347362181,20.15411973918198,0.9187907528156491,0.08891523414344991
86,경기도,화성시을,잘못 투입·구분된 투표지,,0,2,1,1,0,0,0,2,0,-2,50.0,50.0,0.0,0.0,0.0
0,경기도,부천시원미구,거소·선상투표,,501,465,200,151,99,3,2,455,10,36,43.956043956043956,33.18681318681318,21.75824175824176,0.6593406593406593,0.43956043956043955
1,경기도,부천시원미구,관외사전투표,,32590,32581,20231,7452,4156,406,40,32285,296,9,62.66377574725105,23.081926591296266,12.872851169273655,1.257549945795261,0.12389654638376955
2,경기도,부천시원미구,재외투표,,1933,1573,1101,274,164,23,0,1562,11,360,70.4865556978233,17.541613316261202,10.499359795134442,1.47247119078105,0.0
3,경기도,부천시원미구,심곡1동,관내사전투표,2820,2820,1989,595,188,22,3,2797,23,0,71.11190561315695,21.272792277440114,6.721487307829818,0.7865570253843404,0.10725777618877369
4,경기도,부천시원미구,심곡1동,심곡1동제1투,2731,1651,719,789,114,16,3,1641,10,1080,43.81474710542352,48.08043875685558,6.946983546617916,0.9750152346130408,0.18281535648994515
5,경기도,부천시원미구,심곡1동,심곡1동제2투,2189,1490,711,638,119,12,1,1481,9,699,48.00810263335584,43.07900067521945,8.035111411208643,0.8102633355840648,0.0675219446320054
6,경기도,부천시원미구,심곡1동,심곡1동제3투,2302,1225,498,598,116,12,0,1224,1,1077,40.68627450980392,48.8562091503268,9.477124183006536,0.9803921568627451,0.0
7,경기도,부천시원미구,심곡2동,관내사전투표,3969,3968,2765,922,223,29,1,3940,28,1,70.17766497461929,23.4010152284264,5.65989847715736,0.7360406091370558,0.025380710659898477
8,경기도,부천시원미구,심곡2동,심곡2동제1투,3195,1757,778,798,146,17,4,1743,14,1438,44.63568559954102,45.78313253012048,8.376362593230063,0.9753298909925416,0.22948938611589212
9,경기도,부천시원미구,심곡2동,심곡2동제2투,3833,2189,999,925,217,20,2,2163,26,1644,46.18585298196949,42.76467868700878,10.032362459546926,0.9246417013407304,0.09246417013407304
10,경기도,부천시원미구,심곡2동,심곡2동제3투,4288,2260,1018,969,229,21,4,2241,19,2028,45.42614904060687,43.23962516733601,10.218652387327086,0.9370816599732262,0.178491744756805
11,경기도,부천시원미구,심곡3동,관내사전투표,2215,2215,1524,509,143,23,1,2200,15,0,69.27272727272728,23.136363636363637,6.5,1.0454545454545454,0.045454545454545456
12,경기도,부천시원미구,심곡3동,심곡3동제1투,2246,1402,616,675,96,4,2,1393,9,844,44.221105527638194,48.456568557071066,6.891600861450107,0.2871500358937545,0.14357501794687724
13,경기도,부천시원미구,심곡3동,심곡3동제2투,1761,1054,461,485,82,10,3,1041,13,707,44.28434197886648,46.589817483189236,7.877041306436119,0.9606147934678195,0.2881844380403458
14,경기도,부천시원미구,심곡3동,심곡3동제3투,2502,1708,763,779,133,18,0,1693,15,794,45.067926757235675,46.012994683992915,7.855877141169522,1.06320141760189,0.0
15,경기도,부천시원미구,원미1동,관내사전투표,4391,4391,3077,1000,248,36,2,4363,28,0,70.52486820994729,22.920009168003666,5.68416227366491,0.8251203300481321,0.045840018336007336
16,경기도,부천시원미구,원미1동,원미1동제1투,2650,1605,702,773,104,10,3,1592,13,1045,44.095477386934675,48.55527638190954,6.532663316582915,0.628140703517588,0.18844221105527637
17,경기도,부천시원미구,원미1동,원미1동제2투,3294,2050,985,869,150,22,7,2033,17,1244,48.450565666502705,42.7447122479095,7.378258730939498,1.0821446138711266,0.3443187407771766
18,경기도,부천시원미구,원미1동,원미1동제3투,2006,1593,757,714,102,12,0,1585,8,413,47.7602523659306,45.04731861198738,6.435331230283911,0.7570977917981072,0.0
19,경기도,부천시원미구,원미1동,원미1동제4투,1810,1163,523,537,80,13,3,1156,7,647,45.24221453287197,46.45328719723184,6.920415224913495,1.124567474048443,0.25951557093425603
20,경기도,부천시원미구,원미2동,관내사전투표,2547,2547,1707,713,89,20,1,2530,17,0,67.4703557312253,28.18181818181818,3.517786561264822,0.7905138339920948,0.039525691699604744
21,경기도,부천시원미구,원미2동,원미2동제1투,2169,1336,556,666,88,12,0,1322,14,833,42.05748865355522,50.378214826021186,6.656580937972769,0.9077155824508321,0.0
22,경기도,부천시원미구,원미2동,원미2동제2투,2769,1977,900,908,135,17,2,1962,15,792,45.87155963302752,46.279306829765545,6.8807339449541285,0.8664627930682977,0.10193679918450561
23,경기도,부천시원미구,원미2동,원미2동제3투,1820,1118,482,557,62,10,0,1111,7,702,43.38433843384338,50.13501350135014,5.5805580558055805,0.9000900090009001,0.0
24,경기도,부천시원미구,소사동,관내사전투표,1348,1347,853,367,93,23,1,1337,10,1,63.79955123410621,27.44951383694839,6.955871353777113,1.7202692595362752,0.07479431563201197
25,경기도,부천시원미구,소사동,소사동제1투,2260,1413,563,730,91,15,1,1400,13,847,40.214285714285715,52.142857142857146,6.5,1.0714285714285714,0.07142857142857142
26,경기도,부천시원미구,소사동,소사동제2투,1295,843,371,399,62,4,0,836,7,452,44.37799043062201,47.72727272727273,7.4162679425837315,0.4784688995215311,0.0
27,경기도,부천시원미구,역곡1동,관내사전투표,4125,4125,2861,970,234,39,2,4106,19,0,69.67851924013638,23.623964929371652,5.698977106673161,0.9498295177788602,0.04870920603994155
28,경기도,부천시원미구,역곡1동,역곡1동제1투,2809,1886,804,895,152,17,1,1869,17,923,43.01765650080257,47.886570358480476,8.132691278758694,0.9095773140716961,0.05350454788657035
29,경기도,부천시원미구,역곡1동,역곡1동제2투,2514,1762,744,866,124,17,2,1753,9,752,42.441528807758125,49.401026811180834,7.0735881346263545,0.9697661152310325,0.11409013120365087
30,경기도,부천시원미구,역곡1동,역곡1동제3투,1667,1182,532,556,74,14,2,1178,4,485,45.16129032258064,47.198641765704586,6.281833616298811,1.1884550084889642,0.1697792869269949
31,경기도,부천시원미구,역곡1동,역곡1동제4투,1897,1426,704,593,101,17,1,1416,10,471,49.717514124293785,41.87853107344633,7.13276836158192,1.2005649717514124,0.07062146892655367
32,경기도,부천시원미구,역곡2동,관내사전투표,4403,4403,2926,1063,341,38,6,4374,29,0,66.89529035208047,24.30269775948788,7.7960676726108815,0.8687700045724738,0.1371742112482853
33,경기도,부천시원미구,역곡2동,역곡2동제1투,2935,1964,804,916,190,29,3,1942,22,971,41.40061791967044,47.167868177136974,9.783728115345006,1.4933058702368691,0.15447991761071062
34,경기도,부천시원미구,역곡2동,역곡2동제2투,3468,2432,1095,1071,198,41,6,2411,21,1036,45.41683948569059,44.421401907922025,8.212360016590626,1.7005391953546247,0.2488593944421402
35,경기도,부천시원미구,역곡2동,역곡2동제3투,2583,1636,719,739,137,22,2,1619,17,947,44.410129709697344,45.64546016059296,8.46201358863496,1.3588634959851762,0.12353304508956146
36,경기도,부천시원미구,춘의동,관내사전투표,3272,3272,2231,722,259,32,2,3246,26,0,68.73074553296364,22.242760320394332,7.979051139864449,0.9858287122612447,0.06161429451632779
37,경기도,부천시원미구,춘의동,춘의동제1투,2602,1759,793,798,128,20,3,1742,17,843,45.52238805970149,45.80941446613088,7.347876004592423,1.1481056257175661,0.1722158438576349
38,경기도,부천시원미구,춘의동,춘의동제2투,2314,1478,662,687,94,6,5,1454,24,836,45.529573590096284,47.24896836313617,6.464924346629987,0.41265474552957354,0.34387895460797796
39,경기도,부천시원미구,춘의동,춘의동제3투,3426,2342,1097,1003,194,19,3,2316,26,1084,47.36614853195164,43.30742659758204,8.376511226252159,0.8203799654576858,0.1295336787564767
40,경기도,부천시원미구,도당동,관내사전투표,3105,3105,2228,640,195,26,1,3090,15,0,72.10355987055016,20.711974110032365,6.310679611650485,0.8414239482200648,0.032362459546925564
41,경기도,부천시원미구,도당동,도당동제1투,2132,1380,698,553,96,14,2,1363,17,752,51.210564930300805,40.57226705796038,7.043286867204696,1.0271460014673515,0.1467351430667645
42,경기도,부천시원미구,도당동,도당동제2투,2517,1739,849,729,134,13,3,1728,11,778,49.13194444444444,42.1875,7.75462962962963,0.7523148148148148,0.1736111111111111
43,경기도,부천시원미구,도당동,도당동제3투,2674,1833,906,742,151,20,3,1822,11,841,49.72557628979144,40.724478594950604,8.287596048298573,1.0976948408342482,0.1646542261251372
44,경기도,부천시원미구,도당동,도당동제4투,2102,1385,624,662,77,10,3,1376,9,717,45.348837209302324,48.11046511627907,5.59593023255814,0.7267441860465116,0.2180232558139535
45,경기도,부천시원미구,도당동,도당동제5투,1393,844,380,388,60,9,1,838,6,549,45.346062052505964,46.30071599045346,7.159904534606206,1.0739856801909307,0.11933174224343676
46,경기도,부천시원미구,도당동,도당동제6투,1779,1213,583,505,102,13,1,1204,9,566,48.421926910299,41.943521594684384,8.471760797342192,1.0797342192691028,0.08305647840531562
47,경기도,부천시원미구,약대동,관내사전투표,4155,4155,2864,952,283,33,3,4135,20,0,69.26239419588876,23.022974607013303,6.844014510278114,0.7980652962515113,0.07255139056831923
48,경기도,부천시원미구,약대동,약대동제1투,3013,2035,865,972,154,26,3,2020,15,978,42.82178217821782,48.118811881188115,7.623762376237623,1.2871287128712872,0.1485148514851485
49,경기도,부천시원미구,약대동,약대동제2투,3074,2148,935,973,198,14,2,2122,26,926,44.062205466541,45.85296889726673,9.330819981149858,0.6597549481621112,0.0942507068803016
50,경기도,부천시원미구,약대동,약대동제3투,3067,2251,964,1050,193,26,1,2234,17,816,43.15129811996419,47.00089525514772,8.639212175470009,1.1638316920322291,0.044762757385854966
51,경기도,부천시원미구,중동,관내사전투표,3562,3562,2335,948,227,35,1,3546,16,0,65.8488437676255,26.73434856175973,6.401579244218839,0.9870276367738298,0.028200789622109423
52,경기도,부천시원미구,중동,중동제1투,2200,1324,528,683,90,13,2,1316,8,876,40.121580547112465,51.899696048632215,6.838905775075988,0.9878419452887538,0.1519756838905775
53,경기도,부천시원미구,중동,중동제2투,2648,2029,841,971,173,24,1,2010,19,619,41.8407960199005,48.308457711442784,8.606965174129353,1.1940298507462688,0.04975124378109452
54,경기도,부천시원미구,중동,중동제3투,2541,1670,738,776,135,8,0,1657,13,871,44.538322269161135,46.831623415811706,8.147254073627037,0.48280024140012073,0.0
55,경기도,부천시원미구,중동,중동제4투,1973,1316,564,603,130,12,1,1310,6,657,43.05343511450382,46.030534351145036,9.923664122137405,0.9160305343511451,0.07633587786259542
56,경기도,부천시원미구,중동,중동제5투,2794,2110,821,1083,181,15,0,2100,10,684,39.095238095238095,51.57142857142857,8.619047619047619,0.7142857142857143,0.0
57,경기도,부천시원미구,중1동,관내사전투표,7142,7141,4856,1636,559,49,3,7103,38,1,68.36547937491201,23.03252146980149,7.86991412079403,0.6898493594255949,0.04223567506687315
58,경기도,부천시원미구,중1동,중1동제1투,2615,1782,744,858,148,23,0,1773,9,833,41.96277495769882,48.39255499153977,8.347433728144388,1.2972363226170334,0.0
59,경기도,부천시원미구,중1동,중1동제2투,2330,1803,779,823,177,15,1,1795,8,527,43.398328690807794,45.84958217270195,9.860724233983287,0.8356545961002786,0.05571030640668524
60,경기도,부천시원미구,중1동,중1동제3투,3299,1818,707,878,189,29,2,1805,13,1481,39.16897506925208,48.64265927977839,10.470914127423821,1.6066481994459834,0.110803324099723
61,경기도,부천시원미구,중1동,중1동제4투,3096,2368,951,1134,249,23,0,2357,11,728,40.34789987271956,48.1120067882902,10.564276622825625,0.975816716164616,0.0
62,경기도,부천시원미구,중1동,중1동제5투,3150,2054,832,975,203,17,5,2032,22,1096,40.94488188976378,47.982283464566926,9.990157480314961,0.8366141732283465,0.24606299212598426
63,경기도,부천시원미구,중1동,중1동제6투,2072,1650,675,819,130,14,1,1639,11,422,41.1836485661989,49.96949359365467,7.9316656497864555,0.8541793776693106,0.06101281269066504
64,경기도,부천시원미구,중1동,중1동제7투,3191,2043,890,887,225,28,3,2033,10,1148,43.77766847024102,43.630103295622234,11.067388096409248,1.3772749631087065,0.14756517461878996
65,경기도,부천시원미구,중1동,중1동제8투,3006,2383,1091,1054,191,30,0,2366,17,623,46.11158072696534,44.54775993237532,8.072696534234995,1.267962806424345,0.0
66,경기도,부천시원미구,중2동,관내사전투표,2904,2904,1929,749,188,15,2,2883,21,0,66.90946930280958,25.979882067291015,6.520985084980922,0.5202913631633715,0.0693721817551162
67,경기도,부천시원미구,중2동,중2동제1투,2522,1708,629,929,117,14,1,1690,18,814,37.2189349112426,54.97041420118344,6.923076923076923,0.8284023668639053,0.0591715976331361
68,경기도,부천시원미구,중2동,중2동제2투,1696,1254,405,723,101,17,1,1247,7,442,32.47794707297514,57.979149959903765,8.09943865276664,1.36327185244587,0.08019246190858059
69,경기도,부천시원미구,중2동,중2동제3투,2733,1837,695,959,153,20,1,1828,9,896,38.01969365426696,52.4617067833698,8.369803063457331,1.0940919037199124,0.05470459518599562
70,경기도,부천시원미구,중2동,중2동제4투,2564,2008,863,970,145,18,1,1997,11,556,43.21482223335003,48.5728592889334,7.260891337005508,0.9013520280420632,0.050075112669003496
71,경기도,부천시원미구,중2동,중2동제5투,2692,1990,787,1014,150,25,3,1979,11,702,39.767559373420916,51.23799898938858,7.579585649317837,1.263264274886306,0.15159171298635674
72,경기도,부천시원미구,중2동,중2동제6투,2372,1816,705,948,124,18,0,1795,21,556,39.27576601671309,52.8133704735376,6.90807799442897,1.0027855153203342,0.0
73,경기도,부천시원미구,중2동,중2동제7투,2010,1527,545,849,109,12,1,1516,11,483,35.949868073878626,56.00263852242744,7.189973614775726,0.79155672823219,0.06596306068601583
74,경기도,부천시원미구,중3동,관내사전투표,5414,5414,3552,1293,477,54,4,5380,34,0,66.02230483271376,24.033457249070633,8.866171003717472,1.0037174721189592,0.07434944237918216
75,경기도,부천시원미구,중3동,중3동제1투,3017,2154,895,1022,203,23,3,2146,8,863,41.705498602050326,47.62348555452004,9.45945945945946,1.0717614165890028,0.13979496738117428
76,경기도,부천시원미구,중3동,중3동제2투,3115,2341,845,1258,196,21,2,2322,19,774,36.39104220499569,54.17743324720069,8.440999138673558,0.9043927648578811,0.08613264427217916
77,경기도,부천시원미구,중3동,중3동제3투,2350,1675,745,753,136,22,2,1658,17,675,44.933655006031366,45.416164053075995,8.202653799758746,1.3268998793727382,0.12062726176115801
78,경기도,부천시원미구,중3동,중3동제4투,2803,2175,1041,929,169,24,2,2165,10,628,48.083140877598154,42.90993071593533,7.806004618937644,1.1085450346420322,0.09237875288683603
79,경기도,부천시원미구,중3동,중3동제5투,1571,968,443,450,54,12,3,962,6,603,46.04989604989605,46.77754677754678,5.613305613305614,1.2474012474012475,0.31185031185031187
80,경기도,부천시원미구,중4동,관내사전투표,7319,7319,4847,1626,695,91,6,7265,54,0,66.7171369580179,22.381280110117,9.56641431520991,1.2525808671713696,0.08258774948382656
81,경기도,부천시원미구,중4동,중4동제1투,3095,2352,886,1262,169,20,0,2337,15,743,37.91185280273856,54.000855798031665,7.231493367565254,0.8557980316645273,0.0
82,경기도,부천시원미구,중4동,중4동제2투,2086,1392,568,693,100,16,0,1377,15,694,41.24909222948438,50.326797385620914,7.262164124909224,1.1619462599854757,0.0
83,경기도,부천시원미구,중4동,중4동제3투,2409,1588,657,730,171,15,2,1575,13,821,41.714285714285715,46.34920634920635,10.857142857142858,0.9523809523809524,0.12698412698412698
84,경기도,부천시원미구,중4동,중4동제4투,2153,1636,740,702,159,25,2,1628,8,517,45.45454545454545,43.12039312039312,9.766584766584767,1.5356265356265357,0.12285012285012285
85,경기도,부천시원미구,상동,관내사전투표,4458,4458,2940,1158,295,30,5,4428,30,0,66.39566395663957,26.151761517615174,6.6621499548328815,0.6775067750677507,0.11291779584462511
86,경기도,부천시원미구,상동,상동제1투,2386,1781,568,1050,136,22,0,1776,5,605,31.98198198198198,59.12162162162162,7.657657657657657,1.2387387387387387,0.0
87,경기도,부천시원미구,상동,상동제2투,3425,2348,903,1185,213,24,0,2325,23,1077,38.83870967741935,50.967741935483865,9.161290322580646,1.032258064516129,0.0
88,경기도,부천시원미구,상동,상동제3투,2188,1494,670,681,116,15,1,1483,11,694,45.17869184086312,45.92043155765341,7.82198246797033,1.0114632501685772,0.06743088334457181
89,경기도,부천시원미구,상동,상동제4투,2461,1626,716,753,131,12,2,1614,12,835,44.36183395291202,46.6542750929368,8.116480793060719,0.7434944237918215,0.12391573729863693
90,경기도,부천시원미구,상1동,관내사전투표,6454,6454,4416,1402,527,65,2,6412,42,0,68.87086712414224,21.86525265127885,8.218964441671865,1.0137242669993762,0.031191515907673113
91,경기도,부천시원미구,상1동,상1동제1투,2669,2028,895,896,199,26,1,2017,11,641,44.372830937035204,44.42240951908775,9.866137828458106,1.2890431333663859,0.04957858205255329
92,경기도,부천시원미구,상1동,상1동제2투,3955,2692,1206,1152,268,36,1,2663,29,1263,45.28726999624484,43.25948178745775,10.063837776943299,1.3518588058580547,0.03755163349605708
93,경기도,부천시원미구,상1동,상1동제3투,2524,1943,849,886,164,33,0,1932,11,581,43.94409937888199,45.8592132505176,8.488612836438923,1.7080745341614907,0.0
94,경기도,부천시원미구,상1동,상1동제4투,3103,2335,1027,1087,185,18,2,2319,16,768,44.28633031479086,46.873652436395,7.977576541612764,0.7761966364812419,0.086244070720138
95,경기도,부천시원미구,상2동,관내사전투표,6712,6712,4625,1462,511,68,2,6668,44,0,69.36112777444511,21.925614877024596,7.663467306538692,1.0197960407918416,0.029994001199760045
96,경기도,부천시원미구,상2동,상2동제1투,1678,1155,491,543,97,13,2,1146,9,523,42.84467713787086,47.38219895287958,8.464223385689355,1.1343804537521813,0.17452006980802792
97,경기도,부천시원미구,상2동,상2동제2투,2978,2272,924,1105,208,24,3,2264,8,706,40.812720848056536,48.80742049469965,9.187279151943462,1.0600706713780919,0.13250883392226148
98,경기도,부천시원미구,상2동,상2동제3투,3472,2462,1083,1125,213,29,1,2451,11,1010,44.18604651162791,45.89963280293758,8.69033047735618,1.1831905344757243,0.04079967360261118
99,경기도,부천시원미구,상2동,상2동제4투,2804,2258,990,1032,202,21,1,2246,12,546,44.078361531611755,45.94835262689225,8.993766696349065,0.9349955476402494,0.04452359750667854
100,경기도,부천시원미구,상2동,상2동제5투,3116,2327,1092,938,238,31,1,2300,27,789,47.47826086956522,40.78260869565217,10.347826086956522,1.3478260869565217,0.043478260869565216
101,경기도,부천시원미구,상3동,관내사전투표,7062,7062,4785,1576,609,57,4,7031,31,0,68.05575309344333,22.41501920068269,8.661641302801877,0.8106954913952497,0.056890911676859626
102,경기도,부천시원미구,상3동,상3동제1투,3284,2235,929,1045,214,25,2,2215,20,1049,41.941309255079005,47.17832957110609,9.661399548532732,1.1286681715575622,0.09029345372460496
103,경기도,부천시원미구,상3동,상3동제2투,2985,2228,947,1031,214,16,1,2209,19,757,42.8700769578995,46.6727025803531,9.687641466727026,0.724309642372114,0.04526935264825713
104,경기도,부천시원미구,상3동,상3동제3투,2947,2199,788,1160,217,23,1,2189,10,748,35.99817268158977,52.99223389675652,9.913202375513935,1.0507080858839652,0.04568296025582458
105,경기도,부천시원미구,상3동,상3동제4투,3038,2371,934,1191,201,30,3,2359,12,667,39.59304790165324,50.487494701144556,8.520559559135227,1.2717253073336159,0.1271725307333616
106,경기도,부천시원미구,상3동,상3동제5투,3085,2395,1122,1014,215,24,2,2377,18,690,47.20235591081195,42.65881363062684,9.045014724442575,1.0096760622633572,0.08413967185527976
107,경기도,부천시원미구,잘못 투입·구분된 투표지,,0,2,2,0,0,0,0,2,0,-2,100.0,0.0,0.0,0.0,0.0
0,경기도,부천시소사구,거소·선상투표,,293,260,108,76,44,1,3,232,28,33,46.55172413793103,32.758620689655174,18.96551724137931,0.43103448275862066,1.293103448275862
1,경기도,부천시소사구,관외사전투표,,23091,23086,14978,5163,2470,268,13,22892,194,5,65.42897081950026,22.553730560894635,10.789795561768303,1.1707146601432814,0.05678839769351739
2,경기도,부천시소사구,재외투표,,1127,925,660,173,70,18,0,921,4,202,71.66123778501628,18.783930510314875,7.600434310532031,1.9543973941368076,0.0
3,경기도,부천시소사구,심곡본1동,관내사전투표,4586,4586,3017,1272,242,30,2,4563,23,0,66.11878150339689,27.87639710716634,5.303528380451458,0.6574621959237344,0.04383081306158229
4,경기도,부천시소사구,심곡본1동,심곡본1동제1투,2611,1402,574,703,98,14,2,1391,11,1209,41.265276779295476,50.5391804457225,7.0452911574406905,1.00647016534867,0.14378145219266716
5,경기도,부천시소사구,심곡본1동,심곡본1동제2투,2406,1574,671,762,114,12,3,1562,12,832,42.95774647887324,48.78361075544174,7.298335467349553,0.7682458386683738,0.19206145966709345
6,경기도,부천시소사구,심곡본1동,심곡본1동제3투,2257,1363,569,669,96,16,0,1350,13,894,42.148148148148145,49.55555555555556,7.111111111111111,1.1851851851851851,0.0
7,경기도,부천시소사구,심곡본1동,심곡본1동제4투,2118,1393,585,691,96,12,2,1386,7,725,42.2077922077922,49.855699855699854,6.926406926406926,0.8658008658008658,0.1443001443001443
8,경기도,부천시소사구,심곡본동,관내사전투표,2406,2406,1579,663,134,16,1,2393,13,0,65.98412035102382,27.705808608441284,5.599665691600501,0.6686167989970748,0.041788549937317176
9,경기도,부천시소사구,심곡본동,심곡본동제1투,2197,1372,564,689,95,9,2,1359,13,825,41.501103752759384,50.6990434142752,6.990434142752024,0.6622516556291391,0.14716703458425312
10,경기도,부천시소사구,심곡본동,심곡본동제2투,2034,1239,465,653,100,12,4,1234,5,795,37.68233387358185,52.91734197730956,8.103727714748784,0.9724473257698543,0.3241491085899514
11,경기도,부천시소사구,심곡본동,심곡본동제3투,2021,1203,480,604,95,14,0,1193,10,818,40.2347024308466,50.62866722548198,7.963118189438391,1.173512154233026,0.0
12,경기도,부천시소사구,심곡본동,심곡본동제4투,2419,1746,681,912,112,24,1,1730,16,673,39.36416184971098,52.716763005780344,6.473988439306358,1.3872832369942196,0.05780346820809249
13,경기도,부천시소사구,소사본동,관내사전투표,4298,4298,2858,1156,210,39,4,4267,31,0,66.97914225451137,27.091633466135455,4.921490508554019,0.9139910944457464,0.0937426763534099
14,경기도,부천시소사구,소사본동,소사본동제1투,2264,1431,520,807,81,9,2,1419,12,833,36.64552501761804,56.87103594080338,5.708245243128964,0.6342494714587738,0.14094432699083861
15,경기도,부천시소사구,소사본동,소사본동제2투,1770,1095,433,581,65,7,1,1087,8,675,39.83440662373505,53.449862005519776,5.979760809567617,0.6439742410303588,0.09199632014719411
16,경기도,부천시소사구,소사본동,소사본동제3투,2321,1529,687,717,96,14,1,1515,14,792,45.34653465346535,47.32673267326732,6.336633663366337,0.9240924092409241,0.066006600660066
17,경기도,부천시소사구,소사본동,소사본동제4투,3369,2222,970,995,207,25,1,2198,24,1147,44.13102820746133,45.26842584167425,9.417652411282983,1.1373976342129208,0.04549590536851684
18,경기도,부천시소사구,소사본동,소사본동제5투,1792,1182,499,578,88,13,1,1179,3,610,42.324003392705684,49.02459711620017,7.463952502120441,1.102629346904156,0.08481764206955046
19,경기도,부천시소사구,소사본동,소사본동제6투,3094,2206,991,1009,163,23,2,2188,18,888,45.29250457038391,46.11517367458867,7.4497257769652645,1.0511882998171846,0.09140767824497258
20,경기도,부천시소사구,소사본1동,관내사전투표,5873,5873,3840,1621,352,38,6,5857,16,0,65.56257469694383,27.67628478743384,6.009902680553184,0.6487963121051733,0.10244152296397474
21,경기도,부천시소사구,소사본1동,소사본1동제1투,2431,1594,623,832,109,16,3,1583,11,837,39.35565382185723,52.5584333543904,6.885660138976626,1.010739102969046,0.18951358180669614
22,경기도,부천시소사구,소사본1동,소사본1동제2투,3149,2424,1128,1071,175,34,0,2408,16,725,46.84385382059801,44.47674418604651,7.267441860465117,1.4119601328903655,0.0
23,경기도,부천시소사구,소사본1동,소사본1동제3투,3067,2215,953,1048,172,22,1,2196,19,852,43.397085610200364,47.72313296903461,7.832422586520947,1.0018214936247722,0.04553734061930783
24,경기도,부천시소사구,소사본1동,소사본1동제4투,2816,1898,781,978,109,13,5,1886,12,918,41.41039236479321,51.855779427359494,5.779427359490986,0.689289501590668,0.2651113467656416
25,경기도,부천시소사구,소사본1동,소사본1동제5투,2185,1719,757,802,127,16,1,1703,16,466,44.45096887844979,47.09336465061656,7.457428068115091,0.9395184967704051,0.05871990604815032
26,경기도,부천시소사구,소사본1동,소사본1동제6투,2228,1782,721,937,99,18,0,1775,7,446,40.61971830985915,52.7887323943662,5.577464788732395,1.0140845070422535,0.0
27,경기도,부천시소사구,범박동,관내사전투표,6020,6020,4191,1326,426,40,5,5988,32,0,69.98997995991984,22.14428857715431,7.114228456913827,0.6680026720106881,0.08350033400133601
28,경기도,부천시소사구,범박동,범박동제1투,3043,2227,1080,930,182,20,1,2213,14,816,48.802530501581565,42.02440126525079,8.224130140081337,0.903750564844103,0.045187528242205156
29,경기도,부천시소사구,범박동,범박동제2투,2152,1639,678,805,135,14,1,1633,6,513,41.51867728107777,49.29577464788733,8.266993263931415,0.8573178199632578,0.0612369871402327
30,경기도,부천시소사구,범박동,범박동제3투,2228,1745,772,834,109,18,1,1734,11,483,44.52133794694348,48.09688581314879,6.286043829296424,1.0380622837370241,0.05767012687427912
31,경기도,부천시소사구,범박동,범박동제4투,2441,1906,775,948,151,20,2,1896,10,535,40.87552742616033,50.0,7.9641350210970465,1.0548523206751055,0.10548523206751054
32,경기도,부천시소사구,범박동,범박동제5투,3721,2724,1284,1120,266,35,1,2706,18,997,47.45011086474501,41.38950480413895,9.830007390983,1.2934220251293422,0.03695491500369549
33,경기도,부천시소사구,옥길동,관내사전투표,5660,5660,4144,1035,389,46,9,5623,37,0,73.69731460074694,18.40654454917304,6.918015294326872,0.8180686466299129,0.16005690912324383
34,경기도,부천시소사구,옥길동,옥길동제1투,3191,2292,945,1129,184,17,2,2277,15,899,41.50197628458498,49.58278436539306,8.080808080808081,0.7465963987703118,0.0878348704435661
35,경기도,부천시소사구,옥길동,옥길동제2투,2480,2108,1117,796,152,30,0,2095,13,372,53.31742243436754,37.995226730310264,7.255369928400955,1.431980906921241,0.0
36,경기도,부천시소사구,옥길동,옥길동제3투,2827,2214,1169,820,189,25,0,2203,11,613,53.064003631411715,37.22197004085338,8.579210167952791,1.1348161597821154,0.0
37,경기도,부천시소사구,옥길동,옥길동제4투,2175,1716,903,639,145,20,1,1708,8,459,52.86885245901639,37.41217798594848,8.489461358313816,1.1709601873536302,0.0585480093676815
38,경기도,부천시소사구,옥길동,옥길동제5투,2382,1877,1078,647,106,30,0,1861,16,505,57.925846319183236,34.76625470177324,5.6958624395486295,1.6120365394948952,0.0
39,경기도,부천시소사구,옥길동,옥길동제6투,1723,1280,608,557,88,17,0,1270,10,443,47.874015748031496,43.85826771653543,6.929133858267717,1.3385826771653544,0.0
40,경기도,부천시소사구,괴안동,관내사전투표,4461,4461,2982,1134,274,42,10,4442,19,0,67.13192255740658,25.529040972534894,6.1683926159387665,0.9455200360198109,0.22512381809995496
41,경기도,부천시소사구,괴안동,괴안동제1투,2074,1196,479,613,79,8,3,1182,14,878,40.524534686971236,51.86125211505922,6.683587140439933,0.676818950930626,0.25380710659898476
42,경기도,부천시소사구,괴안동,괴안동제2투,2041,1328,529,670,99,15,1,1314,14,713,40.25875190258752,50.98934550989346,7.534246575342466,1.141552511415525,0.076103500761035
43,경기도,부천시소사구,괴안동,괴안동제3투,1740,1146,486,547,85,10,1,1129,17,594,43.04694419840567,48.44995571302037,7.528786536758194,0.8857395925597875,0.08857395925597875
44,경기도,부천시소사구,괴안동,괴안동제4투,1712,1077,482,494,83,10,0,1069,8,635,45.088868101029,46.21141253507952,7.764265668849392,0.9354536950420954,0.0
45,경기도,부천시소사구,괴안동,괴안동제5투,2268,1637,658,805,137,19,3,1622,15,631,40.5672009864365,49.63008631319359,8.446362515413071,1.1713933415536375,0.18495684340320592
46,경기도,부천시소사구,역곡3동,관내사전투표,5283,5283,3551,1334,309,51,2,5247,36,0,67.67676767676768,25.424051839146177,5.889079473985134,0.9719839908519153,0.03811701924909472
47,경기도,부천시소사구,역곡3동,역곡3동제1투,2112,1396,603,650,119,11,2,1385,11,716,43.537906137184116,46.931407942238266,8.592057761732852,0.7942238267148014,0.1444043321299639
48,경기도,부천시소사구,역곡3동,역곡3동제2투,1910,1308,614,570,98,15,1,1298,10,602,47.303543913713405,43.91371340523883,7.550077041602465,1.155624036979969,0.07704160246533129
49,경기도,부천시소사구,역곡3동,역곡3동제3투,1987,1410,683,608,92,9,1,1393,17,577,49.03086862885858,43.64680545585068,6.604450825556353,0.6460875807609476,0.07178750897343862
50,경기도,부천시소사구,역곡3동,역곡3동제4투,2200,1458,686,641,100,15,1,1443,15,742,47.53984753984754,44.42134442134442,6.93000693000693,1.0395010395010396,0.0693000693000693
51,경기도,부천시소사구,역곡3동,역곡3동제5투,2061,1579,732,657,154,22,1,1566,13,482,46.74329501915709,41.95402298850575,9.83397190293742,1.40485312899106,0.06385696040868455
52,경기도,부천시소사구,역곡3동,역곡3동제6투,2785,1955,920,884,122,18,0,1944,11,830,47.325102880658434,45.47325102880658,6.275720164609054,0.9259259259259258,0.0
53,경기도,부천시소사구,송내1동,관내사전투표,3372,3372,2338,800,191,26,4,3359,13,0,69.60404882405477,23.816612086930633,5.686216135754689,0.7740398928252455,0.11908306043465318
54,경기도,부천시소사구,송내1동,송내1동제1투,2023,1385,541,714,102,17,4,1378,7,638,39.25979680696662,51.814223512336724,7.402031930333817,1.2336719883889695,0.29027576197387517
55,경기도,부천시소사구,송내1동,송내1동제2투,1960,1249,505,616,102,12,1,1236,13,711,40.85760517799353,49.83818770226537,8.25242718446602,0.9708737864077669,0.08090614886731393
56,경기도,부천시소사구,송내1동,송내1동제3투,1761,1372,592,668,93,12,0,1365,7,389,43.36996336996337,48.937728937728934,6.813186813186813,0.8791208791208791,0.0
57,경기도,부천시소사구,송내1동,송내1동제4투,1817,1456,623,690,114,17,4,1448,8,361,43.02486187845304,47.651933701657455,7.872928176795579,1.1740331491712708,0.2762430939226519
58,경기도,부천시소사구,송내1동,송내1동제5투,1595,1160,464,595,71,24,2,1156,4,435,40.13840830449827,51.470588235294116,6.141868512110726,2.0761245674740483,0.17301038062283738
59,경기도,부천시소사구,송내1동,송내1동제6투,2431,1824,801,855,140,21,0,1817,7,607,44.083654375343976,47.05558613098514,7.705008255365987,1.1557512383048982,0.0
60,경기도,부천시소사구,송내2동,관내사전투표,5202,5202,3502,1257,358,51,5,5173,29,0,67.69766093176108,24.29924608544365,6.920549004446162,0.9858882659965204,0.09665571235260004
61,경기도,부천시소사구,송내2동,송내2동제1투,2082,1452,620,707,105,15,0,1447,5,630,42.847270214236346,48.85970974429855,7.256392536281962,1.0366275051831375,0.0
62,경기도,부천시소사구,송내2동,송내2동제2투,2130,1400,608,651,107,20,3,1389,11,730,43.772498200143986,46.868250539956804,7.703383729301656,1.4398848092152627,0.21598272138228944
63,경기도,부천시소사구,송내2동,송내2동제3투,2961,2089,942,946,162,29,1,2080,9,872,45.28846153846154,45.48076923076923,7.788461538461538,1.3942307692307694,0.04807692307692308
64,경기도,부천시소사구,송내2동,송내2동제4투,2718,1923,830,933,117,30,4,1914,9,795,43.364681295715776,48.7460815047022,6.112852664576803,1.5673981191222568,0.20898641588296762
65,경기도,부천시소사구,송내2동,송내2동제5투,2277,1531,620,769,108,21,1,1519,12,746,40.816326530612244,50.625411454904544,7.109940750493745,1.3824884792626728,0.06583278472679394
66,경기도,부천시소사구,송내2동,송내2동제6투,1787,1493,733,606,127,14,0,1480,13,294,49.527027027027025,40.945945945945944,8.58108108108108,0.945945945945946,0.0
67,경기도,부천시소사구,잘못 투입·구분된 투표지,,0,1,0,1,0,0,0,1,0,-1,0.0,100.0,0.0,0.0,0.0
0,경기도,부천시오정구,거소·선상투표,,202,194,82,62,38,3,1,186,8,8,44.086021505376344,33.33333333333333,20.43010752688172,1.6129032258064515,0.5376344086021506
1,경기도,부천시오정구,관외사전투표,,14684,14677,9538,3276,1568,145,20,14547,130,7,65.56678352925002,22.5201072386059,10.778854746683166,0.9967690932838386,0.1374853921770812
2,경기도,부천시오정구,재외투표,,654,517,375,85,45,8,1,514,3,137,72.95719844357976,16.536964980544745,8.754863813229571,1.556420233463035,0.19455252918287938
3,경기도,부천시오정구,성곡동,관내사전투표,7610,7610,5422,1646,429,60,4,7561,49,0,71.71009125777013,21.769607194815503,5.673852664991403,0.7935458272715249,0.052903055151434994
4,경기도,부천시오정구,성곡동,성곡동제1투,2528,1443,655,645,121,15,0,1436,7,1085,45.61281337047354,44.91643454038997,8.426183844011142,1.0445682451253482,0.0
5,경기도,부천시오정구,성곡동,성곡동제2투,2703,1817,950,689,138,19,3,1799,18,886,52.80711506392441,38.299055030572546,7.670928293496387,1.056142301278488,0.16675931072818231
6,경기도,부천시오정구,성곡동,성곡동제3투,2339,1523,764,609,122,15,1,1511,12,816,50.56254136333555,40.30443414956982,8.074123097286565,0.9927200529450696,0.06618133686300463
7,경기도,부천시오정구,성곡동,성곡동제4투,2109,1386,605,649,106,12,4,1376,10,723,43.968023255813954,47.1656976744186,7.703488372093023,0.872093023255814,0.29069767441860467
8,경기도,부천시오정구,성곡동,성곡동제5투,1710,1064,499,472,77,10,1,1059,5,646,47.11992445703494,44.57034938621341,7.2710103871576965,0.9442870632672332,0.09442870632672333
9,경기도,부천시오정구,성곡동,성곡동제6투,2430,1684,726,837,96,16,2,1677,7,746,43.29159212880143,49.910554561717355,5.724508050089446,0.9540846750149076,0.11926058437686345
10,경기도,부천시오정구,성곡동,성곡동제7투,1680,1199,491,614,81,6,2,1194,5,481,41.12227805695142,51.42378559463987,6.78391959798995,0.5025125628140703,0.16750418760469013
11,경기도,부천시오정구,성곡동,성곡동제8투,2051,1382,642,615,107,9,2,1375,7,669,46.69090909090909,44.72727272727273,7.781818181818181,0.6545454545454545,0.14545454545454545
12,경기도,부천시오정구,성곡동,성곡동제9투,1989,1524,666,734,102,11,2,1515,9,465,43.960396039603964,48.44884488448845,6.732673267326733,0.7260726072607261,0.132013201320132
13,경기도,부천시오정구,성곡동,성곡동제10투,3006,2235,1027,1000,172,24,2,2225,10,771,46.157303370786515,44.9438202247191,7.730337078651685,1.0786516853932584,0.0898876404494382
14,경기도,부천시오정구,원종1동,관내사전투표,4670,4670,3302,995,307,38,5,4647,23,0,71.05659565310954,21.411663438777705,6.606412739401765,0.8177318700236712,0.10759629868732515
15,경기도,부천시오정구,원종1동,원종1동제1투,2709,1711,784,754,144,18,1,1701,10,998,46.09053497942387,44.32686654908877,8.465608465608465,1.0582010582010581,0.058788947677836566
16,경기도,부천시오정구,원종1동,원종1동제2투,2569,1792,754,867,137,20,2,1780,12,777,42.359550561797754,48.70786516853933,7.6966292134831455,1.1235955056179776,0.11235955056179776
17,경기도,부천시오정구,원종1동,원종1동제3투,2243,1433,668,626,114,11,3,1422,11,810,46.976090014064695,44.0225035161744,8.016877637130802,0.7735583684950774,0.21097046413502107
18,경기도,부천시오정구,원종1동,원종1동제4투,2251,1378,633,614,105,16,3,1371,7,873,46.17067833698031,44.78482859226842,7.658643326039387,1.1670313639679066,0.2188183807439825
19,경기도,부천시오정구,원종1동,원종1동제5투,2679,1670,751,745,136,21,3,1656,14,1009,45.350241545893724,44.98792270531401,8.212560386473431,1.2681159420289856,0.18115942028985507
20,경기도,부천시오정구,원종2동,관내사전투표,1989,1989,1416,447,106,9,3,1981,8,0,71.47905098435133,22.564361433619386,5.350832912670368,0.4543160020191822,0.1514386673397274
21,경기도,부천시오정구,원종2동,원종2동제1투,1946,1183,560,510,88,14,3,1175,8,763,47.65957446808511,43.40425531914894,7.48936170212766,1.1914893617021276,0.2553191489361702
22,경기도,부천시오정구,원종2동,원종2동제2투,2721,1871,926,771,152,10,1,1860,11,850,49.78494623655914,41.4516129032258,8.172043010752688,0.5376344086021506,0.053763440860215055
23,경기도,부천시오정구,원종2동,원종2동제3투,1789,1281,544,628,96,12,0,1280,1,508,42.5,49.0625,7.5,0.9375,0.0
24,경기도,부천시오정구,원종2동,원종2동제4투,2001,1247,566,570,97,10,1,1244,3,754,45.4983922829582,45.81993569131833,7.797427652733119,0.8038585209003215,0.08038585209003216
25,경기도,부천시오정구,원종2동,원종2동제5투,2641,1783,877,757,107,28,4,1773,10,858,49.46418499717992,42.69599548787366,6.034968979131416,1.5792442188381277,0.2256063169768754
26,경기도,부천시오정구,고강본동,관내사전투표,4795,4795,3416,1050,247,43,2,4758,37,0,71.7948717948718,22.06809583858764,5.191256830601093,0.903741067675494,0.04203446826397646
27,경기도,부천시오정구,고강본동,고강본동제1투,2453,1503,678,699,102,13,2,1494,9,950,45.38152610441767,46.787148594377506,6.827309236947792,0.8701472556894244,0.13386880856760375
28,경기도,부천시오정구,고강본동,고강본동제2투,2317,1301,601,572,100,16,2,1291,10,1016,46.553059643687064,44.306738962044925,7.745933384972889,1.2393493415956625,0.1549186676994578
29,경기도,부천시오정구,고강본동,고강본동제3투,2532,1475,699,652,98,12,6,1467,8,1057,47.648261758691206,44.44444444444444,6.680299931833675,0.81799591002045,0.408997955010225
30,경기도,부천시오정구,고강본동,고강본동제4투,3115,2038,969,885,151,15,3,2023,15,1077,47.89915966386555,43.74691052891745,7.464162135442412,0.7414730598121602,0.14829461196243204
31,경기도,부천시오정구,고강본동,고강본동제5투,3026,1900,994,763,115,19,2,1893,7,1126,52.50924458531432,40.30639197041733,6.075013206550449,1.0036978341257263,0.10565240359218173
32,경기도,부천시오정구,고강본동,고강본동제6투,1688,1160,517,545,73,13,1,1149,11,528,44.99564838990426,47.4325500435161,6.353350739773717,1.1314186248912097,0.08703220191470844
33,경기도,부천시오정구,고강1동,관내사전투표,3986,3985,2791,908,232,22,7,3960,25,1,70.47979797979798,22.92929292929293,5.858585858585859,0.5555555555555556,0.17676767676767677
34,경기도,부천시오정구,고강1동,고강1동제1투,1536,917,407,413,84,9,0,913,4,619,44.57831325301205,45.2354874041621,9.200438116100766,0.9857612267250823,0.0
35,경기도,부천시오정구,고강1동,고강1동제2투,1725,1039,472,475,67,12,4,1030,9,686,45.8252427184466,46.116504854368934,6.5048543689320395,1.1650485436893203,0.3883495145631068
36,경기도,부천시오정구,고강1동,고강1동제3투,1792,1221,601,517,89,9,3,1219,2,571,49.30270713699754,42.41181296144381,7.301066447908121,0.7383100902378998,0.2461033634126333
37,경기도,부천시오정구,고강1동,고강1동제4투,2267,1454,673,658,100,13,4,1448,6,813,46.47790055248619,45.44198895027624,6.906077348066299,0.8977900552486188,0.2762430939226519
38,경기도,부천시오정구,오정동,관내사전투표,4713,4713,3340,1037,274,42,2,4695,18,0,71.1395101171459,22.087326943556977,5.8359957401490945,0.8945686900958467,0.042598509052183174
39,경기도,부천시오정구,오정동,오정동제1투,2996,1923,917,828,133,27,3,1908,15,1073,48.06079664570231,43.39622641509434,6.970649895178196,1.4150943396226416,0.15723270440251574
40,경기도,부천시오정구,오정동,오정동제2투,3817,2793,1266,1255,231,33,2,2787,6,1024,45.425188374596345,45.03049874416936,8.288482238966631,1.1840688912809472,0.07176175098672408
41,경기도,부천시오정구,오정동,오정동제3투,2600,1759,850,759,121,15,2,1747,12,841,48.65483686319404,43.44590726960504,6.926159129937035,0.8586147681740127,0.11448196908986834
42,경기도,부천시오정구,오정동,오정동제4투,2273,1463,715,626,100,6,4,1451,12,810,49.276361130255,43.142660234321156,6.891798759476224,0.41350792556857335,0.2756719503790489
43,경기도,부천시오정구,오정동,오정동제5투,226,166,43,110,9,2,0,164,2,60,26.21951219512195,67.07317073170732,5.487804878048781,1.2195121951219512,0.0
44,경기도,부천시오정구,신흥동,관내사전투표,2032,2032,1449,462,100,10,2,2023,9,0,71.62629757785467,22.837370242214533,4.9431537320810675,0.4943153732081068,0.09886307464162135
45,경기도,부천시오정구,신흥동,신흥동제1투,1942,1259,593,558,93,10,0,1254,5,683,47.28867623604466,44.49760765550239,7.4162679425837315,0.7974481658692184,0.0
46,경기도,부천시오정구,신흥동,신흥동제2투,3606,2434,1324,906,163,24,2,2419,15,1172,54.73336089293096,37.45349317899959,6.738321620504341,0.9921455146754857,0.0826787928896238
47,경기도,부천시오정구,신흥동,신흥동제3투,1974,1231,581,531,97,13,1,1223,8,743,47.50613246116108,43.41782502044153,7.931316434995912,1.062959934587081,0.08176614881439084
48,경기도,부천시오정구,신흥동,신흥동제4투,1601,1007,461,469,66,6,2,1004,3,594,45.91633466135458,46.713147410358566,6.573705179282868,0.5976095617529881,0.199203187250996
49,경기도,부천시오정구,신흥동,신흥동제5투,1484,981,467,418,74,11,2,972,9,503,48.04526748971193,43.00411522633745,7.613168724279835,1.131687242798354,0.205761316872428
50,경기도,부천시오정구,잘못 투입·구분된 투표지,,0,0,0,0,0,0,0,0,0,0,0.0,0.0,0.0,0.0,0.0
0,강원특별자치도,춘천시,거소·선상투표,,610,576,214,236,100,6,2,558,18,34,38.35125448028674,42.29390681003584,17.921146953405017,1.0752688172043012,0.35842293906810035
1,강원특별자치도,춘천시,관외사전투표,,16075,16074,8548,4611,2502,213,18,15892,182,1,53.788069468915175,29.014598540145986,15.743770450541152,1.3402970047822804,0.11326453561540396
2,강원특별자치도,춘천시,재외투표,,1152,939,668,152,103,15,0,938,1,213,71.21535181236673,16.204690831556505,10.980810234541579,1.5991471215351813,0.0
3,강원특별자치도,춘천시,신북읍,관내사전투표,3426,3426,1996,1101,259,46,2,3404,22,0,58.63689776733255,32.34430082256169,7.608695652173914,1.3513513513513513,0.05875440658049354
4,강원특별자치도,춘천시,신북읍,신북읍제1투,1030,663,172,430,47,9,2,660,3,367,26.060606060606062,65.15151515151516,7.121212121212121,1.3636363636363635,0.30303030303030304
5,강원특별자치도,춘천시,신북읍,신북읍제2투,1625,1081,355,658,56,7,1,1077,4,544,32.9619312906221,61.09563602599815,5.199628597957289,0.6499535747446611,0.09285051067780872
6,강원특별자치도,춘천시,신북읍,신북읍제3투,1123,721,244,422,36,5,1,708,13,402,34.463276836158194,59.6045197740113,5.084745762711865,0.7062146892655368,0.14124293785310735
7,강원특별자치도,춘천시,신북읍,신북읍제4투,608,381,96,265,16,1,0,378,3,227,25.396825396825395,70.1058201058201,4.232804232804233,0.26455026455026454,0.0
8,강원특별자치도,춘천시,동면,관내사전투표,2404,2404,1489,738,142,21,2,2392,12,0,62.249163879598655,30.85284280936455,5.936454849498328,0.8779264214046822,0.08361204013377926
9,강원특별자치도,춘천시,동면,동면제1투,2371,1771,711,900,136,18,0,1765,6,600,40.28328611898017,50.991501416430594,7.705382436260623,1.019830028328612,0.0
10,강원특별자치도,춘천시,동면,동면제2투,906,570,170,350,37,9,0,566,4,336,30.03533568904594,61.83745583038869,6.5371024734982335,1.5901060070671376,0.0
11,강원특별자치도,춘천시,동면,동면제3투,177,123,20,98,1,0,1,120,3,54,16.666666666666664,81.66666666666667,0.8333333333333334,0.0,0.8333333333333334
12,강원특별자치도,춘천시,동면,동면제4투,3173,2140,847,1109,146,24,3,2129,11,1033,39.78393612024425,52.090183184593705,6.857679661813059,1.1272898074213245,0.14091122592766556
13,강원특별자치도,춘천시,동면,동면제5투,3226,2228,902,1110,167,34,2,2215,13,998,40.72234762979684,50.112866817155755,7.539503386004514,1.5349887133182845,0.09029345372460496
14,강원특별자치도,춘천시,동산면,관내사전투표,516,516,290,166,54,3,0,513,3,0,56.53021442495126,32.35867446393762,10.526315789473683,0.5847953216374269,0.0
15,강원특별자치도,춘천시,동산면,동산면제1투,542,359,67,274,14,0,0,355,4,183,18.87323943661972,77.1830985915493,3.943661971830986,0.0,0.0
16,강원특별자치도,춘천시,동산면,동산면제2투,318,185,42,138,4,0,0,184,1,133,22.82608695652174,75.0,2.1739130434782608,0.0,0.0
17,강원특별자치도,춘천시,신동면,관내사전투표,1901,1901,1137,544,186,17,4,1888,13,0,60.222457627118644,28.8135593220339,9.851694915254237,0.9004237288135594,0.211864406779661
18,강원특별자치도,춘천시,신동면,신동면투표소,1395,900,227,608,53,1,0,889,11,495,25.534308211473565,68.39145106861643,5.961754780652419,0.11248593925759282,0.0
19,강원특별자치도,춘천시,동내면,관내사전투표,5353,5352,3391,1424,434,54,6,5309,43,1,63.87266905255227,26.82237709549821,8.174797513656056,1.0171407044641174,0.1130156338293464
20,강원특별자치도,춘천시,동내면,동내면제1투,2432,1477,489,857,111,11,1,1469,8,955,33.28795098706603,58.339006126616745,7.556160653505787,0.7488087134104833,0.06807351940095302
21,강원특별자치도,춘천시,동내면,동내면제2투,3727,2424,870,1320,197,20,2,2409,15,1303,36.1145703611457,54.794520547945204,8.17766708177667,0.8302200083022002,0.08302200083022
22,강원특별자치도,춘천시,동내면,동내면제3투,2430,1814,725,879,173,27,2,1806,8,616,40.14396456256921,48.671096345514954,9.579180509413067,1.495016611295681,0.11074197120708748
23,강원특별자치도,춘천시,동내면,동내면제4투,2507,1771,707,859,168,23,2,1759,12,736,40.19329164297897,48.83456509380329,9.55088118249005,1.3075611142694712,0.11370096645821488
24,강원특별자치도,춘천시,남면,관내사전투표,362,362,170,154,30,3,2,359,3,0,47.353760445682454,42.89693593314763,8.356545961002785,0.8356545961002786,0.5571030640668524
25,강원특별자치도,춘천시,남면,남면투표소,574,340,75,252,8,1,0,336,4,234,22.321428571428573,75.0,2.380952380952381,0.2976190476190476,0.0
26,강원특별자치도,춘천시,남산면,관내사전투표,1018,1018,574,367,65,8,0,1014,4,0,56.60749506903353,36.19329388560158,6.41025641025641,0.7889546351084813,0.0
27,강원특별자치도,춘천시,남산면,남산면제1투,1010,617,135,456,13,8,1,613,4,393,22.02283849918434,74.38825448613376,2.1207177814029365,1.3050570962479608,0.1631321370309951
28,강원특별자치도,춘천시,남산면,남산면제2투,543,358,102,240,15,0,0,357,1,185,28.57142857142857,67.22689075630252,4.201680672268908,0.0,0.0
29,강원특별자치도,춘천시,남산면,남산면제3투,481,329,66,242,13,3,0,324,5,152,20.37037037037037,74.69135802469135,4.012345679012346,0.9259259259259258,0.0
30,강원특별자치도,춘천시,서면,관내사전투표,1048,1048,590,353,89,9,1,1042,6,0,56.62188099808061,33.87715930902112,8.54126679462572,0.8637236084452975,0.09596928982725528
31,강원특별자치도,춘천시,서면,서면제1투,753,496,119,341,29,4,0,493,3,257,24.137931034482758,69.1683569979716,5.88235294117647,0.8113590263691683,0.0
32,강원특별자치도,춘천시,서면,서면제2투,984,655,152,462,32,2,1,649,6,329,23.42064714946071,71.1864406779661,4.930662557781202,0.30816640986132515,0.15408320493066258
33,강원특별자치도,춘천시,서면,서면제3투,578,279,77,192,7,2,0,278,1,299,27.697841726618705,69.06474820143885,2.5179856115107913,0.7194244604316548,0.0
34,강원특별자치도,춘천시,사북면,관내사전투표,371,371,219,119,27,3,0,368,3,0,59.5108695652174,32.33695652173913,7.336956521739131,0.8152173913043478,0.0
35,강원특별자치도,춘천시,사북면,사북면제1투,590,439,119,287,22,6,0,434,5,151,27.419354838709676,66.12903225806451,5.0691244239631335,1.3824884792626728,0.0
36,강원특별자치도,춘천시,사북면,사북면제2투,260,199,51,133,9,2,1,196,3,61,26.02040816326531,67.85714285714286,4.591836734693878,1.0204081632653061,0.5102040816326531
37,강원특별자치도,춘천시,사북면,사북면제3투,630,411,114,285,6,3,1,409,2,219,27.87286063569682,69.68215158924205,1.466992665036675,0.7334963325183375,0.24449877750611246
38,강원특별자치도,춘천시,북산면,관내사전투표,292,292,140,139,12,1,0,292,0,0,47.94520547945205,47.6027397260274,4.10958904109589,0.3424657534246575,0.0
39,강원특별자치도,춘천시,북산면,북산면제1투,315,189,33,150,4,0,0,187,2,126,17.647058823529413,80.21390374331551,2.13903743315508,0.0,0.0
40,강원특별자치도,춘천시,북산면,북산면제2투,136,101,19,78,1,1,0,99,2,35,19.19191919191919,78.78787878787878,1.0101010101010102,1.0101010101010102,0.0
41,강원특별자치도,춘천시,소양동,관내사전투표,3248,3248,1949,967,274,33,3,3226,22,0,60.41537507749535,29.975201487910724,8.493490390576564,1.022938623682579,0.09299442033477992
42,강원특별자치도,춘천시,소양동,소양동제1투,871,549,178,322,37,3,2,542,7,322,32.84132841328413,59.40959409594095,6.826568265682657,0.5535055350553505,0.36900369003690037
43,강원특별자치도,춘천시,소양동,소양동제2투,2843,1901,646,1083,144,16,0,1889,12,942,34.19798835362626,57.33192165166755,7.623080995235575,0.8470089994706195,0.0
44,강원특별자치도,춘천시,소양동,소양동제3투,487,270,62,176,22,2,2,264,6,217,23.484848484848484,66.66666666666666,8.333333333333332,0.7575757575757576,0.7575757575757576
45,강원특별자치도,춘천시,교동,관내사전투표,1757,1756,985,484,247,21,1,1738,18,1,56.67433831990793,27.848101265822784,14.211737629459147,1.2082853855005753,0.05753739930955121
46,강원특별자치도,춘천시,교동,교동투표소,2297,1442,353,893,168,8,2,1424,18,855,24.78932584269663,62.71067415730337,11.797752808988763,0.5617977528089888,0.1404494382022472
47,강원특별자치도,춘천시,조운동,관내사전투표,2065,2065,1209,601,204,28,2,2044,21,0,59.14872798434442,29.403131115459885,9.980430528375733,1.36986301369863,0.09784735812133072
48,강원특별자치도,춘천시,조운동,조운동투표소,1483,806,197,541,55,5,0,798,8,677,24.686716791979947,67.79448621553885,6.8922305764411025,0.6265664160401002,0.0
49,강원특별자치도,춘천시,약사명동,관내사전투표,1773,1773,987,606,146,22,1,1762,11,0,56.01589103291714,34.39273552780931,8.286038592508513,1.2485811577752552,0.056753688989784334
50,강원특별자치도,춘천시,약사명동,약사명동투표소,2401,1561,512,888,130,21,1,1552,9,840,32.98969072164948,57.21649484536082,8.376288659793813,1.3530927835051547,0.06443298969072164
51,강원특별자치도,춘천시,근화동,관내사전투표,1951,1951,1196,579,147,17,1,1940,11,0,61.649484536082475,29.84536082474227,7.577319587628866,0.8762886597938144,0.051546391752577324
52,강원특별자치도,춘천시,근화동,근화동제1투,3174,2047,714,1063,226,28,0,2031,16,1127,35.15509601181684,52.33874938453964,11.127523387493845,1.3786312161496799,0.0
53,강원특별자치도,춘천시,근화동,근화동제2투,1459,778,230,474,57,7,3,771,7,681,29.831387808041505,61.478599221789885,7.392996108949417,0.9079118028534372,0.38910505836575876
54,강원특별자치도,춘천시,후평1동,관내사전투표,4085,4085,2456,1167,384,50,3,4060,25,0,60.49261083743842,28.743842364532018,9.458128078817735,1.2315270935960592,0.07389162561576355
55,강원특별자치도,춘천시,후평1동,후평1동제1투,2202,1267,377,787,70,15,3,1252,15,935,30.11182108626198,62.85942492012779,5.5910543130990416,1.1980830670926517,0.23961661341853036
56,강원특별자치도,춘천시,후평1동,후평1동제2투,2245,1276,339,771,140,14,1,1265,11,969,26.798418972332016,60.948616600790515,11.067193675889328,1.1067193675889329,0.07905138339920949
57,강원특별자치도,춘천시,후평1동,후평1동제3투,2144,1326,405,803,95,11,1,1315,11,818,30.798479087452474,61.06463878326996,7.224334600760455,0.8365019011406843,0.07604562737642585
58,강원특별자치도,춘천시,후평2동,관내사전투표,3147,3147,1809,925,344,48,2,3128,19,0,57.832480818414325,29.571611253196934,10.997442455242968,1.5345268542199488,0.0639386189258312
59,강원특별자치도,춘천시,후평2동,후평2동제1투,2708,1769,623,949,162,26,1,1761,8,939,35.37762634866553,53.889835320840426,9.19931856899489,1.4764338444065872,0.05678591709256105
60,강원특별자치도,춘천시,후평2동,후평2동제2투,1890,1133,365,633,109,12,0,1119,14,757,32.618409294012515,56.56836461126006,9.740840035746203,1.0723860589812333,0.0
61,강원특별자치도,춘천시,후평2동,후평2동제3투,2541,1677,553,972,124,21,1,1671,6,864,33.09395571514063,58.16876122082585,7.4207061639736684,1.2567324955116697,0.059844404548174746
62,강원특별자치도,춘천시,후평3동,관내사전투표,4906,4906,2866,1530,414,60,5,4875,31,0,58.789743589743594,31.384615384615383,8.492307692307692,1.2307692307692308,0.10256410256410256
63,강원특별자치도,춘천시,후평3동,후평3동제1투,2776,1852,633,1066,124,12,5,1840,12,924,34.40217391304348,57.934782608695656,6.739130434782608,0.6521739130434783,0.2717391304347826
64,강원특별자치도,춘천시,후평3동,후평3동제2투,2320,1509,638,701,137,22,2,1500,9,811,42.53333333333333,46.733333333333334,9.133333333333333,1.4666666666666666,0.13333333333333333
65,강원특별자치도,춘천시,후평3동,후평3동제3투,1769,1006,333,572,74,14,3,996,10,763,33.433734939759034,57.42971887550201,7.429718875502007,1.4056224899598393,0.30120481927710846
66,강원특별자치도,춘천시,후평3동,후평3동제4투,1225,833,285,473,53,15,3,829,4,392,34.37876960193004,57.05669481302774,6.393244873341375,1.8094089264173705,0.3618817852834741
67,강원특별자치도,춘천시,후평3동,후평3동제5투,2680,1745,621,992,105,15,1,1734,11,935,35.813148788927336,57.208765859284895,6.055363321799308,0.8650519031141869,0.05767012687427912
68,강원특별자치도,춘천시,효자1동,관내사전투표,2081,2081,1180,705,150,26,1,2062,19,0,57.22599418040737,34.19010669253152,7.274490785645005,1.2609117361784674,0.04849660523763337
69,강원특별자치도,춘천시,효자1동,효자1동투표소,2061,1355,416,829,92,9,2,1348,7,706,30.86053412462908,61.49851632047477,6.824925816023739,0.6676557863501483,0.1483679525222552
70,강원특별자치도,춘천시,효자2동,관내사전투표,2567,2567,1329,701,479,33,1,2543,24,0,52.26110892646481,27.565867086118757,18.83602044828942,1.2976799056232795,0.039323633503735744
71,강원특별자치도,춘천시,효자2동,효자2동제1투,2148,1321,440,718,142,8,3,1311,10,827,33.56216628527841,54.7673531655225,10.831426392067124,0.6102212051868803,0.2288329519450801
72,강원특별자치도,춘천시,효자2동,효자2동제2투,2287,1439,433,858,122,14,3,1430,9,848,30.27972027972028,60.0,8.531468531468532,0.9790209790209791,0.2097902097902098
73,강원특별자치도,춘천시,효자2동,효자2동제3투,1841,1066,273,586,183,13,1,1056,10,775,25.85227272727273,55.49242424242424,17.329545454545457,1.231060606060606,0.0946969696969697
74,강원특별자치도,춘천시,효자2동,효자2동제4투,1355,807,211,459,121,8,3,802,5,548,26.309226932668327,57.23192019950125,15.087281795511224,0.997506234413965,0.3740648379052369
75,강원특별자치도,춘천시,효자3동,관내사전투표,1668,1668,894,474,259,24,1,1652,16,0,54.116222760290555,28.692493946731233,15.677966101694915,1.4527845036319613,0.06053268765133172
76,강원특별자치도,춘천시,효자3동,효자3동투표소,2578,1536,429,895,180,14,4,1522,14,1042,28.186596583442842,58.8042049934297,11.826544021024969,0.9198423127463863,0.2628120893561104
77,강원특별자치도,춘천시,석사동,관내사전투표,6138,6138,3790,1657,580,66,5,6098,40,0,62.1515250901935,27.17284355526402,9.511315185306659,1.0823220728107577,0.0819940964250574
78,강원특별자치도,춘천시,석사동,석사동제1투,2097,1420,478,820,96,13,1,1408,12,677,33.94886363636363,58.23863636363637,6.8181818181818175,0.9232954545454546,0.07102272727272728
79,강원특별자치도,춘천시,석사동,석사동제2투,1432,798,184,509,81,11,2,787,11,634,23.37992376111817,64.67598475222364,10.292249047013977,1.3977128335451081,0.25412960609911056
80,강원특별자치도,춘천시,석사동,석사동제3투,1739,1165,392,589,163,9,1,1154,11,574,33.96880415944541,51.03986135181976,14.124783362218372,0.779896013864818,0.08665511265164644
81,강원특별자치도,춘천시,석사동,석사동제4투,2567,1971,782,993,164,18,2,1959,12,596,39.91832567636549,50.68912710566615,8.371618172537008,0.9188361408882083,0.10209290454313426
82,강원특별자치도,춘천시,석사동,석사동제5투,1887,1314,547,634,108,15,1,1305,9,573,41.91570881226054,48.582375478927204,8.275862068965518,1.1494252873563218,0.07662835249042146
83,강원특별자치도,춘천시,석사동,석사동제6투,3163,2227,853,1142,190,27,2,2214,13,936,38.527551942186086,51.58084914182475,8.581752484191508,1.2195121951219512,0.09033423667570009
84,강원특별자치도,춘천시,석사동,석사동제7투,1369,832,277,486,60,5,0,828,4,537,33.45410628019324,58.69565217391305,7.246376811594203,0.6038647342995169,0.0
85,강원특별자치도,춘천시,석사동,석사동제8투,1603,1203,562,502,118,16,0,1198,5,400,46.91151919866444,41.90317195325542,9.84974958263773,1.335559265442404,0.0
86,강원특별자치도,춘천시,석사동,석사동제9투,2889,1963,861,874,181,31,2,1949,14,926,44.17650076962545,44.843509492047204,9.286813750641354,1.5905592611595691,0.1026167265264238
87,강원특별자치도,춘천시,퇴계동,관내사전투표,7688,7688,4919,2002,650,68,5,7644,44,0,64.35112506541077,26.190476190476193,8.503401360544217,0.8895866038723181,0.06541077969649398
88,강원특별자치도,춘천시,퇴계동,퇴계동제1투,2889,1880,594,1055,186,29,0,1864,16,1009,31.86695278969957,56.598712446351925,9.97854077253219,1.555793991416309,0.0
89,강원특별자치도,춘천시,퇴계동,퇴계동제2투,1479,997,327,575,76,10,1,989,8,482,33.06370070778564,58.139534883720934,7.684529828109202,1.0111223458038423,0.10111223458038424
90,강원특별자치도,춘천시,퇴계동,퇴계동제3투,1568,1143,434,602,94,7,1,1138,5,425,38.13708260105449,52.899824253075565,8.260105448154658,0.6151142355008787,0.08787346221441124
91,강원특별자치도,춘천시,퇴계동,퇴계동제4투,1798,1358,492,743,99,16,1,1351,7,440,36.417468541820874,54.99629903774982,7.327905255366396,1.1843079200592153,0.07401924500370095
92,강원특별자치도,춘천시,퇴계동,퇴계동제5투,1226,910,373,462,67,4,0,906,4,316,41.16997792494481,50.993377483443716,7.39514348785872,0.44150110375275936,0.0
93,강원특별자치도,춘천시,퇴계동,퇴계동제6투,2037,1527,563,853,89,15,0,1520,7,510,37.03947368421053,56.11842105263158,5.855263157894737,0.9868421052631579,0.0
94,강원특별자치도,춘천시,퇴계동,퇴계동제7투,2798,1861,688,997,133,27,0,1845,16,937,37.289972899728994,54.03794037940379,7.208672086720867,1.4634146341463417,0.0
95,강원특별자치도,춘천시,퇴계동,퇴계동제8투,2297,1616,630,846,107,20,3,1606,10,681,39.22789539227895,52.6774595267746,6.662515566625156,1.2453300124533,0.18679950186799502
96,강원특별자치도,춘천시,퇴계동,퇴계동제9투,1639,1234,583,554,75,17,2,1231,3,405,47.35987002437043,45.00406173842404,6.092607636068237,1.380991064175467,0.16246953696181965
97,강원특별자치도,춘천시,퇴계동,퇴계동제10투,2385,1693,660,889,120,19,1,1689,4,692,39.07637655417407,52.634695085849614,7.104795737122557,1.1249259917110717,0.059206631142687975
98,강원특별자치도,춘천시,퇴계동,퇴계동제11투,1980,1592,704,711,148,24,2,1589,3,388,44.30459408432977,44.745122718691,9.314033983637508,1.5103838892385149,0.12586532410320958
99,강원특별자치도,춘천시,퇴계동,퇴계동제12투,3797,2917,1349,1235,279,43,0,2906,11,880,46.421197522367514,42.498279421885755,9.600825877494838,1.4796971782518926,0.0
100,강원특별자치도,춘천시,강남동,관내사전투표,6503,6503,3825,1991,560,88,2,6466,37,0,59.15558304979894,30.79183420971234,8.660686668728735,1.3609650479430868,0.03093102381688834
101,강원특별자치도,춘천시,강남동,강남동제1투,1597,982,365,510,87,13,2,977,5,615,37.35926305015353,52.20061412487206,8.904810644831116,1.3306038894575232,0.2047082906857728
102,강원특별자치도,춘천시,강남동,강남동제2투,3655,2546,759,1498,252,22,3,2534,12,1109,29.952644041041832,59.11602209944752,9.94475138121547,0.8681925808997633,0.11838989739542227
103,강원특별자치도,춘천시,강남동,강남동제3투,1709,1192,349,746,90,6,0,1191,1,517,29.303106633081445,62.636439966414784,7.5566750629722925,0.5037783375314862,0.0
104,강원특별자치도,춘천시,강남동,강남동제4투,3122,2119,829,1127,127,24,2,2109,10,1003,39.30772878141299,53.437648174490285,6.02181128496918,1.1379800853485065,0.0948316737790422
105,강원특별자치도,춘천시,강남동,강남동제5투,3299,2493,1120,1113,223,26,2,2484,9,806,45.088566827697264,44.806763285024154,8.977455716586151,1.0466988727858293,0.08051529790660225
106,강원특별자치도,춘천시,신사우동,관내사전투표,5707,5707,3476,1699,433,64,5,5677,30,0,61.22952263519464,29.927778756385415,7.627267923198873,1.1273559978862076,0.08807468733485996
107,강원특별자치도,춘천시,신사우동,신사우동제1투,2793,1858,763,935,133,12,3,1846,12,935,41.33261105092091,50.65005417118093,7.204767063921993,0.6500541711809318,0.16251354279523295
108,강원특별자치도,춘천시,신사우동,신사우동제2투,1581,1147,372,678,76,10,2,1138,9,434,32.68892794376098,59.57820738137083,6.6783831282952555,0.8787346221441126,0.17574692442882248
109,강원특별자치도,춘천시,신사우동,신사우동제3투,2067,1370,413,820,105,12,3,1353,17,697,30.524759793052475,60.60606060606061,7.760532150776053,0.8869179600886918,0.22172949002217296
110,강원특별자치도,춘천시,신사우동,신사우동제4투,944,591,177,361,46,4,0,588,3,353,30.102040816326532,61.39455782312925,7.8231292517006805,0.6802721088435374,0.0
111,강원특별자치도,춘천시,신사우동,신사우동제5투,2254,1504,536,794,148,11,3,1492,12,750,35.924932975871315,53.2171581769437,9.919571045576408,0.7372654155495978,0.20107238605898123
112,강원특별자치도,춘천시,신사우동,신사우동제6투,3454,2345,919,1167,216,29,2,2333,12,1109,39.391341620231465,50.021431633090444,9.258465495070723,1.2430347192456064,0.08572653236176596
113,강원특별자치도,춘천시,잘못 투입·구분된 투표지,,0,2,1,0,1,0,0,2,0,-2,50.0,0.0,50.0,0.0,0.0
0,강원특별자치도,원주시,거소·선상투표,,583,534,220,179,106,11,2,518,16,49,42.471042471042466,34.55598455598455,20.463320463320464,2.1235521235521233,0.3861003861003861
1,강원특별자치도,원주시,관외사전투표,,20854,20848,11413,5795,3136,237,35,20616,232,6,55.35991462941404,28.109235545207607,15.211486224291813,1.149592549476135,0.16977105161039968
2,강원특별자치도,원주시,재외투표,,1156,930,638,181,86,18,1,924,6,226,69.04761904761905,19.58874458874459,9.307359307359308,1.948051948051948,0.10822510822510822
3,강원특별자치도,원주시,문막읍,관내사전투표,4969,4969,3086,1486,312,55,3,4942,27,0,62.44435451234318,30.068798057466612,6.3132335087009315,1.112909753136382,0.06070416835289356
4,강원특별자치도,원주시,문막읍,문막읍제1투,3908,2417,954,1272,145,26,3,2400,17,1491,39.75,53.0,6.041666666666667,1.0833333333333335,0.125
5,강원특별자치도,원주시,문막읍,문막읍제2투,1468,794,204,541,35,5,1,786,8,674,25.954198473282442,68.8295165394402,4.4529262086514,0.6361323155216284,0.1272264631043257
6,강원특별자치도,원주시,문막읍,문막읍제3투,774,513,135,358,16,1,1,511,2,261,26.418786692759294,70.0587084148728,3.131115459882583,0.19569471624266144,0.19569471624266144
7,강원특별자치도,원주시,문막읍,문막읍제4투,4062,2438,981,1231,174,32,5,2423,15,1624,40.48699958728849,50.80478745356996,7.181180354931903,1.3206768468840282,0.20635575732562939
8,강원특별자치도,원주시,소초면,관내사전투표,1565,1565,829,584,129,13,3,1558,7,0,53.20924261874198,37.48395378690629,8.2798459563543,0.8344030808729139,0.19255455712451863
9,강원특별자치도,원주시,소초면,소초면제1투,1426,908,279,581,35,10,0,905,3,518,30.82872928176796,64.19889502762432,3.867403314917127,1.1049723756906076,0.0
10,강원특별자치도,원주시,소초면,소초면제2투,1138,805,241,530,25,8,0,804,1,333,29.975124378109452,65.92039800995025,3.109452736318408,0.9950248756218906,0.0
11,강원특별자치도,원주시,소초면,소초면제3투,1778,1109,291,732,67,9,0,1099,10,669,26.478616924476796,66.60600545950864,6.096451319381256,0.8189262966333031,0.0
12,강원특별자치도,원주시,소초면,소초면제4투,792,539,145,318,64,3,1,531,8,253,27.30696798493409,59.887005649717516,12.052730696798493,0.5649717514124294,0.18832391713747645
13,강원특별자치도,원주시,호저면,관내사전투표,1153,1153,597,443,85,10,2,1137,16,0,52.5065963060686,38.962181178540014,7.475813544415128,0.8795074758135445,0.1759014951627089
14,강원특별자치도,원주시,호저면,호저면제1투,1418,914,205,660,36,9,1,911,3,504,22.502744237102085,72.44785949506037,3.951701427003293,0.9879253567508233,0.10976948408342481
15,강원특별자치도,원주시,호저면,호저면제2투,692,457,122,308,17,3,0,450,7,235,27.111111111111114,68.44444444444444,3.7777777777777777,0.6666666666666667,0.0
16,강원특별자치도,원주시,지정면,관내사전투표,6743,6743,4545,1425,656,53,8,6687,56,0,67.96769851951548,21.310004486316732,9.8100792582623,0.7925826229998505,0.1196351129056378
17,강원특별자치도,원주시,지정면,지정면제1투,1067,700,174,478,32,10,1,695,5,367,25.03597122302158,68.77697841726619,4.60431654676259,1.4388489208633095,0.14388489208633093
18,강원특별자치도,원주시,지정면,지정면제2투,695,471,145,298,19,7,0,469,2,224,30.916844349680172,63.53944562899787,4.051172707889126,1.4925373134328357,0.0
19,강원특별자치도,원주시,지정면,지정면제3투,2410,1627,744,699,162,12,0,1617,10,783,46.01113172541744,43.22820037105751,10.018552875695732,0.7421150278293136,0.0
20,강원특별자치도,원주시,지정면,지정면제4투,3239,2131,967,934,185,28,4,2118,13,1108,45.65627950897073,44.09820585457979,8.734655335221909,1.3220018885741265,0.18885741265344666
21,강원특별자치도,원주시,지정면,지정면제5투,3867,2682,1219,1172,247,34,0,2672,10,1185,45.62125748502994,43.862275449101794,9.244011976047904,1.2724550898203593,0.0
22,강원특별자치도,원주시,지정면,지정면제6투,3610,2302,988,1014,253,34,1,2290,12,1308,43.14410480349345,44.27947598253275,11.048034934497815,1.48471615720524,0.043668122270742356
23,강원특별자치도,원주시,부론면,관내사전투표,585,585,268,285,24,4,0,581,4,0,46.12736660929432,49.05335628227194,4.130808950086059,0.6884681583476765,0.0
24,강원특별자치도,원주시,부론면,부론면투표소,1271,838,171,630,23,5,2,831,7,433,20.577617328519857,75.81227436823104,2.7677496991576414,0.601684717208183,0.24067388688327318
25,강원특별자치도,원주시,귀래면,관내사전투표,745,745,386,315,33,4,1,739,6,0,52.232746955345064,42.625169147496614,4.465493910690121,0.5412719891745602,0.13531799729364005
26,강원특별자치도,원주시,귀래면,귀래면투표소,1180,738,169,547,18,2,2,738,0,442,22.899728997289973,74.11924119241192,2.4390243902439024,0.27100271002710025,0.27100271002710025
27,강원특별자치도,원주시,흥업면,관내사전투표,4129,4129,2415,1199,426,43,4,4087,42,0,59.08979691705407,29.336921947638857,10.423293369219476,1.0521164668460974,0.09787129924149743
28,강원특별자치도,원주시,흥업면,흥업면제1투,3089,1873,615,1066,155,18,5,1859,14,1216,33.082302313071544,57.34265734265735,8.337816030123722,0.9682625067240451,0.26896180742334586
29,강원특별자치도,원주시,흥업면,흥업면제2투,764,508,152,318,33,3,1,507,1,256,29.980276134122285,62.721893491124256,6.508875739644971,0.591715976331361,0.19723865877712032
30,강원특별자치도,원주시,흥업면,흥업면제3투,1223,707,188,443,63,6,0,700,7,516,26.857142857142858,63.28571428571429,9.0,0.8571428571428572,0.0
31,강원특별자치도,원주시,판부면,관내사전투표,2018,2018,1312,469,199,22,0,2002,16,0,65.53446553446554,23.426573426573427,9.94005994005994,1.098901098901099,0.0
32,강원특별자치도,원주시,판부면,판부면제1투,800,585,178,361,35,4,0,578,7,215,30.79584775086505,62.45674740484429,6.055363321799308,0.6920415224913495,0.0
33,강원특별자치도,원주시,판부면,판부면제2투,565,397,122,254,11,6,0,393,4,168,31.043256997455472,64.63104325699746,2.7989821882951653,1.5267175572519083,0.0
34,강원특별자치도,원주시,판부면,판부면제3투,2650,1500,493,866,118,14,1,1492,8,1150,33.042895442359246,58.04289544235925,7.908847184986595,0.938337801608579,0.06702412868632708
35,강원특별자치도,원주시,신림면,관내사전투표,1224,1224,674,475,60,11,0,1220,4,0,55.24590163934426,38.9344262295082,4.918032786885246,0.9016393442622952,0.0
36,강원특별자치도,원주시,신림면,신림면제1투,1459,936,228,670,27,5,1,931,5,523,24.489795918367346,71.9656283566058,2.9001074113856067,0.5370569280343717,0.10741138560687433
37,강원특별자치도,원주시,신림면,신림면제2투,605,444,135,289,12,4,2,442,2,161,30.542986425339368,65.38461538461539,2.7149321266968327,0.904977375565611,0.4524886877828055
38,강원특별자치도,원주시,중앙동,관내사전투표,2261,2261,1139,932,155,22,2,2250,11,0,50.62222222222223,41.422222222222224,6.888888888888889,0.9777777777777777,0.08888888888888889
39,강원특별자치도,원주시,중앙동,중앙동투표소,1397,725,159,537,21,3,1,721,4,672,22.052704576976424,74.47988904299584,2.912621359223301,0.4160887656033287,0.13869625520110956
40,강원특별자치도,원주시,원인동,관내사전투표,846,846,433,337,56,10,1,837,9,0,51.732377538829155,40.26284348864994,6.690561529271206,1.1947431302270013,0.11947431302270012
41,강원특별자치도,원주시,원인동,원인동제1투,1682,1025,331,590,91,8,2,1022,3,657,32.38747553816047,57.72994129158513,8.904109589041095,0.7827788649706457,0.19569471624266144
42,강원특별자치도,원주시,원인동,원인동제2투,640,371,104,234,24,3,1,366,5,269,28.415300546448087,63.934426229508205,6.557377049180328,0.819672131147541,0.273224043715847
43,강원특별자치도,원주시,개운동,관내사전투표,2952,2952,1603,1085,209,30,5,2932,20,0,54.67257844474761,37.005457025920876,7.128240109140519,1.023192360163711,0.17053206002728513
44,강원특별자치도,원주시,개운동,개운동제1투,2323,1389,413,859,89,16,0,1377,12,934,29.99273783587509,62.381989832970234,6.463326071169208,1.1619462599854757,0.0
45,강원특별자치도,원주시,개운동,개운동제2투,2575,1696,529,1019,126,12,1,1687,9,879,31.357439241256667,60.40308239478364,7.468879668049793,0.7113218731475993,0.05927682276229994
46,강원특별자치도,원주시,개운동,개운동제3투,1974,1279,411,750,98,13,1,1273,6,695,32.285938727415555,58.9159465828751,7.698350353495679,1.021209740769835,0.07855459544383347
47,강원특별자치도,원주시,명륜1동,관내사전투표,3420,3420,2035,1054,261,31,3,3384,36,0,60.13593380614657,31.14657210401891,7.712765957446808,0.9160756501182032,0.08865248226950355
48,강원특별자치도,원주시,명륜1동,명륜1동제1투,1408,890,257,572,51,3,2,885,5,518,29.039548022598872,64.63276836158191,5.762711864406779,0.3389830508474576,0.22598870056497175
49,강원특별자치도,원주시,명륜1동,명륜1동제2투,1256,782,249,475,46,8,2,780,2,474,31.92307692307692,60.89743589743589,5.897435897435897,1.0256410256410255,0.2564102564102564
50,강원특별자치도,원주시,명륜1동,명륜1동제3투,1948,1401,474,814,90,12,1,1391,10,547,34.07620416966211,58.519051042415526,6.470165348670022,0.8626887131560028,0.07189072609633358
51,강원특별자치도,원주시,명륜2동,관내사전투표,3835,3835,2248,1235,283,40,5,3811,24,0,58.987142482288114,32.406192600367355,7.425872474416163,1.0495932826029915,0.13119916032537393
52,강원특별자치도,원주시,명륜2동,명륜2동제1투,2281,1307,414,731,129,18,2,1294,13,974,31.993817619783616,56.49149922720247,9.969088098918084,1.3910355486862442,0.1545595054095827
53,강원특별자치도,원주시,명륜2동,명륜2동제2투,2792,2033,769,1093,140,22,1,2025,8,759,37.97530864197531,53.9753086419753,6.91358024691358,1.0864197530864197,0.04938271604938272
54,강원특별자치도,원주시,명륜2동,명륜2동제3투,2825,1893,598,1102,165,13,0,1878,15,932,31.842385516506923,58.67944621938233,8.78594249201278,0.6922257720979765,0.0
55,강원특별자치도,원주시,명륜2동,명륜2동제4투,1666,983,291,611,56,15,1,974,9,683,29.876796714579058,62.73100616016427,5.749486652977413,1.5400410677618068,0.10266940451745381
56,강원특별자치도,원주시,단구동,관내사전투표,8618,8618,5486,2356,624,83,10,8559,59,0,64.0962729290805,27.52658020796822,7.290571328426218,0.9697394555438719,0.11683607898118939
57,강원특별자치도,원주시,단구동,단구동제1투,2396,1459,515,815,106,11,2,1449,10,937,35.54175293305728,56.245686680469284,7.315389924085576,0.759144237405107,0.13802622498274672
58,강원특별자치도,원주시,단구동,단구동제2투,2500,1690,618,924,115,16,3,1676,14,810,36.87350835322196,55.131264916467785,6.8615751789976125,0.9546539379474941,0.17899761336515513
59,강원특별자치도,원주시,단구동,단구동제3투,2234,1373,571,642,133,17,2,1365,8,861,41.83150183150183,47.03296703296703,9.743589743589745,1.2454212454212454,0.14652014652014653
60,강원특별자치도,원주시,단구동,단구동제4투,1297,767,212,480,61,8,3,764,3,530,27.748691099476442,62.82722513089005,7.984293193717278,1.0471204188481675,0.3926701570680628
61,강원특별자치도,원주시,단구동,단구동제5투,2635,1618,530,924,136,22,0,1612,6,1017,32.878411910669975,57.32009925558312,8.436724565756824,1.3647642679900744,0.0
62,강원특별자치도,원주시,단구동,단구동제6투,2437,1568,580,822,128,19,3,1552,16,869,37.371134020618555,52.9639175257732,8.24742268041237,1.2242268041237114,0.19329896907216496
63,강원특별자치도,원주시,단구동,단구동제7투,2638,1567,600,805,131,17,1,1554,13,1071,38.61003861003861,51.80180180180181,8.42985842985843,1.093951093951094,0.06435006435006435
64,강원특별자치도,원주시,단구동,단구동제8투,2326,1419,613,649,138,13,0,1413,6,907,43.38287331917905,45.930644019816,9.766454352441615,0.9200283085633405,0.0
65,강원특별자치도,원주시,단구동,단구동제9투,2912,1964,917,847,174,16,0,1954,10,948,46.92937563971341,43.34698055271238,8.904810644831116,0.8188331627430911,0.0
66,강원특별자치도,원주시,단구동,단구동제10투,2157,1337,570,632,108,15,3,1328,9,820,42.92168674698795,47.59036144578313,8.132530120481928,1.1295180722891567,0.2259036144578313
67,강원특별자치도,원주시,일산동,관내사전투표,2273,2273,1301,673,249,23,3,2249,24,0,57.8479324144064,29.92441084926634,11.071587372165407,1.0226767452200978,0.1333926189417519
68,강원특별자치도,원주시,일산동,일산동제1투,2242,1381,461,773,126,9,1,1370,11,861,33.64963503649635,56.42335766423358,9.197080291970803,0.656934306569343,0.072992700729927
69,강원특별자치도,원주시,일산동,일산동제2투,2598,1611,453,970,160,13,1,1597,14,987,28.36568566061365,60.738885410144015,10.018785222291797,0.8140262993112084,0.06261740763932373
70,강원특별자치도,원주시,학성동,관내사전투표,2186,2186,1264,761,126,23,0,2174,12,0,58.141674333026685,35.00459981600736,5.795768169273229,1.0579576816927323,0.0
71,강원특별자치도,원주시,학성동,학성동제1투,1880,1114,325,716,63,6,2,1112,2,766,29.22661870503597,64.38848920863309,5.66546762589928,0.539568345323741,0.1798561151079137
72,강원특별자치도,원주시,학성동,학성동제2투,802,442,105,315,20,1,0,441,1,360,23.809523809523807,71.42857142857143,4.535147392290249,0.22675736961451248,0.0
73,강원특별자치도,원주시,단계동,관내사전투표,6070,6068,3667,1810,495,56,2,6030,38,2,60.81260364842455,30.016583747927033,8.208955223880597,0.9286898839137645,0.03316749585406302
74,강원특별자치도,원주시,단계동,단계동제1투,2785,1669,486,1003,140,21,2,1652,17,1116,29.418886198547217,60.71428571428571,8.47457627118644,1.2711864406779663,0.12106537530266344
75,강원특별자치도,원주시,단계동,단계동제2투,3097,2031,680,1172,135,25,4,2016,15,1066,33.730158730158735,58.13492063492064,6.696428571428571,1.2400793650793651,0.1984126984126984
76,강원특별자치도,원주시,단계동,단계동제3투,3377,2170,710,1261,162,22,6,2161,9,1207,32.855159648310966,58.35261453031004,7.496529384544193,1.018047200370199,0.2776492364645997
77,강원특별자치도,원주시,단계동,단계동제4투,1184,691,207,419,57,4,0,687,4,493,30.131004366812224,60.98981077147017,8.296943231441048,0.5822416302765648,0.0
78,강원특별자치도,원주시,단계동,단계동제5투,2966,1977,732,1034,171,20,3,1960,17,989,37.3469387755102,52.755102040816325,8.724489795918368,1.0204081632653061,0.15306122448979592
79,강원특별자치도,원주시,단계동,단계동제6투,2419,1660,762,720,153,14,1,1650,10,759,46.18181818181818,43.63636363636363,9.272727272727273,0.8484848484848486,0.06060606060606061
80,강원특별자치도,원주시,우산동,관내사전투표,3127,3127,1858,913,289,45,3,3108,19,0,59.781209781209775,29.375804375804375,9.298584298584299,1.4478764478764479,0.09652509652509653
81,강원특별자치도,원주시,우산동,우산동제1투,2368,1336,340,859,107,15,4,1325,11,1032,25.660377358490567,64.83018867924528,8.075471698113207,1.1320754716981132,0.3018867924528302
82,강원특별자치도,원주시,우산동,우산동제2투,2894,1969,793,1021,125,15,2,1956,13,925,40.54192229038855,52.19836400817995,6.3905930470347645,0.7668711656441718,0.10224948875255625
83,강원특별자치도,원주시,우산동,우산동제3투,2537,1541,488,915,121,9,3,1536,5,996,31.770833333333332,59.5703125,7.877604166666667,0.5859375,0.1953125
84,강원특별자치도,원주시,태장1동,관내사전투표,3436,3436,2008,1099,272,28,6,3413,23,0,58.83387049516554,32.20041019630823,7.969528274245532,0.8203926164664519,0.17579841781423966
85,강원특별자치도,원주시,태장1동,태장1동제1투,3295,2083,753,1140,151,24,4,2072,11,1212,36.34169884169884,55.01930501930502,7.287644787644787,1.1583011583011582,0.19305019305019305
86,강원특별자치도,원주시,태장1동,태장1동제2투,3414,1941,690,1061,162,16,4,1933,8,1473,35.695809622348676,54.88877392653906,8.380755302638386,0.8277289187790998,0.20693222969477496
87,강원특별자치도,원주시,태장2동,관내사전투표,5365,5365,3140,1736,400,49,7,5332,33,0,58.88972243060765,32.55813953488372,7.501875468867217,0.918979744936234,0.1312828207051763
88,강원특별자치도,원주시,태장2동,태장2동제1투,1709,892,286,540,49,9,0,884,8,817,32.35294117647059,61.085972850678736,5.542986425339366,1.0180995475113122,0.0
89,강원특별자치도,원주시,태장2동,태장2동제2투,3282,2144,876,1095,141,25,1,2138,6,1138,40.97287184284378,51.21608980355472,6.594948550046772,1.1693171188026192,0.04677268475210477
90,강원특별자치도,원주시,태장2동,태장2동제3투,2111,1325,467,734,99,19,1,1320,5,786,35.378787878787875,55.6060606060606,7.5,1.4393939393939394,0.07575757575757576
91,강원특별자치도,원주시,태장2동,태장2동제4투,1410,842,238,552,45,6,0,841,1,568,28.299643281807374,65.63614744351962,5.35077288941736,0.713436385255648,0.0
92,강원특별자치도,원주시,태장2동,태장2동제5투,2587,1574,586,876,88,16,2,1568,6,1013,37.37244897959184,55.86734693877551,5.612244897959184,1.0204081632653061,0.12755102040816327
93,강원특별자치도,원주시,태장2동,태장2동제6투,3057,1856,650,1024,132,26,5,1837,19,1201,35.38377789874796,55.74305933587371,7.18562874251497,1.4153511159499184,0.2721829069134458
94,강원특별자치도,원주시,봉산동,관내사전투표,1791,1791,1007,644,110,11,3,1775,16,0,56.732394366197184,36.28169014084507,6.197183098591549,0.6197183098591549,0.16901408450704225
95,강원특별자치도,원주시,봉산동,봉산동제1투,1289,839,224,559,43,7,1,834,5,450,26.85851318944844,67.0263788968825,5.155875299760192,0.8393285371702638,0.1199040767386091
96,강원특별자치도,원주시,봉산동,봉산동제2투,1258,744,202,487,43,6,1,739,5,514,27.33423545331529,65.8998646820027,5.818673883626523,0.8119079837618403,0.13531799729364005
97,강원특별자치도,원주시,봉산동,봉산동제3투,1921,1354,490,761,79,11,1,1342,12,567,36.51266766020864,56.706408345752614,5.886736214605067,0.819672131147541,0.07451564828614009
98,강원특별자치도,원주시,행구동,관내사전투표,3577,3577,2321,914,278,33,2,3548,29,0,65.41713641488163,25.760992108229992,7.835400225479143,0.9301014656144307,0.05636978579481398
99,강원특별자치도,원주시,행구동,행구동제1투,1600,1002,229,696,65,4,0,994,8,598,23.038229376257547,70.02012072434609,6.539235412474849,0.4024144869215292,0.0
100,강원특별자치도,원주시,행구동,행구동제2투,2857,1944,800,993,126,13,0,1932,12,913,41.40786749482402,51.39751552795031,6.521739130434782,0.6728778467908902,0.0
101,강원특별자치도,원주시,무실동,관내사전투표,7543,7543,4891,1860,658,75,4,7488,55,0,65.31784188034187,24.83974358974359,8.787393162393162,1.001602564102564,0.05341880341880342
102,강원특별자치도,원주시,무실동,무실동제1투,3120,1885,697,983,164,24,1,1869,16,1235,37.29266987693954,52.59497057249867,8.774745853397539,1.2841091492776886,0.05350454788657035
103,강원특별자치도,원주시,무실동,무실동제2투,3536,2399,949,1204,205,23,2,2383,16,1137,39.82375157364667,50.52454888795636,8.602601762484262,0.9651699538396977,0.0839278220730172
104,강원특별자치도,원주시,무실동,무실동제3투,2380,1901,863,848,154,22,3,1890,11,479,45.661375661375665,44.86772486772487,8.148148148148149,1.164021164021164,0.15873015873015872
105,강원특별자치도,원주시,무실동,무실동제4투,3360,1942,649,1076,179,25,2,1931,11,1418,33.60952874158467,55.72242361470741,9.269808389435525,1.294665976178146,0.10357327809425168
106,강원특별자치도,원주시,무실동,무실동제5투,3293,2299,1010,1071,182,21,1,2285,14,994,44.201312910284464,46.87089715536105,7.964989059080962,0.9190371991247264,0.0437636761487965
107,강원특별자치도,원주시,무실동,무실동제6투,3833,2690,1217,1175,258,28,0,2678,12,1143,45.44436146377894,43.87602688573563,9.634055265123227,1.0455563853622107,0.0
108,강원특별자치도,원주시,반곡관설동,관내사전투표,8719,8719,5910,1866,790,101,6,8673,46,0,68.14251124178486,21.51504669664476,9.108728237057536,1.1645336100541912,0.06918021445866482
109,강원특별자치도,원주시,반곡관설동,반곡관설동제1투,1814,1294,480,705,89,10,4,1288,6,520,37.267080745341616,54.7360248447205,6.909937888198758,0.7763975155279503,0.3105590062111801
110,강원특별자치도,원주시,반곡관설동,반곡관설동제2투,2598,1941,878,822,193,30,0,1923,18,657,45.657826313052524,42.74570982839314,10.036401456058243,1.5600624024960998,0.0
111,강원특별자치도,원주시,반곡관설동,반곡관설동제3투,4064,2504,1067,1173,216,25,0,2481,23,1560,43.006852075775896,47.27932285368803,8.706166868198308,1.007658202337767,0.0
112,강원특별자치도,원주시,반곡관설동,반곡관설동제4투,2754,1916,912,801,162,27,2,1904,12,838,47.89915966386555,42.069327731092436,8.508403361344538,1.4180672268907564,0.10504201680672269
113,강원특별자치도,원주시,반곡관설동,반곡관설동제5투,3320,2286,935,1126,181,27,2,2271,15,1034,41.171290180537206,49.58168207837957,7.970057243505063,1.1889035667107,0.08806693086745927
114,강원특별자치도,원주시,반곡관설동,반곡관설동제6투,2940,1981,856,847,229,32,1,1965,16,959,43.56234096692112,43.10432569974555,11.653944020356235,1.6284987277353689,0.05089058524173028
115,강원특별자치도,원주시,반곡관설동,반곡관설동제7투,3148,2212,1018,949,211,26,0,2204,8,936,46.18874773139746,43.05807622504537,9.573502722323049,1.17967332123412,0.0
116,강원특별자치도,원주시,반곡관설동,반곡관설동제8투,2882,2000,929,903,144,12,1,1989,11,882,46.70688788335847,45.399698340874814,7.239819004524888,0.603318250377074,0.050276520864756154
117,강원특별자치도,원주시,잘못 투입·구분된 투표지,,0,2,1,1,0,0,0,2,0,-2,50.0,50.0,0.0,0.0,0.0
0,강원특별자치도,강릉시,거소·선상투표,,325,306,122,114,56,3,3,298,8,19,40.939597315436245,38.25503355704698,18.79194630872483,1.006711409395973,1.006711409395973
1,강원특별자치도,강릉시,관외사전투표,,10413,10409,5174,3347,1635,115,22,10293,116,4,50.26717186437385,32.517244729427766,15.8845817545905,1.1172641601088118,0.21373749149907703
2,강원특별자치도,강릉시,재외투표,,646,538,407,67,53,8,0,535,3,108,76.07476635514018,12.52336448598131,9.906542056074766,1.4953271028037385,0.0
3,강원특별자치도,강릉시,주문진읍,관내사전투표,3361,3361,1740,1388,193,15,1,3337,24,0,52.14264309259814,41.59424632903806,5.783637998201978,0.4495055439017081,0.029967036260113877
4,강원특별자치도,강릉시,주문진읍,주문진읍제1투,1760,999,228,719,35,8,1,991,8,761,23.007063572149345,72.55297679112009,3.5317860746720484,0.8072653884964682,0.10090817356205853
5,강원특별자치도,강릉시,주문진읍,주문진읍제2투,2291,1289,355,857,56,9,1,1278,11,1002,27.77777777777778,67.05790297339593,4.381846635367762,0.7042253521126761,0.0782472613458529
6,강원특별자치도,강릉시,주문진읍,주문진읍제3투,1813,1125,286,794,34,4,3,1121,4,688,25.512934879571812,70.82961641391614,3.033006244424621,0.35682426404995543,0.2676181980374665
7,강원특별자치도,강릉시,주문진읍,주문진읍제4투,693,427,80,322,19,3,0,424,3,266,18.867924528301888,75.94339622641509,4.481132075471698,0.7075471698113208,0.0
8,강원특별자치도,강릉시,주문진읍,주문진읍제5투,2037,1263,395,778,69,9,1,1252,11,774,31.549520766773163,62.14057507987221,5.5111821086261985,0.7188498402555911,0.07987220447284345
9,강원특별자치도,강릉시,주문진읍,주문진읍제6투,1493,876,250,563,49,8,0,870,6,617,28.735632183908045,64.71264367816092,5.632183908045977,0.9195402298850575,0.0
10,강원특별자치도,강릉시,성산면,관내사전투표,1130,1130,588,444,74,15,3,1124,6,0,52.313167259786475,39.50177935943061,6.583629893238434,1.3345195729537367,0.26690391459074736
11,강원특별자치도,강릉시,성산면,성산면제1투,1483,935,213,678,32,4,1,928,7,548,22.95258620689655,73.0603448275862,3.4482758620689653,0.43103448275862066,0.10775862068965517
12,강원특별자치도,강릉시,성산면,성산면제2투,583,405,119,257,23,3,0,402,3,178,29.601990049751244,63.93034825870647,5.721393034825871,0.7462686567164178,0.0
13,강원특별자치도,강릉시,왕산면,관내사전투표,330,330,151,162,14,2,1,330,0,0,45.75757575757576,49.09090909090909,4.242424242424243,0.6060606060606061,0.30303030303030304
14,강원특별자치도,강릉시,왕산면,왕산면제1투,444,307,54,229,13,3,1,300,7,137,18.0,76.33333333333333,4.333333333333334,1.0,0.33333333333333337
15,강원특별자치도,강릉시,왕산면,왕산면제2투,249,162,39,113,7,1,0,160,2,87,24.375,70.625,4.375,0.625,0.0
16,강원특별자치도,강릉시,왕산면,왕산면제3투,230,172,42,116,9,3,0,170,2,58,24.705882352941178,68.23529411764706,5.294117647058823,1.7647058823529411,0.0
17,강원특별자치도,강릉시,구정면,관내사전투표,1290,1290,702,487,84,10,1,1284,6,0,54.67289719626168,37.92834890965732,6.5420560747663545,0.778816199376947,0.0778816199376947
18,강원특별자치도,강릉시,구정면,구정면제1투,1702,1140,317,728,71,10,3,1129,11,562,28.077945084145263,64.48184233835252,6.288751107174491,0.8857395925597875,0.2657218777679362
19,강원특별자치도,강릉시,구정면,구정면제2투,756,481,113,349,13,4,0,479,2,275,23.59081419624217,72.86012526096033,2.7139874739039667,0.8350730688935281,0.0
20,강원특별자치도,강릉시,강동면,관내사전투표,1411,1411,635,633,117,12,2,1399,12,0,45.38956397426733,45.24660471765547,8.36311651179414,0.8577555396711937,0.14295925661186562
21,강원특별자치도,강릉시,강동면,강동면제1투,1531,1001,209,751,27,5,1,993,8,530,21.04733131923464,75.62940584088619,2.719033232628399,0.5035246727089627,0.10070493454179255
22,강원특별자치도,강릉시,강동면,강동면제2투,848,522,122,380,15,1,0,518,4,326,23.552123552123554,73.35907335907336,2.8957528957528957,0.19305019305019305,0.0
23,강원특별자치도,강릉시,옥계면,관내사전투표,1067,1067,459,537,61,3,1,1061,6,0,43.26107445805844,50.61262959472196,5.749293119698398,0.2827521206409048,0.0942507068803016
24,강원특별자치도,강릉시,옥계면,옥계면제1투,1135,709,149,515,35,4,0,703,6,426,21.19487908961593,73.2574679943101,4.978662873399715,0.5689900426742532,0.0
25,강원특별자치도,강릉시,옥계면,옥계면제2투,709,444,95,323,20,5,1,444,0,265,21.396396396396398,72.74774774774775,4.504504504504505,1.1261261261261262,0.22522522522522523
26,강원특별자치도,강릉시,사천면,관내사전투표,2187,2187,1237,750,159,16,0,2162,25,0,57.21554116558741,34.69010175763182,7.354301572617946,0.7400555041628123,0.0
27,강원특별자치도,강릉시,사천면,사천면제1투,2055,1252,345,819,73,6,2,1245,7,803,27.710843373493976,65.78313253012048,5.863453815261044,0.48192771084337355,0.1606425702811245
28,강원특별자치도,강릉시,사천면,사천면제2투,926,641,160,436,32,6,0,634,7,285,25.236593059936908,68.76971608832808,5.047318611987381,0.9463722397476341,0.0
29,강원특별자치도,강릉시,연곡면,관내사전투표,2491,2491,1343,950,155,29,1,2478,13,0,54.19693301049233,38.33736884584342,6.255044390637611,1.1702986279257466,0.04035512510088781
30,강원특별자치도,강릉시,연곡면,연곡면제1투,2380,1441,419,924,84,10,2,1439,2,939,29.117442668519804,64.21125781792911,5.837387074357193,0.6949270326615705,0.13898540653231412
31,강원특별자치도,강릉시,연곡면,연곡면제2투,1088,692,142,523,20,5,1,691,1,396,20.549927641099856,75.68740955137481,2.894356005788712,0.723589001447178,0.1447178002894356
32,강원특별자치도,강릉시,홍제동,관내사전투표,2540,2540,1470,862,183,13,0,2528,12,0,58.14873417721519,34.098101265822784,7.238924050632911,0.5142405063291139,0.0
33,강원특별자치도,강릉시,홍제동,홍제동제1투,2610,1666,521,1014,103,18,2,1658,8,944,31.423401688781667,61.158021712907114,6.212303980699638,1.0856453558504222,0.12062726176115801
34,강원특별자치도,강릉시,홍제동,홍제동제2투,1765,1154,288,790,58,9,0,1145,9,611,25.1528384279476,68.99563318777294,5.065502183406114,0.7860262008733625,0.0
35,강원특별자치도,강릉시,홍제동,홍제동제3투,3425,2459,929,1290,194,24,1,2438,21,966,38.10500410172272,52.91222313371616,7.957342083675144,0.9844134536505332,0.04101722723543889
36,강원특별자치도,강릉시,중앙동,관내사전투표,2403,2403,1264,925,171,21,2,2383,20,0,53.04238355014688,38.81661770877046,7.175828787242971,0.8812421317666806,0.0839278220730172
37,강원특별자치도,강릉시,중앙동,중앙동제1투,1049,647,149,461,27,4,1,642,5,402,23.20872274143302,71.80685358255452,4.205607476635514,0.6230529595015576,0.1557632398753894
38,강원특별자치도,강릉시,중앙동,중앙동제2투,1652,958,194,711,41,5,1,952,6,694,20.3781512605042,74.68487394957984,4.30672268907563,0.5252100840336135,0.10504201680672269
39,강원특별자치도,강릉시,옥천동,관내사전투표,1666,1666,833,702,112,10,1,1658,8,0,50.241254523522315,42.340168878166466,6.7551266586248495,0.6031363088057901,0.060313630880579006
40,강원특별자치도,강릉시,옥천동,옥천동투표소,1968,1123,273,789,47,9,1,1119,4,845,24.396782841823057,70.50938337801608,4.20017873100983,0.8042895442359249,0.08936550491510277
41,강원특별자치도,강릉시,교1동,관내사전투표,6053,6053,3568,1817,549,64,3,6001,52,0,59.45675720713215,30.27828695217464,9.148475254124312,1.066488918513581,0.049991668055324116
42,강원특별자치도,강릉시,교1동,교1동제1투,2198,1394,378,911,83,18,0,1390,4,804,27.194244604316548,65.53956834532374,5.971223021582734,1.2949640287769784,0.0
43,강원특별자치도,강릉시,교1동,교1동제2투,3764,2513,933,1353,195,19,3,2503,10,1251,37.27526967638833,54.05513383939273,7.7906512185377546,0.7590890930882941,0.11985617259288853
44,강원특별자치도,강릉시,교1동,교1동제3투,1901,1397,495,774,107,9,1,1386,11,504,35.714285714285715,55.84415584415584,7.72005772005772,0.6493506493506493,0.07215007215007214
45,강원특별자치도,강릉시,교1동,교1동제4투,2525,1522,517,815,163,13,2,1510,12,1003,34.23841059602649,53.973509933774835,10.794701986754966,0.8609271523178808,0.13245033112582782
46,강원특별자치도,강릉시,교1동,교1동제5투,2111,1350,429,790,112,11,0,1342,8,761,31.967213114754102,58.867362146050674,8.345752608047691,0.819672131147541,0.0
47,강원특별자치도,강릉시,교1동,교1동제6투,2256,1480,464,874,124,13,0,1475,5,776,31.457627118644066,59.25423728813559,8.40677966101695,0.8813559322033898,0.0
48,강원특별자치도,강릉시,교2동,관내사전투표,2300,2300,1280,795,183,28,4,2290,10,0,55.895196506550214,34.71615720524017,7.991266375545851,1.222707423580786,0.17467248908296942
49,강원특별자치도,강릉시,교2동,교2동제1투,1285,705,143,524,33,1,0,701,4,580,20.399429386590583,74.75035663338089,4.70756062767475,0.14265335235378032,0.0
50,강원특별자치도,강릉시,교2동,교2동제2투,1176,722,165,504,44,7,2,722,0,454,22.85318559556787,69.80609418282549,6.094182825484765,0.9695290858725761,0.2770083102493075
51,강원특별자치도,강릉시,교2동,교2동제3투,2405,1670,521,994,124,20,0,1659,11,735,31.404460518384568,59.91561181434599,7.474382157926461,1.2055455093429777,0.0
52,강원특별자치도,강릉시,포남1동,관내사전투표,2470,2470,1328,941,165,17,2,2453,17,0,54.13779046066042,38.3611903791276,6.726457399103139,0.6930289441500204,0.08153281695882593
53,강원특별자치도,강릉시,포남1동,포남1동제1투,2369,1470,355,976,111,14,3,1459,11,899,24.33173406442769,66.89513365318712,7.607950651130911,0.9595613433858807,0.205620287868403
54,강원특별자치도,강릉시,포남1동,포남1동제2투,1851,1176,245,868,53,5,0,1171,5,675,20.922288642186164,74.12467976088813,4.526046114432109,0.4269854824935952,0.0
55,강원특별자치도,강릉시,포남1동,포남1동제3투,2266,1420,378,937,81,11,1,1408,12,846,26.84659090909091,66.54829545454545,5.752840909090909,0.78125,0.07102272727272728
56,강원특별자치도,강릉시,포남2동,관내사전투표,2984,2984,1675,1066,197,25,6,2969,15,0,56.416301785112836,35.904344897271805,6.635230717413271,0.8420343550016841,0.20208824520040417
57,강원특별자치도,강릉시,포남2동,포남2동제1투,2013,1139,293,760,69,12,0,1134,5,874,25.83774250440917,67.01940035273368,6.084656084656085,1.0582010582010581,0.0
58,강원특별자치도,강릉시,포남2동,포남2동제2투,1804,1154,308,762,64,9,0,1143,11,650,26.94663167104112,66.66666666666666,5.599300087489064,0.7874015748031495,0.0
59,강원특별자치도,강릉시,포남2동,포남2동제3투,1694,1084,269,729,60,16,2,1076,8,610,25.0,67.75092936802974,5.5762081784386615,1.486988847583643,0.18587360594795538
60,강원특별자치도,강릉시,포남2동,포남2동제4투,1588,1098,295,716,69,7,3,1090,8,490,27.06422018348624,65.68807339449542,6.330275229357799,0.6422018348623854,0.27522935779816515
61,강원특별자치도,강릉시,초당동,관내사전투표,1418,1418,868,409,119,12,1,1409,9,0,61.60397444996452,29.027679205110008,8.445706174591908,0.8516678495386799,0.07097232079488999
62,강원특별자치도,강릉시,초당동,초당동제1투,1027,708,175,467,58,3,0,703,5,319,24.893314366998577,66.42958748221906,8.250355618776672,0.42674253200568996,0.0
63,강원특별자치도,강릉시,초당동,초당동제2투,1339,908,299,535,51,14,2,901,7,431,33.18534961154273,59.37846836847947,5.660377358490567,1.553829078801332,0.22197558268590456
64,강원특별자치도,강릉시,송정동,관내사전투표,2460,2460,1476,779,169,19,4,2447,13,0,60.318757662443815,31.8348998774009,6.906416019615856,0.7764609726195342,0.1634654679199019
65,강원특별자치도,강릉시,송정동,송정동제1투,2533,1671,529,999,108,24,2,1662,9,862,31.829121540312876,60.108303249097474,6.4981949458483745,1.444043321299639,0.12033694344163659
66,강원특별자치도,강릉시,송정동,송정동제2투,2281,1566,462,972,113,8,0,1555,11,715,29.710610932475884,62.508038585209,7.266881028938907,0.5144694533762058,0.0
67,강원특별자치도,강릉시,내곡동,관내사전투표,3690,3690,2155,1128,345,37,2,3667,23,0,58.76738478320153,30.760839923643307,9.408235614944097,1.0089991818925552,0.0545404963185165
68,강원특별자치도,강릉시,내곡동,내곡동제1투,3597,2485,996,1283,173,19,2,2473,12,1112,40.274969672462596,51.88030731904569,6.995551961180752,0.7682976142337242,0.08087343307723413
69,강원특별자치도,강릉시,내곡동,내곡동제2투,3549,2349,854,1267,178,32,1,2332,17,1200,36.62092624356775,54.33104631217839,7.632933104631218,1.3722126929674099,0.04288164665523156
70,강원특별자치도,강릉시,내곡동,내곡동제3투,3036,1829,505,1113,176,19,1,1814,15,1207,27.839029768467476,61.3561190738699,9.70231532524807,1.0474090407938257,0.05512679162072767
71,강원특별자치도,강릉시,강남동,관내사전투표,2855,2855,1482,1120,200,37,3,2842,13,0,52.14637579169599,39.40886699507389,7.0372976776917655,1.3019000703729768,0.1055594651653765
72,강원특별자치도,강릉시,강남동,강남동제1투,2243,1422,419,891,84,7,2,1403,19,821,29.864575908766927,63.50677120456165,5.987170349251604,0.4989308624376337,0.14255167498218105
73,강원특별자치도,강릉시,강남동,강남동제2투,3196,1952,575,1261,89,14,1,1940,12,1244,29.63917525773196,65.0,4.587628865979381,0.7216494845360825,0.051546391752577324
74,강원특별자치도,강릉시,강남동,강남동제3투,1716,1017,244,711,51,6,0,1012,5,699,24.110671936758894,70.25691699604744,5.0395256916996045,0.592885375494071,0.0
75,강원특별자치도,강릉시,강남동,강남동제4투,1505,919,233,610,63,8,1,915,4,586,25.46448087431694,66.66666666666666,6.885245901639345,0.8743169398907104,0.1092896174863388
76,강원특별자치도,강릉시,강남동,강남동제5투,897,564,147,388,26,1,0,562,2,333,26.156583629893237,69.03914590747331,4.6263345195729535,0.1779359430604982,0.0
77,강원특별자치도,강릉시,강남동,강남동제6투,590,369,92,261,12,1,0,366,3,221,25.136612021857925,71.31147540983606,3.278688524590164,0.273224043715847,0.0
78,강원특별자치도,강릉시,성덕동,관내사전투표,4812,4812,2930,1470,327,49,6,4782,30,0,61.27143454621498,30.740276035131743,6.838143036386449,1.0246758678377248,0.12547051442910914
79,강원특별자치도,강릉시,성덕동,성덕동제1투,2798,1709,586,962,117,23,3,1691,18,1089,34.654050857480776,56.889414547604964,6.9189828503843875,1.360141927853341,0.17740981667652278
80,강원특별자치도,강릉시,성덕동,성덕동제2투,2729,1769,559,1032,145,17,2,1755,14,960,31.851851851851855,58.80341880341881,8.262108262108262,0.9686609686609686,0.11396011396011395
81,강원특별자치도,강릉시,성덕동,성덕동제3투,3077,1908,592,1180,108,12,2,1894,14,1169,31.25659978880676,62.30200633579726,5.70221752903907,0.6335797254487857,0.10559662090813093
82,강원특별자치도,강릉시,성덕동,성덕동제4투,2481,1652,607,902,126,8,4,1647,5,829,36.854887674559805,54.766241651487555,7.650273224043716,0.4857316332726169,0.24286581663630846
83,강원특별자치도,강릉시,성덕동,성덕동제5투,2758,1848,778,868,159,24,1,1830,18,910,42.513661202185794,47.431693989071036,8.688524590163935,1.3114754098360655,0.0546448087431694
84,강원특별자치도,강릉시,성덕동,성덕동제6투,909,587,165,378,38,2,1,584,3,322,28.25342465753425,64.72602739726028,6.506849315068493,0.3424657534246575,0.17123287671232876
85,강원특별자치도,강릉시,경포동,관내사전투표,3054,3054,1943,715,340,31,3,3032,22,0,64.08311345646437,23.58179419525066,11.213720316622691,1.0224274406332454,0.09894459102902375
86,강원특별자치도,강릉시,경포동,경포동제1투,2073,1237,339,710,168,5,2,1224,13,836,27.696078431372552,58.00653594771242,13.725490196078432,0.40849673202614384,0.16339869281045752
87,강원특별자치도,강릉시,경포동,경포동제2투,1485,1031,263,716,37,7,0,1023,8,454,25.708699902248288,69.99022482893452,3.6168132942326494,0.6842619745845552,0.0
88,강원특별자치도,강릉시,경포동,경포동제3투,2135,1573,623,778,139,26,2,1568,5,562,39.732142857142854,49.61734693877551,8.864795918367346,1.6581632653061225,0.12755102040816327
89,강원특별자치도,강릉시,잘못 투입·구분된 투표지,,0,0,0,0,0,0,0,0,0,0,0.0,0.0,0.0,0.0,0.0
0,강원특별자치도,동해시,거소·선상투표,,687,664,235,216,178,6,5,640,24,23,36.71875,33.75,27.8125,0.9375,0.78125
1,강원특별자치도,동해시,관외사전투표,,5242,5242,2662,1636,788,65,9,5160,82,0,51.5891472868217,31.705426356589143,15.271317829457365,1.2596899224806202,0.1744186046511628
2,강원특별자치도,동해시,재외투표,,225,192,131,45,13,1,0,190,2,33,68.94736842105263,23.684210526315788,6.842105263157896,0.5263157894736842,0.0
3,강원특별자치도,동해시,천곡동,관내사전투표,4440,4440,2503,1594,280,34,4,4415,25,0,56.69309173272933,36.10419026047565,6.342015855039637,0.7701019252548131,0.09060022650056625
4,강원특별자치도,동해시,천곡동,천곡동제1투,1579,998,277,666,44,4,0,991,7,581,27.95156407669021,67.20484359233097,4.439959636730576,0.4036326942482341,0.0
5,강원특별자치도,동해시,천곡동,천곡동제2투,1267,768,202,510,41,7,1,761,7,499,26.544021024967147,67.01708278580814,5.387647831800263,0.9198423127463863,0.1314060446780552
6,강원특별자치도,동해시,천곡동,천곡동제3투,1823,1031,254,685,71,8,3,1021,10,792,24.877571008814886,67.09108716944172,6.953966699314397,0.7835455435847208,0.2938295788442703
7,강원특별자치도,동해시,천곡동,천곡동제4투,1474,931,252,627,40,7,3,929,2,543,27.125941872981702,67.491926803014,4.3057050592034445,0.7534983853606028,0.32292787944025836
8,강원특별자치도,동해시,천곡동,천곡동제5투,1647,1118,303,745,55,8,1,1112,6,529,27.248201438848923,66.99640287769785,4.946043165467626,0.7194244604316548,0.08992805755395684
9,강원특별자치도,동해시,천곡동,천곡동제6투,1998,1410,459,846,80,18,2,1405,5,588,32.669039145907476,60.213523131672595,5.6939501779359425,1.2811387900355873,0.1423487544483986
10,강원특별자치도,동해시,천곡동,천곡동제7투,1384,813,240,528,35,5,1,809,4,571,29.666254635352285,65.26576019777504,4.326328800988875,0.6180469715698393,0.12360939431396785
11,강원특별자치도,동해시,천곡동,천곡동제8투,2380,1634,667,845,100,15,0,1627,7,746,40.995697602950216,51.9360786724032,6.146281499692686,0.921942224953903,0.0
12,강원특별자치도,동해시,천곡동,천곡동제9투,2431,1656,560,943,116,20,4,1643,13,775,34.08399269628728,57.395009129640904,7.060255629945223,1.2172854534388313,0.24345709068776628
13,강원특별자치도,동해시,송정동,관내사전투표,1625,1625,859,570,164,17,1,1611,14,0,53.32091868404718,35.38175046554935,10.180012414649287,1.0552451893234016,0.06207324643078833
14,강원특별자치도,동해시,송정동,송정동제1투,1313,820,206,564,37,3,4,814,6,493,25.307125307125304,69.28746928746928,4.545454545454546,0.36855036855036855,0.4914004914004914
15,강원특별자치도,동해시,송정동,송정동제2투,736,443,123,301,13,4,0,441,2,293,27.89115646258503,68.25396825396825,2.947845804988662,0.9070294784580499,0.0
16,강원특별자치도,동해시,북삼동,관내사전투표,5464,5464,3216,1795,376,46,7,5440,24,0,59.11764705882353,32.99632352941176,6.911764705882353,0.8455882352941176,0.12867647058823528
17,강원특별자치도,동해시,북삼동,북삼동제1투,1362,820,270,502,36,9,1,818,2,542,33.007334963325185,61.36919315403423,4.400977995110025,1.1002444987775062,0.12224938875305623
18,강원특별자치도,동해시,북삼동,북삼동제2투,747,462,142,296,17,3,0,458,4,285,31.004366812227076,64.62882096069869,3.711790393013101,0.6550218340611353,0.0
19,강원특별자치도,동해시,북삼동,북삼동제3투,2717,1803,710,921,151,13,2,1797,6,914,39.510294936004456,51.25208681135225,8.402893711741791,0.7234279354479688,0.11129660545353368
20,강원특별자치도,동해시,북삼동,북삼동제4투,2141,1258,485,654,100,12,2,1253,5,883,38.70710295291301,52.19473264166001,7.980845969672785,0.9577015163607342,0.1596169193934557
21,강원특별자치도,동해시,북삼동,북삼동제5투,1740,1098,389,616,79,10,1,1095,3,642,35.52511415525114,56.25570776255707,7.214611872146119,0.91324200913242,0.091324200913242
22,강원특별자치도,동해시,북삼동,북삼동제6투,1790,1117,389,595,111,13,0,1108,9,673,35.108303249097474,53.70036101083032,10.018050541516246,1.1732851985559567,0.0
23,강원특별자치도,동해시,부곡동,관내사전투표,2338,2338,1294,833,170,20,2,2319,19,0,55.799913755929275,35.920655454937474,7.330746011211729,0.8624407072013798,0.086244070720138
24,강원특별자치도,동해시,부곡동,부곡동제1투,1152,701,182,484,28,3,2,699,2,451,26.03719599427754,69.241773962804,4.005722460658083,0.4291845493562232,0.28612303290414876
25,강원특별자치도,동해시,부곡동,부곡동제2투,738,425,135,271,12,4,0,422,3,313,31.990521327014214,64.21800947867298,2.843601895734597,0.9478672985781991,0.0
26,강원특별자치도,동해시,부곡동,부곡동제3투,822,509,140,341,18,6,1,506,3,313,27.66798418972332,67.3913043478261,3.557312252964427,1.185770750988142,0.1976284584980237
27,강원특별자치도,동해시,동호동,관내사전투표,1254,1254,654,521,53,14,2,1244,10,0,52.572347266881025,41.88102893890675,4.260450160771704,1.1254019292604502,0.1607717041800643
28,강원특별자치도,동해시,동호동,동호동제1투,1523,927,275,577,53,11,6,922,5,596,29.826464208242946,62.581344902386114,5.748373101952278,1.193058568329718,0.6507592190889371
29,강원특별자치도,동해시,동호동,동호동제2투,1191,678,148,498,18,6,0,670,8,513,22.08955223880597,74.32835820895522,2.6865671641791042,0.8955223880597015,0.0
30,강원특별자치도,동해시,발한동,관내사전투표,1076,1076,483,519,53,11,1,1067,9,0,45.26710402999063,48.641049671977505,4.967197750702906,1.0309278350515463,0.09372071227741331
31,강원특별자치도,동해시,발한동,발한동제1투,899,526,103,400,20,1,1,525,1,373,19.61904761904762,76.19047619047619,3.8095238095238098,0.19047619047619047,0.19047619047619047
32,강원특별자치도,동해시,발한동,발한동제2투,1125,677,151,504,16,2,0,673,4,448,22.436849925705797,74.888558692422,2.37741456166419,0.2971768202080238,0.0
33,강원특별자치도,동해시,묵호동,관내사전투표,657,657,344,275,34,2,0,655,2,0,52.519083969465655,41.98473282442748,5.190839694656488,0.3053435114503817,0.0
34,강원특별자치도,동해시,묵호동,묵호동제1투,1140,641,185,435,15,2,0,637,4,499,29.04238618524333,68.28885400313972,2.3547880690737837,0.3139717425431711,0.0
35,강원특별자치도,동해시,묵호동,묵호동제2투,508,286,63,217,3,2,0,285,1,222,22.105263157894736,76.14035087719299,1.0526315789473684,0.7017543859649122,0.0
36,강원특별자치도,동해시,북평동,관내사전투표,3356,3356,1767,1330,203,28,9,3337,19,0,52.95175307162122,39.856158225951454,6.083308360803116,0.8390770152831885,0.26970332634102484
37,강원특별자치도,동해시,북평동,북평동제1투,2352,1481,482,871,104,13,1,1471,10,871,32.76682528891911,59.2114208021754,7.070020394289599,0.8837525492861998,0.06798096532970768
38,강원특별자치도,동해시,북평동,북평동제2투,1115,636,160,426,39,4,1,630,6,479,25.396825396825395,67.61904761904762,6.190476190476191,0.6349206349206349,0.15873015873015872
39,강원특별자치도,동해시,북평동,북평동제3투,3203,2075,787,1102,154,19,5,2067,8,1128,38.07450411223996,53.313981615868414,7.45041122399613,0.9192065795839381,0.24189646831156267
40,강원특별자치도,동해시,망상동,관내사전투표,697,697,369,294,27,4,0,694,3,0,53.170028818443804,42.363112391930834,3.890489913544669,0.5763688760806917,0.0
41,강원특별자치도,동해시,망상동,망상동제1투,840,544,137,383,19,5,0,544,0,296,25.183823529411764,70.40441176470588,3.4926470588235294,0.9191176470588236,0.0
42,강원특별자치도,동해시,망상동,망상동제2투,1129,654,169,454,20,4,1,648,6,475,26.080246913580247,70.06172839506173,3.0864197530864197,0.6172839506172839,0.15432098765432098
43,강원특별자치도,동해시,삼화동,관내사전투표,898,898,426,404,60,5,0,895,3,0,47.59776536312849,45.13966480446928,6.70391061452514,0.5586592178770949,0.0
44,강원특별자치도,동해시,삼화동,삼화동제1투,810,497,108,371,15,0,0,494,3,313,21.86234817813765,75.10121457489879,3.0364372469635628,0.0,0.0
45,강원특별자치도,동해시,삼화동,삼화동제2투,653,444,101,326,13,0,0,440,4,209,22.954545454545457,74.0909090909091,2.9545454545454546,0.0,0.0
46,강원특별자치도,동해시,잘못 투입·구분된 투표지,,0,0,0,0,0,0,0,0,0,0,0.0,0.0,0.0,0.0,0.0
0,강원특별자치도,삼척시,거소·선상투표,,148,145,44,78,16,0,0,138,7,3,31.88405797101449,56.52173913043478,11.594202898550725,0.0,0.0
1,강원특별자치도,삼척시,관외사전투표,,4575,4575,2193,1611,666,48,7,4525,50,0,48.46408839779006,35.60220994475138,14.718232044198896,1.0607734806629834,0.15469613259668508
2,강원특별자치도,삼척시,재외투표,,133,100,65,21,11,2,0,99,1,33,65.65656565656566,21.21212121212121,11.11111111111111,2.0202020202020203,0.0
3,강원특별자치도,삼척시,도계읍,관내사전투표,2863,2863,1114,1502,202,20,1,2839,24,0,39.23916872138077,52.90595280028179,7.115181401902078,0.7044734061289186,0.03522367030644593
4,강원특별자치도,삼척시,도계읍,도계읍제1투,240,146,22,111,11,0,0,144,2,94,15.277777777777779,77.08333333333334,7.638888888888889,0.0,0.0
5,강원특별자치도,삼척시,도계읍,도계읍제2투,1300,780,177,516,78,2,2,775,5,520,22.838709677419356,66.58064516129032,10.064516129032258,0.25806451612903225,0.25806451612903225
6,강원특별자치도,삼척시,도계읍,도계읍제3투,936,559,123,361,62,8,3,557,2,377,22.082585278276483,64.81149012567326,11.131059245960502,1.436265709156194,0.5385996409335727
7,강원특별자치도,삼척시,도계읍,도계읍제4투,928,569,123,414,25,1,2,565,4,359,21.76991150442478,73.27433628318583,4.424778761061947,0.17699115044247787,0.35398230088495575
8,강원특별자치도,삼척시,도계읍,도계읍제5투,346,208,48,153,4,1,0,206,2,138,23.300970873786408,74.27184466019418,1.9417475728155338,0.48543689320388345,0.0
9,강원특별자치도,삼척시,도계읍,도계읍제6투,112,83,22,59,1,1,0,83,0,29,26.506024096385545,71.08433734939759,1.2048192771084338,1.2048192771084338,0.0
10,강원특별자치도,삼척시,도계읍,도계읍제7투,849,502,134,330,34,3,0,501,1,347,26.746506986027946,65.86826347305389,6.786427145708583,0.5988023952095809,0.0
11,강원특별자치도,삼척시,원덕읍,관내사전투표,1442,1442,708,636,69,14,3,1430,12,0,49.510489510489506,44.47552447552447,4.825174825174825,0.9790209790209791,0.2097902097902098
12,강원특별자치도,삼척시,원덕읍,원덕읍제1투,1033,689,168,503,14,3,0,688,1,344,24.418604651162788,73.11046511627907,2.0348837209302326,0.436046511627907,0.0
13,강원특별자치도,삼척시,원덕읍,원덕읍제2투,563,328,68,230,24,2,0,324,4,235,20.98765432098765,70.98765432098766,7.4074074074074066,0.6172839506172839,0.0
14,강원특별자치도,삼척시,원덕읍,원덕읍제3투,796,503,90,381,23,5,0,499,4,293,18.03607214428858,76.35270541082164,4.609218436873747,1.002004008016032,0.0
15,강원특별자치도,삼척시,원덕읍,원덕읍제4투,286,186,36,140,6,0,0,182,4,100,19.78021978021978,76.92307692307693,3.296703296703297,0.0,0.0
16,강원특별자치도,삼척시,근덕면,관내사전투표,1308,1308,564,655,67,15,2,1303,5,0,43.284727551803535,50.26861089792786,5.141980046047583,1.1511895625479662,0.15349194167306215
17,강원특별자치도,삼척시,근덕면,근덕면제1투,406,282,77,196,6,0,0,279,3,124,27.598566308243726,70.25089605734766,2.1505376344086025,0.0,0.0
18,강원특별자치도,삼척시,근덕면,근덕면제2투,941,591,123,441,15,7,0,586,5,350,20.989761092150168,75.25597269624573,2.5597269624573378,1.1945392491467577,0.0
19,강원특별자치도,삼척시,근덕면,근덕면제3투,556,372,71,280,13,5,1,370,2,184,19.18918918918919,75.67567567567568,3.5135135135135136,1.3513513513513513,0.2702702702702703
20,강원특별자치도,삼척시,근덕면,근덕면제4투,491,333,83,233,9,2,0,327,6,158,25.382262996941897,71.25382262996942,2.7522935779816518,0.6116207951070336,0.0
21,강원특별자치도,삼척시,근덕면,근덕면제5투,491,364,100,251,12,0,0,363,1,127,27.548209366391184,69.14600550964187,3.3057851239669422,0.0,0.0
22,강원특별자치도,삼척시,하장면,관내사전투표,253,253,110,125,16,0,0,251,2,0,43.82470119521912,49.800796812749006,6.374501992031872,0.0,0.0
23,강원특별자치도,삼척시,하장면,하장면제1투,287,187,59,122,4,1,0,186,1,100,31.72043010752688,65.59139784946237,2.1505376344086025,0.5376344086021506,0.0
24,강원특별자치도,삼척시,하장면,하장면제2투,221,162,36,120,6,0,0,162,0,59,22.22222222222222,74.07407407407408,3.7037037037037033,0.0,0.0
25,강원특별자치도,삼척시,하장면,하장면제3투,278,210,62,139,5,1,1,208,2,68,29.807692307692307,66.82692307692307,2.403846153846154,0.4807692307692308,0.4807692307692308
26,강원특별자치도,삼척시,노곡면,관내사전투표,123,123,66,53,2,0,0,121,2,0,54.54545454545454,43.80165289256198,1.6528925619834711,0.0,0.0
27,강원특별자치도,삼척시,노곡면,노곡면제1투,239,171,38,125,8,0,0,171,0,68,22.22222222222222,73.09941520467837,4.678362573099415,0.0,0.0
28,강원특별자치도,삼척시,노곡면,노곡면제2투,160,121,30,85,5,1,0,121,0,39,24.793388429752067,70.24793388429752,4.132231404958678,0.8264462809917356,0.0
29,강원특별자치도,삼척시,미로면,관내사전투표,646,646,263,349,23,5,0,640,6,0,41.09375,54.53125,3.5937499999999996,0.78125,0.0
30,강원특별자치도,삼척시,미로면,미로면제1투,482,313,72,232,6,1,0,311,2,169,23.15112540192926,74.59807073954984,1.929260450160772,0.3215434083601286,0.0
31,강원특별자치도,삼척시,미로면,미로면제2투,243,149,22,124,2,0,0,148,1,94,14.864864864864865,83.78378378378379,1.3513513513513513,0.0,0.0
32,강원특별자치도,삼척시,미로면,미로면제3투,180,116,29,81,4,0,1,115,1,64,25.217391304347824,70.43478260869566,3.4782608695652173,0.0,0.8695652173913043
33,강원특별자치도,삼척시,가곡면,관내사전투표,229,229,100,113,10,0,1,224,5,0,44.642857142857146,50.44642857142857,4.464285714285714,0.0,0.4464285714285714
34,강원특별자치도,삼척시,가곡면,가곡면제1투,163,95,19,72,1,1,0,93,2,68,20.43010752688172,77.41935483870968,1.0752688172043012,1.0752688172043012,0.0
35,강원특별자치도,삼척시,가곡면,가곡면제2투,188,149,37,105,4,0,0,146,3,39,25.34246575342466,71.91780821917808,2.73972602739726,0.0,0.0
36,강원특별자치도,삼척시,신기면,관내사전투표,236,236,120,102,10,2,0,234,2,0,51.28205128205128,43.58974358974359,4.273504273504273,0.8547008547008548,0.0
37,강원특별자치도,삼척시,신기면,신기면투표소,335,214,35,164,12,0,0,211,3,121,16.587677725118482,77.72511848341233,5.687203791469194,0.0,0.0
38,강원특별자치도,삼척시,남양동,관내사전투표,2758,2758,1190,1288,232,26,3,2739,19,0,43.4465133260314,47.02446148229281,8.470244614822928,0.9492515516611902,0.10952902519167579
39,강원특별자치도,삼척시,남양동,남양동제1투,638,421,78,329,10,3,1,421,0,217,18.52731591448931,78.14726840855107,2.375296912114014,0.7125890736342043,0.23752969121140144
40,강원특별자치도,삼척시,남양동,남양동제2투,683,433,88,326,16,1,0,431,2,250,20.417633410672853,75.63805104408353,3.7122969837587005,0.23201856148491878,0.0
41,강원특별자치도,삼척시,남양동,남양동제3투,1000,689,159,488,31,4,0,682,7,311,23.313782991202345,71.5542521994135,4.545454545454546,0.5865102639296188,0.0
42,강원특별자치도,삼척시,남양동,남양동제4투,1152,771,207,512,40,3,2,764,7,381,27.094240837696336,67.01570680628272,5.2356020942408374,0.3926701570680628,0.2617801047120419
43,강원특별자치도,삼척시,남양동,남양동제5투,398,292,61,218,9,1,1,290,2,106,21.03448275862069,75.17241379310344,3.103448275862069,0.3448275862068966,0.3448275862068966
44,강원특별자치도,삼척시,성내동,관내사전투표,3034,3034,1745,1071,162,30,4,3012,22,0,57.93492695883135,35.55776892430279,5.378486055776892,0.9960159362549801,0.13280212483399734
45,강원특별자치도,삼척시,성내동,성내동제1투,1055,680,181,455,34,5,0,675,5,375,26.814814814814813,67.4074074074074,5.037037037037037,0.7407407407407408,0.0
46,강원특별자치도,삼척시,성내동,성내동제2투,711,467,141,298,24,4,0,467,0,244,30.19271948608137,63.811563169164884,5.139186295503212,0.8565310492505354,0.0
47,강원특별자치도,삼척시,성내동,성내동제3투,1190,757,201,506,40,4,0,751,6,433,26.764314247669773,67.37683089214381,5.326231691078561,0.5326231691078562,0.0
48,강원특별자치도,삼척시,성내동,성내동제4투,811,530,156,346,19,5,1,527,3,281,29.601518026565465,65.65464895635674,3.6053130929791273,0.9487666034155597,0.18975332068311196
49,강원특별자치도,삼척시,교동,관내사전투표,4447,4447,2634,1399,322,55,3,4413,34,0,59.68728755948335,31.701790165420352,7.296623612055292,1.2463176977113075,0.06798096532970768
50,강원특별자치도,삼척시,교동,교동제1투,1719,1128,368,656,85,12,0,1121,7,591,32.8278322925959,58.51917930419268,7.582515611061552,1.070472792149866,0.0
51,강원특별자치도,삼척시,교동,교동제2투,1863,1202,446,649,88,7,0,1190,12,661,37.47899159663866,54.53781512605042,7.394957983193278,0.5882352941176471,0.0
52,강원특별자치도,삼척시,교동,교동제3투,1839,1118,320,696,86,8,0,1110,8,721,28.82882882882883,62.70270270270271,7.747747747747748,0.7207207207207207,0.0
53,강원특별자치도,삼척시,교동,교동제4투,1240,861,375,400,67,14,1,857,4,379,43.75729288214703,46.67444574095683,7.8179696616102685,1.633605600933489,0.11668611435239205
54,강원특별자치도,삼척시,정라동,관내사전투표,805,805,360,391,41,7,1,800,5,0,45.0,48.875,5.125,0.8750000000000001,0.125
55,강원특별자치도,삼척시,정라동,정라동제1투,788,476,108,344,17,0,0,469,7,312,23.02771855010661,73.34754797441366,3.624733475479744,0.0,0.0
56,강원특별자치도,삼척시,정라동,정라동제2투,1487,911,256,599,44,7,0,906,5,576,28.2560706401766,66.11479028697572,4.856512141280353,0.772626931567329,0.0
57,강원특별자치도,삼척시,정라동,정라동제3투,1983,1251,488,647,89,19,1,1244,7,732,39.228295819935695,52.0096463022508,7.154340836012862,1.527331189710611,0.08038585209003216
58,강원특별자치도,삼척시,정라동,정라동제4투,598,402,146,228,19,4,3,400,2,196,36.5,56.99999999999999,4.75,1.0,0.75
59,강원특별자치도,삼척시,잘못 투입·구분된 투표지,,0,0,0,0,0,0,0,0,0,0,0.0,0.0,0.0,0.0,0.0
0,강원특별자치도,태백시,거소·선상투표,,123,114,37,65,5,2,0,109,5,9,33.94495412844037,59.63302752293578,4.587155963302752,1.834862385321101,0.0
1,강원특별자치도,태백시,관외사전투표,,2461,2461,1233,855,325,22,2,2437,24,0,50.594993844891256,35.084119819450144,13.33606893721789,0.9027492819039803,0.08206811653672548
2,강원특별자치도,태백시,재외투표,,112,85,63,15,5,2,0,85,0,27,74.11764705882354,17.647058823529413,5.88235294117647,2.3529411764705883,0.0
3,강원특별자치도,태백시,황지동,관내사전투표,2473,2473,1445,834,156,23,3,2461,12,0,58.715969118244615,33.88866314506298,6.33888663145063,0.9345794392523363,0.12190166598943519
4,강원특별자치도,태백시,황지동,황지동제1투,1088,726,176,511,29,4,0,720,6,362,24.444444444444443,70.97222222222223,4.027777777777778,0.5555555555555556,0.0
5,강원특별자치도,태백시,황지동,황지동제2투,1159,716,243,426,36,8,0,713,3,443,34.081346423562415,59.74754558204769,5.049088359046284,1.1220196353436185,0.0
6,강원특별자치도,태백시,황지동,황지동제3투,1478,921,348,504,55,7,0,914,7,557,38.074398249452955,55.14223194748359,6.017505470459518,0.7658643326039387,0.0
7,강원특별자치도,태백시,황연동,관내사전투표,1557,1557,765,695,70,12,1,1543,14,0,49.57874270900843,45.042125729099155,4.536616979909268,0.7777057679844459,0.06480881399870382
8,강원특별자치도,태백시,황연동,황연동제1투,815,512,135,357,16,3,0,511,1,303,26.418786692759294,69.86301369863014,3.131115459882583,0.5870841487279843,0.0
9,강원특별자치도,태백시,황연동,황연동제2투,492,276,80,188,5,1,0,274,2,216,29.1970802919708,68.61313868613139,1.824817518248175,0.36496350364963503,0.0
10,강원특별자치도,태백시,황연동,황연동제3투,938,591,136,433,13,4,0,586,5,347,23.208191126279864,73.89078498293516,2.218430034129693,0.6825938566552902,0.0
11,강원특별자치도,태백시,삼수동,관내사전투표,992,991,516,423,41,3,1,984,7,1,52.4390243902439,42.98780487804878,4.166666666666666,0.3048780487804878,0.10162601626016261
12,강원특별자치도,태백시,삼수동,삼수동제1투,1325,729,222,481,23,2,0,728,1,596,30.494505494505496,66.07142857142857,3.159340659340659,0.27472527472527475,0.0
13,강원특별자치도,태백시,삼수동,삼수동제2투,1024,630,199,407,18,2,0,626,4,394,31.789137380191697,65.01597444089457,2.8753993610223643,0.3194888178913738,0.0
14,강원특별자치도,태백시,삼수동,삼수동제3투,359,263,86,168,5,0,0,259,4,96,33.204633204633204,64.86486486486487,1.9305019305019304,0.0,0.0
15,강원특별자치도,태백시,상장동,관내사전투표,2375,2375,1409,775,156,22,2,2364,11,0,59.60236886632826,32.7834179357022,6.598984771573605,0.9306260575296108,0.08460236886632826
16,강원특별자치도,태백시,상장동,상장동제1투,941,577,155,400,15,4,0,574,3,364,27.00348432055749,69.68641114982579,2.6132404181184667,0.6968641114982579,0.0
17,강원특별자치도,태백시,상장동,상장동제2투,1841,1165,472,611,61,13,0,1157,8,676,40.79515989628349,52.80898876404494,5.2722558340535866,1.1235955056179776,0.0
18,강원특별자치도,태백시,상장동,상장동제3투,907,625,266,316,28,7,2,619,6,282,42.972536348949916,51.050080775444265,4.523424878836833,1.1308562197092082,0.32310177705977383
19,강원특별자치도,태백시,상장동,상장동제4투,697,412,118,267,22,3,0,410,2,285,28.780487804878046,65.1219512195122,5.365853658536586,0.7317073170731708,0.0
20,강원특별자치도,태백시,상장동,상장동제5투,1063,636,205,380,41,4,1,631,5,427,32.48811410459588,60.22187004754358,6.497622820919176,0.6339144215530903,0.15847860538827258
21,강원특별자치도,태백시,문곡소도동,관내사전투표,832,832,452,331,41,3,1,828,4,0,54.589371980676326,39.97584541062802,4.951690821256038,0.36231884057971014,0.12077294685990338
22,강원특별자치도,태백시,문곡소도동,문곡소도동제1투,414,251,56,174,14,2,2,248,3,163,22.58064516129032,70.16129032258065,5.64516129032258,0.8064516129032258,0.8064516129032258
23,강원특별자치도,태백시,문곡소도동,문곡소도동제2투,722,499,146,330,14,5,1,496,3,223,29.435483870967744,66.53225806451613,2.82258064516129,1.0080645161290323,0.20161290322580644
24,강원특별자치도,태백시,문곡소도동,문곡소도동제3투,828,542,168,348,19,1,3,539,3,286,31.16883116883117,64.56400742115028,3.525046382189239,0.1855287569573284,0.5565862708719851
25,강원특별자치도,태백시,장성동,관내사전투표,1544,1544,724,726,75,10,0,1535,9,0,47.16612377850163,47.296416938110745,4.88599348534202,0.6514657980456027,0.0
26,강원특별자치도,태백시,장성동,장성동제1투,284,166,39,121,3,0,0,163,3,118,23.92638036809816,74.23312883435584,1.8404907975460123,0.0,0.0
27,강원특별자치도,태백시,장성동,장성동제2투,732,438,110,292,25,6,1,434,4,294,25.34562211981567,67.2811059907834,5.76036866359447,1.3824884792626728,0.2304147465437788
28,강원특별자치도,태백시,장성동,장성동제3투,419,265,54,197,11,1,0,263,2,154,20.53231939163498,74.90494296577947,4.182509505703422,0.38022813688212925,0.0
29,강원특별자치도,태백시,구문소동,관내사전투표,720,720,302,389,24,5,0,720,0,0,41.94444444444444,54.02777777777777,3.3333333333333335,0.6944444444444444,0.0
30,강원특별자치도,태백시,구문소동,구문소동제1투,654,393,102,269,16,3,0,390,3,261,26.153846153846157,68.97435897435898,4.102564102564102,0.7692307692307693,0.0
31,강원특별자치도,태백시,구문소동,구문소동제2투,422,263,59,188,10,3,0,260,3,159,22.692307692307693,72.3076923076923,3.8461538461538463,1.153846153846154,0.0
32,강원특별자치도,태백시,철암동,관내사전투표,629,629,254,337,32,3,0,626,3,0,40.57507987220447,53.833865814696495,5.111821086261981,0.4792332268370607,0.0
33,강원특별자치도,태백시,철암동,철암동제1투,572,356,79,265,6,2,0,352,4,216,22.443181818181817,75.2840909090909,1.7045454545454544,0.5681818181818182,0.0
34,강원특별자치도,태백시,철암동,철암동제2투,430,255,40,198,15,0,0,253,2,175,15.810276679841898,78.26086956521739,5.928853754940711,0.0,0.0
35,강원특별자치도,태백시,잘못 투입·구분된 투표지,,0,1,0,1,0,0,0,1,0,-1,0.0,100.0,0.0,0.0,0.0
0,강원특별자치도,정선군,거소·선상투표,,74,73,27,33,9,0,1,70,3,1,38.57142857142858,47.14285714285714,12.857142857142856,0.0,1.4285714285714286
1,강원특별자치도,정선군,관외사전투표,,2485,2485,1298,868,270,20,6,2462,23,0,52.721364744110474,35.25588952071487,10.966693744922827,0.8123476848090982,0.2437043054427295
2,강원특별자치도,정선군,재외투표,,85,65,53,9,3,0,0,65,0,20,81.53846153846153,13.846153846153847,4.615384615384616,0.0,0.0
3,강원특별자치도,정선군,정선읍,관내사전투표,2751,2751,1669,856,163,35,2,2725,26,0,61.24770642201835,31.412844036697248,5.981651376146789,1.2844036697247707,0.07339449541284404
4,강원특별자치도,정선군,정선읍,정선읍제1투,1054,713,201,478,20,5,2,706,7,341,28.47025495750708,67.70538243626062,2.8328611898017,0.708215297450425,0.28328611898017
5,강원특별자치도,정선군,정선읍,정선읍제2투,1132,729,232,453,32,6,0,723,6,403,32.088520055325034,62.655601659751035,4.426002766251729,0.8298755186721992,0.0
6,강원특별자치도,정선군,정선읍,정선읍제3투,1152,723,281,399,34,4,1,719,4,429,39.082058414464534,55.493741307371344,4.728789986091794,0.5563282336578581,0.13908205841446453
7,강원특별자치도,정선군,정선읍,정선읍제4투,817,464,153,291,14,2,0,460,4,353,33.26086956521739,63.26086956521739,3.0434782608695654,0.43478260869565216,0.0
8,강원특별자치도,정선군,정선읍,정선읍제5투,506,372,109,248,11,1,0,369,3,134,29.539295392953928,67.20867208672087,2.9810298102981028,0.27100271002710025,0.0
9,강원특별자치도,정선군,정선읍,정선읍제6투,219,153,42,106,4,0,1,153,0,66,27.450980392156865,69.28104575163398,2.6143790849673203,0.0,0.6535947712418301
10,강원특별자치도,정선군,정선읍,정선읍제7투,212,160,68,86,3,1,1,159,1,52,42.76729559748428,54.088050314465406,1.8867924528301887,0.628930817610063,0.628930817610063
11,강원특별자치도,정선군,고한읍,관내사전투표,1363,1363,749,504,89,9,1,1352,11,0,55.399408284023664,37.278106508875744,6.5828402366863905,0.6656804733727811,0.07396449704142012
12,강원특별자치도,정선군,고한읍,고한읍제1투,477,248,75,160,11,0,1,247,1,229,30.364372469635626,64.77732793522267,4.4534412955465585,0.0,0.4048582995951417
13,강원특별자치도,정선군,고한읍,고한읍제2투,999,518,167,326,22,0,0,515,3,481,32.42718446601941,63.30097087378641,4.271844660194175,0.0,0.0
14,강원특별자치도,정선군,고한읍,고한읍제3투,648,400,146,225,23,3,1,398,2,248,36.68341708542713,56.53266331658291,5.778894472361809,0.7537688442211055,0.25125628140703515
15,강원특별자치도,정선군,사북읍,관내사전투표,1351,1351,770,497,67,11,1,1346,5,0,57.20653789004457,36.92421991084696,4.977711738484398,0.8172362555720655,0.07429420505200594
16,강원특별자치도,정선군,사북읍,사북읍제1투,1489,893,227,613,38,5,1,884,9,596,25.678733031674206,69.34389140271493,4.298642533936651,0.5656108597285068,0.11312217194570137
17,강원특별자치도,정선군,사북읍,사북읍제2투,740,443,97,331,15,0,0,443,0,297,21.896162528216703,74.7178329571106,3.3860045146726865,0.0,0.0
18,강원특별자치도,정선군,신동읍,관내사전투표,711,711,401,273,26,3,0,703,8,0,57.04125177809388,38.83357041251778,3.698435277382646,0.42674253200568996,0.0
19,강원특별자치도,정선군,신동읍,신동읍제1투,780,590,215,344,25,3,0,587,3,190,36.626916524701876,58.603066439523,4.258943781942079,0.5110732538330494,0.0
20,강원특별자치도,정선군,신동읍,신동읍제2투,582,362,104,242,12,2,0,360,2,220,28.888888888888886,67.22222222222223,3.3333333333333335,0.5555555555555556,0.0
21,강원특별자치도,정선군,신동읍,신동읍제3투,253,182,52,119,9,0,0,180,2,71,28.888888888888886,66.11111111111111,5.0,0.0,0.0
22,강원특별자치도,정선군,신동읍,신동읍제4투,322,228,78,140,8,1,0,227,1,94,34.36123348017621,61.67400881057269,3.524229074889868,0.4405286343612335,0.0
23,강원특별자치도,정선군,화암면,관내사전투표,435,435,225,188,20,1,1,435,0,0,51.724137931034484,43.2183908045977,4.597701149425287,0.22988505747126436,0.22988505747126436
24,강원특별자치도,정선군,화암면,화암면제1투,684,447,109,321,7,3,0,440,7,237,24.772727272727273,72.95454545454545,1.5909090909090908,0.6818181818181818,0.0
25,강원특별자치도,정선군,화암면,화암면제2투,172,120,43,71,6,0,0,120,0,52,35.833333333333336,59.166666666666664,5.0,0.0,0.0
26,강원특별자치도,정선군,남면,관내사전투표,748,748,427,288,23,4,0,742,6,0,57.54716981132076,38.81401617250674,3.0997304582210243,0.5390835579514826,0.0
27,강원특별자치도,정선군,남면,남면제1투,498,318,106,195,15,1,0,317,1,180,33.4384858044164,61.51419558359621,4.73186119873817,0.31545741324921134,0.0
28,강원특별자치도,정선군,남면,남면제2투,1003,644,171,446,17,3,1,638,6,359,26.802507836990596,69.90595611285266,2.664576802507837,0.4702194357366771,0.1567398119122257
29,강원특별자치도,정선군,남면,남면제3투,294,224,77,137,5,1,2,222,2,70,34.68468468468468,61.711711711711715,2.2522522522522523,0.45045045045045046,0.9009009009009009
30,강원특별자치도,정선군,여량면,관내사전투표,575,575,277,261,29,2,2,571,4,0,48.51138353765324,45.709281961471106,5.078809106830122,0.3502626970227671,0.3502626970227671
31,강원특별자치도,정선군,여량면,여량면제1투,850,565,109,431,15,2,1,558,7,285,19.53405017921147,77.24014336917563,2.6881720430107525,0.35842293906810035,0.17921146953405018
32,강원특별자치도,정선군,여량면,여량면제2투,186,142,28,111,3,0,0,142,0,44,19.718309859154928,78.16901408450704,2.112676056338028,0.0,0.0
33,강원특별자치도,정선군,북평면,관내사전투표,752,752,408,285,47,7,1,748,4,0,54.54545454545454,38.101604278074866,6.283422459893048,0.9358288770053476,0.1336898395721925
34,강원특별자치도,정선군,북평면,북평면제1투,829,545,136,384,19,2,0,541,4,284,25.13863216266174,70.97966728280961,3.512014787430684,0.36968576709796674,0.0
35,강원특별자치도,정선군,북평면,북평면제2투,460,280,94,175,8,2,0,279,1,180,33.691756272401435,62.72401433691756,2.867383512544803,0.7168458781362007,0.0
36,강원특별자치도,정선군,임계면,관내사전투표,1035,1035,483,487,50,8,1,1029,6,0,46.93877551020408,47.327502429543244,4.8590864917395535,0.7774538386783284,0.09718172983479105
37,강원특별자치도,정선군,임계면,임계면제1투,653,413,112,273,20,4,0,409,4,240,27.383863080684595,66.74816625916871,4.88997555012225,0.9779951100244498,0.0
38,강원특별자치도,정선군,임계면,임계면제2투,263,193,53,128,12,0,0,193,0,70,27.461139896373055,66.32124352331607,6.217616580310881,0.0,0.0
39,강원특별자치도,정선군,임계면,임계면제3투,424,249,66,171,8,1,1,247,2,175,26.720647773279353,69.23076923076923,3.2388663967611335,0.4048582995951417,0.4048582995951417
40,강원특별자치도,정선군,임계면,임계면제4투,240,163,51,107,2,2,0,162,1,77,31.48148148148148,66.0493827160494,1.2345679012345678,1.2345679012345678,0.0
41,강원특별자치도,정선군,임계면,임계면제5투,274,194,52,135,5,1,0,193,1,80,26.94300518134715,69.94818652849742,2.5906735751295336,0.5181347150259068,0.0
42,강원특별자치도,정선군,잘못 투입·구분된 투표지,,0,0,0,0,0,0,0,0,0,0,0.0,0.0,0.0,0.0,0.0
0,강원특별자치도,속초시,거소·선상투표,,160,149,49,61,36,0,2,148,1,11,33.108108108108105,41.21621621621622,24.324324324324326,0.0,1.3513513513513513
1,강원특별자치도,속초시,관외사전투표,,5927,5926,3140,1898,745,74,10,5867,59,1,53.5196863814556,32.350434634395775,12.698142151014146,1.2612919720470428,0.17044486108743823
2,강원특별자치도,속초시,재외투표,,273,222,141,51,26,2,0,220,2,51,64.0909090909091,23.18181818181818,11.818181818181818,0.9090909090909091,0.0
3,강원특별자치도,속초시,영랑동,관내사전투표,1729,1729,1048,540,117,13,3,1721,8,0,60.894828588030215,31.37710633352702,6.798373038930854,0.7553747821034282,0.17431725740848344
4,강원특별자치도,속초시,영랑동,영랑동제1투,1270,837,278,503,38,6,0,825,12,433,33.696969696969695,60.969696969696976,4.6060606060606055,0.7272727272727273,0.0
5,강원특별자치도,속초시,영랑동,영랑동제2투,1461,894,245,599,38,8,0,890,4,567,27.52808988764045,67.30337078651687,4.269662921348314,0.8988764044943821,0.0
6,강원특별자치도,속초시,동명동,관내사전투표,1211,1211,650,458,83,14,0,1205,6,0,53.941908713692946,38.00829875518672,6.8879668049792535,1.161825726141079,0.0
7,강원특별자치도,속초시,동명동,동명동제1투,1540,926,278,581,55,7,1,922,4,614,30.151843817787416,63.015184381778745,5.965292841648591,0.7592190889370932,0.10845986984815618
8,강원특별자치도,속초시,동명동,동명동제2투,1030,618,185,405,23,4,0,617,1,412,29.983792544570502,65.64019448946516,3.727714748784441,0.6482982171799028,0.0
9,강원특별자치도,속초시,금호동,관내사전투표,1702,1702,861,710,106,10,2,1689,13,0,50.97690941385436,42.03670811130847,6.275902901124926,0.5920663114268798,0.11841326228537595
10,강원특별자치도,속초시,금호동,금호동제1투,1431,791,174,578,36,0,1,789,2,640,22.0532319391635,73.25728770595691,4.562737642585551,0.0,0.12674271229404308
11,강원특별자치도,속초시,금호동,금호동제2투,1007,600,154,414,26,2,0,596,4,407,25.838926174496645,69.46308724832215,4.3624161073825505,0.33557046979865773,0.0
12,강원특별자치도,속초시,금호동,금호동제3투,678,443,138,274,25,2,0,439,4,235,31.435079726651484,62.414578587699324,5.694760820045558,0.45558086560364464,0.0
13,강원특별자치도,속초시,교동,관내사전투표,2342,2342,1401,772,134,21,1,2329,13,0,60.154572778016316,33.147273507943325,5.7535422928295405,0.9016745384285102,0.042936882782310004
14,강원특별자치도,속초시,교동,교동제1투,2045,1099,298,743,44,4,4,1093,6,946,27.264409881061297,67.97804208600184,4.025617566331198,0.36596523330283626,0.36596523330283626
15,강원특별자치도,속초시,교동,교동제2투,3091,1886,643,1101,112,14,2,1872,14,1205,34.348290598290596,58.81410256410257,5.982905982905983,0.7478632478632479,0.10683760683760685
16,강원특별자치도,속초시,노학동,관내사전투표,5034,5034,2894,1761,292,47,7,5001,33,0,57.86842631473705,35.2129574085183,5.83883223355329,0.9398120375924814,0.13997200559888023
17,강원특별자치도,속초시,노학동,노학동제1투,2201,1338,434,791,90,11,1,1327,11,863,32.705350414468725,59.608138658628484,6.782215523737754,0.8289374529012812,0.07535795026375283
18,강원특별자치도,속초시,노학동,노학동제2투,1520,842,243,545,43,6,1,838,4,678,28.997613365155132,65.03579952267303,5.13126491646778,0.7159904534606205,0.11933174224343676
19,강원특별자치도,속초시,노학동,노학동제3투,2231,1200,390,713,74,18,3,1198,2,1031,32.5542570951586,59.515859766277124,6.176961602671119,1.5025041736227045,0.25041736227045075
20,강원특별자치도,속초시,노학동,노학동제4투,1107,654,238,374,36,1,0,649,5,453,36.67180277349769,57.6271186440678,5.546995377503852,0.15408320493066258,0.0
21,강원특별자치도,속초시,노학동,노학동제5투,1577,951,255,648,35,10,0,948,3,626,26.89873417721519,68.35443037974683,3.691983122362869,1.0548523206751055,0.0
22,강원특별자치도,속초시,노학동,노학동제6투,2534,1683,614,924,112,26,0,1676,7,851,36.63484486873509,55.131264916467785,6.682577565632458,1.5513126491646778,0.0
23,강원특별자치도,속초시,조양동,관내사전투표,5487,5487,3409,1604,392,50,1,5456,31,0,62.481671554252195,29.398826979472144,7.184750733137831,0.9164222873900294,0.018328445747800588
24,강원특별자치도,속초시,조양동,조양동제1투,2102,1280,514,670,73,12,2,1271,9,822,40.440597954366645,52.71439811172305,5.743509047993705,0.9441384736428009,0.15735641227380015
25,강원특별자치도,속초시,조양동,조양동제2투,1818,1123,434,601,71,7,1,1114,9,695,38.95870736086176,53.94973070017953,6.373429084380611,0.6283662477558348,0.08976660682226212
26,강원특별자치도,속초시,조양동,조양동제3투,2695,1480,504,865,94,9,1,1473,7,1215,34.21588594704684,58.72369314324508,6.381534283774609,0.6109979633401221,0.0678886625933469
27,강원특별자치도,속초시,조양동,조양동제4투,3493,2116,777,1125,178,21,1,2102,14,1377,36.96479543292103,53.520456707897246,8.468125594671742,0.9990485252140819,0.04757373929590866
28,강원특별자치도,속초시,조양동,조양동제5투,2002,1376,481,773,98,18,0,1370,6,626,35.10948905109489,56.42335766423358,7.153284671532846,1.313868613138686,0.0
29,강원특별자치도,속초시,조양동,조양동제6투,3095,1946,678,1124,118,14,2,1936,10,1149,35.0206611570248,58.057851239669425,6.095041322314049,0.7231404958677686,0.10330578512396695
30,강원특별자치도,속초시,청호동,관내사전투표,1360,1360,744,513,83,13,1,1354,6,0,54.94830132939439,37.8877400295421,6.129985228951256,0.9601181683899557,0.07385524372230429
31,강원특별자치도,속초시,청호동,청호동제1투,1870,1113,296,756,47,8,2,1109,4,757,26.690712353471596,68.16952209197476,4.2380522993688015,0.7213706041478809,0.18034265103697023
32,강원특별자치도,속초시,청호동,청호동제2투,746,457,128,297,27,2,0,454,3,289,28.193832599118945,65.41850220264317,5.947136563876652,0.4405286343612335,0.0
33,강원특별자치도,속초시,대포동,관내사전투표,717,717,387,265,51,7,2,712,5,0,54.35393258426966,37.21910112359551,7.162921348314606,0.9831460674157303,0.2808988764044944
34,강원특별자치도,속초시,대포동,대포동제1투,785,517,109,376,21,7,0,513,4,268,21.24756335282651,73.2943469785575,4.093567251461988,1.364522417153996,0.0
35,강원특별자치도,속초시,대포동,대포동제2투,1063,698,177,497,19,2,0,695,3,365,25.467625899280577,71.51079136690647,2.7338129496402876,0.28776978417266186,0.0
36,강원특별자치도,속초시,잘못 투입·구분된 투표지,,0,0,0,0,0,0,0,0,0,0,0.0,0.0,0.0,0.0,0.0
0,강원특별자치도,고성군,거소·선상투표,,137,131,38,50,37,0,0,125,6,6,30.4,40.0,29.599999999999998,0.0,0.0
1,강원특별자치도,고성군,관외사전투표,,2457,2456,1259,861,281,29,2,2432,24,1,51.76809210526315,35.40296052631579,11.554276315789473,1.192434210526316,0.08223684210526315
2,강원특별자치도,고성군,재외투표,,83,67,47,12,7,1,0,67,0,16,70.1492537313433,17.91044776119403,10.44776119402985,1.4925373134328357,0.0
3,강원특별자치도,고성군,간성읍,관내사전투표,2205,2205,1234,728,200,23,2,2187,18,0,56.42432556012803,33.28760859625057,9.144947416552354,1.0516689529035208,0.09144947416552354
4,강원특별자치도,고성군,간성읍,간성읍제1투,700,449,128,292,23,2,0,445,4,251,28.764044943820227,65.61797752808988,5.168539325842696,0.44943820224719105,0.0
5,강원특별자치도,고성군,간성읍,간성읍제2투,1867,1111,375,623,92,6,2,1098,13,756,34.15300546448087,56.73952641165756,8.378870673952642,0.546448087431694,0.18214936247723132
6,강원특별자치도,고성군,간성읍,간성읍제3투,677,462,132,306,15,3,1,457,5,215,28.88402625820569,66.95842450765865,3.282275711159737,0.6564551422319475,0.2188183807439825
7,강원특별자치도,고성군,간성읍,간성읍제4투,178,127,46,77,2,1,1,127,0,51,36.22047244094488,60.629921259842526,1.574803149606299,0.7874015748031495,0.7874015748031495
8,강원특별자치도,고성군,간성읍,간성읍제5투,147,124,29,89,5,1,0,124,0,23,23.387096774193548,71.7741935483871,4.032258064516129,0.8064516129032258,0.0
9,강원특별자치도,고성군,거진읍,관내사전투표,1309,1309,680,545,76,3,1,1305,4,0,52.10727969348659,41.7624521072797,5.823754789272031,0.22988505747126436,0.07662835249042146
10,강원특별자치도,고성군,거진읍,거진읍제1투,1518,1011,266,703,29,5,2,1005,6,507,26.46766169154229,69.9502487562189,2.8855721393034823,0.4975124378109453,0.1990049751243781
11,강원특별자치도,고성군,거진읍,거진읍제2투,835,533,156,344,25,0,2,527,6,302,29.601518026565465,65.2751423149905,4.743833017077799,0.0,0.3795066413662239
12,강원특별자치도,고성군,거진읍,거진읍제3투,490,321,106,205,5,3,0,319,2,169,33.22884012539185,64.26332288401254,1.5673981191222568,0.9404388714733543,0.0
13,강원특별자치도,고성군,거진읍,거진읍제4투,259,186,57,124,4,0,0,185,1,73,30.810810810810814,67.02702702702703,2.1621621621621623,0.0,0.0
14,강원특별자치도,고성군,거진읍,거진읍제5투,379,250,88,144,13,3,0,248,2,129,35.483870967741936,58.06451612903226,5.241935483870968,1.2096774193548387,0.0
15,강원특별자치도,고성군,현내면,관내사전투표,532,532,265,232,28,3,1,529,3,0,50.0945179584121,43.85633270321361,5.293005671077505,0.5671077504725899,0.1890359168241966
16,강원특별자치도,고성군,현내면,현내면제1투,423,291,88,192,9,1,0,290,1,132,30.344827586206897,66.20689655172414,3.103448275862069,0.3448275862068966,0.0
17,강원특별자치도,고성군,현내면,현내면제2투,487,332,84,233,9,0,0,326,6,155,25.766871165644172,71.47239263803681,2.7607361963190185,0.0,0.0
18,강원특별자치도,고성군,현내면,현내면제3투,224,157,41,107,3,2,0,153,4,67,26.797385620915033,69.93464052287581,1.9607843137254901,1.3071895424836601,0.0
19,강원특별자치도,고성군,현내면,현내면제4투,195,153,35,109,5,2,1,152,1,42,23.026315789473685,71.71052631578947,3.289473684210526,1.3157894736842104,0.6578947368421052
20,강원특별자치도,고성군,죽왕면,관내사전투표,865,865,447,350,56,7,2,862,3,0,51.85614849187935,40.60324825986079,6.496519721577726,0.8120649651972157,0.23201856148491878
21,강원특별자치도,고성군,죽왕면,죽왕면제1투,490,314,87,211,11,2,1,312,2,176,27.884615384615387,67.62820512820514,3.5256410256410255,0.641025641025641,0.3205128205128205
22,강원특별자치도,고성군,죽왕면,죽왕면제2투,373,264,67,179,9,3,1,259,5,109,25.868725868725868,69.1119691119691,3.474903474903475,1.1583011583011582,0.3861003861003861
23,강원특별자치도,고성군,죽왕면,죽왕면제3투,657,437,110,300,20,3,0,433,4,220,25.40415704387991,69.28406466512702,4.618937644341801,0.6928406466512702,0.0
24,강원특별자치도,고성군,죽왕면,죽왕면제4투,332,252,71,171,6,1,0,249,3,80,28.514056224899598,68.67469879518072,2.4096385542168677,0.4016064257028112,0.0
25,강원특별자치도,고성군,토성면,관내사전투표,2028,2028,1095,757,131,25,2,2010,18,0,54.47761194029851,37.66169154228856,6.5174129353233825,1.2437810945273633,0.09950248756218905
26,강원특별자치도,고성군,토성면,토성면제1투,1986,1228,346,800,64,7,0,1217,11,758,28.430566967953986,65.7354149548069,5.258833196384552,0.5751848808545604,0.0
27,강원특별자치도,고성군,토성면,토성면제2투,788,551,147,379,20,1,0,547,4,237,26.87385740402194,69.28702010968921,3.656307129798903,0.18281535648994515,0.0
28,강원특별자치도,고성군,토성면,토성면제3투,722,487,150,314,19,3,0,486,1,235,30.864197530864196,64.60905349794238,3.909465020576132,0.6172839506172839,0.0
29,강원특별자치도,고성군,토성면,토성면제4투,1050,656,216,398,33,3,1,651,5,394,33.17972350230415,61.136712749615974,5.0691244239631335,0.4608294930875576,0.15360983102918588
30,강원특별자치도,고성군,잘못 투입·구분된 투표지,,0,0,0,0,0,0,0,0,0,0,0.0,0.0,0.0,0.0,0.0
0,강원특별자치도,양양군,거소·선상투표,,64,60,19,30,8,0,0,57,3,4,33.33333333333333,52.63157894736842,14.035087719298245,0.0,0.0
1,강원특별자치도,양양군,관외사전투표,,2355,2355,1243,838,226,23,3,2333,22,0,53.27903986283755,35.91941705957994,9.687098156879555,0.9858551221603087,0.12858979854264896
2,강원특별자치도,양양군,재외투표,,79,64,41,13,6,4,0,64,0,15,64.0625,20.3125,9.375,6.25,0.0
3,강원특별자치도,양양군,양양읍,관내사전투표,3542,3542,2029,1247,222,22,2,3522,20,0,57.609312890403174,35.406019307211814,6.303236797274275,0.6246450880181714,0.05678591709256105
4,강원특별자치도,양양군,양양읍,양양읍제1투,2822,1721,531,1064,99,16,1,1711,10,1101,31.03448275862069,62.18585622443016,5.786090005844535,0.9351256575102279,0.058445353594389245
5,강원특별자치도,양양군,양양읍,양양읍제2투,1763,1201,371,761,55,4,1,1192,9,562,31.1241610738255,63.84228187919463,4.614093959731544,0.33557046979865773,0.08389261744966443
6,강원특별자치도,양양군,양양읍,양양읍제3투,787,507,111,373,14,5,0,503,4,280,22.067594433399602,74.15506958250498,2.783300198807157,0.9940357852882704,0.0
7,강원특별자치도,양양군,양양읍,양양읍제4투,551,372,124,234,8,2,0,368,4,179,33.69565217391305,63.58695652173913,2.1739130434782608,0.5434782608695652,0.0
8,강원특별자치도,양양군,양양읍,양양읍제5투,541,379,99,257,15,2,0,373,6,162,26.541554959785525,68.90080428954424,4.021447721179625,0.5361930294906166,0.0
9,강원특별자치도,양양군,서면,관내사전투표,693,693,312,333,34,2,0,681,12,0,45.81497797356828,48.89867841409692,4.992657856093979,0.2936857562408223,0.0
10,강원특별자치도,양양군,서면,서면제1투,627,360,92,253,8,2,0,355,5,267,25.915492957746476,71.26760563380282,2.2535211267605635,0.5633802816901409,0.0
11,강원특별자치도,양양군,서면,서면제2투,387,279,91,180,6,0,0,277,2,108,32.851985559566785,64.98194945848375,2.166064981949458,0.0,0.0
12,강원특별자치도,양양군,서면,서면제3투,300,194,59,127,2,1,1,190,4,106,31.05263157894737,66.84210526315789,1.0526315789473684,0.5263157894736842,0.5263157894736842
13,강원특별자치도,양양군,서면,서면제4투,226,159,29,127,2,1,0,159,0,67,18.238993710691823,79.87421383647799,1.257861635220126,0.628930817610063,0.0
14,강원특별자치도,양양군,손양면,관내사전투표,689,689,377,271,35,1,1,685,4,0,55.03649635036496,39.56204379562044,5.109489051094891,0.145985401459854,0.145985401459854
15,강원특별자치도,양양군,손양면,손양면제1투,683,446,141,278,18,7,0,444,2,237,31.756756756756754,62.612612612612615,4.054054054054054,1.5765765765765765,0.0
16,강원특별자치도,양양군,손양면,손양면제2투,580,392,92,283,12,3,0,390,2,188,23.589743589743588,72.56410256410255,3.076923076923077,0.7692307692307693,0.0
17,강원특별자치도,양양군,현북면,관내사전투표,623,623,340,248,24,6,0,618,5,0,55.016181229773466,40.1294498381877,3.8834951456310676,0.9708737864077669,0.0
18,강원특별자치도,양양군,현북면,현북면제1투,616,404,92,287,21,0,0,400,4,212,23.0,71.75,5.25,0.0,0.0
19,강원특별자치도,양양군,현북면,현북면제2투,292,205,67,130,4,2,1,204,1,87,32.84313725490196,63.725490196078425,1.9607843137254901,0.9803921568627451,0.49019607843137253
20,강원특별자치도,양양군,현북면,현북면제3투,320,231,84,141,5,0,0,230,1,89,36.52173913043478,61.30434782608696,2.1739130434782608,0.0,0.0
21,강원특별자치도,양양군,현북면,현북면제4투,247,175,43,128,2,1,0,174,1,72,24.71264367816092,73.5632183908046,1.1494252873563218,0.5747126436781609,0.0
22,강원특별자치도,양양군,현남면,관내사전투표,614,614,275,303,29,6,0,613,1,0,44.86133768352366,49.42903752039152,4.730831973898858,0.9787928221859705,0.0
23,강원특별자치도,양양군,현남면,현남면제1투,593,384,77,295,9,1,0,382,2,209,20.157068062827225,77.22513089005236,2.356020942408377,0.2617801047120419,0.0
24,강원특별자치도,양양군,현남면,현남면제2투,707,438,109,310,14,2,1,436,2,269,25.0,71.10091743119266,3.211009174311927,0.45871559633027525,0.22935779816513763
25,강원특별자치도,양양군,현남면,현남면제3투,434,278,81,189,7,0,0,277,1,156,29.24187725631769,68.23104693140795,2.527075812274368,0.0,0.0
26,강원특별자치도,양양군,강현면,관내사전투표,1257,1257,675,498,64,15,1,1253,4,0,53.8707102952913,39.74461292897047,5.107741420590583,1.1971268954509178,0.07980845969672785
27,강원특별자치도,양양군,강현면,강현면제1투,1183,711,204,465,34,6,0,709,2,472,28.772919605077576,65.58533145275035,4.795486600846263,0.846262341325811,0.0
28,강원특별자치도,양양군,강현면,강현면제2투,513,356,106,234,12,3,0,355,1,157,29.859154929577464,65.91549295774648,3.3802816901408446,0.8450704225352111,0.0
29,강원특별자치도,양양군,강현면,강현면제3투,314,193,57,126,9,1,0,193,0,121,29.533678756476682,65.28497409326425,4.66321243523316,0.5181347150259068,0.0
30,강원특별자치도,양양군,강현면,강현면제4투,578,388,90,281,13,2,0,386,2,190,23.316062176165804,72.7979274611399,3.3678756476683938,0.5181347150259068,0.0
31,강원특별자치도,양양군,잘못 투입·구분된 투표지,,0,0,0,0,0,0,0,0,0,0,0.0,0.0,0.0,0.0,0.0
0,강원특별자치도,인제군,거소·선상투표,,185,174,39,64,54,1,0,158,16,11,24.68354430379747,40.50632911392405,34.177215189873415,0.6329113924050633,0.0
1,강원특별자치도,인제군,관외사전투표,,2546,2545,1201,940,349,21,6,2517,28,1,47.7155343663091,37.34604688120779,13.865713150576084,0.834326579261025,0.23837902264600713
2,강원특별자치도,인제군,재외투표,,79,61,43,10,7,1,0,61,0,18,70.49180327868852,16.39344262295082,11.475409836065573,1.639344262295082,0.0
3,강원특별자치도,인제군,인제읍,관내사전투표,2827,2827,1582,916,280,27,2,2807,20,0,56.35910224438903,32.632703954399716,9.975062344139651,0.9618810117563236,0.07125044531528321
4,강원특별자치도,인제군,인제읍,인제읍제1투,696,402,129,242,25,3,0,399,3,294,32.33082706766917,60.6516290726817,6.265664160401002,0.7518796992481203,0.0
5,강원특별자치도,인제군,인제읍,인제읍제2투,1603,1017,402,534,69,5,1,1011,6,586,39.762611275964396,52.818991097922854,6.824925816023739,0.4945598417408506,0.09891196834817012
6,강원특별자치도,인제군,인제읍,인제읍제3투,1911,1202,422,650,101,15,5,1193,9,709,35.37300922045264,54.48449287510477,8.466051969823972,1.2573344509639564,0.4191114836546521
7,강원특별자치도,인제군,인제읍,인제읍제4투,486,352,88,251,10,2,0,351,1,134,25.071225071225072,71.50997150997152,2.849002849002849,0.5698005698005698,0.0
8,강원특별자치도,인제군,인제읍,인제읍제5투,359,284,103,168,7,1,1,280,4,75,36.78571428571429,60.0,2.5,0.35714285714285715,0.35714285714285715
9,강원특별자치도,인제군,남면,관내사전투표,1142,1142,551,436,133,8,2,1130,12,0,48.76106194690266,38.58407079646018,11.76991150442478,0.7079646017699115,0.17699115044247787
10,강원특별자치도,인제군,남면,남면제1투,1106,641,191,416,25,3,0,635,6,465,30.078740157480315,65.51181102362204,3.937007874015748,0.47244094488188976,0.0
11,강원특별자치도,인제군,남면,남면제2투,660,380,116,202,53,6,1,378,2,280,30.687830687830687,53.43915343915344,14.02116402116402,1.5873015873015872,0.26455026455026454
12,강원특별자치도,인제군,북면,관내사전투표,2084,2084,1171,696,171,19,2,2059,25,0,56.87226809130645,33.80281690140845,8.305002428363283,0.9227780475959204,0.09713453132588634
13,강원특별자치도,인제군,북면,북면제1투,1328,788,266,467,45,6,3,787,1,540,33.7992376111817,59.339263024142305,5.717916137229987,0.7623888182973316,0.3811944091486658
14,강원특별자치도,인제군,북면,북면제2투,1210,773,263,437,63,5,0,768,5,437,34.24479166666667,56.901041666666664,8.203125,0.6510416666666667,0.0
15,강원특별자치도,인제군,북면,북면제3투,420,275,93,161,18,1,1,274,1,145,33.941605839416056,58.75912408759124,6.569343065693431,0.36496350364963503,0.36496350364963503
16,강원특별자치도,인제군,북면,북면제4투,368,250,55,184,10,0,1,250,0,118,22.0,73.6,4.0,0.0,0.4
17,강원특별자치도,인제군,북면,북면제5투,810,591,195,372,16,3,0,586,5,219,33.27645051194539,63.48122866894198,2.7303754266211606,0.5119453924914675,0.0
18,강원특별자치도,인제군,기린면,관내사전투표,1284,1284,639,490,121,20,4,1274,10,0,50.15698587127159,38.46153846153847,9.497645211930926,1.5698587127158554,0.3139717425431711
19,강원특별자치도,인제군,기린면,기린면제1투,638,441,126,289,17,3,1,436,5,197,28.899082568807337,66.28440366972477,3.89908256880734,0.6880733944954129,0.22935779816513763
20,강원특별자치도,인제군,기린면,기린면제2투,310,206,54,141,9,0,1,205,1,104,26.34146341463415,68.78048780487805,4.390243902439024,0.0,0.4878048780487805
21,강원특별자치도,인제군,기린면,기린면제3투,249,186,44,135,5,2,0,186,0,63,23.655913978494624,72.58064516129032,2.6881720430107525,1.0752688172043012,0.0
22,강원특별자치도,인제군,기린면,기린면제4투,274,193,52,134,3,1,0,190,3,81,27.368421052631582,70.52631578947368,1.5789473684210527,0.5263157894736842,0.0
23,강원특별자치도,인제군,기린면,기린면제5투,343,270,106,95,9,6,7,223,47,73,47.53363228699551,42.600896860986545,4.0358744394618835,2.690582959641256,3.1390134529147984
24,강원특별자치도,인제군,기린면,기린면제6투,877,558,175,320,55,5,0,555,3,319,31.53153153153153,57.65765765765766,9.90990990990991,0.9009009009009009,0.0
25,강원특별자치도,인제군,서화면,관내사전투표,716,716,331,258,111,6,1,707,9,0,46.81753889674682,36.49222065063649,15.700141442715701,0.8486562942008486,0.14144271570014144
26,강원특별자치도,인제군,서화면,서화면제1투,774,452,129,271,44,1,2,447,5,322,28.859060402684566,60.62639821029083,9.843400447427292,0.22371364653243847,0.44742729306487694
27,강원특별자치도,인제군,서화면,서화면제2투,282,196,62,105,23,2,1,193,3,86,32.12435233160622,54.40414507772021,11.917098445595855,1.0362694300518136,0.5181347150259068
28,강원특별자치도,인제군,서화면,서화면제3투,203,141,46,89,4,1,0,140,1,62,32.857142857142854,63.57142857142857,2.857142857142857,0.7142857142857143,0.0
29,강원특별자치도,인제군,상남면,관내사전투표,579,579,269,219,78,6,3,575,4,0,46.78260869565217,38.08695652173913,13.56521739130435,1.0434782608695654,0.5217391304347827
30,강원특별자치도,인제군,상남면,상남면제1투,667,408,99,267,37,4,0,407,1,259,24.324324324324326,65.6019656019656,9.090909090909092,0.9828009828009828,0.0
31,강원특별자치도,인제군,상남면,상남면제2투,367,248,94,140,12,1,0,247,1,119,38.05668016194332,56.68016194331984,4.8582995951417,0.4048582995951417,0.0
32,강원특별자치도,인제군,잘못 투입·구분된 투표지,,0,0,0,0,0,0,0,0,0,0,0.0,0.0,0.0,0.0,0.0
0,강원특별자치도,홍천군,거소·선상투표,,124,119,39,47,16,0,2,104,15,5,37.5,45.19230769230769,15.384615384615385,0.0,1.9230769230769231
1,강원특별자치도,홍천군,관외사전투표,,5300,5297,2621,2004,562,47,7,5241,56,3,50.00954016409083,38.236977676016025,10.723144438084335,0.896775424537302,0.1335622972715131
2,강원특별자치도,홍천군,재외투표,,228,182,135,37,8,1,0,181,1,46,74.58563535911603,20.441988950276244,4.41988950276243,0.5524861878453038,0.0
3,강원특별자치도,홍천군,홍천읍,관내사전투표,7380,7380,3990,2772,490,59,5,7316,64,0,54.53799890650629,37.88955713504647,6.697648988518316,0.8064516129032258,0.0683433570256971
4,강원특별자치도,홍천군,홍천읍,홍천읍제1투,823,539,193,301,32,3,3,532,7,284,36.278195488721806,56.57894736842105,6.015037593984962,0.5639097744360901,0.5639097744360901
5,강원특별자치도,홍천군,홍천읍,홍천읍제2투,860,517,158,320,30,2,2,512,5,343,30.859375,62.5,5.859375,0.390625,0.390625
6,강원특별자치도,홍천군,홍천읍,홍천읍제3투,1083,624,177,405,33,4,0,619,5,459,28.594507269789982,65.4281098546042,5.3311793214862675,0.6462035541195477,0.0
7,강원특별자치도,홍천군,홍천읍,홍천읍제4투,1240,770,247,458,53,1,3,762,8,470,32.414698162729664,60.10498687664042,6.955380577427822,0.13123359580052493,0.39370078740157477
8,강원특별자치도,홍천군,홍천읍,홍천읍제5투,1220,790,237,513,33,2,0,785,5,430,30.19108280254777,65.35031847133757,4.203821656050955,0.25477707006369427,0.0
9,강원특별자치도,홍천군,홍천읍,홍천읍제6투,513,311,100,196,10,1,1,308,3,202,32.467532467532465,63.63636363636363,3.2467532467532463,0.3246753246753247,0.3246753246753247
10,강원특별자치도,홍천군,홍천읍,홍천읍제7투,2610,1681,641,881,132,11,3,1668,13,929,38.42925659472422,52.81774580335732,7.913669064748201,0.6594724220623501,0.1798561151079137
11,강원특별자치도,홍천군,홍천읍,홍천읍제8투,1363,951,389,472,66,8,2,937,14,412,41.51547491995731,50.3735325506937,7.043756670224119,0.8537886872998933,0.21344717182497333
12,강원특별자치도,홍천군,홍천읍,홍천읍제9투,2151,1293,492,674,102,11,1,1280,13,858,38.4375,52.65625000000001,7.968749999999999,0.8593750000000001,0.078125
13,강원특별자치도,홍천군,홍천읍,홍천읍제10투,2135,1324,501,723,80,8,0,1312,12,811,38.1859756097561,55.106707317073166,6.097560975609756,0.6097560975609756,0.0
14,강원특별자치도,홍천군,홍천읍,홍천읍제11투,1216,779,286,440,45,4,1,776,3,437,36.855670103092784,56.70103092783505,5.798969072164948,0.5154639175257731,0.12886597938144329
15,강원특별자치도,홍천군,홍천읍,홍천읍제12투,3075,2056,753,1085,178,16,5,2037,19,1019,36.96612665684831,53.264604810996566,8.738340697103583,0.7854688267059401,0.24545900834560627
16,강원특별자치도,홍천군,화촌면,관내사전투표,1220,1220,643,460,94,11,1,1209,11,0,53.18444995864351,38.0479735318445,7.775020678246484,0.9098428453267163,0.0827129859387924
17,강원특별자치도,홍천군,화촌면,화촌면제1투,1033,658,197,429,18,9,2,655,3,375,30.076335877862597,65.49618320610688,2.7480916030534353,1.3740458015267176,0.3053435114503817
18,강원특별자치도,홍천군,화촌면,화촌면제2투,498,307,90,195,19,1,0,305,2,191,29.508196721311474,63.934426229508205,6.229508196721312,0.32786885245901637,0.0
19,강원특별자치도,홍천군,화촌면,화촌면제3투,410,275,78,186,8,2,0,274,1,135,28.467153284671532,67.88321167883211,2.9197080291970803,0.7299270072992701,0.0
20,강원특별자치도,홍천군,화촌면,화촌면제4투,536,331,85,230,10,5,1,331,0,205,25.6797583081571,69.48640483383686,3.0211480362537766,1.5105740181268883,0.3021148036253776
21,강원특별자치도,홍천군,두촌면,관내사전투표,666,666,286,343,27,6,1,663,3,0,43.13725490196079,51.734539969834096,4.072398190045249,0.904977375565611,0.1508295625942685
22,강원특별자치도,홍천군,두촌면,두촌면제1투,851,534,111,391,22,3,1,528,6,317,21.022727272727273,74.0530303030303,4.166666666666666,0.5681818181818182,0.1893939393939394
23,강원특별자치도,홍천군,두촌면,두촌면제2투,467,327,90,222,10,1,1,324,3,140,27.77777777777778,68.51851851851852,3.0864197530864197,0.30864197530864196,0.30864197530864196
24,강원특별자치도,홍천군,내촌면,관내사전투표,709,709,311,333,41,10,1,696,13,0,44.68390804597701,47.8448275862069,5.890804597701149,1.4367816091954022,0.14367816091954022
25,강원특별자치도,홍천군,내촌면,내촌면제1투,539,345,85,241,13,3,0,342,3,194,24.853801169590643,70.46783625730994,3.8011695906432745,0.8771929824561403,0.0
26,강원특별자치도,홍천군,내촌면,내촌면제2투,456,328,78,235,9,2,0,324,4,128,24.074074074074073,72.53086419753086,2.7777777777777777,0.6172839506172839,0.0
27,강원특별자치도,홍천군,내촌면,내촌면제3투,336,220,53,151,14,0,0,218,2,116,24.31192660550459,69.26605504587155,6.422018348623854,0.0,0.0
28,강원특별자치도,홍천군,서석면,관내사전투표,1037,1037,551,423,50,5,1,1030,7,0,53.49514563106796,41.067961165048544,4.854368932038835,0.48543689320388345,0.0970873786407767
29,강원특별자치도,홍천군,서석면,서석면제1투,793,498,144,324,21,2,0,491,7,295,29.327902240325866,65.9877800407332,4.276985743380855,0.40733197556008144,0.0
30,강원특별자치도,홍천군,서석면,서석면제2투,587,385,93,281,7,0,0,381,4,202,24.409448818897637,73.75328083989501,1.837270341207349,0.0,0.0
31,강원특별자치도,홍천군,서석면,서석면제3투,390,292,95,185,9,1,0,290,2,98,32.758620689655174,63.793103448275865,3.103448275862069,0.3448275862068966,0.0
32,강원특별자치도,홍천군,서석면,서석면제4투,341,242,59,171,9,0,1,240,2,99,24.583333333333332,71.25,3.75,0.0,0.4166666666666667
33,강원특별자치도,홍천군,영귀미면,관내사전투표,1386,1386,765,527,75,8,1,1376,10,0,55.595930232558146,38.299418604651166,5.450581395348837,0.5813953488372093,0.07267441860465117
34,강원특별자치도,홍천군,영귀미면,영귀미면제1투,1532,975,318,614,26,10,2,970,5,557,32.78350515463917,63.298969072164944,2.6804123711340204,1.0309278350515463,0.2061855670103093
35,강원특별자치도,홍천군,영귀미면,영귀미면제2투,528,352,103,227,14,2,0,346,6,176,29.76878612716763,65.60693641618496,4.046242774566474,0.5780346820809248,0.0
36,강원특별자치도,홍천군,영귀미면,영귀미면제3투,262,197,77,113,4,1,0,195,2,65,39.48717948717949,57.948717948717956,2.051282051282051,0.5128205128205128,0.0
37,강원특별자치도,홍천군,남면,관내사전투표,1677,1677,877,641,132,11,2,1663,14,0,52.73601924233313,38.544798556825015,7.9374624173181,0.661455201443175,0.12026458208057728
38,강원특별자치도,홍천군,남면,남면제1투,1170,748,185,503,53,4,0,745,3,422,24.832214765100673,67.51677852348993,7.114093959731544,0.5369127516778524,0.0
39,강원특별자치도,홍천군,남면,남면제2투,703,436,146,270,17,2,1,436,0,267,33.48623853211009,61.92660550458715,3.89908256880734,0.45871559633027525,0.22935779816513763
40,강원특별자치도,홍천군,남면,남면제3투,1222,747,217,465,48,12,0,742,5,475,29.245283018867923,62.668463611859835,6.46900269541779,1.6172506738544474,0.0
41,강원특별자치도,홍천군,서면,관내사전투표,790,790,393,354,32,6,0,785,5,0,50.06369426751592,45.095541401273884,4.076433121019108,0.7643312101910829,0.0
42,강원특별자치도,홍천군,서면,서면제1투,768,483,86,368,17,5,1,477,6,285,18.029350104821802,77.14884696016772,3.563941299790356,1.0482180293501049,0.20964360587002098
43,강원특별자치도,홍천군,서면,서면제2투,390,255,66,178,4,1,1,250,5,135,26.400000000000002,71.2,1.6,0.4,0.4
44,강원특별자치도,홍천군,서면,서면제3투,1074,700,166,496,28,4,2,696,4,374,23.850574712643677,71.26436781609196,4.022988505747127,0.5747126436781609,0.28735632183908044
45,강원특별자치도,홍천군,북방면,관내사전투표,1475,1475,749,566,134,10,2,1461,14,0,51.266255989048595,38.74058863791923,9.17180013689254,0.6844626967830253,0.13689253935660506
46,강원특별자치도,홍천군,북방면,북방면제1투,1381,890,237,607,33,4,0,881,9,491,26.901248581157777,68.89897843359817,3.745743473325766,0.4540295119182747,0.0
47,강원특별자치도,홍천군,북방면,북방면제2투,608,417,101,304,9,1,0,415,2,191,24.337349397590362,73.25301204819277,2.1686746987951806,0.24096385542168677,0.0
48,강원특별자치도,홍천군,북방면,북방면제3투,346,241,86,147,5,1,1,240,1,105,35.833333333333336,61.25000000000001,2.083333333333333,0.4166666666666667,0.4166666666666667
49,강원특별자치도,홍천군,내면,관내사전투표,793,793,421,336,31,5,0,793,0,0,53.089533417402265,42.37074401008827,3.909205548549811,0.6305170239596469,0.0
50,강원특별자치도,홍천군,내면,내면제1투,763,479,150,289,29,3,0,471,8,284,31.84713375796178,61.3588110403397,6.1571125265392785,0.6369426751592357,0.0
51,강원특별자치도,홍천군,내면,내면제2투,457,326,76,229,16,2,0,323,3,131,23.52941176470588,70.89783281733746,4.953560371517028,0.6191950464396285,0.0
52,강원특별자치도,홍천군,내면,내면제3투,392,270,74,187,4,4,1,270,0,122,27.40740740740741,69.25925925925925,1.4814814814814816,1.4814814814814816,0.3703703703703704
53,강원특별자치도,홍천군,잘못 투입·구분된 투표지,,0,0,0,0,0,0,0,0,0,0,0.0,0.0,0.0,0.0,0.0
0,강원특별자치도,횡성군,거소·선상투표,,66,62,25,27,9,1,0,62,0,4,40.32258064516129,43.54838709677419,14.516129032258066,1.6129032258064515,0.0
1,강원특별자치도,횡성군,관외사전투표,,4096,4095,2006,1595,405,43,4,4053,42,1,49.49420182580804,39.35356526030101,9.99259807549963,1.0609425117197138,0.09869232667160127
2,강원특별자치도,횡성군,재외투표,,186,154,113,31,7,1,0,152,2,32,74.3421052631579,20.394736842105264,4.605263157894736,0.6578947368421052,0.0
3,강원특별자치도,횡성군,횡성읍,관내사전투표,5433,5433,3032,1957,361,42,4,5396,37,0,56.18977020014826,36.267605633802816,6.690140845070422,0.7783543365455894,0.07412898443291327
4,강원특별자치도,횡성군,횡성읍,횡성읍제1투,2876,1766,511,1107,113,13,3,1747,19,1110,29.25014310246136,63.36576989124213,6.468231253577561,0.7441327990841442,0.17172295363480253
5,강원특별자치도,횡성군,횡성읍,횡성읍제2투,473,339,101,216,17,1,0,335,4,134,30.149253731343283,64.4776119402985,5.074626865671641,0.2985074626865672,0.0
6,강원특별자치도,횡성군,횡성읍,횡성읍제3투,443,294,83,197,10,0,0,290,4,149,28.620689655172416,67.93103448275862,3.4482758620689653,0.0,0.0
7,강원특별자치도,횡성군,횡성읍,횡성읍제4투,786,554,141,390,16,3,1,551,3,232,25.58983666061706,70.78039927404718,2.9038112522686026,0.5444646098003629,0.18148820326678766
8,강원특별자치도,횡성군,횡성읍,횡성읍제5투,3156,1867,604,1101,128,13,4,1850,17,1289,32.648648648648646,59.513513513513516,6.918918918918919,0.7027027027027027,0.21621621621621623
9,강원특별자치도,횡성군,횡성읍,횡성읍제6투,1439,931,328,543,37,9,1,918,13,508,35.72984749455338,59.150326797385624,4.030501089324619,0.9803921568627451,0.10893246187363835
10,강원특별자치도,횡성군,횡성읍,횡성읍제7투,1452,877,276,543,47,7,0,873,4,575,31.615120274914087,62.19931271477663,5.383734249713632,0.8018327605956471,0.0
11,강원특별자치도,횡성군,우천면,관내사전투표,1264,1264,640,549,55,10,2,1256,8,0,50.955414012738856,43.710191082802545,4.378980891719745,0.7961783439490446,0.15923566878980894
12,강원특별자치도,횡성군,우천면,우천면제1투,834,539,157,353,19,4,0,533,6,295,29.45590994371482,66.22889305816135,3.564727954971857,0.7504690431519699,0.0
13,강원특별자치도,횡성군,우천면,우천면제2투,917,590,148,421,15,3,2,589,1,327,25.127334465195243,71.47707979626486,2.5466893039049237,0.5093378607809848,0.3395585738539898
14,강원특별자치도,횡성군,우천면,우천면제3투,798,523,158,340,22,2,0,522,1,275,30.268199233716476,65.13409961685824,4.21455938697318,0.38314176245210724,0.0
15,강원특별자치도,횡성군,안흥면,관내사전투표,861,861,456,367,28,3,0,854,7,0,53.39578454332553,42.97423887587822,3.278688524590164,0.351288056206089,0.0
16,강원특별자치도,횡성군,안흥면,안흥면제1투,1176,791,183,579,18,3,1,784,7,385,23.341836734693878,73.85204081632652,2.295918367346939,0.3826530612244898,0.12755102040816327
17,강원특별자치도,횡성군,안흥면,안흥면제2투,419,303,96,187,14,5,0,302,1,116,31.788079470198678,61.920529801324506,4.635761589403973,1.6556291390728477,0.0
18,강원특별자치도,횡성군,둔내면,관내사전투표,1637,1637,913,631,71,11,1,1627,10,0,56.11555009219422,38.78303626306085,4.363859864781807,0.6760909649661955,0.06146281499692685
19,강원특별자치도,횡성군,둔내면,둔내면제1투,1191,747,194,499,41,5,3,742,5,444,26.1455525606469,67.25067385444744,5.525606469002695,0.6738544474393532,0.40431266846361186
20,강원특별자치도,횡성군,둔내면,둔내면제2투,386,256,63,184,6,0,1,254,2,130,24.803149606299215,72.44094488188976,2.3622047244094486,0.0,0.39370078740157477
21,강원특별자치도,횡성군,둔내면,둔내면제3투,1442,895,268,566,48,7,0,889,6,547,30.146231721034873,63.66704161979753,5.399325084364454,0.7874015748031495,0.0
22,강원특별자치도,횡성군,둔내면,둔내면제4투,343,235,60,162,9,0,1,232,3,108,25.862068965517242,69.82758620689656,3.8793103448275863,0.0,0.43103448275862066
23,강원특별자치도,횡성군,갑천면,관내사전투표,622,622,324,261,21,8,1,615,7,0,52.6829268292683,42.4390243902439,3.414634146341464,1.3008130081300813,0.16260162601626016
24,강원특별자치도,횡성군,갑천면,갑천면제1투,959,634,138,465,18,4,2,627,7,325,22.00956937799043,74.16267942583733,2.8708133971291865,0.6379585326953748,0.3189792663476874
25,강원특별자치도,횡성군,갑천면,갑천면제2투,454,331,105,209,11,3,1,329,2,123,31.914893617021278,63.525835866261396,3.343465045592705,0.911854103343465,0.303951367781155
26,강원특별자치도,횡성군,청일면,관내사전투표,657,657,329,289,31,3,0,652,5,0,50.4601226993865,44.325153374233125,4.754601226993866,0.4601226993865031,0.0
27,강원특별자치도,횡성군,청일면,청일면제1투,357,231,33,193,3,2,0,231,0,126,14.285714285714285,83.54978354978356,1.2987012987012987,0.8658008658008658,0.0
28,강원특별자치도,횡성군,청일면,청일면제2투,421,284,60,212,6,2,1,281,3,137,21.352313167259787,75.44483985765125,2.135231316725979,0.7117437722419928,0.3558718861209964
29,강원특별자치도,횡성군,청일면,청일면제3투,517,329,86,226,13,1,0,326,3,188,26.380368098159508,69.32515337423312,3.9877300613496933,0.3067484662576687,0.0
30,강원특별자치도,횡성군,공근면,관내사전투표,1055,1055,526,471,43,7,0,1047,8,0,50.238777459407835,44.985673352435526,4.106972301814708,0.6685768863419294,0.0
31,강원특별자치도,횡성군,공근면,공근면제1투,1191,761,201,535,21,0,1,758,3,430,26.517150395778366,70.58047493403694,2.7704485488126647,0.0,0.13192612137203166
32,강원특별자치도,횡성군,공근면,공근면제2투,693,467,100,339,19,5,0,463,4,226,21.598272138228943,73.2181425485961,4.103671706263499,1.079913606911447,0.0
33,강원특별자치도,횡성군,서원면,관내사전투표,530,530,288,204,26,5,1,524,6,0,54.961832061068705,38.93129770992366,4.961832061068702,0.9541984732824428,0.19083969465648853
34,강원특별자치도,횡성군,서원면,서원면제1투,596,403,91,295,8,5,0,399,4,193,22.807017543859647,73.93483709273183,2.0050125313283207,1.2531328320802004,0.0
35,강원특별자치도,횡성군,서원면,서원면제2투,546,394,128,248,12,2,0,390,4,152,32.82051282051282,63.589743589743584,3.076923076923077,0.5128205128205128,0.0
36,강원특별자치도,횡성군,강림면,관내사전투표,510,510,227,255,22,2,1,507,3,0,44.773175542406314,50.29585798816568,4.339250493096647,0.39447731755424065,0.19723865877712032
37,강원특별자치도,횡성군,강림면,강림면투표소,943,642,155,461,19,2,0,637,5,301,24.332810047095762,72.37048665620094,2.9827315541601256,0.3139717425431711,0.0
38,강원특별자치도,횡성군,잘못 투입·구분된 투표지,,0,0,0,0,0,0,0,0,0,0,0.0,0.0,0.0,0.0,0.0
0,강원특별자치도,영월군,거소·선상투표,,101,89,32,42,8,3,3,88,1,12,36.36363636363637,47.72727272727273,9.090909090909092,3.4090909090909087,3.4090909090909087
1,강원특별자치도,영월군,관외사전투표,,3184,3183,1682,1123,320,26,5,3156,27,1,53.29531051964512,35.5830164765526,10.139416983523446,0.8238276299112801,0.15842839036755385
2,강원특별자치도,영월군,재외투표,,118,87,66,16,4,1,0,87,0,31,75.86206896551724,18.39080459770115,4.597701149425287,1.1494252873563218,0.0
3,강원특별자치도,영월군,영월읍,관내사전투표,5393,5393,3214,1801,290,47,5,5357,36,0,59.99626656710846,33.61956318835169,5.413477692738473,0.877356729512787,0.09333582228859437
4,강원특별자치도,영월군,영월읍,영월읍제1투,1117,742,207,501,23,4,0,735,7,375,28.163265306122447,68.16326530612244,3.1292517006802725,0.5442176870748299,0.0
5,강원특별자치도,영월군,영월읍,영월읍제2투,1412,880,285,532,52,5,1,875,5,532,32.57142857142858,60.8,5.942857142857143,0.5714285714285714,0.1142857142857143
6,강원특별자치도,영월군,영월읍,영월읍제3투,1990,1158,424,648,63,13,3,1151,7,832,36.8375325803649,56.298870547350134,5.473501303214596,1.1294526498696786,0.26064291920069504
7,강원특별자치도,영월군,영월읍,영월읍제4투,1610,1082,384,609,72,7,1,1073,9,528,35.787511649580615,56.75675675675676,6.710158434296365,0.65237651444548,0.09319664492078285
8,강원특별자치도,영월군,영월읍,영월읍제5투,905,567,150,396,17,1,1,565,2,338,26.548672566371685,70.08849557522124,3.0088495575221237,0.17699115044247787,0.17699115044247787
9,강원특별자치도,영월군,영월읍,영월읍제6투,440,290,73,203,10,1,2,289,1,150,25.259515570934255,70.24221453287197,3.4602076124567476,0.34602076124567477,0.6920415224913495
10,강원특별자치도,영월군,영월읍,영월읍제7투,296,173,47,121,2,0,0,170,3,123,27.647058823529413,71.17647058823529,1.1764705882352942,0.0,0.0
11,강원특별자치도,영월군,영월읍,영월읍제8투,850,551,157,352,26,5,1,541,10,299,29.02033271719039,65.06469500924214,4.805914972273567,0.9242144177449169,0.18484288354898337
12,강원특별자치도,영월군,영월읍,영월읍제9투,1562,1002,299,636,56,4,2,997,5,560,29.989969909729187,63.7913741223671,5.616850551654965,0.4012036108324975,0.20060180541624875
13,강원특별자치도,영월군,상동읍,관내사전투표,320,320,154,148,14,1,0,317,3,0,48.580441640378545,46.68769716088328,4.416403785488959,0.31545741324921134,0.0
14,강원특별자치도,영월군,상동읍,상동읍제1투,157,90,27,59,3,0,0,89,1,67,30.337078651685395,66.29213483146067,3.3707865168539324,0.0,0.0
15,강원특별자치도,영월군,상동읍,상동읍제2투,165,103,33,67,2,1,0,103,0,62,32.038834951456316,65.0485436893204,1.9417475728155338,0.9708737864077669,0.0
16,강원특별자치도,영월군,상동읍,상동읍제3투,216,143,33,103,4,1,0,141,2,73,23.404255319148938,73.04964539007092,2.8368794326241136,0.7092198581560284,0.0
17,강원특별자치도,영월군,산솔면,관내사전투표,359,359,166,167,19,7,0,359,0,0,46.239554317548745,46.51810584958218,5.2924791086350975,1.9498607242339834,0.0
18,강원특별자치도,영월군,산솔면,산솔면제1투,470,319,82,221,7,4,0,314,5,151,26.11464968152866,70.38216560509554,2.229299363057325,1.2738853503184715,0.0
19,강원특별자치도,영월군,산솔면,산솔면제2투,394,270,66,195,5,2,1,269,1,124,24.53531598513011,72.4907063197026,1.858736059479554,0.7434944237918215,0.37174721189591076
20,강원특별자치도,영월군,김삿갓면,관내사전투표,543,543,289,223,22,3,0,537,6,0,53.81750465549349,41.527001862197395,4.0968342644320295,0.5586592178770949,0.0
21,강원특별자치도,영월군,김삿갓면,김삿갓면제1투,484,331,96,227,7,1,0,331,0,153,29.003021148036257,68.58006042296071,2.1148036253776437,0.3021148036253776,0.0
22,강원특별자치도,영월군,김삿갓면,김삿갓면제2투,409,267,61,196,7,1,0,265,2,142,23.0188679245283,73.9622641509434,2.6415094339622645,0.37735849056603776,0.0
23,강원특별자치도,영월군,북면,관내사전투표,431,431,220,179,25,3,0,427,4,0,51.52224824355972,41.92037470725995,5.85480093676815,0.702576112412178,0.0
24,강원특별자치도,영월군,북면,북면제1투,439,278,64,200,14,0,0,278,0,161,23.021582733812952,71.94244604316546,5.0359712230215825,0.0,0.0
25,강원특별자치도,영월군,북면,북면제2투,440,306,91,203,8,0,0,302,4,134,30.132450331125828,67.21854304635761,2.6490066225165565,0.0,0.0
26,강원특별자치도,영월군,북면,북면제3투,358,241,76,148,13,3,0,240,1,117,31.666666666666664,61.66666666666667,5.416666666666667,1.25,0.0
27,강원특별자치도,영월군,남면,관내사전투표,789,789,397,331,41,4,1,774,15,0,51.291989664082685,42.764857881136955,5.297157622739018,0.516795865633075,0.12919896640826875
28,강원특별자치도,영월군,남면,남면제1투,754,460,106,321,26,2,1,456,4,294,23.24561403508772,70.39473684210526,5.701754385964912,0.43859649122807015,0.21929824561403508
29,강원특별자치도,영월군,남면,남면제2투,353,261,87,160,11,1,1,260,1,92,33.46153846153846,61.53846153846154,4.230769230769231,0.38461538461538464,0.38461538461538464
30,강원특별자치도,영월군,남면,남면제3투,160,118,38,79,1,0,0,118,0,42,32.20338983050847,66.94915254237289,0.847457627118644,0.0,0.0
31,강원특별자치도,영월군,한반도면,관내사전투표,494,494,276,189,21,3,2,491,3,0,56.211812627291245,38.4928716904277,4.276985743380855,0.6109979633401221,0.40733197556008144
32,강원특별자치도,영월군,한반도면,한반도면제1투,587,379,101,261,14,1,1,378,1,208,26.71957671957672,69.04761904761905,3.7037037037037033,0.26455026455026454,0.26455026455026454
33,강원특별자치도,영월군,한반도면,한반도면제2투,1072,759,213,501,29,5,3,751,8,313,28.362183754993342,66.711051930759,3.861517976031957,0.6657789613848202,0.3994673768308922
34,강원특별자치도,영월군,주천면,관내사전투표,1257,1257,622,568,55,5,1,1251,6,0,49.72022382094325,45.40367705835332,4.396482813749001,0.3996802557953637,0.07993605115907274
35,강원특별자치도,영월군,주천면,주천면제1투,1243,762,201,510,38,7,1,757,5,481,26.55217965653897,67.37120211360634,5.019815059445178,0.9247027741083224,0.13210039630118892
36,강원특별자치도,영월군,주천면,주천면제2투,241,162,45,112,3,2,0,162,0,79,27.77777777777778,69.1358024691358,1.8518518518518516,1.2345679012345678,0.0
37,강원특별자치도,영월군,주천면,주천면제3투,563,427,135,273,17,2,0,427,0,136,31.61592505854801,63.934426229508205,3.9812646370023423,0.468384074941452,0.0
38,강원특별자치도,영월군,무릉도원면,관내사전투표,408,408,190,196,19,3,0,408,0,0,46.568627450980394,48.03921568627451,4.6568627450980395,0.7352941176470588,0.0
39,강원특별자치도,영월군,무릉도원면,무릉도원면제1투,627,423,108,292,15,3,0,418,5,204,25.837320574162682,69.85645933014354,3.588516746411483,0.7177033492822966,0.0
40,강원특별자치도,영월군,무릉도원면,무릉도원면제2투,539,405,92,291,12,5,1,401,4,134,22.942643391521198,72.56857855361596,2.9925187032418954,1.2468827930174564,0.24937655860349126
41,강원특별자치도,영월군,잘못 투입·구분된 투표지,,0,0,0,0,0,0,0,0,0,0,0.0,0.0,0.0,0.0,0.0
0,강원특별자치도,평창군,거소·선상투표,,67,64,19,35,8,0,0,62,2,3,30.64516129032258,56.451612903225815,12.903225806451612,0.0,0.0
1,강원특별자치도,평창군,관외사전투표,,3798,3798,1829,1499,387,46,3,3764,34,0,48.59192348565356,39.82465462274176,10.281615302869287,1.2221041445270988,0.07970244420828905
2,강원특별자치도,평창군,재외투표,,158,133,94,26,11,1,1,133,0,25,70.67669172932331,19.548872180451127,8.270676691729323,0.7518796992481203,0.7518796992481203
3,강원특별자치도,평창군,평창읍,관내사전투표,2463,2463,1305,931,165,35,4,2440,23,0,53.48360655737705,38.15573770491803,6.762295081967213,1.4344262295081966,0.16393442622950818
4,강원특별자치도,평창군,평창읍,평창읍제1투,999,592,147,407,31,3,2,590,2,407,24.91525423728814,68.98305084745763,5.2542372881355925,0.5084745762711864,0.3389830508474576
5,강원특별자치도,평창군,평창읍,평창읍제2투,1440,844,268,510,50,5,1,834,10,596,32.13429256594724,61.15107913669065,5.995203836930456,0.5995203836930456,0.1199040767386091
6,강원특별자치도,평창군,평창읍,평창읍제3투,208,149,30,111,4,2,0,147,2,59,20.408163265306122,75.51020408163265,2.7210884353741496,1.3605442176870748,0.0
7,강원특별자치도,평창군,평창읍,평창읍제4투,411,293,85,190,12,2,0,289,4,118,29.411764705882355,65.7439446366782,4.1522491349480966,0.6920415224913495,0.0
8,강원특별자치도,평창군,평창읍,평창읍제5투,405,295,69,212,10,1,0,292,3,110,23.63013698630137,72.6027397260274,3.4246575342465753,0.3424657534246575,0.0
9,강원특별자치도,평창군,평창읍,평창읍제6투,411,293,90,185,12,2,2,291,2,118,30.927835051546392,63.57388316151202,4.123711340206185,0.6872852233676976,0.6872852233676976
10,강원특별자치도,평창군,평창읍,평창읍제7투,314,217,45,167,2,2,0,216,1,97,20.833333333333336,77.31481481481481,0.9259259259259258,0.9259259259259258,0.0
11,강원특별자치도,평창군,미탄면,관내사전투표,531,531,247,248,33,1,1,530,1,0,46.60377358490566,46.79245283018868,6.226415094339623,0.18867924528301888,0.18867924528301888
12,강원특별자치도,평창군,미탄면,미탄면제1투,686,459,123,314,16,3,0,456,3,227,26.973684210526315,68.85964912280701,3.508771929824561,0.6578947368421052,0.0
13,강원특별자치도,평창군,미탄면,미탄면제2투,104,81,19,62,0,0,0,81,0,23,23.456790123456788,76.5432098765432,0.0,0.0,0.0
14,강원특별자치도,평창군,방림면,관내사전투표,578,578,328,213,24,7,0,572,6,0,57.34265734265735,37.23776223776224,4.195804195804196,1.2237762237762237,0.0
15,강원특별자치도,평창군,방림면,방림면제1투,429,279,96,174,9,0,0,279,0,150,34.40860215053764,62.365591397849464,3.225806451612903,0.0,0.0
16,강원특별자치도,평창군,방림면,방림면제2투,339,244,82,155,2,1,0,240,4,95,34.166666666666664,64.58333333333334,0.8333333333333334,0.4166666666666667,0.0
17,강원특별자치도,평창군,방림면,방림면제3투,770,524,155,335,24,4,0,518,6,246,29.922779922779924,64.67181467181467,4.633204633204633,0.7722007722007722,0.0
18,강원특별자치도,평창군,대화면,관내사전투표,1516,1516,782,625,74,14,3,1498,18,0,52.20293724966623,41.722296395193595,4.939919893190922,0.9345794392523363,0.20026702269692925
19,강원특별자치도,평창군,대화면,대화면제1투,1079,643,185,411,37,4,2,639,4,436,28.951486697965574,64.31924882629107,5.790297339593114,0.6259780907668232,0.3129890453834116
20,강원특별자치도,평창군,대화면,대화면제2투,536,325,107,206,8,1,0,322,3,211,33.22981366459628,63.975155279503106,2.484472049689441,0.3105590062111801,0.0
21,강원특별자치도,평창군,대화면,대화면제3투,756,490,160,296,28,2,1,487,3,266,32.85420944558521,60.78028747433265,5.749486652977413,0.41067761806981523,0.20533880903490762
22,강원특별자치도,평창군,대화면,대화면제4투,222,153,49,100,3,0,0,152,1,69,32.23684210526316,65.78947368421053,1.9736842105263157,0.0,0.0
23,강원특별자치도,평창군,봉평면,관내사전투표,1496,1496,800,582,96,8,2,1488,8,0,53.76344086021505,39.11290322580645,6.451612903225806,0.5376344086021506,0.13440860215053765
24,강원특별자치도,평창군,봉평면,봉평면제1투,1311,838,207,576,47,4,0,834,4,473,24.820143884892087,69.06474820143885,5.635491606714628,0.4796163069544364,0.0
25,강원특별자치도,평창군,봉평면,봉평면제2투,677,439,103,306,24,2,0,435,4,238,23.678160919540232,70.34482758620689,5.517241379310345,0.45977011494252873,0.0
26,강원특별자치도,평창군,봉평면,봉평면제3투,939,559,152,380,20,7,0,559,0,380,27.191413237924866,67.97853309481216,3.5778175313059033,1.2522361359570662,0.0
27,강원특별자치도,평창군,용평면,관내사전투표,773,773,436,298,33,2,0,769,4,0,56.697009102730824,38.751625487646294,4.291287386215865,0.26007802340702213,0.0
28,강원특별자치도,평창군,용평면,용평면제1투,450,327,82,229,12,2,0,325,2,123,25.23076923076923,70.46153846153847,3.6923076923076925,0.6153846153846154,0.0
29,강원특별자치도,평창군,용평면,용평면제2투,495,339,79,241,13,1,1,335,4,156,23.582089552238806,71.94029850746269,3.880597014925373,0.2985074626865672,0.2985074626865672
30,강원특별자치도,평창군,용평면,용평면제3투,778,489,134,329,19,2,0,484,5,289,27.685950413223143,67.97520661157024,3.925619834710744,0.4132231404958678,0.0
31,강원특별자치도,평창군,진부면,관내사전투표,2308,2308,1238,891,145,21,2,2297,11,0,53.896386591205925,38.789725729212016,6.31258162821071,0.914235959947758,0.087070091423596
32,강원특별자치도,평창군,진부면,진부면제1투,798,507,160,324,17,2,0,503,4,291,31.809145129224653,64.41351888667992,3.3797216699801194,0.3976143141153081,0.0
33,강원특별자치도,평창군,진부면,진부면제2투,1324,824,248,498,65,8,0,819,5,500,30.28083028083028,60.8058608058608,7.936507936507936,0.9768009768009768,0.0
34,강원특별자치도,평창군,진부면,진부면제3투,1254,735,211,476,37,5,0,729,6,519,28.9437585733882,65.29492455418381,5.075445816186557,0.6858710562414266,0.0
35,강원특별자치도,평창군,진부면,진부면제4투,346,239,65,164,10,0,0,239,0,107,27.19665271966527,68.6192468619247,4.184100418410042,0.0,0.0
36,강원특별자치도,평창군,진부면,진부면제5투,371,225,58,153,8,1,0,220,5,146,26.36363636363636,69.54545454545455,3.6363636363636362,0.45454545454545453,0.0
37,강원특별자치도,평창군,진부면,진부면제6투,317,219,63,142,12,0,0,217,2,98,29.03225806451613,65.43778801843318,5.529953917050691,0.0,0.0
38,강원특별자치도,평창군,진부면,진부면제7투,256,172,43,121,7,1,0,172,0,84,25.0,70.34883720930233,4.069767441860465,0.5813953488372093,0.0
39,강원특별자치도,평창군,대관령면,관내사전투표,1595,1595,823,641,112,12,0,1588,7,0,51.82619647355163,40.36523929471033,7.052896725440807,0.7556675062972292,0.0
40,강원특별자치도,평창군,대관령면,대관령면제1투,1216,665,123,493,41,5,1,663,2,551,18.552036199095024,74.35897435897436,6.184012066365008,0.7541478129713424,0.1508295625942685
41,강원특별자치도,평창군,대관령면,대관령면제2투,1539,818,199,556,54,5,1,815,3,721,24.41717791411043,68.22085889570552,6.625766871165645,0.6134969325153374,0.1226993865030675
42,강원특별자치도,평창군,대관령면,대관령면제3투,290,187,56,125,6,0,0,187,0,103,29.946524064171122,66.84491978609626,3.2085561497326207,0.0,0.0
43,강원특별자치도,평창군,잘못 투입·구분된 투표지,,0,0,0,0,0,0,0,0,0,0,0.0,0.0,0.0,0.0,0.0
0,강원특별자치도,화천군,거소·선상투표,,171,168,41,68,46,4,0,159,9,3,25.78616352201258,42.76729559748428,28.930817610062892,2.515723270440252,0.0
1,강원특별자치도,화천군,관외사전투표,,2148,2148,1029,785,287,25,0,2126,22,0,48.40075258701788,36.92380056444026,13.49952963311383,1.175917215428034,0.0
2,강원특별자치도,화천군,재외투표,,65,47,23,15,7,1,0,46,1,18,50.0,32.608695652173914,15.217391304347828,2.1739130434782608,0.0
3,강원특별자치도,화천군,화천읍,관내사전투표,2227,2227,1154,830,194,25,3,2206,21,0,52.31187669990934,37.62466001813237,8.794197642792383,1.1332728921124207,0.1359927470534905
4,강원특별자치도,화천군,화천읍,화천읍제1투,1168,693,206,437,36,7,3,689,4,475,29.898403483309146,63.42525399129173,5.2249637155297535,1.0159651669085632,0.43541364296081275
5,강원특별자치도,화천군,화천읍,화천읍제2투,1981,1246,434,680,103,13,4,1234,12,735,35.17017828200972,55.10534846029174,8.346839546191248,1.053484602917342,0.3241491085899514
6,강원특별자치도,화천군,화천읍,화천읍제3투,492,309,96,191,20,1,1,309,0,183,31.06796116504854,61.81229773462783,6.472491909385113,0.3236245954692557,0.3236245954692557
7,강원특별자치도,화천군,화천읍,화천읍제4투,482,310,102,193,14,1,0,310,0,172,32.903225806451616,62.25806451612903,4.516129032258064,0.3225806451612903,0.0
8,강원특별자치도,화천군,간동면,관내사전투표,602,602,334,210,47,8,0,599,3,0,55.75959933222037,35.058430717863104,7.846410684474124,1.335559265442404,0.0
9,강원특별자치도,화천군,간동면,간동면제1투,501,289,59,212,14,2,0,287,2,212,20.557491289198605,73.86759581881533,4.878048780487805,0.6968641114982579,0.0
10,강원특별자치도,화천군,간동면,간동면제2투,508,367,105,246,11,2,0,364,3,141,28.846153846153843,67.58241758241759,3.021978021978022,0.5494505494505495,0.0
11,강원특별자치도,화천군,간동면,간동면제3투,354,252,78,160,11,0,0,249,3,102,31.32530120481928,64.2570281124498,4.417670682730924,0.0,0.0
12,강원특별자치도,화천군,간동면,간동면제4투,119,87,25,59,0,0,0,84,3,32,29.761904761904763,70.23809523809523,0.0,0.0,0.0
13,강원특별자치도,화천군,하남면,관내사전투표,774,774,413,273,75,9,1,771,3,0,53.56679636835279,35.40856031128405,9.72762645914397,1.1673151750972763,0.12970168612191957
14,강원특별자치도,화천군,하남면,하남면제1투,764,520,149,333,22,9,3,516,4,244,28.875968992248062,64.53488372093024,4.263565891472868,1.744186046511628,0.5813953488372093
15,강원특별자치도,화천군,하남면,하남면제2투,486,361,132,206,13,5,0,356,5,125,37.07865168539326,57.865168539325836,3.651685393258427,1.4044943820224718,0.0
16,강원특별자치도,화천군,하남면,하남면제3투,249,182,37,136,7,1,0,181,1,67,20.441988950276244,75.13812154696133,3.867403314917127,0.5524861878453038,0.0
17,강원특별자치도,화천군,상서면,관내사전투표,756,756,299,295,134,6,5,739,17,0,40.46008119079838,39.918809201623816,18.132611637347768,0.8119079837618403,0.6765899864682002
18,강원특별자치도,화천군,상서면,상서면제1투,497,328,93,205,26,2,0,326,2,169,28.52760736196319,62.88343558282209,7.975460122699387,0.6134969325153374,0.0
19,강원특별자치도,화천군,상서면,상서면제2투,266,193,60,116,11,3,1,191,2,73,31.413612565445025,60.73298429319372,5.7591623036649215,1.5706806282722512,0.5235602094240838
20,강원특별자치도,화천군,상서면,상서면제3투,279,189,50,131,7,0,0,188,1,90,26.595744680851062,69.68085106382979,3.723404255319149,0.0,0.0
21,강원특별자치도,화천군,상서면,상서면제4투,505,263,69,157,28,3,1,258,5,242,26.744186046511626,60.85271317829457,10.852713178294573,1.1627906976744187,0.3875968992248062
22,강원특별자치도,화천군,상서면,상서면제5투,195,123,45,69,7,2,0,123,0,72,36.58536585365854,56.09756097560976,5.691056910569105,1.6260162601626018,0.0
23,강원특별자치도,화천군,상서면,상서면제6투,213,116,28,80,5,2,0,115,1,97,24.347826086956523,69.56521739130434,4.3478260869565215,1.7391304347826086,0.0
24,강원특별자치도,화천군,사내면,관내사전투표,1515,1515,736,590,159,14,1,1500,15,0,49.06666666666666,39.33333333333333,10.6,0.9333333333333335,0.06666666666666667
25,강원특별자치도,화천군,사내면,사내면제1투,1389,818,238,489,75,8,0,810,8,571,29.38271604938272,60.370370370370374,9.25925925925926,0.9876543209876543,0.0
26,강원특별자치도,화천군,사내면,사내면제2투,505,339,92,227,12,3,1,335,4,166,27.46268656716418,67.76119402985074,3.582089552238806,0.8955223880597015,0.2985074626865672
27,강원특별자치도,화천군,사내면,사내면제3투,285,178,39,125,9,0,1,174,4,107,22.413793103448278,71.83908045977012,5.172413793103448,0.0,0.5747126436781609
28,강원특별자치도,화천군,사내면,사내면제4투,518,336,94,216,21,1,2,334,2,182,28.143712574850298,64.67065868263472,6.287425149700598,0.29940119760479045,0.5988023952095809
29,강원특별자치도,화천군,잘못 투입·구분된 투표지,,0,0,0,0,0,0,0,0,0,0,0.0,0.0,0.0,0.0,0.0
0,강원특별자치도,양구군,거소·선상투표,,192,185,64,58,49,5,1,177,8,7,36.15819209039548,32.7683615819209,27.683615819209038,2.824858757062147,0.5649717514124294
1,강원특별자치도,양구군,관외사전투표,,1582,1581,724,594,230,15,3,1566,15,1,46.23243933588761,37.93103448275862,14.687100893997446,0.9578544061302682,0.19157088122605362
2,강원특별자치도,양구군,재외투표,,50,38,24,10,3,0,0,37,1,12,64.86486486486487,27.027027027027028,8.108108108108109,0.0,0.0
3,강원특별자치도,양구군,양구읍,관내사전투표,3158,3158,1668,1127,292,35,5,3127,31,0,53.341861208826344,36.04093380236649,9.338023664854493,1.1192836584585866,0.1598976654940838
4,강원특별자치도,양구군,양구읍,양구읍제1투,421,288,95,181,10,1,0,287,1,133,33.10104529616725,63.06620209059234,3.484320557491289,0.34843205574912894,0.0
5,강원특별자치도,양구군,양구읍,양구읍제2투,354,245,86,145,12,1,0,244,1,109,35.24590163934426,59.42622950819673,4.918032786885246,0.4098360655737705,0.0
6,강원특별자치도,양구군,양구읍,양구읍제3투,1059,686,226,386,66,3,0,681,5,373,33.186490455212926,56.6813509544787,9.691629955947137,0.4405286343612335,0.0
7,강원특별자치도,양구군,양구읍,양구읍제4투,633,432,124,275,28,1,1,429,3,201,28.904428904428904,64.1025641025641,6.526806526806526,0.2331002331002331,0.2331002331002331
8,강원특별자치도,양구군,양구읍,양구읍제5투,2296,1471,530,783,128,15,2,1458,13,825,36.35116598079561,53.70370370370371,8.77914951989026,1.02880658436214,0.1371742112482853
9,강원특별자치도,양구군,양구읍,양구읍제6투,1378,830,215,531,64,12,4,826,4,548,26.02905569007264,64.28571428571429,7.74818401937046,1.4527845036319613,0.48426150121065376
10,강원특별자치도,양구군,양구읍,양구읍제7투,96,67,16,46,4,0,0,66,1,29,24.242424242424242,69.6969696969697,6.0606060606060606,0.0,0.0
11,강원특별자치도,양구군,양구읍,양구읍제8투,172,123,44,73,4,1,0,122,1,49,36.0655737704918,59.83606557377049,3.278688524590164,0.819672131147541,0.0
12,강원특별자치도,양구군,국토정중앙면,관내사전투표,774,774,353,334,71,7,1,766,8,0,46.083550913838124,43.60313315926893,9.26892950391645,0.9138381201044387,0.13054830287206268
13,강원특별자치도,양구군,국토정중앙면,국토정중앙면제1투,286,196,70,114,10,2,0,196,0,90,35.714285714285715,58.16326530612245,5.1020408163265305,1.0204081632653061,0.0
14,강원특별자치도,양구군,국토정중앙면,국토정중앙면제2투,801,492,137,316,33,2,0,488,4,309,28.07377049180328,64.75409836065575,6.762295081967213,0.4098360655737705,0.0
15,강원특별자치도,양구군,국토정중앙면,국토정중앙면제3투,559,355,94,237,14,1,0,346,9,204,27.167630057803464,68.4971098265896,4.046242774566474,0.2890173410404624,0.0
16,강원특별자치도,양구군,국토정중앙면,국토정중앙면제4투,290,210,46,151,9,1,0,207,3,80,22.22222222222222,72.94685990338165,4.3478260869565215,0.4830917874396135,0.0
17,강원특별자치도,양구군,동면,관내사전투표,571,571,297,197,64,6,0,564,7,0,52.659574468085104,34.9290780141844,11.347517730496454,1.0638297872340425,0.0
18,강원특별자치도,양구군,동면,동면제1투,333,229,63,155,9,0,0,227,2,104,27.75330396475771,68.28193832599119,3.9647577092511015,0.0,0.0
19,강원특별자치도,양구군,동면,동면제2투,480,315,85,196,26,3,0,310,5,165,27.419354838709676,63.2258064516129,8.38709677419355,0.967741935483871,0.0
20,강원특별자치도,양구군,동면,동면제3투,252,187,50,117,12,1,3,183,4,65,27.322404371584703,63.934426229508205,6.557377049180328,0.546448087431694,1.639344262295082
21,강원특별자치도,양구군,방산면,관내사전투표,299,299,154,103,38,3,0,298,1,0,51.67785234899329,34.56375838926174,12.751677852348994,1.006711409395973,0.0
22,강원특별자치도,양구군,방산면,방산면제1투,243,173,61,98,8,2,1,170,3,70,35.88235294117647,57.647058823529406,4.705882352941177,1.1764705882352942,0.5882352941176471
23,강원특별자치도,양구군,방산면,방산면제2투,240,192,67,114,11,0,0,192,0,48,34.89583333333333,59.375,5.729166666666666,0.0,0.0
24,강원특별자치도,양구군,방산면,방산면제3투,174,107,38,60,9,0,0,107,0,67,35.51401869158878,56.074766355140184,8.411214953271028,0.0,0.0
25,강원특별자치도,양구군,해안면,관내사전투표,411,411,249,139,18,1,1,408,3,0,61.029411764705884,34.068627450980394,4.411764705882353,0.24509803921568626,0.24509803921568626
26,강원특별자치도,양구군,해안면,해안면투표소,609,384,126,238,18,1,0,383,1,225,32.89817232375979,62.14099216710183,4.699738903394255,0.26109660574412535,0.0
27,강원특별자치도,양구군,잘못 투입·구분된 투표지,,0,0,0,0,0,0,0,0,0,0,0.0,0.0,0.0,0.0,0.0
0,강원특별자치도,철원군,거소·선상투표,,234,224,63,70,70,0,1,204,20,10,30.88235294117647,34.31372549019608,34.31372549019608,0.0,0.49019607843137253
1,강원특별자치도,철원군,관외사전투표,,2728,2728,1309,935,407,34,6,2691,37,0,48.643626904496465,34.74544778892605,15.124489037532515,1.26347082868822,0.2229654403567447
2,강원특별자치도,철원군,재외투표,,130,105,77,20,7,1,0,105,0,25,73.33333333333333,19.047619047619047,6.666666666666667,0.9523809523809524,0.0
3,강원특별자치도,철원군,철원읍,관내사전투표,1408,1408,730,537,115,9,3,1394,14,0,52.36728837876614,38.5222381635581,8.24964131994261,0.6456241032998565,0.2152080344332855
4,강원특별자치도,철원군,철원읍,철원읍제1투,569,362,121,218,16,4,0,359,3,207,33.70473537604457,60.724233983286915,4.456824512534819,1.1142061281337048,0.0
5,강원특별자치도,철원군,철원읍,철원읍제2투,985,630,240,321,59,6,1,627,3,355,38.27751196172249,51.196172248803826,9.409888357256778,0.9569377990430622,0.1594896331738437
6,강원특별자치도,철원군,철원읍,철원읍제3투,180,126,44,73,8,0,0,125,1,54,35.199999999999996,58.4,6.4,0.0,0.0
7,강원특별자치도,철원군,철원읍,철원읍제4투,370,241,91,142,6,2,0,241,0,129,37.75933609958506,58.921161825726145,2.4896265560165975,0.8298755186721992,0.0
8,강원특별자치도,철원군,철원읍,철원읍제5투,540,313,108,184,16,1,1,310,3,227,34.83870967741935,59.354838709677416,5.161290322580645,0.3225806451612903,0.3225806451612903
9,강원특별자치도,철원군,김화읍,관내사전투표,668,668,317,256,86,6,1,666,2,0,47.5975975975976,38.43843843843844,12.912912912912914,0.9009009009009009,0.15015015015015015
10,강원특별자치도,철원군,김화읍,김화읍제1투,391,245,80,149,11,4,0,244,1,146,32.78688524590164,61.065573770491795,4.508196721311475,1.639344262295082,0.0
11,강원특별자치도,철원군,김화읍,김화읍제2투,157,118,57,53,5,0,2,117,1,39,48.717948717948715,45.2991452991453,4.273504273504273,0.0,1.7094017094017095
12,강원특별자치도,철원군,김화읍,김화읍제3투,895,618,181,383,45,3,1,613,5,277,29.526916802610113,62.47960848287113,7.3409461663947795,0.48939641109298526,0.1631321370309951
13,강원특별자치도,철원군,김화읍,김화읍제4투,220,149,55,88,5,1,0,149,0,71,36.91275167785235,59.06040268456376,3.3557046979865772,0.6711409395973155,0.0
14,강원특별자치도,철원군,갈말읍,관내사전투표,2628,2628,1459,896,215,22,2,2594,34,0,56.24518118735543,34.54124903623747,8.288357748650732,0.8481110254433308,0.07710100231303006
15,강원특별자치도,철원군,갈말읍,갈말읍제1투,721,468,131,306,25,2,2,466,2,253,28.11158798283262,65.66523605150213,5.36480686695279,0.4291845493562232,0.4291845493562232
16,강원특별자치도,철원군,갈말읍,갈말읍제2투,695,455,122,297,27,3,0,449,6,240,27.171492204899778,66.14699331848553,6.013363028953229,0.6681514476614699,0.0
17,강원특별자치도,철원군,갈말읍,갈말읍제3투,897,425,122,248,46,5,0,421,4,472,28.978622327790976,58.90736342042755,10.926365795724466,1.187648456057007,0.0
18,강원특별자치도,철원군,갈말읍,갈말읍제4투,430,278,95,159,19,1,0,274,4,152,34.67153284671533,58.02919708029197,6.934306569343065,0.36496350364963503,0.0
19,강원특별자치도,철원군,갈말읍,갈말읍제5투,582,422,115,286,15,1,1,418,4,160,27.51196172248804,68.42105263157895,3.588516746411483,0.23923444976076555,0.23923444976076555
20,강원특별자치도,철원군,갈말읍,갈말읍제6투,442,303,71,220,8,1,1,301,2,139,23.588039867109632,73.08970099667775,2.6578073089700998,0.33222591362126247,0.33222591362126247
21,강원특별자치도,철원군,갈말읍,갈말읍제7투,1798,1182,462,625,79,9,1,1176,6,616,39.285714285714285,53.146258503401356,6.717687074829932,0.7653061224489796,0.08503401360544217
22,강원특별자치도,철원군,갈말읍,갈말읍제8투,896,568,180,333,44,8,2,567,1,328,31.746031746031743,58.730158730158735,7.760141093474426,1.4109347442680775,0.3527336860670194
23,강원특별자치도,철원군,갈말읍,갈말읍제9투,148,122,38,77,5,0,0,120,2,26,31.666666666666664,64.16666666666667,4.166666666666666,0.0,0.0
24,강원특별자치도,철원군,동송읍,관내사전투표,2412,2412,1309,904,170,15,2,2400,12,0,54.541666666666664,37.666666666666664,7.083333333333333,0.625,0.08333333333333334
25,강원특별자치도,철원군,동송읍,동송읍제1투,1905,1168,429,636,85,9,0,1159,9,737,37.01466781708369,54.874892148403795,7.333908541846419,0.7765314926660914,0.0
26,강원특별자치도,철원군,동송읍,동송읍제2투,1067,672,231,403,27,6,0,667,5,395,34.63268365817092,60.41979010494752,4.0479760119940025,0.8995502248875562,0.0
27,강원특별자치도,철원군,동송읍,동송읍제3투,1376,893,318,497,68,4,2,889,4,483,35.77052868391451,55.90551181102362,7.64904386951631,0.44994375703037126,0.22497187851518563
28,강원특별자치도,철원군,동송읍,동송읍제4투,831,522,165,316,33,3,1,518,4,309,31.85328185328185,61.003861003861005,6.370656370656371,0.5791505791505791,0.19305019305019305
29,강원특별자치도,철원군,동송읍,동송읍제5투,325,235,69,155,8,0,1,233,2,90,29.613733905579398,66.52360515021459,3.4334763948497855,0.0,0.4291845493562232
30,강원특별자치도,철원군,동송읍,동송읍제6투,649,442,134,287,15,3,1,440,2,207,30.454545454545457,65.22727272727272,3.4090909090909087,0.6818181818181818,0.22727272727272727
31,강원특별자치도,철원군,동송읍,동송읍제7투,393,272,75,184,10,2,0,271,1,121,27.67527675276753,67.89667896678966,3.6900369003690034,0.7380073800738007,0.0
32,강원특별자치도,철원군,동송읍,동송읍제8투,1038,663,221,396,35,3,0,655,8,375,33.74045801526718,60.45801526717557,5.343511450381679,0.45801526717557256,0.0
33,강원특별자치도,철원군,동송읍,동송읍제9투,430,302,96,189,14,1,0,300,2,128,32.0,63.0,4.666666666666667,0.33333333333333337,0.0
34,강원특별자치도,철원군,동송읍,동송읍제10투,244,184,86,93,3,0,0,182,2,60,47.25274725274725,51.098901098901095,1.6483516483516485,0.0,0.0
35,강원특별자치도,철원군,서면,관내사전투표,1437,1437,718,537,148,13,2,1418,19,0,50.634696755994355,37.870239774330045,10.437235543018335,0.9167842031029618,0.14104372355430184
36,강원특별자치도,철원군,서면,서면제1투,902,555,191,321,34,4,3,553,2,347,34.53887884267631,58.04701627486437,6.148282097649186,0.7233273056057866,0.5424954792043399
37,강원특별자치도,철원군,서면,서면제2투,939,544,178,324,33,6,0,541,3,395,32.90203327171904,59.88909426987061,6.099815157116451,1.1090573012939002,0.0
38,강원특별자치도,철원군,서면,서면제3투,1004,637,207,401,26,1,1,636,1,367,32.54716981132076,63.05031446540881,4.088050314465408,0.15723270440251574,0.15723270440251574
39,강원특별자치도,철원군,근남면,관내사전투표,386,386,194,143,37,4,0,378,8,0,51.32275132275132,37.83068783068783,9.788359788359788,1.0582010582010581,0.0
40,강원특별자치도,철원군,근남면,근남면제1투,254,185,46,130,2,3,0,181,4,69,25.41436464088398,71.8232044198895,1.1049723756906076,1.6574585635359116,0.0
41,강원특별자치도,철원군,근남면,근남면제2투,583,394,127,236,22,4,2,391,3,189,32.48081841432225,60.35805626598465,5.626598465473146,1.0230179028132993,0.5115089514066496
42,강원특별자치도,철원군,근남면,근남면제3투,344,249,76,162,7,1,0,246,3,95,30.89430894308943,65.85365853658537,2.8455284552845526,0.40650406504065045,0.0
43,강원특별자치도,철원군,근북면,관내사전투표,71,71,38,18,11,0,0,67,4,0,56.71641791044776,26.865671641791046,16.417910447761194,0.0,0.0
44,강원특별자치도,철원군,근북면,근북면투표소,54,38,13,24,1,0,0,38,0,16,34.21052631578947,63.1578947368421,2.631578947368421,0.0,0.0
45,강원특별자치도,철원군,잘못 투입·구분된 투표지,,0,0,0,0,0,0,0,0,0,0,0.0,0.0,0.0,0.0,0.0
0,충청북도,청주시상당구,거소·선상투표,,279,264,98,89,59,3,2,251,13,15,39.04382470119522,35.45816733067729,23.50597609561753,1.1952191235059761,0.796812749003984
1,충청북도,청주시상당구,관외사전투표,,16629,16624,9804,4232,2197,208,22,16463,161,5,59.55172204336998,25.7061288950981,13.345076838972242,1.2634392273583186,0.13363299520136063
2,충청북도,청주시상당구,재외투표,,585,478,338,89,43,6,0,476,2,107,71.00840336134453,18.69747899159664,9.033613445378151,1.2605042016806722,0.0
3,충청북도,청주시상당구,낭성면,관내사전투표,743,743,366,318,29,9,1,723,20,0,50.62240663900415,43.983402489626556,4.011065006915629,1.2448132780082988,0.13831258644536654
4,충청북도,청주시상당구,낭성면,낭성면투표소,1205,819,156,623,29,6,0,814,5,386,19.164619164619165,76.53562653562653,3.562653562653563,0.7371007371007371,0.0
5,충청북도,청주시상당구,미원면,관내사전투표,1458,1458,701,658,72,14,1,1446,12,0,48.47856154910097,45.50484094052559,4.979253112033195,0.9681881051175657,0.06915629322268327
6,충청북도,청주시상당구,미원면,미원면제1투,896,477,137,320,15,1,2,475,2,419,28.842105263157897,67.36842105263158,3.1578947368421053,0.21052631578947367,0.42105263157894735
7,충청북도,청주시상당구,미원면,미원면제2투,1149,659,190,441,16,7,0,654,5,490,29.051987767584098,67.43119266055045,2.4464831804281344,1.0703363914373087,0.0
8,충청북도,청주시상당구,미원면,미원면제3투,523,375,87,266,12,3,1,369,6,148,23.577235772357724,72.08672086720867,3.2520325203252036,0.8130081300813009,0.27100271002710025
9,충청북도,청주시상당구,가덕면,관내사전투표,1102,1102,570,434,67,12,3,1086,16,0,52.48618784530387,39.963167587476974,6.169429097605893,1.1049723756906076,0.2762430939226519
10,충청북도,청주시상당구,가덕면,가덕면제1투,1467,984,288,634,45,9,1,977,7,483,29.47799385875128,64.89252814738997,4.605936540429887,0.9211873080859775,0.1023541453428864
11,충청북도,청주시상당구,가덕면,가덕면제2투,720,452,144,280,18,5,1,448,4,268,32.142857142857146,62.5,4.017857142857143,1.1160714285714286,0.2232142857142857
12,충청북도,청주시상당구,남일면,관내사전투표,2084,2083,1208,719,125,21,0,2073,10,1,58.273034249879395,34.684032802701395,6.02990834539315,1.0130246020260492,0.0
13,충청북도,청주시상당구,남일면,남일면제1투,1678,1066,307,695,46,14,1,1063,3,612,28.88052681091251,65.38099717779869,4.327375352775165,1.317027281279398,0.09407337723424271
14,충청북도,청주시상당구,남일면,남일면제2투,1965,1254,380,784,74,8,1,1247,7,711,30.473135525260624,62.87089013632718,5.934242181234964,0.6415396952686447,0.08019246190858059
15,충청북도,청주시상당구,문의면,관내사전투표,965,965,514,380,51,8,2,955,10,0,53.82198952879581,39.79057591623037,5.340314136125655,0.8376963350785341,0.20942408376963353
16,충청북도,청주시상당구,문의면,문의면제1투,1546,970,255,653,42,9,3,962,8,576,26.507276507276504,67.87941787941789,4.365904365904366,0.9355509355509356,0.31185031185031187
17,충청북도,청주시상당구,문의면,문의면제2투,553,371,106,249,11,2,1,369,2,182,28.72628726287263,67.47967479674797,2.9810298102981028,0.5420054200542005,0.27100271002710025
18,충청북도,청주시상당구,중앙동,관내사전투표,1752,1752,1026,515,180,16,1,1738,14,0,59.033371691599534,29.63176064441887,10.356731875719218,0.9205983889528193,0.05753739930955121
19,충청북도,청주시상당구,중앙동,중앙동제1투,2221,1448,429,867,123,18,0,1437,11,773,29.853862212943632,60.33402922755741,8.559498956158663,1.2526096033402923,0.0
20,충청북도,청주시상당구,중앙동,중앙동제2투,1585,1016,296,636,67,7,2,1008,8,569,29.365079365079367,63.095238095238095,6.646825396825397,0.6944444444444444,0.1984126984126984
21,충청북도,청주시상당구,성안동,관내사전투표,2070,2070,1190,699,151,21,0,2061,9,0,57.73896166909267,33.9155749636099,7.3265405143134394,1.0189228529839884,0.0
22,충청북도,청주시상당구,성안동,성안동제1투,2301,1398,380,881,110,15,2,1388,10,903,27.37752161383285,63.472622478386164,7.92507204610951,1.080691642651297,0.1440922190201729
23,충청북도,청주시상당구,성안동,성안동제2투,1700,1031,268,704,45,8,1,1026,5,669,26.120857699805068,68.61598440545808,4.385964912280701,0.7797270955165692,0.09746588693957114
24,충청북도,청주시상당구,탑·대성동,관내사전투표,1869,1869,1041,687,109,21,1,1859,10,0,55.99784830554061,36.955352339967725,5.86336740182894,1.1296395911780528,0.05379236148466917
25,충청북도,청주시상당구,탑·대성동,탑·대성동제1투,1858,1154,296,782,62,6,1,1147,7,704,25.806451612903224,68.17785527462948,5.405405405405405,0.5231037489102005,0.08718395815170009
26,충청북도,청주시상당구,탑·대성동,탑·대성동제2투,2414,1746,591,960,167,17,1,1736,10,668,34.04377880184332,55.29953917050692,9.619815668202765,0.9792626728110598,0.0576036866359447
27,충청북도,청주시상당구,탑·대성동,탑·대성동제3투,2118,1324,454,752,96,12,0,1314,10,794,34.55098934550989,57.22983257229832,7.30593607305936,0.91324200913242,0.0
28,충청북도,청주시상당구,영운동,관내사전투표,2461,2461,1443,829,140,30,4,2446,15,0,58.99427636958299,33.892068683565,5.723630417007359,1.2264922322158627,0.1635322976287817
29,충청북도,청주시상당구,영운동,영운동제1투,1857,1142,350,713,64,7,1,1135,7,715,30.837004405286343,62.8193832599119,5.638766519823789,0.6167400881057269,0.0881057268722467
30,충청북도,청주시상당구,영운동,영운동제2투,2355,1461,565,783,87,13,1,1449,12,894,38.99240855762595,54.037267080745345,6.004140786749482,0.8971704623878536,0.06901311249137336
31,충청북도,청주시상당구,영운동,영운동제3투,1854,1203,445,662,79,6,3,1195,8,651,37.238493723849366,55.39748953974895,6.610878661087866,0.502092050209205,0.2510460251046025
32,충청북도,청주시상당구,금천동,관내사전투표,5192,5191,3189,1609,317,44,2,5161,30,1,61.79035070722728,31.17612865723697,6.142220499903119,0.8525479558225151,0.038752179810114314
33,충청북도,청주시상당구,금천동,금천동제1투,2223,1416,463,819,110,15,1,1408,8,807,32.88352272727273,58.16761363636363,7.8125,1.065340909090909,0.07102272727272728
34,충청북도,청주시상당구,금천동,금천동제2투,3444,2070,719,1175,134,18,7,2053,17,1374,35.02191914271797,57.23331709693132,6.527033609352167,0.876765708718948,0.34096444227959083
35,충청북도,청주시상당구,금천동,금천동제3투,2839,2070,893,991,148,23,3,2058,12,769,43.391642371234205,48.15354713313897,7.191448007774539,1.1175898931000972,0.1457725947521866
36,충청북도,청주시상당구,금천동,금천동제4투,1914,1266,451,707,98,7,1,1264,2,648,35.68037974683544,55.93354430379747,7.753164556962025,0.5537974683544303,0.07911392405063292
37,충청북도,청주시상당구,금천동,금천동제5투,2944,2061,928,903,186,27,2,2046,15,883,45.35679374389051,44.13489736070381,9.090909090909092,1.3196480938416422,0.09775171065493646
38,충청북도,청주시상당구,금천동,금천동제6투,2069,1479,691,641,127,14,1,1474,5,590,46.87924016282225,43.487109905020354,8.616010854816825,0.9497964721845319,0.06784260515603799
39,충청북도,청주시상당구,금천동,금천동제7투,2057,1602,774,672,122,23,0,1591,11,455,48.64864864864865,42.23758642363293,7.668133249528599,1.4456316781898177,0.0
40,충청북도,청주시상당구,용담·명암·산성동,관내사전투표,3086,3086,2110,746,186,25,4,3071,15,0,68.70726147834581,24.291761641159233,6.056659068707262,0.81406707912732,0.1302507326603712
41,충청북도,청주시상당구,용담·명암·산성동,용담·명암·산성동제1투,1626,956,296,589,54,7,2,948,8,670,31.223628691983123,62.130801687763714,5.69620253164557,0.7383966244725738,0.21097046413502107
42,충청북도,청주시상당구,용담·명암·산성동,용담·명암·산성동제2투,1989,1477,606,714,127,20,4,1471,6,512,41.196464989802855,48.53840924541129,8.633582596872875,1.3596193065941535,0.27192386131883073
43,충청북도,청주시상당구,용담·명암·산성동,용담·명암·산성동제3투,2843,2115,1034,859,169,31,3,2096,19,728,49.33206106870229,40.98282442748092,8.062977099236642,1.4790076335877862,0.1431297709923664
44,충청북도,청주시상당구,용암제1동,관내사전투표,7140,7140,4561,1972,497,58,3,7091,49,0,64.32097024397123,27.809899873078553,7.00888450148075,0.8179382315611338,0.04230714990833451
45,충청북도,청주시상당구,용암제1동,용암제1동제1투,2401,1492,497,850,116,14,3,1480,12,909,33.58108108108108,57.432432432432435,7.837837837837839,0.945945945945946,0.20270270270270271
46,충청북도,청주시상당구,용암제1동,용암제1동제2투,1935,1245,476,658,88,17,1,1240,5,690,38.387096774193544,53.064516129032256,7.096774193548387,1.370967741935484,0.08064516129032258
47,충청북도,청주시상당구,용암제1동,용암제1동제3투,2127,1428,538,733,115,33,1,1420,8,699,37.88732394366197,51.61971830985915,8.098591549295776,2.323943661971831,0.07042253521126761
48,충청북도,청주시상당구,용암제1동,용암제1동제4투,1891,1147,478,564,86,13,0,1141,6,744,41.89307624890447,49.430324276950046,7.537248028045573,1.1393514460999123,0.0
49,충청북도,청주시상당구,용암제1동,용암제1동제5투,2472,1682,713,832,107,8,3,1663,19,790,42.8743235117258,50.030066145520145,6.4341551413108835,0.4810583283223091,0.1803968731208659
50,충청북도,청주시상당구,용암제1동,용암제1동제6투,3141,2061,947,913,154,30,3,2047,14,1080,46.262823644357596,44.601856375183196,7.523204689789936,1.4655593551538837,0.14655593551538837
51,충청북도,청주시상당구,용암제1동,용암제1동제7투,2494,1678,742,764,140,18,3,1667,11,816,44.51109778044391,45.830833833233356,8.398320335932812,1.0797840431913617,0.1799640071985603
52,충청북도,청주시상당구,용암제1동,용암제1동제8투,2713,1493,584,747,134,18,1,1484,9,1220,39.35309973045822,50.33692722371968,9.029649595687331,1.2129380053908356,0.06738544474393532
53,충청북도,청주시상당구,용암제1동,용암제1동제9투,3448,2462,1113,1108,207,21,1,2450,12,986,45.42857142857143,45.224489795918366,8.448979591836734,0.8571428571428572,0.04081632653061225
54,충청북도,청주시상당구,용암제1동,용암제1동제10투,4099,2996,1504,1155,274,42,0,2975,21,1103,50.5546218487395,38.82352941176471,9.210084033613446,1.411764705882353,0.0
55,충청북도,청주시상당구,용암제1동,용암제1동제11투,3515,2595,1346,1008,195,26,4,2579,16,920,52.19077161690577,39.0849166343544,7.561070182241179,1.0081426909654905,0.15509887553315238
56,충청북도,청주시상당구,용암제1동,용암제1동제12투,2967,2080,1028,826,198,19,1,2072,8,887,49.61389961389961,39.86486486486486,9.555984555984557,0.916988416988417,0.04826254826254826
57,충청북도,청주시상당구,용암제2동,관내사전투표,5973,5973,4044,1346,502,52,1,5945,28,0,68.02354920100925,22.640874684608914,8.444070647603027,0.8746846089150547,0.01682085786375105
58,충청북도,청주시상당구,용암제2동,용암제2동제1투,2044,1253,518,619,87,18,0,1242,11,791,41.70692431561997,49.8389694041868,7.004830917874397,1.4492753623188406,0.0
59,충청북도,청주시상당구,용암제2동,용암제2동제2투,2885,2068,869,978,185,22,1,2055,13,817,42.28710462287105,47.59124087591241,9.002433090024331,1.0705596107055961,0.04866180048661801
60,충청북도,청주시상당구,용암제2동,용암제2동제3투,2819,2176,970,1008,147,30,4,2159,17,643,44.928207503473836,46.68828161185734,6.808707735062529,1.3895321908290876,0.18527095877721167
61,충청북도,청주시상당구,용암제2동,용암제2동제4투,2737,1844,823,848,141,15,2,1829,15,893,44.99726626571897,46.36413340623292,7.709130672498634,0.8201202843083653,0.10934937124111535
62,충청북도,청주시상당구,용암제2동,용암제2동제5투,2561,2031,981,813,202,23,0,2019,12,530,48.588410104011885,40.26745913818722,10.004952947003467,1.1391778107974244,0.0
63,충청북도,청주시상당구,용암제2동,용암제2동제6투,2982,2289,1056,951,248,17,1,2273,16,693,46.458424989001315,41.8389793224813,10.910690717113948,0.7479102507699076,0.04399472063352398
64,충청북도,청주시상당구,용암제2동,용암제2동제7투,2663,1713,718,795,168,24,1,1706,7,950,42.08675263774912,46.60023446658851,9.847596717467761,1.406799531066823,0.058616647127784284
65,충청북도,청주시상당구,용암제2동,용암제2동제8투,4390,3016,1429,1202,327,32,5,2995,21,1374,47.71285475792988,40.13355592654424,10.918196994991652,1.0684474123539232,0.1669449081803005
66,충청북도,청주시상당구,용암제2동,용암제2동제9투,1712,1263,581,533,121,14,3,1252,11,449,46.405750798722046,42.57188498402556,9.664536741214057,1.1182108626198082,0.23961661341853036
67,충청북도,청주시상당구,잘못 투입·구분된 투표지,,0,1,0,1,0,0,0,1,0,-1,0.0,100.0,0.0,0.0,0.0
0,충청북도,청주시흥덕구,거소·선상투표,,309,296,135,95,56,4,0,290,6,13,46.55172413793103,32.758620689655174,19.310344827586206,1.3793103448275863,0.0
1,충청북도,청주시흥덕구,관외사전투표,,22551,22551,12735,5864,3384,269,30,22282,269,0,57.153756395296654,26.317206713939502,15.187146575711335,1.2072524907997488,0.13463782425276008
2,충청북도,청주시흥덕구,재외투표,,960,763,543,121,82,13,0,759,4,197,71.54150197628458,15.942028985507244,10.80368906455863,1.7127799736495388,0.0
3,충청북도,청주시흥덕구,오송읍,관내사전투표,6415,6415,4110,1511,666,63,6,6356,59,0,64.66331025802391,23.772813089993708,10.478288231592197,0.9911894273127754,0.09439899307740718
4,충청북도,청주시흥덕구,오송읍,오송읍제1투,2000,1198,424,698,51,9,2,1184,14,802,35.810810810810814,58.952702702702695,4.3074324324324325,0.7601351351351352,0.16891891891891891
5,충청북도,청주시흥덕구,오송읍,오송읍제2투,4125,2924,1233,1239,401,27,5,2905,19,1201,42.44406196213425,42.65060240963855,13.803786574870912,0.9294320137693631,0.17211703958691912
6,충청북도,청주시흥덕구,오송읍,오송읍제3투,2147,1389,515,721,122,17,0,1375,14,758,37.45454545454546,52.43636363636364,8.872727272727273,1.2363636363636363,0.0
7,충청북도,청주시흥덕구,오송읍,오송읍제4투,1868,1389,719,544,102,10,4,1379,10,479,52.139231327048584,39.44887599709935,7.396664249456128,0.7251631617113851,0.290065264684554
8,충청북도,청주시흥덕구,오송읍,오송읍제5투,2078,1642,837,645,134,17,2,1635,7,436,51.19266055045871,39.44954128440367,8.19571865443425,1.039755351681957,0.12232415902140673
9,충청북도,청주시흥덕구,오송읍,오송읍제6투,2502,1903,918,706,225,29,1,1879,24,599,48.85577434805748,37.57317722192656,11.974454497072912,1.5433741351782864,0.05321979776476849
10,충청북도,청주시흥덕구,오송읍,오송읍제7투,2401,1612,665,756,167,18,0,1606,6,789,41.40722291407223,47.073474470734745,10.398505603985056,1.1207970112079702,0.0
11,충청북도,청주시흥덕구,오송읍,오송읍제8투,3492,2534,1108,981,397,18,5,2509,25,958,44.16102032682343,39.09924272618573,15.823037066560383,0.7174172977281785,0.19928258270227184
12,충청북도,청주시흥덕구,오송읍,오송읍제9투,3877,2972,1384,1181,353,33,5,2956,16,905,46.820027063599454,39.952638700947226,11.941813261163734,1.1163734776725303,0.16914749661705006
13,충청북도,청주시흥덕구,강내면,관내사전투표,3636,3636,2226,981,348,40,8,3603,33,0,61.78184845961698,27.22731057452123,9.658617818484597,1.1101859561476548,0.22203719122953097
14,충청북도,청주시흥덕구,강내면,강내면제1투,2002,1268,464,660,113,19,2,1258,10,734,36.88394276629571,52.46422893481717,8.982511923688394,1.5103338632750398,0.1589825119236884
15,충청북도,청주시흥덕구,강내면,강내면제2투,1093,705,253,411,31,4,0,699,6,388,36.194563662374826,58.798283261802574,4.434907010014307,0.5722460658082975,0.0
16,충청북도,청주시흥덕구,강내면,강내면제3투,2526,1660,643,846,138,23,2,1652,8,866,38.922518159806295,51.210653753026634,8.353510895883778,1.3922518159806294,0.12106537530266344
17,충청북도,청주시흥덕구,옥산면,관내사전투표,3509,3509,2296,911,251,20,4,3482,27,0,65.9391154508903,26.163124641010917,7.208500861573808,0.5743825387708213,0.11487650775416428
18,충청북도,청주시흥덕구,옥산면,옥산면제1투,1341,801,288,461,44,6,0,799,2,540,36.0450563204005,57.69712140175219,5.506883604505632,0.7509386733416771,0.0
19,충청북도,청주시흥덕구,옥산면,옥산면제2투,2908,1740,676,937,84,19,4,1720,20,1168,39.30232558139535,54.47674418604651,4.883720930232558,1.1046511627906976,0.23255813953488372
20,충청북도,청주시흥덕구,옥산면,옥산면제3투,2077,1478,693,618,128,30,0,1469,9,599,47.17494894486045,42.069434989788974,8.713410483321987,2.042205582028591,0.0
21,충청북도,청주시흥덕구,옥산면,옥산면제4투,3617,2651,1289,1070,247,25,4,2635,16,966,48.918406072106265,40.60721062618596,9.37381404174573,0.9487666034155597,0.15180265654648956
22,충청북도,청주시흥덕구,운천·신봉동,관내사전투표,2176,2176,1401,610,128,18,1,2158,18,0,64.92122335495829,28.26691380908248,5.9314179796107505,0.8341056533827619,0.04633920296570899
23,충청북도,청주시흥덕구,운천·신봉동,운천·신봉동제1투,1680,1052,352,620,64,9,0,1045,7,628,33.68421052631579,59.33014354066985,6.124401913875598,0.8612440191387559,0.0
24,충청북도,청주시흥덕구,운천·신봉동,운천·신봉동제2투,2759,1859,755,932,140,23,1,1851,8,900,40.788762830902215,50.351161534305774,7.5634792004322,1.242571582928147,0.05402485143165856
25,충청북도,청주시흥덕구,운천·신봉동,운천·신봉동제3투,2037,1319,443,761,90,12,0,1306,13,718,33.920367534456354,58.26952526799387,6.891271056661561,0.9188361408882083,0.0
26,충청북도,청주시흥덕구,운천·신봉동,운천·신봉동제4투,2605,1848,780,922,112,17,2,1833,15,757,42.5531914893617,50.300054555373706,6.110201854882706,0.9274413529732678,0.10911074740861974
27,충청북도,청주시흥덕구,복대제1동,관내사전투표,8831,8831,5642,2087,940,94,11,8774,57,0,64.30362434465466,23.78618645999544,10.713471620697515,1.0713471620697514,0.12537041258263049
28,충청북도,청주시흥덕구,복대제1동,복대제1동제1투,2201,1273,521,588,138,16,0,1263,10,928,41.25098970704671,46.55581947743468,10.926365795724466,1.2668250197941409,0.0
29,충청북도,청주시흥덕구,복대제1동,복대제1동제2투,2075,1489,671,672,118,17,0,1478,11,586,45.39918809201624,45.46684709066306,7.983761840324763,1.1502029769959403,0.0
30,충청북도,청주시흥덕구,복대제1동,복대제1동제3투,2714,1714,709,785,186,21,0,1701,13,1000,41.681363903586124,46.149323927101705,10.934744268077601,1.2345679012345678,0.0
31,충청북도,청주시흥덕구,복대제1동,복대제1동제4투,1212,698,248,374,56,11,0,689,9,514,35.99419448476052,54.28156748911466,8.127721335268506,1.5965166908563133,0.0
32,충청북도,청주시흥덕구,복대제1동,복대제1동제5투,2630,1651,671,786,166,13,4,1640,11,979,40.91463414634146,47.92682926829268,10.121951219512196,0.7926829268292683,0.24390243902439024
33,충청북도,청주시흥덕구,복대제1동,복대제1동제6투,2688,1457,622,654,148,19,0,1443,14,1231,43.1046431046431,45.32224532224532,10.256410256410255,1.3167013167013166,0.0
34,충청북도,청주시흥덕구,복대제1동,복대제1동제7투,2440,1706,836,652,182,21,2,1693,13,734,49.379799173065564,38.51151801535735,10.750147666863556,1.2404016538688718,0.11813349084465447
35,충청북도,청주시흥덕구,복대제1동,복대제1동제8투,2536,1877,829,825,180,30,2,1866,11,659,44.42658092175777,44.21221864951769,9.646302250803858,1.607717041800643,0.10718113612004287
36,충청북도,청주시흥덕구,복대제1동,복대제1동제9투,2654,1899,900,742,211,23,3,1879,20,755,47.89781798829165,39.489089941458225,11.229377328366152,1.2240553485896752,0.15965939329430548
37,충청북도,청주시흥덕구,복대제1동,복대제1동제10투,3741,2881,1119,1412,311,23,2,2867,14,860,39.030345308685035,49.25008719916289,10.847575863271713,0.8022322985699336,0.06975933031042902
38,충청북도,청주시흥덕구,복대제1동,복대제1동제11투,3076,2485,1214,964,259,30,4,2471,14,591,49.12990692027519,39.01254552812626,10.48158640226629,1.2140833670578712,0.16187778227438285
39,충청북도,청주시흥덕구,복대제1동,복대제1동제12투,1297,948,380,408,142,9,2,941,7,349,40.38257173219979,43.35812964930925,15.090329436769395,0.9564293304994688,0.21253985122210414
40,충청북도,청주시흥덕구,복대제2동,관내사전투표,2714,2714,1575,813,272,25,3,2688,26,0,58.59375,30.245535714285715,10.119047619047619,0.9300595238095238,0.11160714285714285
41,충청북도,청주시흥덕구,복대제2동,복대제2동제1투,1894,1157,396,644,93,14,2,1149,8,737,34.46475195822455,56.04873803307223,8.093994778067886,1.2184508268059182,0.17406440382941687
42,충청북도,청주시흥덕구,복대제2동,복대제2동제2투,1595,985,332,577,60,7,2,978,7,610,33.94683026584867,58.99795501022494,6.134969325153374,0.7157464212678937,0.2044989775051125
43,충청북도,청주시흥덕구,복대제2동,복대제2동제3투,2189,1373,497,733,118,12,0,1360,13,816,36.54411764705882,53.897058823529406,8.676470588235293,0.8823529411764706,0.0
44,충청북도,청주시흥덕구,복대제2동,복대제2동제4투,2511,1566,486,838,201,24,3,1552,14,945,31.314432989690722,53.99484536082474,12.951030927835053,1.5463917525773196,0.19329896907216496
45,충청북도,청주시흥덕구,복대제2동,복대제2동제5투,1963,1181,406,616,145,9,0,1176,5,782,34.523809523809526,52.38095238095239,12.329931972789115,0.7653061224489796,0.0
46,충청북도,청주시흥덕구,가경동,관내사전투표,6492,6492,4247,1654,494,53,7,6455,37,0,65.79395817195972,25.62354763749032,7.652982184353214,0.8210689388071263,0.10844306738962044
47,충청북도,청주시흥덕구,가경동,가경동제1투,3531,2357,812,1353,159,13,2,2339,18,1174,34.71569046601112,57.84523300555793,6.797776827704147,0.5557930739632322,0.08550662676357418
48,충청북도,청주시흥덕구,가경동,가경동제2투,2626,1783,693,923,134,21,2,1773,10,843,39.08629441624365,52.05865764241398,7.557811618725324,1.1844331641285957,0.1128031584884377
49,충청북도,청주시흥덕구,가경동,가경동제3투,2843,2121,897,984,195,22,2,2100,21,722,42.714285714285715,46.85714285714286,9.285714285714286,1.0476190476190477,0.09523809523809523
50,충청북도,청주시흥덕구,가경동,가경동제4투,2744,1690,636,896,136,10,3,1681,9,1054,37.83462224866151,53.30160618679357,8.09042236763831,0.594883997620464,0.1784651992861392
51,충청북도,청주시흥덕구,가경동,가경동제5투,2753,1930,813,888,195,16,5,1917,13,823,42.41001564945227,46.322378716744915,10.172143974960877,0.8346374543557642,0.2608242044861763
52,충청북도,청주시흥덕구,가경동,가경동제6투,2313,1499,592,784,103,11,2,1492,7,814,39.67828418230563,52.54691689008043,6.90348525469169,0.7372654155495978,0.13404825737265416
53,충청북도,청주시흥덕구,가경동,가경동제7투,2936,2011,849,945,167,31,5,1997,14,925,42.513770655983976,47.32098147220831,8.362543815723585,1.5523284927391086,0.25037556334501754
54,충청북도,청주시흥덕구,가경동,가경동제8투,4201,2972,1298,1330,286,37,2,2953,19,1229,43.9552996952252,45.03894344734169,9.685066034541144,1.2529630883846934,0.06772773450728073
55,충청북도,청주시흥덕구,가경동,가경동제9투,3394,2382,977,1129,241,13,1,2361,21,1012,41.38077085980517,47.81872088098263,10.207539178314274,0.5506141465480728,0.042354934349851756
56,충청북도,청주시흥덕구,가경동,가경동제10투,3669,2928,1483,1119,278,33,1,2914,14,741,50.89224433768016,38.40082361015786,9.540150995195608,1.1324639670555936,0.03431708991077557
57,충청북도,청주시흥덕구,봉명제1동,관내사전투표,2547,2547,1531,730,245,21,2,2529,18,0,60.5377619612495,28.86516409648082,9.687623566627126,0.8303677342823249,0.07908264136022143
58,충청북도,청주시흥덕구,봉명제1동,봉명제1동제1투,2273,1165,384,636,122,8,1,1151,14,1108,33.362293657688966,55.25629887054735,10.599478714161599,0.6950477845351868,0.08688097306689835
59,충청북도,청주시흥덕구,봉명제1동,봉명제1동제2투,2414,1388,487,747,124,15,1,1374,14,1026,35.443959243085885,54.366812227074234,9.024745269286754,1.0917030567685588,0.0727802037845706
60,충청북도,청주시흥덕구,봉명제1동,봉명제1동제3투,3387,2259,916,1050,249,23,4,2242,17,1128,40.856378233719894,46.83318465655665,11.10615521855486,1.0258697591436219,0.17841213202497772
61,충청북도,청주시흥덕구,봉명제2·송정동,관내사전투표,4076,4075,2473,1133,390,40,4,4040,35,1,61.21287128712871,28.044554455445546,9.653465346534654,0.9900990099009901,0.09900990099009901
62,충청북도,청주시흥덕구,봉명제2·송정동,봉명제2·송정동제1투,2253,1312,404,783,98,14,2,1301,11,941,31.053036126056877,60.184473481936976,7.532667179093005,1.0760953112990008,0.15372790161414296
63,충청북도,청주시흥덕구,봉명제2·송정동,봉명제2·송정동제2투,2260,1280,456,695,111,13,0,1275,5,980,35.76470588235294,54.509803921568626,8.705882352941176,1.019607843137255,0.0
64,충청북도,청주시흥덕구,봉명제2·송정동,봉명제2·송정동제3투,2974,1585,597,799,163,12,3,1574,11,1389,37.92884371029225,50.76238881829733,10.355781448538755,0.7623888182973316,0.1905972045743329
65,충청북도,청주시흥덕구,봉명제2·송정동,봉명제2·송정동제4투,2152,1378,552,583,204,19,2,1360,18,774,40.588235294117645,42.86764705882353,15.0,1.397058823529412,0.14705882352941177
66,충청북도,청주시흥덕구,봉명제2·송정동,봉명제2·송정동제5투,2416,1852,814,852,144,31,1,1842,10,564,44.19109663409338,46.25407166123778,7.81758957654723,1.6829533116178068,0.05428881650380022
67,충청북도,청주시흥덕구,봉명제2·송정동,봉명제2·송정동제6투,2832,1396,545,668,153,20,0,1386,10,1436,39.321789321789325,48.1962481962482,11.03896103896104,1.443001443001443,0.0
68,충청북도,청주시흥덕구,강서제1동,관내사전투표,6083,6083,3797,1583,598,60,6,6044,39,0,62.82263401720714,26.19126406353408,9.894109861019192,0.9927200529450696,0.09927200529450694
69,충청북도,청주시흥덕구,강서제1동,강서제1동제1투,4066,2249,725,1183,289,26,3,2226,23,1817,32.5696316262354,53.144654088050316,12.98292902066487,1.1680143755615455,0.13477088948787064
70,충청북도,청주시흥덕구,강서제1동,강서제1동제2투,717,480,131,328,13,3,0,475,5,237,27.57894736842105,69.05263157894737,2.736842105263158,0.631578947368421,0.0
71,충청북도,청주시흥덕구,강서제1동,강서제1동제3투,943,629,206,384,29,2,2,623,6,314,33.06581059390048,61.63723916532905,4.654895666131622,0.32102728731942215,0.32102728731942215
72,충청북도,청주시흥덕구,강서제1동,강서제1동제4투,3067,2061,907,892,230,16,2,2047,14,1006,44.30874450415242,43.57596482657547,11.235955056179774,0.7816316560820713,0.09770395701025891
73,충청북도,청주시흥덕구,강서제1동,강서제1동제5투,3976,2914,1352,1232,275,41,1,2901,13,1062,46.604619096863146,42.46811444329541,9.479489831092728,1.4133057566356428,0.03447087211306446
74,충청북도,청주시흥덕구,강서제1동,강서제1동제6투,3923,2608,1073,1277,215,26,2,2593,15,1315,41.38064018511376,49.247975318164286,8.291554184342461,1.0026995757809487,0.07713073659853452
75,충청북도,청주시흥덕구,강서제1동,강서제1동제7투,1877,1273,587,561,103,15,0,1266,7,604,46.36650868878357,44.312796208530806,8.135860979462874,1.1848341232227488,0.0
76,충청북도,청주시흥덕구,강서제2동,관내사전투표,3566,3566,2259,769,465,25,8,3526,40,0,64.06693136698809,21.80941576857629,13.187748156551333,0.7090187180941577,0.22688598979013047
77,충청북도,청주시흥덕구,강서제2동,강서제2동제1투,2337,1487,427,841,195,13,2,1478,9,850,28.89039242219215,56.90121786197564,13.193504736129904,0.8795669824086604,0.13531799729364005
78,충청북도,청주시흥덕구,강서제2동,강서제2동제2투,2744,2002,928,794,244,18,3,1987,15,742,46.703573225968796,39.95973829894313,12.279818822345243,0.9058882737795673,0.1509813789632612
79,충청북도,청주시흥덕구,강서제2동,강서제2동제3투,2499,1886,937,690,209,28,2,1866,20,613,50.21436227224009,36.97749196141479,11.20042872454448,1.5005359056806002,0.10718113612004287
80,충청북도,청주시흥덕구,잘못 투입·구분된 투표지,,0,0,0,0,0,0,0,0,0,0,0.0,0.0,0.0,0.0,0.0
0,충청북도,충주시,거소·선상투표,,347,330,132,141,47,2,0,322,8,17,40.993788819875775,43.7888198757764,14.596273291925465,0.6211180124223602,0.0
1,충청북도,충주시,관외사전투표,,11166,11166,5876,3362,1684,113,13,11048,118,0,53.18609703113686,30.430847212165098,15.242577842143373,1.0228095582910934,0.11766835626357713
2,충청북도,충주시,재외투표,,644,532,383,101,42,4,0,530,2,112,72.26415094339622,19.056603773584907,7.9245283018867925,0.7547169811320755,0.0
3,충청북도,충주시,주덕읍,관내사전투표,1903,1903,1098,656,123,11,2,1890,13,0,58.0952380952381,34.70899470899471,6.507936507936509,0.582010582010582,0.10582010582010583
4,충청북도,충주시,주덕읍,주덕읍제1투,867,540,169,316,46,4,0,535,5,327,31.588785046728972,59.06542056074766,8.598130841121495,0.7476635514018692,0.0
5,충청북도,충주시,주덕읍,주덕읍제2투,2457,1272,461,675,115,9,2,1262,10,1185,36.52931854199683,53.486529318542,9.112519809825674,0.7131537242472267,0.15847860538827258
6,충청북도,충주시,주덕읍,주덕읍제3투,971,598,168,396,21,6,1,592,6,373,28.37837837837838,66.8918918918919,3.5472972972972974,1.0135135135135136,0.16891891891891891
7,충청북도,충주시,살미면,관내사전투표,732,732,411,272,37,9,1,730,2,0,56.3013698630137,37.26027397260274,5.068493150684931,1.2328767123287672,0.136986301369863
8,충청북도,충주시,살미면,살미면투표소,1118,761,175,554,24,3,0,756,5,357,23.14814814814815,73.28042328042328,3.1746031746031744,0.3968253968253968,0.0
9,충청북도,충주시,수안보면,관내사전투표,886,886,454,379,48,3,0,884,2,0,51.35746606334841,42.873303167420815,5.429864253393665,0.3393665158371041,0.0
10,충청북도,충주시,수안보면,수안보면제1투,1179,739,149,556,24,6,0,735,4,440,20.272108843537413,75.64625850340137,3.2653061224489797,0.8163265306122449,0.0
11,충청북도,충주시,수안보면,수안보면제2투,438,317,99,197,15,4,1,316,1,121,31.329113924050635,62.34177215189873,4.746835443037975,1.2658227848101267,0.31645569620253167
12,충청북도,충주시,대소원면,관내사전투표,3182,3182,1904,862,367,21,3,3157,25,0,60.310421286031044,27.30440291415901,11.62496040544821,0.6651884700665188,0.09502692429521697
13,충청북도,충주시,대소원면,대소원면제1투,3523,1973,743,1015,180,21,3,1962,11,1550,37.869520897043834,51.73292558613659,9.174311926605505,1.0703363914373087,0.1529051987767584
14,충청북도,충주시,대소원면,대소원면제2투,1675,1029,222,661,128,9,0,1020,9,646,21.764705882352942,64.80392156862746,12.549019607843137,0.8823529411764706,0.0
15,충청북도,충주시,대소원면,대소원면제3투,406,265,65,185,6,2,2,260,5,141,25.0,71.15384615384616,2.307692307692308,0.7692307692307693,0.7692307692307693
16,충청북도,충주시,신니면,관내사전투표,905,905,463,370,59,7,2,901,4,0,51.38734739178691,41.06548279689235,6.548279689234185,0.776914539400666,0.22197558268590456
17,충청북도,충주시,신니면,신니면제1투,904,573,146,380,39,3,1,569,4,331,25.65905096660808,66.78383128295255,6.854130052724078,0.5272407732864675,0.17574692442882248
18,충청북도,충주시,신니면,신니면제2투,767,531,162,333,28,3,1,527,4,236,30.740037950664135,63.18785578747628,5.313092979127135,0.5692599620493358,0.18975332068311196
19,충청북도,충주시,노은면,관내사전투표,887,887,454,376,50,5,1,886,1,0,51.24153498871332,42.43792325056434,5.643340857787811,0.5643340857787811,0.1128668171557562
20,충청북도,충주시,노은면,노은면투표소,1211,749,188,519,33,1,2,743,6,462,25.3028263795424,69.85195154777928,4.441453566621804,0.13458950201884254,0.2691790040376851
21,충청북도,충주시,앙성면,관내사전투표,1116,1116,555,497,54,6,0,1112,4,0,49.910071942446045,44.694244604316545,4.856115107913669,0.539568345323741,0.0
22,충청북도,충주시,앙성면,앙성면제1투,499,310,78,220,7,0,0,305,5,189,25.573770491803277,72.1311475409836,2.2950819672131146,0.0,0.0
23,충청북도,충주시,앙성면,앙성면제2투,1322,830,203,586,35,3,0,827,3,492,24.546553808948005,70.85852478839178,4.2321644498186215,0.36275695284159615,0.0
24,충청북도,충주시,앙성면,앙성면제3투,473,265,76,180,6,1,0,263,2,208,28.89733840304182,68.44106463878326,2.2813688212927756,0.38022813688212925,0.0
25,충청북도,충주시,중앙탑면,관내사전투표,2206,2206,1398,596,183,16,1,2194,12,0,63.719234275296266,27.164995442114858,8.340929808568823,0.7292616226071102,0.04557885141294439
26,충청북도,충주시,중앙탑면,중앙탑면제1투,569,403,114,262,20,4,1,401,2,166,28.428927680798004,65.33665835411472,4.987531172069826,0.997506234413965,0.24937655860349126
27,충청북도,충주시,중앙탑면,중앙탑면제2투,958,618,175,417,19,2,0,613,5,340,28.548123980424144,68.02610114192495,3.0995106035889073,0.3262642740619902,0.0
28,충청북도,충주시,중앙탑면,중앙탑면제3투,3462,2294,1076,932,251,23,0,2282,12,1168,47.15162138475022,40.84136722173532,10.999123575810692,1.0078878177037687,0.0
29,충청북도,충주시,중앙탑면,중앙탑면제4투,2782,1855,893,776,157,17,1,1844,11,927,48.42733188720174,42.0824295010846,8.51409978308026,0.9219088937093275,0.05422993492407809
30,충청북도,충주시,금가면,관내사전투표,959,959,556,277,102,12,1,948,11,0,58.64978902953587,29.219409282700422,10.759493670886076,1.2658227848101267,0.10548523206751054
31,충청북도,충주시,금가면,금가면제1투,844,563,179,345,26,5,1,556,7,281,32.194244604316545,62.05035971223022,4.676258992805756,0.8992805755395683,0.1798561151079137
32,충청북도,충주시,금가면,금가면제2투,1347,883,268,479,125,8,2,882,1,464,30.385487528344672,54.30839002267574,14.17233560090703,0.9070294784580499,0.22675736961451248
33,충청북도,충주시,동량면,관내사전투표,1156,1156,600,460,82,6,2,1150,6,0,52.17391304347826,40.0,7.130434782608695,0.5217391304347827,0.17391304347826086
34,충청북도,충주시,동량면,동량면제1투,896,604,152,431,16,3,0,602,2,292,25.249169435215947,71.59468438538205,2.6578073089700998,0.4983388704318937,0.0
35,충청북도,충주시,동량면,동량면제2투,1125,706,183,491,23,4,2,703,3,419,26.03129445234708,69.84352773826458,3.2716927453769555,0.5689900426742532,0.2844950213371266
36,충청북도,충주시,산척면,관내사전투표,964,964,536,357,55,9,0,957,7,0,56.00835945663532,37.30407523510972,5.747126436781609,0.9404388714733543,0.0
37,충청북도,충주시,산척면,산척면투표소,1289,820,172,615,26,1,1,815,5,469,21.104294478527606,75.4601226993865,3.190184049079755,0.1226993865030675,0.1226993865030675
38,충청북도,충주시,엄정면,관내사전투표,1103,1103,525,510,52,8,2,1097,6,0,47.85779398359161,46.49042844120328,4.740200546946217,0.7292616226071102,0.18231540565177756
39,충청북도,충주시,엄정면,엄정면투표소,1721,1084,266,761,43,5,2,1077,7,637,24.698235840297123,70.65923862581243,3.9925719591457756,0.4642525533890436,0.18570102135561745
40,충청북도,충주시,소태면,관내사전투표,348,348,162,171,11,3,0,347,1,0,46.68587896253602,49.279538904899134,3.170028818443804,0.8645533141210375,0.0
41,충청북도,충주시,소태면,소태면제1투,594,413,121,272,14,4,0,411,2,181,29.44038929440389,66.18004866180048,3.40632603406326,0.9732360097323601,0.0
42,충청북도,충주시,소태면,소태면제2투,498,323,70,244,7,0,0,321,2,175,21.806853582554517,76.01246105919003,2.1806853582554515,0.0,0.0
43,충청북도,충주시,성내·충인동,관내사전투표,1413,1413,630,714,55,5,2,1406,7,0,44.807965860597434,50.782361308677096,3.911806543385491,0.35561877667140823,0.1422475106685633
44,충청북도,충주시,성내·충인동,성내·충인동제1투,399,244,52,178,11,2,0,243,1,155,21.39917695473251,73.25102880658436,4.526748971193416,0.823045267489712,0.0
45,충청북도,충주시,성내·충인동,성내·충인동제2투,1120,659,199,427,24,5,2,657,2,461,30.28919330289193,64.9923896499239,3.65296803652968,0.76103500761035,0.30441400304414
46,충청북도,충주시,교현·안림동,관내사전투표,5063,5063,3204,1469,319,44,4,5040,23,0,63.57142857142857,29.1468253968254,6.329365079365079,0.873015873015873,0.07936507936507936
47,충청북도,충주시,교현·안림동,교현·안림동제1투,1169,762,263,435,48,11,1,758,4,407,34.696569920844325,57.38786279683378,6.33245382585752,1.4511873350923483,0.13192612137203166
48,충청북도,충주시,교현·안림동,교현·안림동제2투,1468,920,296,550,60,5,3,914,6,548,32.38512035010941,60.17505470459519,6.564551422319474,0.5470459518599562,0.3282275711159737
49,충청북도,충주시,교현·안림동,교현·안림동제3투,1893,1287,501,673,92,13,1,1280,7,606,39.140625,52.578125,7.187499999999999,1.015625,0.078125
50,충청북도,충주시,교현·안림동,교현·안림동제4투,1601,988,344,590,44,0,0,978,10,613,35.173824130879346,60.32719836400818,4.4989775051124745,0.0,0.0
51,충청북도,충주시,교현·안림동,교현·안림동제5투,1909,1225,455,690,58,13,1,1217,8,684,37.387017255546425,56.69679539852095,4.7658175842235,1.0682004930156122,0.08216926869350863
52,충청북도,충주시,교현·안림동,교현·안림동제6투,2196,1371,409,875,73,7,3,1367,4,825,29.91953182150695,64.0087783467447,5.340160936356987,0.5120702267739575,0.21945866861741037
53,충청북도,충주시,교현·안림동,교현·안림동제7투,2175,1612,823,634,136,13,0,1606,6,563,51.24533001245331,39.47696139476962,8.468244084682441,0.809464508094645,0.0
54,충청북도,충주시,교현2동,관내사전투표,1758,1758,1043,538,147,16,1,1745,13,0,59.77077363896848,30.830945558739252,8.42406876790831,0.9169054441260744,0.05730659025787965
55,충청북도,충주시,교현2동,교현2동제1투,899,560,178,346,30,0,0,554,6,339,32.12996389891697,62.454873646209386,5.415162454873646,0.0,0.0
56,충청북도,충주시,교현2동,교현2동제2투,1279,756,234,458,50,7,2,751,5,523,31.158455392809586,60.98535286284953,6.657789613848203,0.9320905459387484,0.2663115845539281
57,충청북도,충주시,교현2동,교현2동제3투,1694,1136,351,711,55,8,2,1127,9,558,31.144631765749782,63.08784383318545,4.880212954747116,0.709849157054126,0.1774622892635315
58,충청북도,충주시,용산동,관내사전투표,3319,3319,2059,984,244,15,1,3303,16,0,62.33726914925825,29.791099000908268,7.387223735997578,0.4541326067211626,0.030275507114744173
59,충청북도,충주시,용산동,용산동제1투,1399,838,282,482,57,11,0,832,6,561,33.894230769230774,57.932692307692314,6.850961538461539,1.3221153846153846,0.0
60,충청북도,충주시,용산동,용산동제2투,1594,986,424,454,97,7,0,982,4,608,43.17718940936864,46.23217922606925,9.877800407331975,0.7128309572301426,0.0
61,충청북도,충주시,용산동,용산동제3투,1445,887,322,502,45,8,3,880,7,558,36.59090909090909,57.04545454545455,5.113636363636364,0.9090909090909091,0.3409090909090909
62,충청북도,충주시,용산동,용산동제4투,2817,1915,824,921,136,20,2,1903,12,902,43.30005254860746,48.39726747241198,7.146610614818708,1.0509721492380453,0.10509721492380451
63,충청북도,충주시,지현동,관내사전투표,1371,1371,759,505,88,13,1,1366,5,0,55.56368960468521,36.9692532942899,6.44216691068814,0.951683748169839,0.07320644216691069
64,충청북도,충주시,지현동,지현동제1투,1080,663,230,372,46,9,1,658,5,417,34.954407294832826,56.53495440729483,6.990881458966565,1.3677811550151975,0.1519756838905775
65,충청북도,충주시,지현동,지현동제2투,1657,1051,345,626,60,13,0,1044,7,606,33.04597701149425,59.961685823754785,5.747126436781609,1.2452107279693485,0.0
66,충청북도,충주시,문화동,관내사전투표,2558,2558,1309,1011,189,33,1,2543,15,0,51.47463625639009,39.75619347227684,7.432166732206055,1.2976799056232795,0.039323633503735744
67,충청북도,충주시,문화동,문화동제1투,1305,759,200,511,33,5,0,749,10,546,26.702269692923895,68.22429906542055,4.405874499332444,0.6675567423230975,0.0
68,충청북도,충주시,문화동,문화동제2투,1490,1137,333,730,58,10,1,1132,5,353,29.41696113074205,64.48763250883393,5.123674911660777,0.88339222614841,0.08833922261484099
69,충청북도,충주시,문화동,문화동제3투,1333,914,250,600,53,5,3,911,3,419,27.442371020856204,65.8616904500549,5.817782656421515,0.5488474204171241,0.3293084522502744
70,충청북도,충주시,문화동,문화동제4투,1438,919,285,565,52,7,0,909,10,519,31.353135313531354,62.15621562156216,5.720572057205721,0.77007700770077,0.0
71,충청북도,충주시,호암·직동,관내사전투표,4671,4671,3096,1026,460,52,3,4637,34,0,66.76730644813456,22.12637481130041,9.92020703040759,1.121414707785206,0.06469700237222342
72,충청북도,충주시,호암·직동,호암·직동제1투,2693,1758,734,849,145,16,1,1745,13,935,42.06303724928367,48.653295128939824,8.30945558739255,0.9169054441260744,0.05730659025787965
73,충청북도,충주시,호암·직동,호암·직동제2투,2612,1629,624,813,164,11,2,1614,15,983,38.66171003717472,50.371747211895915,10.161090458488228,0.6815365551425031,0.12391573729863693
74,충청북도,충주시,호암·직동,호암·직동제3투,2883,1952,864,881,172,22,2,1941,11,931,44.513137557959816,45.38897475528078,8.86141164348274,1.1334363730036066,0.10303967027305513
75,충청북도,충주시,호암·직동,호암·직동제4투,2352,1663,679,786,157,20,1,1643,20,689,41.32684114424833,47.83931832014608,9.555690809494827,1.2172854534388313,0.06086427267194157
76,충청북도,충주시,달천동,관내사전투표,1529,1529,826,525,146,15,0,1512,17,0,54.629629629629626,34.72222222222222,9.656084656084655,0.992063492063492,0.0
77,충청북도,충주시,달천동,달천동제1투,1745,1021,292,632,76,9,0,1009,12,724,28.93954410307235,62.636273538156594,7.5322101090188305,0.8919722497522299,0.0
78,충청북도,충주시,달천동,달천동제2투,691,418,145,248,23,2,0,418,0,273,34.688995215311,59.33014354066985,5.502392344497608,0.4784688995215311,0.0
79,충청북도,충주시,봉방동,관내사전투표,3042,3042,1766,1008,209,21,4,3008,34,0,58.71010638297872,33.51063829787234,6.94813829787234,0.6981382978723404,0.13297872340425532
80,충청북도,충주시,봉방동,봉방동제1투,1103,686,203,444,33,4,0,684,2,417,29.678362573099413,64.91228070175438,4.824561403508771,0.5847953216374269,0.0
81,충청북도,충주시,봉방동,봉방동제2투,1957,1267,458,700,87,10,0,1255,12,690,36.49402390438247,55.77689243027888,6.932270916334661,0.796812749003984,0.0
82,충청북도,충주시,봉방동,봉방동제3투,2154,1343,393,835,96,6,1,1331,12,811,29.526671675432002,62.73478587528174,7.212622088655146,0.4507888805409466,0.07513148009015778
83,충청북도,충주시,칠금·금릉동,관내사전투표,3723,3723,2402,959,303,30,4,3698,25,0,64.95402920497565,25.93293672255273,8.193618171984857,0.8112493239588967,0.1081665765278529
84,충청북도,충주시,칠금·금릉동,칠금·금릉동제1투,719,478,144,304,24,3,1,476,2,241,30.252100840336134,63.86554621848739,5.042016806722689,0.6302521008403361,0.21008403361344538
85,충청북도,충주시,칠금·금릉동,칠금·금릉동제2투,1306,850,290,501,50,3,1,845,5,456,34.319526627218934,59.289940828402365,5.9171597633136095,0.35502958579881655,0.1183431952662722
86,충청북도,충주시,칠금·금릉동,칠금·금릉동제3투,1715,1095,408,597,67,10,1,1083,12,620,37.67313019390582,55.124653739612185,6.1865189289012,0.9233610341643583,0.09233610341643582
87,충청북도,충주시,칠금·금릉동,칠금·금릉동제4투,1875,1277,517,635,106,10,0,1268,9,598,40.77287066246057,50.078864353312305,8.3596214511041,0.7886435331230284,0.0
88,충청북도,충주시,칠금·금릉동,칠금·금릉동제5투,2404,1773,736,885,120,20,1,1762,11,631,41.77071509648127,50.227014755959146,6.81044267877412,1.1350737797956867,0.056753688989784334
89,충청북도,충주시,연수동,관내사전투표,5772,5772,3511,1801,366,49,5,5732,40,0,61.252616887648294,31.42009769713887,6.385205861828331,0.8548499651081646,0.08722958827634333
90,충청북도,충주시,연수동,연수동제1투,1852,1144,341,725,65,4,0,1135,9,708,30.04405286343612,63.87665198237885,5.726872246696035,0.3524229074889868,0.0
91,충청북도,충주시,연수동,연수동제2투,2536,1683,686,821,147,15,3,1672,11,853,41.02870813397129,49.10287081339713,8.791866028708133,0.8971291866028708,0.17942583732057416
92,충청북도,충주시,연수동,연수동제3투,2304,1711,663,871,151,17,1,1703,8,593,38.93129770992366,51.14503816793893,8.866705813270698,0.9982384028185555,0.05871990604815032
93,충청북도,충주시,연수동,연수동제4투,1565,1115,423,605,64,10,1,1103,12,450,38.34995466908431,54.85040797824116,5.802357207615594,0.9066183136899365,0.09066183136899365
94,충청북도,충주시,연수동,연수동제5투,1559,1005,382,528,78,10,1,999,6,554,38.23823823823824,52.85285285285285,7.807807807807808,1.001001001001001,0.10010010010010009
95,충청북도,충주시,연수동,연수동제6투,1199,596,170,378,31,3,0,582,14,603,29.20962199312715,64.94845360824742,5.326460481099656,0.5154639175257731,0.0
96,충청북도,충주시,연수동,연수동제7투,1716,1211,524,574,89,11,0,1198,13,505,43.73956594323873,47.91318864774624,7.429048414023372,0.9181969949916527,0.0
97,충청북도,충주시,연수동,연수동제8투,1757,1132,418,602,101,8,1,1130,2,625,36.991150442477874,53.27433628318584,8.938053097345133,0.7079646017699115,0.08849557522123894
98,충청북도,충주시,연수동,연수동제9투,2338,1455,558,760,104,15,7,1444,11,883,38.64265927977839,52.63157894736842,7.202216066481995,1.0387811634349031,0.48476454293628807
99,충청북도,충주시,연수동,연수동제10투,1585,1178,446,617,87,16,2,1168,10,407,38.18493150684932,52.82534246575342,7.448630136986302,1.36986301369863,0.17123287671232876
100,충청북도,충주시,연수동,연수동제11투,1881,1258,483,675,83,11,0,1252,6,623,38.57827476038339,53.91373801916933,6.6293929712460065,0.8785942492012779,0.0
101,충청북도,충주시,목행·용탄동,관내사전투표,1837,1837,1193,456,164,13,1,1827,10,0,65.29830322933772,24.958949096880133,8.976464148877943,0.7115489874110563,0.05473453749315819
102,충청북도,충주시,목행·용탄동,목행·용탄동제1투,1706,1144,506,536,84,12,3,1141,3,562,44.34706397896582,46.97633654688869,7.361963190184049,1.0517090271691498,0.26292725679228746
103,충청북도,충주시,목행·용탄동,목행·용탄동제2투,1643,1073,363,627,67,9,4,1070,3,570,33.925233644859816,58.598130841121495,6.261682242990655,0.8411214953271028,0.3738317757009346
104,충청북도,충주시,잘못 투입·구분된 투표지,,0,0,0,0,0,0,0,0,0,0,0.0,0.0,0.0,0.0,0.0
0,충청북도,제천시,거소·선상투표,,206,193,55,95,36,1,1,188,5,13,29.25531914893617,50.53191489361703,19.148936170212767,0.5319148936170213,0.5319148936170213
1,충청북도,제천시,관외사전투표,,7490,7490,3841,2359,1089,104,10,7403,87,0,51.88437120086451,31.865459948669457,14.710252600297178,1.4048358773470215,0.135080372821829
2,충청북도,제천시,재외투표,,355,289,185,56,36,10,0,287,2,66,64.45993031358886,19.51219512195122,12.543554006968641,3.484320557491289,0.0
3,충청북도,제천시,봉양읍,관내사전투표,1888,1888,1022,724,97,18,3,1864,24,0,54.82832618025751,38.8412017167382,5.203862660944206,0.9656652360515022,0.1609442060085837
4,충청북도,제천시,봉양읍,봉양읍제1투,2038,1256,311,882,51,4,1,1249,7,782,24.89991993594876,70.61649319455564,4.083266613290633,0.32025620496397117,0.08006405124099279
5,충청북도,제천시,봉양읍,봉양읍제2투,1132,799,288,446,50,11,1,796,3,333,36.18090452261307,56.03015075376885,6.281407035175879,1.3819095477386936,0.12562814070351758
6,충청북도,제천시,봉양읍,봉양읍제3투,563,405,103,282,14,1,0,400,5,158,25.75,70.5,3.5000000000000004,0.25,0.0
7,충청북도,제천시,금성면,관내사전투표,605,605,329,238,32,1,0,600,5,0,54.833333333333336,39.666666666666664,5.333333333333334,0.16666666666666669,0.0
8,충청북도,제천시,금성면,금성면제1투,489,329,82,239,6,2,0,329,0,160,24.924012158054712,72.64437689969606,1.82370820668693,0.60790273556231,0.0
9,충청북도,제천시,금성면,금성면제2투,614,412,114,274,13,2,2,405,7,202,28.14814814814815,67.65432098765433,3.2098765432098766,0.49382716049382713,0.49382716049382713
10,충청북도,제천시,청풍면,관내사전투표,382,382,199,150,27,1,1,378,4,0,52.64550264550265,39.682539682539684,7.142857142857142,0.26455026455026454,0.26455026455026454
11,충청북도,제천시,청풍면,청풍면제1투,594,416,82,320,8,3,1,414,2,178,19.806763285024154,77.29468599033817,1.932367149758454,0.7246376811594203,0.24154589371980675
12,충청북도,제천시,청풍면,청풍면제2투,145,118,24,89,3,1,0,117,1,27,20.51282051282051,76.06837606837607,2.564102564102564,0.8547008547008548,0.0
13,충청북도,제천시,수산면,관내사전투표,549,549,272,243,26,4,0,545,4,0,49.908256880733944,44.587155963302756,4.770642201834862,0.7339449541284404,0.0
14,충청북도,제천시,수산면,수산면제1투,938,633,158,447,18,5,1,629,4,305,25.119236883942765,71.06518282988871,2.8616852146263914,0.7949125596184419,0.1589825119236884
15,충청북도,제천시,수산면,수산면제2투,239,165,59,102,2,1,0,164,1,74,35.97560975609756,62.19512195121951,1.2195121951219512,0.6097560975609756,0.0
16,충청북도,제천시,덕산면,관내사전투표,740,740,394,313,26,4,0,737,3,0,53.45997286295794,42.469470827679785,3.5278154681139755,0.5427408412483039,0.0
17,충청북도,제천시,덕산면,덕산면제1투,801,501,143,330,16,5,0,494,7,300,28.947368421052634,66.80161943319838,3.2388663967611335,1.0121457489878543,0.0
18,충청북도,제천시,덕산면,덕산면제2투,266,182,44,128,2,1,1,176,6,84,25.0,72.72727272727273,1.1363636363636365,0.5681818181818182,0.5681818181818182
19,충청북도,제천시,한수면,관내사전투표,155,155,86,65,3,1,0,155,0,0,55.483870967741936,41.935483870967744,1.935483870967742,0.6451612903225806,0.0
20,충청북도,제천시,한수면,한수면투표소,372,242,67,162,7,2,1,239,3,130,28.03347280334728,67.78242677824268,2.928870292887029,0.8368200836820083,0.41841004184100417
21,충청북도,제천시,백운면,관내사전투표,1009,1009,511,428,52,12,1,1004,5,0,50.896414342629484,42.62948207171315,5.179282868525896,1.1952191235059761,0.099601593625498
22,충청북도,제천시,백운면,백운면제1투,1206,790,242,508,24,8,1,783,7,416,30.906768837803323,64.8786717752235,3.065134099616858,1.0217113665389528,0.1277139208173691
23,충청북도,제천시,백운면,백운면제2투,693,487,111,350,20,2,0,483,4,206,22.981366459627328,72.46376811594203,4.140786749482402,0.4140786749482402,0.0
24,충청북도,제천시,송학면,관내사전투표,1376,1376,760,536,69,5,1,1371,5,0,55.43398978847557,39.095550692924874,5.032822757111598,0.36469730123997085,0.07293946024799416
25,충청북도,제천시,송학면,송학면제1투,1651,1050,233,757,47,6,1,1044,6,601,22.31800766283525,72.5095785440613,4.501915708812261,0.5747126436781609,0.09578544061302681
26,충청북도,제천시,송학면,송학면제2투,823,559,144,389,23,1,0,557,2,264,25.852782764811487,69.83842010771993,4.129263913824058,0.17953321364452424,0.0
27,충청북도,제천시,송학면,송학면제3투,317,225,63,145,12,1,0,221,4,92,28.50678733031674,65.61085972850678,5.429864253393665,0.4524886877828055,0.0
28,충청북도,제천시,교동,관내사전투표,3965,3965,2565,1129,219,32,5,3950,15,0,64.9367088607595,28.582278481012658,5.544303797468355,0.8101265822784811,0.12658227848101267
29,충청북도,제천시,교동,교동제1투,1331,862,254,565,31,8,1,859,3,469,29.56926658905704,65.77415599534342,3.608847497089639,0.9313154831199069,0.11641443538998836
30,충청북도,제천시,교동,교동제2투,2830,1746,652,947,120,12,3,1734,12,1084,37.60092272202999,54.613610149942325,6.920415224913495,0.6920415224913495,0.17301038062283738
31,충청북도,제천시,교동,교동제3투,3363,2296,951,1141,163,22,3,2280,16,1067,41.71052631578947,50.0438596491228,7.149122807017544,0.9649122807017544,0.13157894736842105
32,충청북도,제천시,교동,교동제4투,2108,1361,467,791,81,13,1,1353,8,747,34.51589061345159,58.462675535846266,5.986696230598669,0.9608277900960829,0.07390983000739099
33,충청북도,제천시,의림지동,관내사전투표,3670,3670,2288,1046,274,36,5,3649,21,0,62.70211016716909,28.665387777473278,7.508906549739655,0.9865716634694436,0.13702384214853383
34,충청북도,제천시,의림지동,의림지동제1투,2305,1527,561,853,91,9,4,1518,9,778,36.95652173913043,56.192358366271414,5.994729907773387,0.592885375494071,0.2635046113306983
35,충청북도,제천시,의림지동,의림지동제2투,826,540,170,313,47,7,0,537,3,286,31.65735567970205,58.28677839851024,8.752327746741155,1.303538175046555,0.0
36,충청북도,제천시,의림지동,의림지동제3투,1916,1217,361,752,90,5,3,1211,6,699,29.81007431874484,62.097440132122216,7.431874483897605,0.41288191577208916,0.2477291494632535
37,충청북도,제천시,중앙동,관내사전투표,2225,2225,1146,868,168,19,4,2205,20,0,51.97278911564626,39.36507936507937,7.6190476190476195,0.8616780045351473,0.18140589569160998
38,충청북도,제천시,중앙동,중앙동제1투,2009,1305,384,849,56,9,0,1298,7,704,29.583975346687215,65.40832049306626,4.314329738058552,0.6933744221879815,0.0
39,충청북도,제천시,중앙동,중앙동제2투,1108,672,171,464,31,2,0,668,4,436,25.59880239520958,69.46107784431138,4.640718562874251,0.29940119760479045,0.0
40,충청북도,제천시,남현동,관내사전투표,1481,1481,684,704,76,8,1,1473,8,0,46.435845213849284,47.79361846571623,5.159538357094365,0.5431093007467752,0.0678886625933469
41,충청북도,제천시,남현동,남현동제1투,959,586,148,407,25,3,0,583,3,373,25.38593481989708,69.81132075471697,4.288164665523156,0.5145797598627788,0.0
42,충청북도,제천시,남현동,남현동제2투,1617,986,267,653,49,5,0,974,12,631,27.41273100616016,67.04312114989733,5.030800821355236,0.5133470225872689,0.0
43,충청북도,제천시,영서동,관내사전투표,2776,2776,1629,926,182,22,0,2759,17,0,59.043131569409205,33.56288510329829,6.596592968466836,0.7973903588256614,0.0
44,충청북도,제천시,영서동,영서동제1투,1032,649,157,451,31,4,2,645,4,383,24.34108527131783,69.92248062015504,4.8062015503875966,0.6201550387596899,0.31007751937984496
45,충청북도,제천시,영서동,영서동제2투,2365,1423,460,856,85,9,1,1411,12,942,32.60099220411056,60.66619418851879,6.024096385542169,0.6378454996456413,0.07087172218284904
46,충청북도,제천시,영서동,영서동제3투,1885,1274,527,665,60,10,2,1264,10,611,41.69303797468354,52.61075949367089,4.746835443037975,0.7911392405063291,0.15822784810126583
47,충청북도,제천시,용두동,관내사전투표,4455,4455,2682,1405,303,28,7,4425,30,0,60.610169491525426,31.751412429378533,6.8474576271186445,0.6327683615819208,0.1581920903954802
48,충청북도,제천시,용두동,용두동제1투,1676,1067,363,611,75,11,0,1060,7,609,34.24528301886792,57.64150943396227,7.0754716981132075,1.0377358490566038,0.0
49,충청북도,제천시,용두동,용두동제2투,2969,1781,596,964,183,21,2,1766,15,1188,33.74858437146093,54.586636466591166,10.362400906002266,1.189127972819932,0.11325028312570783
50,충청북도,제천시,용두동,용두동제3투,1809,1017,311,624,61,5,3,1004,13,792,30.976095617529882,62.15139442231076,6.075697211155378,0.49800796812749004,0.29880478087649404
51,충청북도,제천시,용두동,용두동제4투,2174,1531,615,791,111,7,1,1525,6,643,40.32786885245901,51.86885245901639,7.278688524590164,0.45901639344262296,0.06557377049180328
52,충청북도,제천시,용두동,용두동제5투,1597,1069,440,497,107,18,1,1063,6,528,41.39228598306679,46.75446848541863,10.06585136406397,1.6933207902163687,0.09407337723424271
53,충청북도,제천시,신백동,관내사전투표,2936,2936,1784,888,172,30,4,2878,58,0,61.98749131341209,30.85476025017373,5.9763724808895065,1.0423905489923557,0.13898540653231412
54,충청북도,제천시,신백동,신백동제1투,1570,1024,426,506,71,14,1,1018,6,546,41.846758349705304,49.70530451866404,6.974459724950884,1.37524557956778,0.09823182711198428
55,충청북도,제천시,신백동,신백동제2투,1206,679,225,413,33,5,0,676,3,527,33.28402366863905,61.094674556213015,4.881656804733728,0.7396449704142012,0.0
56,충청북도,제천시,신백동,신백동제3투,1504,1009,388,525,69,13,1,996,13,495,38.95582329317269,52.71084337349398,6.927710843373494,1.3052208835341366,0.1004016064257028
57,충청북도,제천시,신백동,신백동제4투,988,668,215,410,35,4,1,665,3,320,32.33082706766917,61.65413533834586,5.263157894736842,0.6015037593984963,0.15037593984962408
58,충청북도,제천시,신백동,신백동제5투,593,366,87,248,21,3,1,360,6,227,24.166666666666668,68.88888888888889,5.833333333333333,0.8333333333333334,0.2777777777777778
59,충청북도,제천시,청전동,관내사전투표,3958,3958,2110,1529,265,22,2,3928,30,0,53.716904276985744,38.925661914460285,6.746435845213849,0.560081466395112,0.05091649694501018
60,충청북도,제천시,청전동,청전동제1투,1586,1027,283,668,58,8,1,1018,9,559,27.79960707269155,65.6188605108055,5.697445972495088,0.7858546168958742,0.09823182711198428
61,충청북도,제천시,청전동,청전동제2투,1440,959,297,582,66,8,1,954,5,481,31.132075471698112,61.0062893081761,6.918238993710692,0.8385744234800839,0.10482180293501049
62,충청북도,제천시,청전동,청전동제3투,1047,650,190,424,32,2,1,649,1,397,29.275808936825886,65.33127889060091,4.930662557781202,0.30816640986132515,0.15408320493066258
63,충청북도,제천시,청전동,청전동제4투,1672,948,264,626,45,4,2,941,7,724,28.055260361317746,66.52497343251859,4.782146652497343,0.4250797024442083,0.21253985122210414
64,충청북도,제천시,청전동,청전동제5투,1639,1178,334,769,63,8,2,1176,2,461,28.401360544217685,65.39115646258503,5.357142857142857,0.6802721088435374,0.17006802721088435
65,충청북도,제천시,청전동,청전동제6투,1139,701,186,460,46,6,0,698,3,438,26.64756446991404,65.90257879656161,6.59025787965616,0.8595988538681949,0.0
66,충청북도,제천시,화산동,관내사전투표,2777,2777,1641,928,162,16,6,2753,24,0,59.60770069015619,33.7086814384308,5.884489647657102,0.5811841627315656,0.2179440610243371
67,충청북도,제천시,화산동,화산동제1투,2007,1252,385,767,77,13,0,1242,10,755,30.998389694041865,61.75523349436393,6.199677938808374,1.0466988727858293,0.0
68,충청북도,제천시,화산동,화산동제2투,1998,1368,514,762,77,5,1,1359,9,630,37.821927888153056,56.07064017660044,5.665930831493745,0.36791758646063283,0.07358351729212656
69,충청북도,제천시,화산동,화산동제3투,1209,763,186,525,39,5,1,756,7,446,24.6031746031746,69.44444444444444,5.158730158730158,0.6613756613756614,0.13227513227513227
70,충청북도,제천시,화산동,화산동제4투,2619,1831,841,811,138,26,2,1818,13,788,46.25962596259626,44.60946094609461,7.590759075907591,1.4301430143014302,0.11001100110011
71,충청북도,제천시,잘못 투입·구분된 투표지,,0,0,0,0,0,0,0,0,0,0,0.0,0.0,0.0,0.0,0.0
0,충청북도,단양군,거소·선상투표,,96,84,35,29,9,1,1,75,9,12,46.666666666666664,38.666666666666664,12.0,1.3333333333333335,1.3333333333333335
1,충청북도,단양군,관외사전투표,,2117,2116,994,844,229,20,5,2092,24,1,47.51434034416826,40.344168260038245,10.946462715105163,0.9560229445506693,0.23900573613766732
2,충청북도,단양군,재외투표,,99,91,70,13,6,1,0,90,1,8,77.77777777777779,14.444444444444443,6.666666666666667,1.1111111111111112,0.0
3,충청북도,단양군,단양읍,관내사전투표,3027,3027,1703,1074,213,22,3,3015,12,0,56.48424543946932,35.62189054726368,7.064676616915423,0.7296849087893864,0.09950248756218905
4,충청북도,단양군,단양읍,단양읍제1투,1396,902,239,597,53,4,0,893,9,494,26.763717805151177,66.85330347144458,5.93505039193729,0.4479283314669653,0.0
5,충청북도,단양군,단양읍,단양읍제2투,1426,925,253,607,54,4,0,918,7,501,27.5599128540305,66.12200435729847,5.88235294117647,0.4357298474945534,0.0
6,충청북도,단양군,단양읍,단양읍제3투,2305,1492,469,921,69,16,2,1477,15,813,31.753554502369667,62.35612728503723,4.671631685849696,1.0832769126607988,0.13540961408259986
7,충청북도,단양군,매포읍,관내사전투표,1479,1479,730,658,72,6,0,1466,13,0,49.79536152796726,44.88403819918145,4.911323328785812,0.4092769440654843,0.0
8,충청북도,단양군,매포읍,매포읍제1투,1490,993,283,656,37,6,2,984,9,497,28.760162601626014,66.66666666666666,3.760162601626017,0.6097560975609756,0.20325203252032523
9,충청북도,단양군,매포읍,매포읍제2투,661,391,112,250,26,2,1,391,0,270,28.644501278772378,63.9386189258312,6.649616368286446,0.5115089514066496,0.2557544757033248
10,충청북도,단양군,매포읍,매포읍제3투,549,383,107,252,16,2,3,380,3,166,28.157894736842103,66.3157894736842,4.2105263157894735,0.5263157894736842,0.7894736842105263
11,충청북도,단양군,단성면,관내사전투표,450,450,189,228,24,2,0,443,7,0,42.66365688487584,51.46726862302483,5.417607223476298,0.4514672686230248,0.0
12,충청북도,단양군,단성면,단성면제1투,596,353,85,250,16,2,0,353,0,243,24.07932011331445,70.82152974504248,4.53257790368272,0.56657223796034,0.0
13,충청북도,단양군,단성면,단성면제2투,282,202,41,150,10,1,0,202,0,80,20.2970297029703,74.25742574257426,4.9504950495049505,0.49504950495049505,0.0
14,충청북도,단양군,대강면,관내사전투표,716,716,302,378,30,4,0,714,2,0,42.296918767507,52.94117647058824,4.201680672268908,0.5602240896358543,0.0
15,충청북도,단양군,대강면,대강면제1투,934,644,118,495,22,0,1,636,8,290,18.553459119496853,77.83018867924528,3.459119496855346,0.0,0.15723270440251574
16,충청북도,단양군,대강면,대강면제2투,412,273,53,208,7,1,0,269,4,139,19.702602230483272,77.32342007434944,2.6022304832713754,0.37174721189591076,0.0
17,충청북도,단양군,가곡면,관내사전투표,609,609,320,261,22,3,0,606,3,0,52.8052805280528,43.06930693069307,3.6303630363036308,0.49504950495049505,0.0
18,충청북도,단양군,가곡면,가곡면투표소,1042,662,163,474,20,2,0,659,3,380,24.73444613050076,71.92716236722306,3.0349013657056148,0.30349013657056145,0.0
19,충청북도,단양군,영춘면,관내사전투표,794,794,365,377,38,9,1,790,4,0,46.20253164556962,47.721518987341774,4.810126582278481,1.139240506329114,0.12658227848101267
20,충청북도,단양군,영춘면,영춘면제1투,1061,729,116,585,18,2,1,722,7,332,16.06648199445983,81.02493074792244,2.4930747922437675,0.2770083102493075,0.13850415512465375
21,충청북도,단양군,영춘면,영춘면제2투,124,101,23,75,2,0,0,100,1,23,23.0,75.0,2.0,0.0,0.0
22,충청북도,단양군,영춘면,영춘면제3투,657,447,138,285,16,3,1,443,4,210,31.15124153498871,64.33408577878103,3.611738148984198,0.6772009029345373,0.2257336343115124
23,충청북도,단양군,어상천면,관내사전투표,584,584,297,260,19,5,1,582,2,0,51.03092783505154,44.67353951890035,3.264604810996564,0.859106529209622,0.1718213058419244
24,충청북도,단양군,어상천면,어상천면투표소,1013,619,167,426,22,3,0,618,1,394,27.02265372168285,68.93203883495146,3.559870550161812,0.48543689320388345,0.0
25,충청북도,단양군,적성면,관내사전투표,261,261,132,113,11,1,0,257,4,0,51.36186770428015,43.96887159533074,4.280155642023346,0.38910505836575876,0.0
26,충청북도,단양군,적성면,적성면제1투,336,232,52,169,10,0,0,231,1,104,22.51082251082251,73.16017316017316,4.329004329004329,0.0,0.0
27,충청북도,단양군,적성면,적성면제2투,494,342,89,239,9,1,0,338,4,152,26.331360946745562,70.71005917159763,2.6627218934911245,0.2958579881656805,0.0
28,충청북도,단양군,잘못 투입·구분된 투표지,,0,0,0,0,0,0,0,0,0,0,0.0,0.0,0.0,0.0,0.0
0,충청북도,청주시청원구,거소·선상투표,,240,231,100,79,39,3,2,223,8,9,44.843049327354265,35.42600896860987,17.48878923766816,1.345291479820628,0.8968609865470852
1,충청북도,청주시청원구,관외사전투표,,14523,14519,8441,3632,2114,181,17,14385,134,4,58.67917970107751,25.248522766770943,14.695863746958636,1.2582551268682656,0.11817865832464372
2,충청북도,청주시청원구,재외투표,,549,445,317,66,50,9,0,442,3,104,71.71945701357465,14.93212669683258,11.312217194570136,2.0361990950226243,0.0
3,충청북도,청주시청원구,오창읍,관내사전투표,7454,7454,4959,1655,755,42,5,7416,38,0,66.86893203883496,22.31661272923409,10.180690399137001,0.5663430420711975,0.0674217907227616
4,충청북도,청주시청원구,오창읍,오창읍제1투,1714,929,293,570,51,7,2,923,6,785,31.74431202600217,61.75514626218852,5.52546045503792,0.7583965330444203,0.21668472372697722
5,충청북도,청주시청원구,오창읍,오창읍제2투,1683,1016,375,564,58,7,2,1006,10,667,37.27634194831014,56.063618290258454,5.7654075546719685,0.6958250497017893,0.19880715705765406
6,충청북도,청주시청원구,오창읍,오창읍제3투,742,467,142,295,25,2,2,466,1,275,30.472103004291846,63.30472103004292,5.36480686695279,0.4291845493562232,0.4291845493562232
7,충청북도,청주시청원구,오창읍,오창읍제4투,3253,2438,1194,982,217,31,1,2425,13,815,49.23711340206186,40.49484536082474,8.948453608247423,1.2783505154639174,0.041237113402061855
8,충청북도,청주시청원구,오창읍,오창읍제5투,2142,1742,963,615,139,12,1,1730,12,400,55.664739884393065,35.54913294797688,8.034682080924856,0.6936416184971098,0.05780346820809249
9,충청북도,청주시청원구,오창읍,오창읍제6투,2326,1874,1102,585,160,16,1,1864,10,452,59.12017167381974,31.384120171673818,8.583690987124463,0.8583690987124464,0.0536480686695279
10,충청북도,청주시청원구,오창읍,오창읍제7투,2637,2103,1286,636,158,15,1,2096,7,534,61.35496183206107,30.343511450381676,7.538167938931298,0.7156488549618321,0.047709923664122134
11,충청북도,청주시청원구,오창읍,오창읍제8투,2414,1897,1115,588,155,21,1,1880,17,517,59.308510638297875,31.27659574468085,8.24468085106383,1.1170212765957448,0.05319148936170213
12,충청북도,청주시청원구,오창읍,오창읍제9투,2483,1989,1211,585,157,20,2,1975,14,494,61.31645569620253,29.620253164556964,7.949367088607595,1.0126582278481013,0.10126582278481014
13,충청북도,청주시청원구,오창읍,오창읍제10투,2425,1406,622,563,199,9,2,1395,11,1019,44.587813620071685,40.3584229390681,14.265232974910393,0.6451612903225806,0.14336917562724014
14,충청북도,청주시청원구,오창읍,오창읍제11투,2800,1574,639,651,259,14,4,1567,7,1226,40.77855775366943,41.54435226547543,16.52839821314614,0.8934269304403318,0.2552648372686663
15,충청북도,청주시청원구,오창읍,오창읍제12투,2740,1468,556,619,258,23,2,1458,10,1272,38.13443072702332,42.45541838134431,17.695473251028808,1.577503429355281,0.1371742112482853
16,충청북도,청주시청원구,오창읍,오창읍제13투,2689,1838,930,645,222,27,2,1826,12,851,50.930996714129236,35.32311062431545,12.157721796276014,1.4786418400876233,0.10952902519167579
17,충청북도,청주시청원구,오창읍,오창읍제14투,2059,1568,868,528,142,14,1,1553,15,491,55.89182227945911,33.99871216999356,9.143593045717965,0.901481004507405,0.0643915003219575
18,충청북도,청주시청원구,오창읍,오창읍제15투,2572,1905,976,671,216,18,3,1884,21,667,51.80467091295117,35.615711252653924,11.464968152866243,0.9554140127388535,0.15923566878980894
19,충청북도,청주시청원구,오창읍,오창읍제16투,1997,1682,925,561,175,11,1,1673,9,315,55.2898983861327,33.53257621040048,10.460251046025103,0.657501494321578,0.059772863120143446
20,충청북도,청주시청원구,오창읍,오창읍제17투,3806,2981,1677,936,317,25,2,2957,24,825,56.71288468041934,31.653703077443357,10.720324653364898,0.8454514710855596,0.06763611768684477
21,충청북도,청주시청원구,내수읍,관내사전투표,4002,4002,2399,1275,243,36,5,3958,44,0,60.61141990904497,32.213239009600805,6.1394643759474485,0.9095502779181406,0.12632642748863063
22,충청북도,청주시청원구,내수읍,내수읍제1투,2065,1219,528,596,75,13,0,1212,7,846,43.56435643564357,49.17491749174918,6.188118811881188,1.0726072607260726,0.0
23,충청북도,청주시청원구,내수읍,내수읍제2투,1050,650,245,373,20,2,2,642,8,400,38.161993769470406,58.09968847352025,3.115264797507788,0.3115264797507788,0.3115264797507788
24,충청북도,청주시청원구,내수읍,내수읍제3투,684,450,156,269,21,3,0,449,1,234,34.74387527839644,59.910913140311806,4.67706013363029,0.6681514476614699,0.0
25,충청북도,청주시청원구,내수읍,내수읍제4투,2513,1540,620,722,170,22,2,1536,4,973,40.36458333333333,47.00520833333333,11.067708333333332,1.4322916666666665,0.13020833333333331
26,충청북도,청주시청원구,내수읍,내수읍제5투,1541,983,362,547,58,10,4,981,2,558,36.901121304791026,55.759429153924565,5.9123343527013255,1.019367991845056,0.40774719673802245
27,충청북도,청주시청원구,내수읍,내수읍제6투,2367,1418,621,683,81,16,0,1401,17,949,44.3254817987152,48.75089221984297,5.781584582441114,1.1420413990007139,0.0
28,충청북도,청주시청원구,내수읍,내수읍제7투,914,510,189,282,32,4,0,507,3,404,37.278106508875744,55.62130177514793,6.31163708086785,0.7889546351084813,0.0
29,충청북도,청주시청원구,북이면,관내사전투표,1017,1017,568,354,62,14,5,1003,14,0,56.63010967098704,35.294117647058826,6.181455633100698,1.3958125623130608,0.4985044865403789
30,충청북도,청주시청원구,북이면,북이면제1투,617,408,126,242,24,6,1,399,9,209,31.57894736842105,60.6516290726817,6.015037593984962,1.5037593984962405,0.2506265664160401
31,충청북도,청주시청원구,북이면,북이면제2투,601,358,102,242,9,1,3,357,1,243,28.57142857142857,67.78711484593838,2.5210084033613445,0.2801120448179272,0.8403361344537815
32,충청북도,청주시청원구,북이면,북이면제3투,677,429,128,282,15,1,1,427,2,248,29.97658079625293,66.04215456674473,3.51288056206089,0.234192037470726,0.234192037470726
33,충청북도,청주시청원구,북이면,북이면제4투,792,496,154,308,22,5,1,490,6,296,31.428571428571427,62.857142857142854,4.489795918367347,1.0204081632653061,0.20408163265306123
34,충청북도,청주시청원구,우암동,관내사전투표,2709,2709,1392,1004,264,22,3,2685,24,0,51.84357541899441,37.39292364990689,9.83240223463687,0.819366852886406,0.11173184357541899
35,충청북도,청주시청원구,우암동,우암동제1투,1771,1009,302,585,94,18,0,999,10,762,30.23023023023023,58.55855855855856,9.40940940940941,1.8018018018018018,0.0
36,충청북도,청주시청원구,우암동,우암동제2투,1941,1172,338,685,125,14,1,1163,9,769,29.062768701633708,58.89939810834049,10.748065348237319,1.2037833190025795,0.08598452278589853
37,충청북도,청주시청원구,우암동,우암동제3투,1714,1009,258,679,56,11,1,1005,4,705,25.671641791044774,67.56218905472637,5.5721393034825875,1.0945273631840797,0.09950248756218905
38,충청북도,청주시청원구,우암동,우암동제4투,2205,1410,494,778,113,14,1,1400,10,795,35.285714285714285,55.57142857142857,8.071428571428571,1.0,0.07142857142857142
39,충청북도,청주시청원구,내덕제1동,관내사전투표,2775,2775,1609,947,180,25,3,2764,11,0,58.21273516642547,34.26193921852388,6.512301013024602,0.9044862518089725,0.10853835021707671
40,충청북도,청주시청원구,내덕제1동,내덕제1동제1투,1666,919,261,589,57,4,1,912,7,747,28.618421052631575,64.58333333333334,6.25,0.43859649122807015,0.10964912280701754
41,충청북도,청주시청원구,내덕제1동,내덕제1동제2투,1640,1049,294,666,75,8,3,1046,3,591,28.107074569789674,63.67112810707457,7.170172084130019,0.7648183556405354,0.28680688336520077
42,충청북도,청주시청원구,내덕제1동,내덕제1동제3투,1648,1092,379,638,61,7,1,1086,6,556,34.898710865561696,58.74769797421732,5.616942909760589,0.6445672191528545,0.09208103130755065
43,충청북도,청주시청원구,내덕제2동,관내사전투표,2895,2895,1695,934,220,25,2,2876,19,0,58.93602225312935,32.47566063977747,7.649513212795549,0.8692628650904033,0.06954102920723226
44,충청북도,청주시청원구,내덕제2동,내덕제2동제1투,1525,871,267,532,58,5,3,865,6,654,30.86705202312139,61.50289017341041,6.705202312138728,0.5780346820809248,0.3468208092485549
45,충청북도,청주시청원구,내덕제2동,내덕제2동제2투,2187,1293,459,678,129,16,0,1282,11,894,35.80343213728549,52.886115444617786,10.062402496099844,1.24804992199688,0.0
46,충청북도,청주시청원구,내덕제2동,내덕제2동제3투,3685,2565,1027,1293,201,29,0,2550,15,1120,40.27450980392157,50.70588235294118,7.882352941176471,1.1372549019607843,0.0
47,충청북도,청주시청원구,율량·사천동,관내사전투표,6889,6889,4410,1759,593,68,7,6837,52,0,64.50197455024134,25.72765832967676,8.673394763785286,0.9945882697089367,0.10238408658768466
48,충청북도,청주시청원구,율량·사천동,율량·사천동제1투,2060,1402,528,692,143,22,5,1390,12,658,37.985611510791365,49.7841726618705,10.287769784172662,1.5827338129496402,0.3597122302158274
49,충청북도,청주시청원구,율량·사천동,율량·사천동제2투,2412,1429,524,748,134,10,0,1416,13,983,37.005649717514125,52.824858757062145,9.463276836158192,0.7062146892655368,0.0
50,충청북도,청주시청원구,율량·사천동,율량·사천동제3투,2672,1769,663,920,151,16,4,1754,15,903,37.79931584948689,52.451539338654506,8.608893956670467,0.9122006841505131,0.22805017103762829
51,충청북도,청주시청원구,율량·사천동,율량·사천동제4투,1547,1179,433,648,74,12,3,1170,9,368,37.00854700854701,55.38461538461539,6.3247863247863245,1.0256410256410255,0.2564102564102564
52,충청북도,청주시청원구,율량·사천동,율량·사천동제5투,2589,1702,728,806,133,19,1,1687,15,887,43.15352697095436,47.77711914641375,7.883817427385892,1.1262596324836989,0.05927682276229994
53,충청북도,청주시청원구,율량·사천동,율량·사천동제6투,3294,2343,1086,1055,161,24,2,2328,15,951,46.649484536082475,45.31786941580756,6.915807560137457,1.0309278350515463,0.0859106529209622
54,충청북도,청주시청원구,율량·사천동,율량·사천동제7투,2290,1697,750,769,143,21,3,1686,11,593,44.48398576512456,45.610913404507706,8.48161328588375,1.2455516014234875,0.1779359430604982
55,충청북도,청주시청원구,율량·사천동,율량·사천동제8투,2725,1874,724,962,149,22,3,1860,14,851,38.924731182795696,51.72043010752688,8.010752688172044,1.1827956989247312,0.16129032258064516
56,충청북도,청주시청원구,율량·사천동,율량·사천동제9투,2301,1617,712,701,176,14,0,1603,14,684,44.41671865252651,43.7305053025577,10.979413599500935,0.8733624454148471,0.0
57,충청북도,청주시청원구,율량·사천동,율량·사천동제10투,1900,1224,500,549,144,20,0,1213,11,676,41.22011541632317,45.25968672712284,11.871393239901073,1.6488046166529264,0.0
58,충청북도,청주시청원구,율량·사천동,율량·사천동제11투,2001,1552,691,713,114,25,3,1546,6,449,44.69598965071152,46.11901681759379,7.373868046571798,1.6170763260025873,0.19404915912031048
59,충청북도,청주시청원구,율량·사천동,율량·사천동제12투,1684,1229,573,529,103,12,2,1219,10,455,47.00574241181296,43.39622641509434,8.44954881050041,0.9844134536505332,0.16406890894175555
60,충청북도,청주시청원구,율량·사천동,율량·사천동제13투,1766,1261,569,565,104,12,3,1253,8,505,45.41101356743815,45.09177972865124,8.300079808459698,0.9577015163607342,0.23942537909018355
61,충청북도,청주시청원구,오근장동,관내사전투표,2355,2355,1469,614,240,15,3,2341,14,0,62.750961127723194,26.228107646305,10.252029047415634,0.6407518154634771,0.12815036309269542
62,충청북도,청주시청원구,오근장동,오근장동제1투,1751,1001,289,659,39,5,1,993,8,750,29.103726082578046,66.36455186304129,3.927492447129909,0.5035246727089627,0.10070493454179255
63,충청북도,청주시청원구,오근장동,오근장동제2투,2871,2276,1154,869,206,30,2,2261,15,595,51.03936311366651,38.4343210968598,9.111012826183105,1.3268465280849182,0.08845643520566121
64,충청북도,청주시청원구,오근장동,오근장동제3투,2840,1891,831,887,141,15,4,1878,13,949,44.24920127795527,47.23109691160809,7.507987220447284,0.7987220447284344,0.21299254526091588
65,충청북도,청주시청원구,오근장동,오근장동제4투,2320,1798,942,647,174,23,1,1787,11,522,52.714045886961394,36.20593172915501,9.736989367655289,1.2870733072188025,0.05595970900951316
66,충청북도,청주시청원구,잘못 투입·구분된 투표지,,0,0,0,0,0,0,0,0,0,0,0.0,0.0,0.0,0.0,0.0
0,충청북도,영동군,거소·선상투표,,83,81,23,44,9,0,0,76,5,2,30.263157894736842,57.89473684210527,11.842105263157894,0.0,0.0
1,충청북도,영동군,관외사전투표,,3232,3232,1561,1243,363,25,5,3197,35,0,48.82702533625274,38.880200187675946,11.354394745073506,0.781983109164842,0.15639662183296843
2,충청북도,영동군,재외투표,,158,107,62,31,8,4,1,106,1,51,58.490566037735846,29.245283018867923,7.547169811320755,3.7735849056603774,0.9433962264150944
3,충청북도,영동군,영동읍,관내사전투표,5184,5184,2752,2011,317,61,2,5143,41,0,53.50962473264631,39.10169161967723,6.163717674509042,1.1860781644954306,0.038887808671981335
4,충청북도,영동군,영동읍,영동읍제1투,1477,950,286,589,52,14,0,941,9,527,30.393198724760893,62.59298618490967,5.526036131774708,1.487778958554729,0.0
5,충청북도,영동군,영동읍,영동읍제2투,2431,1536,505,924,81,15,1,1526,10,895,33.093053735255566,60.550458715596335,5.307994757536042,0.9829619921363041,0.0655307994757536
6,충청북도,영동군,영동읍,영동읍제3투,2031,1232,401,739,72,9,0,1221,11,799,32.841932841932845,60.52416052416052,5.896805896805897,0.7371007371007371,0.0
7,충청북도,영동군,영동읍,영동읍제4투,1732,1033,404,547,68,6,2,1027,6,699,39.337877312560856,53.26192794547225,6.621226874391431,0.5842259006815969,0.19474196689386564
8,충청북도,영동군,영동읍,영동읍제5투,1837,1154,348,717,69,11,2,1147,7,683,30.340017436791634,62.51089799476897,6.015693112467306,0.959023539668701,0.17436791630340018
9,충청북도,영동군,용산면,관내사전투표,1438,1438,733,611,64,12,1,1421,17,0,51.58339197748065,42.99788881069669,4.50387051372273,0.844475721323012,0.07037297677691766
10,충청북도,영동군,용산면,용산면투표소,1559,860,236,571,40,5,1,853,7,699,27.667057444314185,66.94021101992966,4.6893317702227435,0.5861664712778429,0.11723329425556857
11,충청북도,영동군,황간면,관내사전투표,1155,1155,560,521,54,11,1,1147,8,0,48.82301656495205,45.42284219703575,4.707933740191804,0.959023539668701,0.08718395815170009
12,충청북도,영동군,황간면,황간면제1투,1248,813,212,554,33,7,0,806,7,435,26.302729528535977,68.73449131513648,4.094292803970223,0.8684863523573202,0.0
13,충청북도,영동군,황간면,황간면제2투,916,601,156,417,21,3,1,598,3,315,26.08695652173913,69.7324414715719,3.511705685618729,0.5016722408026756,0.16722408026755853
14,충청북도,영동군,추풍령면,관내사전투표,585,585,210,345,22,4,1,582,3,0,36.08247422680412,59.27835051546392,3.7800687285223367,0.6872852233676976,0.1718213058419244
15,충청북도,영동군,추풍령면,추풍령면투표소,1259,837,182,617,22,4,2,827,10,422,22.007255139056834,74.60701330108827,2.6602176541717046,0.48367593712212814,0.24183796856106407
16,충청북도,영동군,매곡면,관내사전투표,591,591,276,276,29,2,1,584,7,0,47.26027397260274,47.26027397260274,4.965753424657534,0.3424657534246575,0.17123287671232876
17,충청북도,영동군,매곡면,매곡면투표소,976,592,138,426,17,5,0,586,6,384,23.549488054607508,72.6962457337884,2.901023890784983,0.8532423208191127,0.0
18,충청북도,영동군,상촌면,관내사전투표,726,726,333,353,29,7,1,723,3,0,46.058091286307054,48.82434301521438,4.011065006915629,0.9681881051175657,0.13831258644536654
19,충청북도,영동군,상촌면,상촌면투표소,1124,724,165,526,22,5,0,718,6,400,22.98050139275766,73.25905292479109,3.064066852367688,0.6963788300835655,0.0
20,충청북도,영동군,양강면,관내사전투표,1075,1075,527,460,64,18,0,1069,6,0,49.298409728718426,43.03086997193639,5.9869036482694105,1.683816651075772,0.0
21,충청북도,영동군,양강면,양강면투표소,1639,970,232,681,48,1,1,963,7,669,24.091381100726895,70.7165109034268,4.984423676012461,0.10384215991692627,0.10384215991692627
22,충청북도,영동군,용화면,관내사전투표,318,318,132,168,15,2,0,317,1,0,41.6403785488959,52.99684542586751,4.73186119873817,0.6309148264984227,0.0
23,충청북도,영동군,용화면,용화면투표소,429,240,90,135,11,2,0,238,2,189,37.81512605042017,56.72268907563025,4.621848739495799,0.8403361344537815,0.0
24,충청북도,영동군,학산면,관내사전투표,826,826,409,362,46,2,2,821,5,0,49.817295980511574,44.0925700365408,5.602923264311815,0.24360535931790497,0.24360535931790497
25,충청북도,영동군,학산면,학산면투표소,1441,842,228,572,31,2,2,835,7,599,27.305389221556887,68.50299401197604,3.7125748502994016,0.23952095808383234,0.23952095808383234
26,충청북도,영동군,양산면,관내사전투표,662,662,309,310,35,1,2,657,5,0,47.03196347031963,47.1841704718417,5.32724505327245,0.15220700152207,0.30441400304414
27,충청북도,영동군,양산면,양산면투표소,886,523,123,371,17,6,0,517,6,363,23.791102514506772,71.76015473887814,3.2882011605415857,1.160541586073501,0.0
28,충청북도,영동군,심천면,관내사전투표,904,904,452,396,38,5,1,892,12,0,50.672645739910315,44.39461883408072,4.260089686098654,0.5605381165919282,0.11210762331838565
29,충청북도,영동군,심천면,심천면제1투,1300,801,219,538,24,10,1,792,9,499,27.65151515151515,67.92929292929293,3.0303030303030303,1.2626262626262625,0.12626262626262627
30,충청북도,영동군,심천면,심천면제2투,332,232,57,162,9,2,1,231,1,100,24.675324675324674,70.12987012987013,3.896103896103896,0.8658008658008658,0.4329004329004329
31,충청북도,영동군,잘못 투입·구분된 투표지,,0,0,0,0,0,0,0,0,0,0,0.0,0.0,0.0,0.0,0.0
0,충청북도,보은군,거소·선상투표,,78,78,27,39,5,0,3,74,4,0,36.486486486486484,52.702702702702695,6.756756756756757,0.0,4.054054054054054
1,충청북도,보은군,관외사전투표,,2374,2374,1228,872,222,28,4,2354,20,0,52.16652506372132,37.043330501274426,9.430756159728123,1.1894647408666101,0.16992353440951571
2,충청북도,보은군,재외투표,,104,74,51,18,5,0,0,74,0,30,68.91891891891892,24.324324324324326,6.756756756756757,0.0,0.0
3,충청북도,보은군,보은읍,관내사전투표,4253,4253,2205,1720,239,40,4,4208,45,0,52.400190114068444,40.874524714828894,5.679657794676806,0.9505703422053232,0.09505703422053231
4,충청북도,보은군,보은읍,보은읍제1투,940,552,167,358,18,3,1,547,5,388,30.53016453382084,65.44789762340037,3.2906764168190126,0.5484460694698354,0.18281535648994515
5,충청북도,보은군,보은읍,보은읍제2투,707,419,114,284,14,3,0,415,4,288,27.469879518072286,68.43373493975903,3.3734939759036147,0.7228915662650602,0.0
6,충청북도,보은군,보은읍,보은읍제3투,1324,811,253,503,37,8,2,803,8,513,31.506849315068493,62.64009962640099,4.60772104607721,0.9962640099626401,0.24906600249066002
7,충청북도,보은군,보은읍,보은읍제4투,2391,1482,475,906,78,12,0,1471,11,909,32.290958531611146,61.59075458871516,5.3025152957172,0.8157715839564922,0.0
8,충청북도,보은군,보은읍,보은읍제5투,1388,853,293,496,49,6,1,845,8,535,34.67455621301775,58.698224852071,5.798816568047338,0.7100591715976331,0.1183431952662722
9,충청북도,보은군,속리산면,관내사전투표,720,720,372,313,29,6,0,720,0,0,51.66666666666667,43.47222222222222,4.027777777777778,0.8333333333333334,0.0
10,충청북도,보은군,속리산면,속리산면투표소,826,528,140,372,12,1,1,526,2,298,26.61596958174905,70.72243346007605,2.2813688212927756,0.19011406844106463,0.19011406844106463
11,충청북도,보은군,장안면,관내사전투표,526,526,294,191,32,3,1,521,5,0,56.4299424184261,36.660268714011515,6.142034548944338,0.5758157389635317,0.19193857965451055
12,충청북도,보은군,장안면,장안면투표소,732,487,180,274,27,4,0,485,2,245,37.11340206185567,56.49484536082474,5.567010309278351,0.8247422680412372,0.0
13,충청북도,보은군,마로면,관내사전투표,603,603,292,272,28,2,0,594,9,0,49.158249158249156,45.79124579124579,4.713804713804714,0.33670033670033667,0.0
14,충청북도,보은군,마로면,마로면제1투,808,536,147,366,18,1,1,533,3,272,27.5797373358349,68.66791744840526,3.377110694183865,0.18761726078799248,0.18761726078799248
15,충청북도,보은군,마로면,마로면제2투,446,302,104,179,14,2,1,300,2,144,34.66666666666667,59.66666666666667,4.666666666666667,0.6666666666666667,0.33333333333333337
16,충청북도,보은군,탄부면,관내사전투표,429,429,210,189,20,5,1,425,4,0,49.411764705882355,44.470588235294116,4.705882352941177,1.1764705882352942,0.2352941176470588
17,충청북도,보은군,탄부면,탄부면투표소,873,573,178,368,18,2,1,567,6,300,31.393298059964724,64.90299823633157,3.1746031746031744,0.3527336860670194,0.1763668430335097
18,충청북도,보은군,삼승면,관내사전투표,748,748,382,320,29,8,2,741,7,0,51.55195681511471,43.18488529014845,3.913630229419703,1.0796221322537112,0.2699055330634278
19,충청북도,보은군,삼승면,삼승면투표소,1079,625,220,357,35,5,1,618,7,454,35.59870550161812,57.76699029126213,5.6634304207119746,0.8090614886731391,0.16181229773462785
20,충청북도,보은군,수한면,관내사전투표,845,845,415,367,45,10,1,838,7,0,49.52267303102625,43.794749403341285,5.369928400954653,1.1933174224343674,0.11933174224343676
21,충청북도,보은군,수한면,수한면투표소,970,599,151,422,18,3,1,595,4,371,25.3781512605042,70.92436974789916,3.0252100840336134,0.5042016806722689,0.16806722689075632
22,충청북도,보은군,회남면,관내사전투표,208,208,91,108,5,2,1,207,1,0,43.96135265700483,52.17391304347826,2.4154589371980677,0.966183574879227,0.4830917874396135
23,충청북도,보은군,회남면,회남면투표소,371,250,54,189,3,2,0,248,2,121,21.774193548387096,76.20967741935483,1.2096774193548387,0.8064516129032258,0.0
24,충청북도,보은군,회인면,관내사전투표,539,539,221,292,14,6,3,536,3,0,41.23134328358209,54.47761194029851,2.6119402985074625,1.1194029850746268,0.5597014925373134
25,충청북도,보은군,회인면,회인면투표소,879,545,135,385,16,2,0,538,7,334,25.092936802973973,71.56133828996283,2.973977695167286,0.37174721189591076,0.0
26,충청북도,보은군,내북면,관내사전투표,478,478,246,203,23,4,1,477,1,0,51.57232704402516,42.55765199161425,4.821802935010482,0.8385744234800839,0.20964360587002098
27,충청북도,보은군,내북면,내북면제1투,484,290,79,186,19,4,1,289,1,194,27.33564013840831,64.3598615916955,6.5743944636678195,1.384083044982699,0.34602076124567477
28,충청북도,보은군,내북면,내북면제2투,404,270,74,182,9,2,1,268,2,134,27.611940298507463,67.91044776119402,3.3582089552238807,0.7462686567164178,0.3731343283582089
29,충청북도,보은군,산외면,관내사전투표,440,440,219,191,20,5,0,435,5,0,50.3448275862069,43.9080459770115,4.597701149425287,1.1494252873563218,0.0
30,충청북도,보은군,산외면,산외면제1투,543,365,98,250,11,3,0,362,3,178,27.071823204419886,69.06077348066299,3.0386740331491713,0.8287292817679558,0.0
31,충청북도,보은군,산외면,산외면제2투,390,269,79,172,12,4,1,268,1,121,29.47761194029851,64.17910447761194,4.477611940298507,1.4925373134328357,0.3731343283582089
32,충청북도,보은군,잘못 투입·구분된 투표지,,0,0,0,0,0,0,0,0,0,0,0.0,0.0,0.0,0.0,0.0
0,충청북도,옥천군,거소·선상투표,,72,69,27,27,12,1,1,68,1,3,39.705882352941174,39.705882352941174,17.647058823529413,1.4705882352941175,1.4705882352941175
1,충청북도,옥천군,관외사전투표,,3952,3950,2103,1358,413,39,2,3915,35,2,53.71647509578544,34.687100893997446,10.549169859514688,0.996168582375479,0.05108556832694764
2,충청북도,옥천군,재외투표,,159,112,79,25,6,1,0,111,1,47,71.17117117117117,22.52252252252252,5.405405405405405,0.9009009009009009,0.0
3,충청북도,옥천군,옥천읍,관내사전투표,7313,7313,4197,2510,461,71,16,7255,58,0,57.84975878704341,34.59682977257064,6.354238456237078,0.9786354238456236,0.22053756030323912
4,충청북도,옥천군,옥천읍,옥천읍제1투,1913,1135,417,610,88,13,1,1129,6,778,36.935341009743134,54.030115146147025,7.7945084145261285,1.1514614703277237,0.08857395925597875
5,충청북도,옥천군,옥천읍,옥천읍제2투,1894,1299,491,698,78,17,2,1286,13,595,38.18040435458787,54.27682737169518,6.065318818040436,1.3219284603421462,0.15552099533437014
6,충청북도,옥천군,옥천읍,옥천읍제3투,2490,1540,649,751,107,21,1,1529,11,950,42.44604316546763,49.117069980379334,6.998037933289732,1.3734466971877044,0.06540222367560497
7,충청북도,옥천군,옥천읍,옥천읍제4투,1614,1084,351,656,56,9,2,1074,10,530,32.68156424581006,61.08007448789572,5.21415270018622,0.8379888268156425,0.186219739292365
8,충청북도,옥천군,옥천읍,옥천읍제5투,1852,1120,375,681,44,10,2,1112,8,732,33.723021582733814,61.2410071942446,3.9568345323741005,0.8992805755395683,0.1798561151079137
9,충청북도,옥천군,옥천읍,옥천읍제6투,2457,1579,544,900,98,19,2,1563,16,878,34.804862444017914,57.58157389635316,6.269993602047346,1.2156110044785668,0.12795905310300704
10,충청북도,옥천군,옥천읍,옥천읍제7투,2709,1851,781,907,124,23,2,1837,14,858,42.51497005988024,49.373979314099074,6.750136091453457,1.2520413718018508,0.10887316276537834
11,충청북도,옥천군,동이면,관내사전투표,1208,1208,611,479,74,10,9,1183,25,0,51.64835164835166,40.490278951817416,6.255283178360102,0.84530853761623,0.760777683854607
12,충청북도,옥천군,동이면,동이면투표소,1612,1033,255,720,41,3,4,1023,10,579,24.926686217008797,70.38123167155426,4.007820136852395,0.2932551319648094,0.39100684261974583
13,충청북도,옥천군,안남면,관내사전투표,455,455,233,195,20,5,1,454,1,0,51.3215859030837,42.951541850220266,4.405286343612335,1.1013215859030838,0.22026431718061676
14,충청북도,옥천군,안남면,안남면투표소,689,443,117,306,11,2,1,437,6,246,26.773455377574372,70.0228832951945,2.517162471395881,0.4576659038901602,0.2288329519450801
15,충청북도,옥천군,안내면,관내사전투표,624,624,236,350,27,5,0,618,6,0,38.18770226537217,56.63430420711975,4.368932038834951,0.8090614886731391,0.0
16,충청북도,옥천군,안내면,안내면투표소,954,613,150,436,18,5,0,609,4,341,24.63054187192118,71.5927750410509,2.955665024630542,0.8210180623973727,0.0
17,충청북도,옥천군,청성면,관내사전투표,545,545,236,279,19,4,0,538,7,0,43.866171003717476,51.85873605947955,3.5315985130111525,0.7434944237918215,0.0
18,충청북도,옥천군,청성면,청성면투표소,1138,633,156,445,22,4,2,629,4,505,24.80127186009539,70.74721780604133,3.4976152623211445,0.6359300476947536,0.3179650238473768
19,충청북도,옥천군,청산면,관내사전투표,1049,1049,465,520,45,8,1,1039,10,0,44.75457170356112,50.04812319538018,4.331087584215592,0.769971126082772,0.0962463907603465
20,충청북도,옥천군,청산면,청산면투표소,1421,891,243,606,28,3,1,881,10,530,27.582292849035188,68.78547105561861,3.1782065834279227,0.340522133938706,0.11350737797956867
21,충청북도,옥천군,이원면,관내사전투표,1406,1406,725,604,57,7,0,1393,13,0,52.045944005743,43.35965541995693,4.0918880114860015,0.5025125628140703,0.0
22,충청북도,옥천군,이원면,이원면투표소,2063,1182,334,781,54,5,4,1178,4,881,28.35314091680815,66.29881154499151,4.584040747028863,0.4244482173174873,0.3395585738539898
23,충청북도,옥천군,군서면,관내사전투표,702,702,345,311,28,7,0,691,11,0,49.92764109985528,45.00723589001447,4.052098408104197,1.0130246020260492,0.0
24,충청북도,옥천군,군서면,군서면투표소,1164,777,209,530,29,3,0,771,6,387,27.107652399481193,68.74189364461738,3.761348897535668,0.38910505836575876,0.0
25,충청북도,옥천군,군북면,관내사전투표,897,897,441,389,49,7,1,887,10,0,49.71815107102593,43.85569334836528,5.5242390078917705,0.7891770011273956,0.11273957158962795
26,충청북도,옥천군,군북면,군북면투표소,1511,893,243,599,36,8,2,888,5,618,27.364864864864863,67.45495495495496,4.054054054054054,0.9009009009009009,0.22522522522522523
27,충청북도,옥천군,잘못 투입·구분된 투표지,,0,0,0,0,0,0,0,0,0,0,0.0,0.0,0.0,0.0,0.0
0,충청북도,음성군,거소·선상투표,,159,153,61,49,29,2,0,141,12,6,43.262411347517734,34.751773049645394,20.56737588652482,1.4184397163120568,0.0
1,충청북도,음성군,관외사전투표,,7004,7004,3850,2145,857,66,11,6929,75,0,55.56357338721316,30.95684803001876,12.368307115023814,0.9525184009236543,0.15875306682060902
2,충청북도,음성군,재외투표,,263,229,145,56,21,5,0,227,2,34,63.87665198237885,24.669603524229075,9.251101321585903,2.2026431718061676,0.0
3,충청북도,음성군,음성읍,관내사전투표,4517,4517,2731,1455,256,34,7,4483,34,0,60.919027436984166,32.45594467990185,5.710461744367612,0.7584207004238233,0.15614543832255187
4,충청북도,음성군,음성읍,음성읍제1투,1939,1260,460,704,76,15,1,1256,4,679,36.624203821656046,56.05095541401274,6.050955414012739,1.194267515923567,0.07961783439490447
5,충청북도,음성군,음성읍,음성읍제2투,2124,1382,480,820,66,9,1,1376,6,742,34.883720930232556,59.59302325581395,4.796511627906977,0.6540697674418605,0.07267441860465117
6,충청북도,음성군,음성읍,음성읍제3투,2583,1447,480,869,75,13,2,1439,8,1136,33.35649756775538,60.38915913829048,5.2119527449617795,0.9034051424600417,0.13898540653231412
7,충청북도,음성군,음성읍,음성읍제4투,619,360,136,213,9,2,0,360,0,259,37.77777777777778,59.166666666666664,2.5,0.5555555555555556,0.0
8,충청북도,음성군,음성읍,음성읍제5투,1727,1085,361,646,60,11,0,1078,7,642,33.48794063079777,59.92578849721707,5.565862708719852,1.0204081632653061,0.0
9,충청북도,음성군,금왕읍,관내사전투표,4720,4720,3006,1329,315,36,6,4692,28,0,64.06649616368286,28.324808184143222,6.713554987212277,0.7672634271099744,0.1278772378516624
10,충청북도,음성군,금왕읍,금왕읍제1투,4249,2491,1068,1207,176,19,2,2472,19,1758,43.203883495145625,48.826860841423944,7.119741100323624,0.7686084142394822,0.08090614886731393
11,충청북도,음성군,금왕읍,금왕읍제2투,2429,1356,571,685,82,10,1,1349,7,1073,42.32765011119348,50.7783543365456,6.078576723498888,0.7412898443291327,0.07412898443291327
12,충청북도,음성군,금왕읍,금왕읍제3투,1926,1198,543,553,81,10,3,1190,8,728,45.63025210084034,46.470588235294116,6.80672268907563,0.8403361344537815,0.25210084033613445
13,충청북도,음성군,금왕읍,금왕읍제4투,882,539,184,326,20,5,0,535,4,343,34.39252336448598,60.93457943925233,3.7383177570093453,0.9345794392523363,0.0
14,충청북도,음성군,금왕읍,금왕읍제5투,1185,705,194,472,27,6,2,701,4,480,27.674750356633382,67.3323823109843,3.851640513552068,0.8559201141226819,0.28530670470756064
15,충청북도,음성군,소이면,관내사전투표,890,890,505,342,25,6,1,879,11,0,57.45164960182025,38.907849829351534,2.844141069397042,0.6825938566552902,0.11376564277588168
16,충청북도,음성군,소이면,소이면투표소,1536,922,242,619,44,10,2,917,5,614,26.39040348964013,67.50272628135224,4.79825517993457,1.0905125408942202,0.21810250817884408
17,충청북도,음성군,원남면,관내사전투표,818,818,421,356,30,4,0,811,7,0,51.911220715166465,43.89642416769421,3.6991368680641186,0.4932182490752158,0.0
18,충청북도,음성군,원남면,원남면제1투,937,551,158,364,18,3,2,545,6,386,28.990825688073397,66.78899082568807,3.302752293577982,0.5504587155963303,0.3669724770642202
19,충청북도,음성군,원남면,원남면제2투,719,443,142,281,12,7,0,442,1,276,32.126696832579185,63.57466063348416,2.7149321266968327,1.583710407239819,0.0
20,충청북도,음성군,맹동면,관내사전투표,2429,2429,1556,616,199,20,4,2395,34,0,64.9686847599165,25.72025052192067,8.308977035490607,0.8350730688935281,0.16701461377870563
21,충청북도,음성군,맹동면,맹동면제1투,2479,1029,339,598,80,4,1,1022,7,1450,33.17025440313112,58.51272015655577,7.8277886497064575,0.3913894324853229,0.09784735812133072
22,충청북도,음성군,맹동면,맹동면제2투,2150,1417,687,538,163,16,1,1405,12,733,48.89679715302491,38.29181494661922,11.601423487544483,1.1387900355871887,0.0711743772241993
23,충청북도,음성군,맹동면,맹동면제3투,2275,1571,803,606,132,18,1,1560,11,704,51.47435897435897,38.84615384615385,8.461538461538462,1.153846153846154,0.0641025641025641
24,충청북도,음성군,대소면,관내사전투표,3703,3703,2474,938,234,32,3,3681,22,0,67.20999728334691,25.482205922303724,6.356968215158925,0.8693289866883999,0.08149959250203749
25,충청북도,음성군,대소면,대소면제1투,1604,995,390,541,48,9,1,989,6,609,39.43377148634985,54.70171890798786,4.853387259858443,0.910010111223458,0.10111223458038424
26,충청북도,음성군,대소면,대소면제2투,2381,1468,621,712,111,18,0,1462,6,913,42.476060191518464,48.700410396716826,7.59233926128591,1.231190150478796,0.0
27,충청북도,음성군,대소면,대소면제3투,3829,2247,999,1041,170,26,5,2241,6,1582,44.57831325301205,46.4524765729585,7.585899152164212,1.1601963409192326,0.22311468094600626
28,충청북도,음성군,대소면,대소면제4투,2258,1224,486,616,98,12,1,1213,11,1034,40.065952184666116,50.78318219291014,8.07914262159934,0.9892827699917559,0.08244023083264633
29,충청북도,음성군,삼성면,관내사전투표,1749,1749,1015,644,76,8,1,1744,5,0,58.199541284403665,36.92660550458716,4.3577981651376145,0.45871559633027525,0.05733944954128441
30,충청북도,음성군,삼성면,삼성면제1투,2076,1225,412,729,56,20,0,1217,8,851,33.853738701725554,59.90139687756779,4.6014790468364835,1.6433853738701727,0.0
31,충청북도,음성군,삼성면,삼성면제2투,1613,976,290,640,37,2,1,970,6,637,29.896907216494846,65.97938144329896,3.814432989690722,0.2061855670103093,0.10309278350515465
32,충청북도,음성군,생극면,관내사전투표,1406,1406,799,472,86,13,4,1374,32,0,58.15138282387191,34.35225618631732,6.259097525473072,0.9461426491994178,0.2911208151382824
33,충청북도,음성군,생극면,생극면제1투,1730,1017,287,662,54,3,2,1008,9,713,28.47222222222222,65.67460317460318,5.357142857142857,0.2976190476190476,0.1984126984126984
34,충청북도,음성군,생극면,생극면제2투,832,532,152,343,19,6,1,521,11,300,29.174664107485604,65.83493282149712,3.6468330134357005,1.1516314779270633,0.19193857965451055
35,충청북도,음성군,감곡면,관내사전투표,2507,2507,1465,881,125,15,0,2486,21,0,58.9300080450523,35.438455349959774,5.02815768302494,0.6033789219629927,0.0
36,충청북도,음성군,감곡면,감곡면제1투,2741,1605,566,911,99,11,4,1591,14,1136,35.57510999371464,57.25958516656191,6.222501571338781,0.6913890634820867,0.251414204902577
37,충청북도,음성군,감곡면,감곡면제2투,1861,1096,330,710,43,3,4,1090,6,765,30.275229357798167,65.13761467889908,3.9449541284403673,0.27522935779816515,0.3669724770642202
38,충청북도,음성군,감곡면,감곡면제3투,1013,676,195,447,23,5,0,670,6,337,29.1044776119403,66.71641791044776,3.4328358208955225,0.7462686567164178,0.0
39,충청북도,음성군,잘못 투입·구분된 투표지,,0,0,0,0,0,0,0,0,0,0,0.0,0.0,0.0,0.0,0.0
0,충청북도,진천군,거소·선상투표,,120,107,35,38,26,3,0,102,5,13,34.31372549019608,37.254901960784316,25.49019607843137,2.941176470588235,0.0
1,충청북도,진천군,관외사전투표,,6155,6152,3549,1684,775,57,6,6071,81,3,58.45824411134903,27.738428594959647,12.765606984022401,0.9388898039861638,0.09883050568275407
2,충청북도,진천군,재외투표,,179,155,106,30,14,3,0,153,2,24,69.28104575163398,19.607843137254903,9.15032679738562,1.9607843137254901,0.0
3,충청북도,진천군,진천읍,관내사전투표,6830,6830,4219,2024,465,50,15,6773,57,0,62.29145135095231,29.883360401594565,6.86549534918057,0.7382253063635021,0.22146759190905066
4,충청북도,진천군,진천읍,진천읍제1투,1633,974,334,567,64,3,1,969,5,659,34.46852425180599,58.51393188854489,6.604747162022703,0.30959752321981426,0.10319917440660474
5,충청북도,진천군,진천읍,진천읍제2투,934,640,221,378,33,4,2,638,2,294,34.639498432601876,59.24764890282132,5.172413793103448,0.6269592476489028,0.3134796238244514
6,충청북도,진천군,진천읍,진천읍제3투,1892,1199,525,561,85,14,3,1188,11,693,44.19191919191919,47.22222222222222,7.154882154882154,1.1784511784511784,0.25252525252525254
7,충청북도,진천군,진천읍,진천읍제4투,2180,1304,541,649,88,10,3,1291,13,876,41.90549961270333,50.271107668474045,6.816421378776143,0.774593338497289,0.23237800154918667
8,충청북도,진천군,진천읍,진천읍제5투,2316,1333,596,605,104,14,1,1320,13,983,45.151515151515156,45.83333333333333,7.878787878787878,1.0606060606060608,0.07575757575757576
9,충청북도,진천군,진천읍,진천읍제6투,2656,1642,730,768,117,14,1,1630,12,1014,44.785276073619634,47.11656441717791,7.177914110429448,0.8588957055214724,0.06134969325153375
10,충청북도,진천군,진천읍,진천읍제7투,1390,881,380,419,65,6,2,872,9,509,43.57798165137615,48.05045871559633,7.454128440366972,0.6880733944954129,0.22935779816513763
11,충청북도,진천군,진천읍,진천읍제8투,1319,793,284,459,34,10,0,787,6,526,36.0864040660737,58.32274459974587,4.320203303684879,1.2706480304955527,0.0
12,충청북도,진천군,진천읍,진천읍제9투,2600,1688,759,768,130,20,3,1680,8,912,45.17857142857143,45.714285714285715,7.738095238095238,1.1904761904761905,0.17857142857142858
13,충청북도,진천군,덕산읍,관내사전투표,5540,5540,4086,924,435,63,8,5516,24,0,74.07541696881799,16.751269035532996,7.886149383611313,1.1421319796954315,0.145032632342277
14,충청북도,진천군,덕산읍,덕산읍제1투,2174,1274,538,641,76,11,1,1267,7,900,42.462509865824785,50.59194948697711,5.998421468034728,0.8681925808997633,0.07892659826361484
15,충청북도,진천군,덕산읍,덕산읍제2투,2463,1202,442,644,100,6,1,1193,9,1261,37.04945515507125,53.9815590947192,8.382229673093043,0.5029337803855826,0.08382229673093043
16,충청북도,진천군,덕산읍,덕산읍제3투,1753,1098,470,510,98,12,2,1092,6,655,43.040293040293044,46.7032967032967,8.974358974358974,1.098901098901099,0.18315018315018314
17,충청북도,진천군,덕산읍,덕산읍제4투,1725,1148,665,376,83,16,2,1142,6,577,58.23117338003503,32.9246935201401,7.267950963222416,1.4010507880910683,0.17513134851138354
18,충청북도,진천군,덕산읍,덕산읍제5투,2009,1333,700,491,120,13,1,1325,8,676,52.83018867924528,37.056603773584904,9.056603773584905,0.9811320754716981,0.07547169811320754
19,충청북도,진천군,덕산읍,덕산읍제6투,3840,2653,1414,966,228,26,0,2634,19,1187,53.68261199696279,36.674259681093396,8.656036446469248,0.9870918754745633,0.0
20,충청북도,진천군,덕산읍,덕산읍제7투,1404,888,446,349,70,16,0,881,7,516,50.62429057888763,39.61407491486947,7.945516458569807,1.8161180476730987,0.0
21,충청북도,진천군,초평면,관내사전투표,883,883,507,303,48,14,1,873,10,0,58.075601374570454,34.707903780068726,5.498281786941581,1.6036655211912942,0.11454753722794961
22,충청북도,진천군,초평면,초평면제1투,1086,681,242,405,21,7,1,676,5,405,35.798816568047336,59.9112426035503,3.106508875739645,1.0355029585798818,0.14792899408284024
23,충청북도,진천군,초평면,초평면제2투,657,426,110,293,17,3,0,423,3,231,26.004728132387704,69.26713947990544,4.0189125295508275,0.7092198581560284,0.0
24,충청북도,진천군,문백면,관내사전투표,722,722,417,256,37,6,4,720,2,0,57.91666666666667,35.55555555555556,5.138888888888888,0.8333333333333334,0.5555555555555556
25,충청북도,진천군,문백면,문백면제1투,1179,699,221,420,46,8,3,698,1,480,31.661891117478508,60.17191977077364,6.59025787965616,1.146131805157593,0.42979942693409745
26,충청북도,진천군,문백면,문백면제2투,950,645,230,377,22,6,1,636,9,305,36.16352201257861,59.27672955974843,3.459119496855346,0.9433962264150944,0.15723270440251574
27,충청북도,진천군,백곡면,관내사전투표,738,738,378,315,31,9,1,734,4,0,51.49863760217984,42.915531335149865,4.223433242506812,1.226158038147139,0.13623978201634876
28,충청북도,진천군,백곡면,백곡면투표소,1133,764,172,556,29,4,0,761,3,369,22.601839684625492,73.06176084099869,3.8107752956636007,0.5256241787122208,0.0
29,충청북도,진천군,이월면,관내사전투표,1967,1967,1204,617,123,12,3,1959,8,0,61.45992853496682,31.495661051556915,6.278713629402756,0.6125574272588056,0.1531393568147014
30,충청북도,진천군,이월면,이월면제1투,2084,1258,415,725,90,13,3,1246,12,826,33.30658105939005,58.18619582664526,7.223113964686998,1.043338683788122,0.2407704654895666
31,충청북도,진천군,이월면,이월면제2투,1631,956,349,531,60,9,3,952,4,675,36.659663865546214,55.77731092436975,6.302521008403361,0.9453781512605042,0.31512605042016806
32,충청북도,진천군,광혜원면,관내사전투표,3177,3177,2034,874,227,20,4,3159,18,0,64.38746438746439,27.666983222538775,7.185818296929408,0.6331117442228553,0.12662234884457108
33,충청북도,진천군,광혜원면,광혜원면제1투,1707,950,315,563,58,7,1,944,6,757,33.36864406779661,59.63983050847458,6.1440677966101696,0.7415254237288136,0.1059322033898305
34,충청북도,진천군,광혜원면,광혜원면제2투,1961,1045,426,505,83,16,3,1033,12,916,41.23910939012585,48.88673765730881,8.03484995159729,1.5488867376573088,0.29041626331074544
35,충청북도,진천군,광혜원면,광혜원면제3투,1909,1179,498,564,103,11,1,1177,2,730,42.31096006796942,47.91843670348343,8.75106202209006,0.9345794392523363,0.08496176720475786
36,충청북도,진천군,잘못 투입·구분된 투표지,,0,0,0,0,0,0,0,0,0,0,0.0,0.0,0.0,0.0,0.0
0,충청북도,괴산군,거소·선상투표,,93,88,31,39,10,2,1,83,5,5,37.34939759036144,46.98795180722892,12.048192771084338,2.4096385542168677,1.2048192771084338
1,충청북도,괴산군,관외사전투표,,3530,3530,1807,1358,288,48,4,3505,25,0,51.55492154065621,38.744650499286735,8.216833095577746,1.369472182596291,0.11412268188302425
2,충청북도,괴산군,재외투표,,127,110,78,21,9,0,0,108,2,17,72.22222222222221,19.444444444444446,8.333333333333332,0.0,0.0
3,충청북도,괴산군,괴산읍,관내사전투표,2996,2996,1707,1032,196,34,5,2974,22,0,57.39744451916611,34.700739744451916,6.590450571620712,1.1432414256893073,0.16812373907195696
4,충청북도,괴산군,괴산읍,괴산읍제1투,2174,1363,435,846,59,11,0,1351,12,811,32.198371576609915,62.62028127313102,4.3671354552183566,0.8142116950407106,0.0
5,충청북도,괴산군,괴산읍,괴산읍제2투,1415,914,247,584,72,7,0,910,4,501,27.142857142857142,64.17582417582418,7.9120879120879115,0.7692307692307693,0.0
6,충청북도,괴산군,괴산읍,괴산읍제3투,1048,604,166,391,37,7,1,602,2,444,27.57475083056478,64.95016611295681,6.146179401993355,1.1627906976744187,0.16611295681063123
7,충청북도,괴산군,감물면,관내사전투표,489,489,242,220,12,14,0,488,1,0,49.59016393442623,45.08196721311475,2.459016393442623,2.8688524590163933,0.0
8,충청북도,괴산군,감물면,감물면투표소,1108,732,191,496,23,14,1,725,7,376,26.344827586206897,68.41379310344827,3.1724137931034484,1.9310344827586208,0.13793103448275862
9,충청북도,괴산군,장연면,관내사전투표,532,532,235,275,14,4,1,529,3,0,44.423440453686204,51.98487712665406,2.6465028355387523,0.7561436672967864,0.1890359168241966
10,충청북도,괴산군,장연면,장연면투표소,961,619,153,443,15,4,0,615,4,342,24.878048780487806,72.03252032520325,2.4390243902439024,0.6504065040650406,0.0
11,충청북도,괴산군,연풍면,관내사전투표,729,729,321,372,29,2,1,725,4,0,44.275862068965516,51.310344827586206,4.0,0.27586206896551724,0.13793103448275862
12,충청북도,괴산군,연풍면,연풍면투표소,1081,675,165,482,19,4,0,670,5,406,24.62686567164179,71.94029850746269,2.8358208955223883,0.5970149253731344,0.0
13,충청북도,괴산군,칠성면,관내사전투표,1082,1082,562,452,46,7,3,1070,12,0,52.523364485981304,42.242990654205606,4.299065420560748,0.6542056074766356,0.2803738317757009
14,충청북도,괴산군,칠성면,칠성면투표소,1531,962,272,635,37,9,3,956,6,569,28.451882845188287,66.42259414225941,3.8702928870292883,0.9414225941422595,0.3138075313807531
15,충청북도,괴산군,문광면,관내사전투표,865,865,463,352,35,6,0,856,9,0,54.08878504672897,41.1214953271028,4.0887850467289715,0.7009345794392523,0.0
16,충청북도,괴산군,문광면,문광면투표소,1143,720,233,448,23,8,0,712,8,423,32.7247191011236,62.92134831460674,3.2303370786516856,1.1235955056179776,0.0
17,충청북도,괴산군,청천면,관내사전투표,1103,1103,508,526,31,10,3,1078,25,0,47.124304267161406,48.79406307977737,2.87569573283859,0.927643784786642,0.27829313543599254
18,충청북도,괴산군,청천면,청천면제1투,1615,1021,223,749,32,7,0,1011,10,594,22.05736894164194,74.08506429277942,3.165182987141444,0.6923837784371909,0.0
19,충청북도,괴산군,청천면,청천면제2투,548,401,117,278,5,0,0,400,1,147,29.25,69.5,1.25,0.0,0.0
20,충청북도,괴산군,청천면,청천면제3투,736,566,196,349,9,7,0,561,5,170,34.93761140819964,62.21033868092691,1.6042780748663104,1.2477718360071302,0.0
21,충청북도,괴산군,청안면,관내사전투표,761,761,375,344,29,3,2,753,8,0,49.800796812749006,45.68393094289508,3.851261620185923,0.398406374501992,0.2656042496679947
22,충청북도,괴산군,청안면,청안면제1투,940,542,156,355,26,3,0,540,2,398,28.888888888888886,65.74074074074075,4.814814814814815,0.5555555555555556,0.0
23,충청북도,괴산군,청안면,청안면제2투,842,592,166,407,13,3,0,589,3,250,28.183361629881155,69.10016977928693,2.2071307300509337,0.5093378607809848,0.0
24,충청북도,괴산군,사리면,관내사전투표,696,696,338,322,22,8,0,690,6,0,48.98550724637681,46.666666666666664,3.1884057971014492,1.1594202898550725,0.0
25,충청북도,괴산군,사리면,사리면제1투,859,544,159,356,20,2,0,537,7,315,29.608938547486037,66.29422718808193,3.7243947858473,0.37243947858473,0.0
26,충청북도,괴산군,사리면,사리면제2투,523,357,89,253,10,1,0,353,4,166,25.21246458923513,71.671388101983,2.8328611898017,0.28328611898017,0.0
27,충청북도,괴산군,소수면,관내사전투표,650,650,370,245,28,2,2,647,3,0,57.18701700154559,37.86707882534776,4.327666151468315,0.3091190108191654,0.3091190108191654
28,충청북도,괴산군,소수면,소수면투표소,1070,674,223,423,22,0,1,669,5,396,33.33333333333333,63.22869955156951,3.288490284005979,0.0,0.14947683109118087
29,충청북도,괴산군,불정면,관내사전투표,793,793,383,347,49,7,0,786,7,0,48.72773536895674,44.14758269720102,6.23409669211196,0.8905852417302799,0.0
30,충청북도,괴산군,불정면,불정면투표소,1488,970,247,680,32,6,1,966,4,518,25.56935817805383,70.39337474120083,3.3126293995859215,0.6211180124223602,0.10351966873706005
31,충청북도,괴산군,잘못 투입·구분된 투표지,,0,0,0,0,0,0,0,0,0,0,0.0,0.0,0.0,0.0,0.0
0,충청북도,증평군,거소·선상투표,,54,52,19,24,7,0,1,51,1,2,37.254901960784316,47.05882352941176,13.725490196078432,0.0,1.9607843137254901
1,충청북도,증평군,관외사전투표,,2980,2979,1649,880,375,26,5,2935,44,1,56.1839863713799,29.982964224872234,12.776831345826235,0.8858603066439523,0.17035775127768313
2,충청북도,증평군,재외투표,,98,79,49,14,14,2,0,79,0,19,62.0253164556962,17.72151898734177,17.72151898734177,2.5316455696202533,0.0
3,충청북도,증평군,증평읍,관내사전투표,7858,7858,4768,2378,568,69,9,7792,66,0,61.19096509240246,30.518480492813143,7.289527720739219,0.8855236139630389,0.11550308008213553
4,충청북도,증평군,증평읍,증평읍제1투,1629,985,336,566,65,12,2,981,4,644,34.25076452599388,57.696228338430174,6.625891946992865,1.2232415902140672,0.20387359836901123
5,충청북도,증평군,증평읍,증평읍제2투,1578,925,331,548,34,7,0,920,5,653,35.97826086956522,59.56521739130435,3.6956521739130435,0.7608695652173914,0.0
6,충청북도,증평군,증평읍,증평읍제3투,1692,1053,306,677,49,10,3,1045,8,639,29.282296650717704,64.7846889952153,4.688995215311005,0.9569377990430622,0.28708133971291866
7,충청북도,증평군,증평읍,증평읍제4투,2543,1356,522,692,117,12,6,1349,7,1187,38.695329873980725,51.29725722757599,8.673091178650852,0.8895478131949592,0.4447739065974796
8,충청북도,증평군,증평읍,증평읍제5투,1883,1231,469,659,79,11,1,1219,12,652,38.47415914684167,54.06070549630845,6.480721903199344,0.9023789991796556,0.08203445447087777
9,충청북도,증평군,증평읍,증평읍제6투,1719,1116,521,483,85,17,1,1107,9,603,47.06413730803975,43.63143631436314,7.678410117434507,1.5356820234869015,0.09033423667570009
10,충청북도,증평군,증평읍,증평읍제7투,1727,1026,312,594,93,13,2,1014,12,701,30.76923076923077,58.57988165680473,9.171597633136095,1.282051282051282,0.19723865877712032
11,충청북도,증평군,증평읍,증평읍제8투,1120,742,230,468,37,2,2,739,3,378,31.123139377537214,63.32882273342354,5.006765899864682,0.2706359945872801,0.2706359945872801
12,충청북도,증평군,증평읍,증평읍제9투,2701,1716,691,856,141,11,5,1704,12,985,40.551643192488264,50.23474178403756,8.274647887323944,0.6455399061032864,0.2934272300469483
13,충청북도,증평군,증평읍,증평읍제10투,2757,1655,668,804,147,22,4,1645,10,1102,40.60790273556231,48.87537993920973,8.936170212765958,1.337386018237082,0.24316109422492402
14,충청북도,증평군,도안면,관내사전투표,577,577,326,218,23,3,0,570,7,0,57.19298245614035,38.24561403508772,4.035087719298246,0.5263157894736842,0.0
15,충청북도,증평군,도안면,도안면투표소,1012,645,188,429,20,5,0,642,3,367,29.283489096573206,66.82242990654206,3.115264797507788,0.778816199376947,0.0
16,충청북도,증평군,잘못 투입·구분된 투표지,,0,0,0,0,0,0,0,0,0,0,0.0,0.0,0.0,0.0,0.0
0,충청북도,청주시서원구,거소·선상투표,,315,303,119,100,61,4,2,286,17,12,41.60839160839161,34.96503496503497,21.328671328671327,1.3986013986013985,0.6993006993006993
1,충청북도,청주시서원구,관외사전투표,,16507,16507,9420,4386,2312,201,19,16338,169,0,57.656995960337866,26.8453911127433,14.151058881136002,1.2302607418288651,0.11629330395397233
2,충청북도,청주시서원구,재외투표,,587,462,312,79,59,5,1,456,6,125,68.42105263157895,17.324561403508774,12.938596491228072,1.0964912280701753,0.21929824561403508
3,충청북도,청주시서원구,남이면,관내사전투표,1569,1569,905,567,79,9,2,1562,7,0,57.93854033290653,36.29961587708067,5.057618437900127,0.5761843790012804,0.12804097311139565
4,충청북도,청주시서원구,남이면,남이면제1투,1881,1087,281,747,42,8,3,1081,6,794,25.994449583718783,69.10268270120258,3.885291396854764,0.7400555041628123,0.27752081406105455
5,충청북도,청주시서원구,남이면,남이면제2투,836,556,206,311,30,5,2,554,2,280,37.18411552346571,56.13718411552347,5.415162454873646,0.9025270758122743,0.36101083032490977
6,충청북도,청주시서원구,남이면,남이면제3투,1271,879,255,547,65,5,0,872,7,392,29.243119266055047,62.72935779816514,7.454128440366972,0.573394495412844,0.0
7,충청북도,청주시서원구,남이면,남이면제4투,1966,1574,746,670,128,22,1,1567,7,392,47.60689215060626,42.756860242501595,8.168474792597321,1.4039566049776642,0.06381620931716657
8,충청북도,청주시서원구,현도면,관내사전투표,658,658,325,292,31,5,0,653,5,0,49.77029096477795,44.716692189892804,4.747320061255743,0.7656967840735069,0.0
9,충청북도,청주시서원구,현도면,현도면제1투,1042,689,179,477,20,5,1,682,7,353,26.24633431085044,69.94134897360705,2.932551319648094,0.7331378299120235,0.1466275659824047
10,충청북도,청주시서원구,현도면,현도면제2투,772,405,116,267,14,6,0,403,2,367,28.78411910669975,66.25310173697271,3.4739454094292808,1.488833746898263,0.0
11,충청북도,청주시서원구,사직제1동,관내사전투표,744,744,449,239,47,6,0,741,3,0,60.59379217273953,32.25371120107962,6.342780026990553,0.8097165991902834,0.0
12,충청북도,청주시서원구,사직제1동,사직제1동제1투,1090,601,187,369,39,2,1,598,3,489,31.270903010033447,61.7056856187291,6.521739130434782,0.33444816053511706,0.16722408026755853
13,충청북도,청주시서원구,사직제1동,사직제1동제2투,1607,1210,430,695,59,14,0,1198,12,397,35.89315525876461,58.01335559265443,4.924874791318865,1.1686143572621035,0.0
14,충청북도,청주시서원구,사직제2동,관내사전투표,1250,1250,732,379,112,16,2,1241,9,0,58.98468976631749,30.539887187751813,9.024979854955681,1.2892828364222402,0.16116035455278002
15,충청북도,청주시서원구,사직제2동,사직제2동제1투,1030,594,178,358,44,7,2,589,5,436,30.220713073005097,60.78098471986417,7.470288624787775,1.1884550084889642,0.3395585738539898
16,충청북도,청주시서원구,사직제2동,사직제2동제2투,2808,2235,779,1252,167,28,2,2228,7,573,34.964093357271096,56.193895870736085,7.495511669658887,1.2567324955116697,0.08976660682226212
17,충청북도,청주시서원구,사직제2동,사직제2동제3투,2485,1965,775,990,162,18,3,1948,17,520,39.78439425051335,50.82135523613963,8.316221765913758,0.9240246406570842,0.1540041067761807
18,충청북도,청주시서원구,사창동,관내사전투표,4755,4755,2638,1360,663,55,1,4717,38,0,55.92537629849481,28.83188467246131,14.055543777824889,1.165995336018656,0.0211999152003392
19,충청북도,청주시서원구,사창동,사창동제1투,2903,1634,505,862,229,17,0,1613,21,1269,31.308121512709235,53.44079355238686,14.197148171109733,1.0539367637941723,0.0
20,충청북도,청주시서원구,사창동,사창동제2투,2256,1492,483,854,126,15,0,1478,14,764,32.67929634641407,57.7807848443843,8.525033829499323,1.0148849797023005,0.0
21,충청북도,청주시서원구,사창동,사창동제3투,2393,1519,465,929,100,13,1,1508,11,874,30.83554376657825,61.604774535809014,6.631299734748011,0.8620689655172413,0.0663129973474801
22,충청북도,청주시서원구,사창동,사창동제4투,1592,991,294,563,115,9,1,982,9,601,29.938900203665987,57.331975560081474,11.710794297352342,0.9164969450101833,0.10183299389002036
23,충청북도,청주시서원구,모충동,관내사전투표,2258,2258,1238,714,260,26,2,2240,18,0,55.267857142857146,31.874999999999996,11.607142857142858,1.1607142857142858,0.08928571428571429
24,충청북도,청주시서원구,모충동,모충동제1투,1828,1135,385,639,89,13,2,1128,7,693,34.13120567375886,56.64893617021277,7.890070921985816,1.152482269503546,0.1773049645390071
25,충청북도,청주시서원구,모충동,모충동제2투,1537,848,245,505,79,8,2,839,9,689,29.201430274135877,60.1907032181168,9.415971394517282,0.9535160905840285,0.23837902264600713
26,충청북도,청주시서원구,모충동,모충동제3투,2881,1936,759,1003,146,15,2,1925,11,945,39.42857142857143,52.103896103896105,7.584415584415584,0.7792207792207793,0.1038961038961039
27,충청북도,청주시서원구,모충동,모충동제4투,2159,1295,360,805,110,11,2,1288,7,864,27.95031055900621,62.5,8.540372670807454,0.8540372670807453,0.15527950310559005
28,충청북도,청주시서원구,모충동,모충동제5투,2361,1804,740,834,197,24,1,1796,8,557,41.202672605790646,46.43652561247216,10.96881959910913,1.3363028953229399,0.05567928730512249
29,충청북도,청주시서원구,산남동,관내사전투표,4338,4338,2979,972,300,54,4,4309,29,0,69.1343699234161,22.557437920631237,6.96217219772569,1.2531909955906242,0.09282896263634255
30,충청북도,청주시서원구,산남동,산남동제1투,2340,1456,542,770,114,14,3,1443,13,884,37.56063756063756,53.36105336105336,7.900207900207901,0.9702009702009702,0.2079002079002079
31,충청북도,청주시서원구,산남동,산남동제2투,2345,1605,549,923,102,14,1,1589,16,740,34.55003146633103,58.08684707363121,6.419131529263687,0.881057268722467,0.06293266205160479
32,충청북도,청주시서원구,산남동,산남동제3투,3173,2281,1073,962,198,35,1,2269,12,892,47.28955486998678,42.39753195240194,8.72631115028647,1.5425297487880123,0.044072278536800354
33,충청북도,청주시서원구,산남동,산남동제4투,2962,2039,796,985,222,23,4,2030,9,923,39.21182266009852,48.52216748768473,10.935960591133005,1.1330049261083743,0.19704433497536944
34,충청북도,청주시서원구,산남동,산남동제5투,2779,2055,989,834,187,29,3,2042,13,724,48.432908912830555,40.842311459353574,9.157688540646426,1.4201762977473065,0.14691478942213515
35,충청북도,청주시서원구,분평동,관내사전투표,6540,6540,4240,1699,481,71,6,6497,43,0,65.26088964137294,26.1505310143143,7.403416961674619,1.092812067107896,0.09235031553024474
36,충청북도,청주시서원구,분평동,분평동제1투,673,422,136,262,21,1,1,421,1,251,32.304038004750595,62.23277909738717,4.98812351543943,0.23752969121140144,0.23752969121140144
37,충청북도,청주시서원구,분평동,분평동제2투,3303,2311,981,1081,196,30,3,2291,20,992,42.81972937581842,47.1846355303361,8.555216062854647,1.3094718463553032,0.13094718463553034
38,충청북도,청주시서원구,분평동,분평동제3투,3626,2404,1033,1115,205,33,2,2388,16,1222,43.25795644891122,46.69179229480737,8.58458961474037,1.3819095477386936,0.08375209380234507
39,충청북도,청주시서원구,분평동,분평동제4투,3073,2163,977,964,182,28,1,2152,11,910,45.399628252788105,44.795539033457246,8.45724907063197,1.3011152416356877,0.046468401486988845
40,충청북도,청주시서원구,분평동,분평동제5투,2359,1532,523,827,141,26,2,1519,13,827,34.43054641211323,54.44371296905859,9.282422646477945,1.7116524028966424,0.13166556945358787
41,충청북도,청주시서원구,분평동,분평동제6투,2260,1620,660,781,154,15,2,1612,8,640,40.94292803970223,48.44913151364764,9.553349875930522,0.9305210918114143,0.12406947890818859
42,충청북도,청주시서원구,수곡제1동,관내사전투표,2497,2497,1481,775,185,34,3,2478,19,0,59.76594027441485,31.275221953188055,7.465698143664246,1.3720742534301855,0.12106537530266344
43,충청북도,청주시서원구,수곡제1동,수곡제1동제1투,2075,1279,481,683,92,12,1,1269,10,796,37.903861308116625,53.82190701339638,7.249802994483845,0.9456264775413712,0.07880220646178093
44,충청북도,청주시서원구,수곡제1동,수곡제1동제2투,2009,1219,416,681,100,9,3,1209,10,790,34.40860215053764,56.32754342431762,8.271298593879239,0.7444168734491315,0.24813895781637718
45,충청북도,청주시서원구,수곡제1동,수곡제1동제3투,2050,1244,381,768,73,14,0,1236,8,806,30.8252427184466,62.13592233009708,5.906148867313916,1.132686084142395,0.0
46,충청북도,청주시서원구,수곡제1동,수곡제1동제4투,1914,1253,424,726,76,18,0,1244,9,661,34.08360128617363,58.36012861736335,6.109324758842444,1.4469453376205788,0.0
47,충청북도,청주시서원구,수곡제2동,관내사전투표,3705,3705,2141,1262,238,36,1,3678,27,0,58.21098423056009,34.3121261555193,6.4709081022294725,0.9787928221859705,0.02718868950516585
48,충청북도,청주시서원구,수곡제2동,수곡제2동제1투,2479,1590,556,905,97,16,6,1580,10,889,35.189873417721515,57.27848101265823,6.139240506329114,1.0126582278481013,0.37974683544303794
49,충청북도,청주시서원구,수곡제2동,수곡제2동제2투,2020,1286,418,755,86,14,2,1275,11,734,32.78431372549019,59.21568627450981,6.745098039215685,1.0980392156862746,0.1568627450980392
50,충청북도,청주시서원구,수곡제2동,수곡제2동제3투,2560,1592,493,984,83,11,5,1576,16,968,31.281725888324875,62.43654822335025,5.2664974619289335,0.6979695431472082,0.31725888324873097
51,충청북도,청주시서원구,수곡제2동,수곡제2동제4투,1664,1396,610,625,135,20,0,1390,6,268,43.884892086330936,44.96402877697842,9.712230215827338,1.4388489208633095,0.0
52,충청북도,청주시서원구,성화·개신·죽림동,관내사전투표,6002,6002,3827,1613,470,56,4,5970,32,0,64.10385259631491,27.018425460636514,7.872696817420436,0.9380234505862647,0.06700167504187605
53,충청북도,청주시서원구,성화·개신·죽림동,성화·개신·죽림동제1투,3193,2089,911,980,171,12,1,2075,14,1104,43.903614457831324,47.2289156626506,8.240963855421688,0.5783132530120482,0.048192771084337345
54,충청북도,청주시서원구,성화·개신·죽림동,성화·개신·죽림동제2투,2434,1810,550,1044,187,14,2,1797,13,624,30.60656649972176,58.09682804674458,10.406232609905398,0.7790762381747357,0.11129660545353368
55,충청북도,청주시서원구,성화·개신·죽림동,성화·개신·죽림동제3투,2604,1720,530,971,184,21,2,1708,12,884,31.030444964871194,56.850117096018735,10.772833723653395,1.2295081967213115,0.117096018735363
56,충청북도,청주시서원구,성화·개신·죽림동,성화·개신·죽림동제4투,3047,2318,1103,971,201,22,3,2300,18,729,47.95652173913044,42.21739130434783,8.73913043478261,0.9565217391304347,0.13043478260869568
57,충청북도,청주시서원구,성화·개신·죽림동,성화·개신·죽림동제5투,2774,1995,824,889,235,26,5,1979,16,779,41.63719050025265,44.92167761495705,11.874684183931278,1.3137948458817585,0.25265285497726125
58,충청북도,청주시서원구,성화·개신·죽림동,성화·개신·죽림동제6투,1990,1426,639,638,127,12,1,1417,9,564,45.09527170077629,45.02470007057163,8.962597035991532,0.8468595624558928,0.07057163020465773
59,충청북도,청주시서원구,성화·개신·죽림동,성화·개신·죽림동제7투,1905,1141,449,594,78,12,1,1134,7,764,39.59435626102293,52.38095238095239,6.878306878306878,1.0582010582010581,0.08818342151675485
60,충청북도,청주시서원구,성화·개신·죽림동,성화·개신·죽림동제8투,2342,1516,651,666,170,21,1,1509,7,826,43.141153081510936,44.135188866799204,11.26573889993373,1.3916500994035785,0.06626905235255136
61,충청북도,청주시서원구,성화·개신·죽림동,성화·개신·죽림동제9투,1983,1156,460,590,88,15,1,1154,2,827,39.86135181975737,51.12651646447141,7.625649913344887,1.2998266897746966,0.08665511265164644
62,충청북도,청주시서원구,성화·개신·죽림동,성화·개신·죽림동제10투,2053,1579,771,627,151,23,0,1572,7,474,49.04580152671756,39.88549618320611,9.60559796437659,1.4631043256997456,0.0
63,충청북도,청주시서원구,잘못 투입·구분된 투표지,,0,0,0,0,0,0,0,0,0,0,0.0,0.0,0.0,0.0,0.0
0,충청남도,공주시,거소·선상투표,,150,143,50,59,33,0,0,142,1,7,35.2112676056338,41.54929577464789,23.239436619718308,0.0,0.0
1,충청남도,공주시,관외사전투표,,7706,7706,4194,2432,909,72,9,7616,90,0,55.06827731092437,31.932773109243694,11.935399159663866,0.9453781512605042,0.11817226890756302
2,충청남도,공주시,재외투표,,437,357,243,83,28,3,0,357,0,80,68.0672268907563,23.249299719887954,7.8431372549019605,0.8403361344537815,0.0
3,충청남도,공주시,유구읍,관내사전투표,1489,1489,787,628,56,11,0,1482,7,0,53.103913630229414,42.37516869095816,3.7786774628879893,0.7422402159244265,0.0
4,충청남도,공주시,유구읍,유구읍제1투,2097,1373,331,983,44,4,2,1364,9,724,24.266862170087975,72.0674486803519,3.225806451612903,0.2932551319648094,0.1466275659824047
5,충청남도,공주시,유구읍,유구읍제2투,1442,990,257,688,34,2,1,982,8,452,26.171079429735233,70.06109979633402,3.462321792260693,0.20366598778004072,0.10183299389002036
6,충청남도,공주시,유구읍,유구읍제3투,963,639,150,462,19,1,2,634,5,324,23.65930599369085,72.87066246056783,2.996845425867508,0.15772870662460567,0.31545741324921134
7,충청남도,공주시,이인면,관내사전투표,740,740,407,294,28,5,0,734,6,0,55.449591280653955,40.05449591280654,3.8147138964577656,0.6811989100817438,0.0
8,충청남도,공주시,이인면,이인면제1투,934,583,152,413,10,5,0,580,3,351,26.20689655172414,71.20689655172414,1.7241379310344827,0.8620689655172413,0.0
9,충청남도,공주시,이인면,이인면제2투,906,602,182,389,21,4,1,597,5,304,30.485762144053602,65.15912897822446,3.5175879396984926,0.6700167504187605,0.16750418760469013
10,충청남도,공주시,탄천면,관내사전투표,640,640,332,238,36,3,5,614,26,0,54.071661237785015,38.762214983713356,5.863192182410423,0.4885993485342019,0.8143322475570033
11,충청남도,공주시,탄천면,탄천면제1투,1072,626,188,404,18,4,2,616,10,446,30.519480519480517,65.5844155844156,2.922077922077922,0.6493506493506493,0.3246753246753247
12,충청남도,공주시,탄천면,탄천면제2투,643,405,121,262,16,3,0,402,3,238,30.09950248756219,65.17412935323384,3.9800995024875623,0.7462686567164178,0.0
13,충청남도,공주시,계룡면,관내사전투표,1191,1191,674,461,39,2,3,1179,12,0,57.167090754877016,39.10093299406277,3.307888040712468,0.16963528413910092,0.2544529262086514
14,충청남도,공주시,계룡면,계룡면제1투,1044,662,195,432,24,4,2,657,5,382,29.68036529680365,65.75342465753424,3.65296803652968,0.60882800608828,0.30441400304414
15,충청남도,공주시,계룡면,계룡면제2투,402,278,84,183,6,2,0,275,3,124,30.545454545454547,66.54545454545455,2.181818181818182,0.7272727272727273,0.0
16,충청남도,공주시,계룡면,계룡면제3투,653,432,106,299,17,6,1,429,3,221,24.708624708624708,69.6969696969697,3.9627039627039626,1.3986013986013985,0.2331002331002331
17,충청남도,공주시,계룡면,계룡면제4투,1019,626,217,381,21,4,2,625,1,393,34.72,60.96,3.36,0.64,0.32
18,충청남도,공주시,반포면,관내사전투표,907,907,525,327,46,5,0,903,4,0,58.139534883720934,36.21262458471761,5.094130675526024,0.5537098560354374,0.0
19,충청남도,공주시,반포면,반포면제1투,1398,884,221,613,27,4,1,866,18,514,25.519630484988454,70.78521939953811,3.117782909930716,0.4618937644341801,0.11547344110854503
20,충청남도,공주시,반포면,반포면제2투,1024,675,171,480,16,4,0,671,4,349,25.48435171385991,71.53502235469449,2.384500745156483,0.5961251862891207,0.0
21,충청남도,공주시,의당면,관내사전투표,1657,1657,1031,518,85,10,0,1644,13,0,62.71289537712895,31.508515815085158,5.170316301703163,0.6082725060827251,0.0
22,충청남도,공주시,의당면,의당면제1투,1336,780,283,455,32,5,1,776,4,556,36.46907216494845,58.634020618556704,4.123711340206185,0.6443298969072164,0.12886597938144329
23,충청남도,공주시,의당면,의당면제2투,502,356,125,214,14,2,1,356,0,146,35.1123595505618,60.1123595505618,3.932584269662921,0.5617977528089888,0.2808988764044944
24,충청남도,공주시,의당면,의당면제3투,695,444,128,289,15,4,1,437,7,251,29.290617848970253,66.13272311212815,3.4324942791762014,0.9153318077803204,0.2288329519450801
25,충청남도,공주시,정안면,관내사전투표,1172,1172,642,446,71,5,0,1164,8,0,55.154639175257735,38.31615120274915,6.099656357388316,0.429553264604811,0.0
26,충청남도,공주시,정안면,정안면제1투,835,488,94,358,27,2,1,482,6,347,19.502074688796682,74.27385892116183,5.601659751037345,0.4149377593360996,0.2074688796680498
27,충청남도,공주시,정안면,정안면제2투,668,448,121,312,12,3,0,448,0,220,27.00892857142857,69.64285714285714,2.6785714285714284,0.6696428571428571,0.0
28,충청남도,공주시,정안면,정안면제3투,1172,700,212,454,24,3,1,694,6,472,30.547550432276655,65.4178674351585,3.45821325648415,0.43227665706051877,0.1440922190201729
29,충청남도,공주시,우성면,관내사전투표,851,851,516,273,50,7,1,847,4,0,60.92089728453365,32.231404958677686,5.90318772136954,0.8264462809917356,0.11806375442739078
30,충청남도,공주시,우성면,우성면제1투,681,427,129,285,9,1,0,424,3,254,30.424528301886795,67.21698113207547,2.1226415094339623,0.2358490566037736,0.0
31,충청남도,공주시,우성면,우성면제2투,837,561,160,377,17,2,2,558,3,276,28.673835125448026,67.56272401433692,3.046594982078853,0.35842293906810035,0.35842293906810035
32,충청남도,공주시,우성면,우성면제3투,1060,723,267,423,23,4,1,718,5,337,37.1866295264624,58.91364902506964,3.203342618384401,0.5571030640668524,0.1392757660167131
33,충청남도,공주시,우성면,우성면제4투,631,417,117,278,15,0,3,413,4,214,28.329297820823246,67.31234866828088,3.631961259079903,0.0,0.7263922518159807
34,충청남도,공주시,사곡면,관내사전투표,648,648,336,266,38,2,1,643,5,0,52.255054432348366,41.368584758942454,5.909797822706065,0.3110419906687403,0.15552099533437014
35,충청남도,공주시,사곡면,사곡면제1투,892,533,125,381,21,3,1,531,2,359,23.540489642184557,71.75141242937853,3.954802259887006,0.5649717514124294,0.18832391713747645
36,충청남도,공주시,사곡면,사곡면제2투,685,464,165,275,18,1,1,460,4,221,35.869565217391305,59.78260869565217,3.91304347826087,0.21739130434782608,0.21739130434782608
37,충청남도,공주시,신풍면,관내사전투표,751,751,375,343,24,3,0,745,6,0,50.33557046979866,46.04026845637584,3.2214765100671143,0.4026845637583893,0.0
38,충청남도,공주시,신풍면,신풍면제1투,1098,680,176,467,32,2,0,677,3,418,25.997045790251107,68.98079763663219,4.726735598227474,0.29542097488921715,0.0
39,충청남도,공주시,신풍면,신풍면제2투,527,347,108,220,17,2,0,347,0,180,31.12391930835735,63.40057636887608,4.899135446685879,0.5763688760806917,0.0
40,충청남도,공주시,중학동,관내사전투표,1284,1284,798,357,107,11,0,1273,11,0,62.68656716417911,28.043990573448546,8.40534171249018,0.864100549882168,0.0
41,충청남도,공주시,중학동,중학동제1투,491,313,103,188,17,3,0,311,2,178,33.11897106109325,60.45016077170418,5.466237942122187,0.964630225080386,0.0
42,충청남도,공주시,중학동,중학동제2투,632,426,112,275,34,2,0,423,3,206,26.47754137115839,65.01182033096927,8.037825059101655,0.4728132387706856,0.0
43,충청남도,공주시,중학동,중학동제3투,780,516,164,310,37,3,0,514,2,264,31.906614785992215,60.311284046692606,7.198443579766536,0.5836575875486382,0.0
44,충청남도,공주시,중학동,중학동제4투,652,410,148,234,19,5,0,406,4,242,36.45320197044335,57.635467980295566,4.679802955665025,1.2315270935960592,0.0
45,충청남도,공주시,웅진동,관내사전투표,2614,2614,1498,932,148,16,5,2599,15,0,57.63755290496345,35.859946133128126,5.694497883801462,0.6156213928434013,0.19238168526356292
46,충청남도,공주시,웅진동,웅진동제1투,630,392,125,245,15,3,0,388,4,238,32.21649484536083,63.144329896907216,3.865979381443299,0.7731958762886598,0.0
47,충청남도,공주시,웅진동,웅진동제2투,754,431,110,302,13,3,0,428,3,323,25.70093457943925,70.56074766355141,3.0373831775700935,0.7009345794392523,0.0
48,충청남도,공주시,웅진동,웅진동제3투,1320,858,250,547,49,6,0,852,6,462,29.342723004694836,64.2018779342723,5.751173708920188,0.7042253521126761,0.0
49,충청남도,공주시,웅진동,웅진동제4투,1389,857,328,458,58,5,1,850,7,532,38.588235294117645,53.88235294117647,6.8235294117647065,0.5882352941176471,0.1176470588235294
50,충청남도,공주시,금학동,관내사전투표,1526,1526,913,406,173,17,2,1511,15,0,60.42356055592323,26.86962276637988,11.4493712772998,1.1250827266710788,0.13236267372600927
51,충청남도,공주시,금학동,금학동제1투,1900,1229,420,667,103,19,1,1210,19,671,34.710743801652896,55.12396694214876,8.512396694214877,1.5702479338842976,0.08264462809917356
52,충청남도,공주시,금학동,금학동제2투,940,524,165,331,20,1,4,521,3,416,31.669865642994242,63.53166986564299,3.8387715930902107,0.19193857965451055,0.7677543186180422
53,충청남도,공주시,옥룡동,관내사전투표,1909,1909,1088,714,90,9,1,1902,7,0,57.202944269190326,37.53943217665615,4.73186119873817,0.47318611987381703,0.052576235541535225
54,충청남도,공주시,옥룡동,옥룡동제1투,804,493,129,333,22,3,1,488,5,311,26.434426229508194,68.23770491803278,4.508196721311475,0.6147540983606558,0.20491803278688525
55,충청남도,공주시,옥룡동,옥룡동제2투,1625,941,298,582,50,3,1,934,7,684,31.905781584582442,62.31263383297645,5.353319057815846,0.32119914346895073,0.10706638115631692
56,충청남도,공주시,옥룡동,옥룡동제3투,1026,670,258,371,34,2,2,667,3,356,38.68065967016492,55.62218890554723,5.097451274362818,0.29985007496251875,0.29985007496251875
57,충청남도,공주시,옥룡동,옥룡동제4투,818,492,145,324,16,1,3,489,3,326,29.65235173824131,66.25766871165644,3.2719836400818,0.2044989775051125,0.6134969325153374
58,충청남도,공주시,신관동,관내사전투표,4676,4676,2826,1180,567,45,7,4625,51,0,61.10270270270271,25.513513513513512,12.25945945945946,0.9729729729729729,0.15135135135135136
59,충청남도,공주시,신관동,신관동제1투,1602,1039,322,589,110,10,0,1031,8,563,31.23181377303589,57.12900096993211,10.66925315227934,0.9699321047526674,0.0
60,충청남도,공주시,신관동,신관동제2투,1878,1224,481,635,82,17,3,1218,6,654,39.49096880131363,52.13464696223317,6.732348111658457,1.3957307060755337,0.24630541871921183
61,충청남도,공주시,신관동,신관동제3투,4438,2633,906,1463,217,26,2,2614,19,1805,34.659525631216525,55.96786534047437,8.301453710788065,0.9946442234123948,0.07651109410864575
62,충청남도,공주시,신관동,신관동제4투,2494,1639,616,864,128,18,1,1627,12,855,37.86109403810695,53.10387215734481,7.867240319606637,1.1063306699446833,0.06146281499692685
63,충청남도,공주시,월송동,관내사전투표,3313,3313,2252,808,209,29,3,3301,12,0,68.22175098455013,24.477431081490458,6.33141472281127,0.8785216601029991,0.09088155104513784
64,충청남도,공주시,월송동,월송동제1투,2726,1918,842,904,127,23,2,1898,20,808,44.36248682824026,47.629083245521606,6.691253951527925,1.2118018967334034,0.10537407797681769
65,충청남도,공주시,월송동,월송동제2투,471,305,87,209,5,1,0,302,3,166,28.807947019867548,69.20529801324503,1.6556291390728477,0.33112582781456956,0.0
66,충청남도,공주시,월송동,월송동제3투,2334,1431,562,743,106,13,1,1425,6,903,39.438596491228076,52.140350877192986,7.438596491228071,0.9122807017543859,0.07017543859649122
67,충청남도,공주시,월송동,월송동제4투,2456,1675,701,819,140,7,0,1667,8,781,42.051589682063586,49.13017396520696,8.398320335932812,0.4199160167966407,0.0
68,충청남도,공주시,잘못 투입·구분된 투표지,,0,0,0,0,0,0,0,0,0,0,0.0,0.0,0.0,0.0,0.0
0,충청남도,보령시,거소·선상투표,,182,176,68,70,28,3,1,170,6,6,40.0,41.17647058823529,16.470588235294116,1.7647058823529411,0.5882352941176471
1,충청남도,보령시,관외사전투표,,5756,5755,2985,1914,730,50,9,5688,67,1,52.47890295358649,33.64978902953587,12.834036568213783,0.8790436005625879,0.15822784810126583
2,충청남도,보령시,재외투표,,283,225,161,36,20,7,0,224,1,58,71.875,16.071428571428573,8.928571428571429,3.125,0.0
3,충청남도,보령시,웅천읍,관내사전투표,1587,1587,811,671,65,12,4,1563,24,0,51.887396033269354,42.93026231605886,4.158669225847729,0.7677543186180422,0.2559181062060141
4,충청남도,보령시,웅천읍,웅천읍제1투,1275,829,173,624,19,4,0,820,9,446,21.097560975609756,76.09756097560975,2.317073170731707,0.4878048780487805,0.0
5,충청남도,보령시,웅천읍,웅천읍제2투,1054,656,146,488,15,1,1,651,5,398,22.427035330261134,74.96159754224271,2.3041474654377883,0.15360983102918588,0.15360983102918588
6,충청남도,보령시,웅천읍,웅천읍제3투,1057,683,193,459,26,3,0,681,2,374,28.34067547723935,67.40088105726872,3.81791483113069,0.4405286343612335,0.0
7,충청남도,보령시,주포면,관내사전투표,587,587,324,221,32,6,0,583,4,0,55.57461406518011,37.9073756432247,5.4888507718696395,1.0291595197255576,0.0
8,충청남도,보령시,주포면,주포면투표소,803,540,134,370,27,3,0,534,6,263,25.0936329588015,69.28838951310861,5.056179775280898,0.5617977528089888,0.0
9,충청남도,보령시,주교면,관내사전투표,1575,1575,893,520,88,12,12,1525,50,0,58.557377049180324,34.0983606557377,5.770491803278689,0.7868852459016393,0.7868852459016393
10,충청남도,보령시,주교면,주교면제1투,1577,897,264,578,41,1,1,885,12,680,29.830508474576273,65.31073446327683,4.632768361581921,0.11299435028248588,0.11299435028248588
11,충청남도,보령시,주교면,주교면제2투,1109,680,198,448,25,3,0,674,6,429,29.376854599406528,66.46884272997032,3.7091988130563793,0.44510385756676557,0.0
12,충청남도,보령시,오천면,관내사전투표,665,663,314,298,42,1,0,655,8,2,47.93893129770993,45.49618320610687,6.412213740458015,0.15267175572519084,0.0
13,충청남도,보령시,오천면,오천면제1투,972,600,151,418,20,6,1,596,4,372,25.335570469798657,70.13422818791946,3.3557046979865772,1.006711409395973,0.16778523489932887
14,충청남도,보령시,오천면,오천면제2투,150,80,20,56,1,1,0,78,2,70,25.64102564102564,71.7948717948718,1.282051282051282,1.282051282051282,0.0
15,충청남도,보령시,오천면,오천면제3투,619,462,101,332,25,1,1,460,2,157,21.956521739130437,72.17391304347827,5.434782608695652,0.21739130434782608,0.21739130434782608
16,충청남도,보령시,오천면,오천면제4투,284,184,59,112,11,0,0,182,2,100,32.417582417582416,61.53846153846154,6.043956043956044,0.0,0.0
17,충청남도,보령시,오천면,오천면제5투,112,75,26,49,0,0,0,75,0,37,34.66666666666667,65.33333333333333,0.0,0.0,0.0
18,충청남도,보령시,오천면,오천면제6투,148,107,39,60,4,1,0,104,3,41,37.5,57.692307692307686,3.8461538461538463,0.9615384615384616,0.0
19,충청남도,보령시,오천면,오천면제7투,114,80,26,49,3,0,0,78,2,34,33.33333333333333,62.82051282051282,3.8461538461538463,0.0,0.0
20,충청남도,보령시,오천면,오천면제8투,133,94,28,61,4,0,0,93,1,39,30.107526881720432,65.59139784946237,4.301075268817205,0.0,0.0
21,충청남도,보령시,오천면,오천면제9투,218,142,68,70,4,0,0,142,0,76,47.88732394366197,49.29577464788733,2.8169014084507045,0.0,0.0
22,충청남도,보령시,천북면,관내사전투표,851,851,416,368,51,6,1,842,9,0,49.4061757719715,43.705463182897866,6.0570071258907365,0.7125890736342043,0.11876484560570072
23,충청남도,보령시,천북면,천북면투표소,1829,1162,328,786,30,2,2,1148,14,667,28.57142857142857,68.46689895470384,2.6132404181184667,0.17421602787456447,0.17421602787456447
24,충청남도,보령시,청소면,관내사전투표,800,800,375,376,37,4,0,792,8,0,47.34848484848485,47.474747474747474,4.671717171717172,0.5050505050505051,0.0
25,충청남도,보령시,청소면,청소면투표소,1306,790,178,587,12,6,0,783,7,516,22.7330779054917,74.96807151979566,1.532567049808429,0.7662835249042145,0.0
26,충청남도,보령시,청라면,관내사전투표,800,800,403,342,42,8,1,796,4,0,50.62814070351759,42.96482412060301,5.276381909547738,1.0050251256281406,0.12562814070351758
27,충청남도,보령시,청라면,청라면제1투,683,453,88,349,14,0,0,451,2,230,19.51219512195122,77.38359201773835,3.1042128603104215,0.0,0.0
28,충청남도,보령시,청라면,청라면제2투,734,522,134,364,19,2,0,519,3,212,25.818882466281313,70.13487475915221,3.6608863198458574,0.3853564547206166,0.0
29,충청남도,보령시,청라면,청라면제3투,738,503,144,337,16,1,2,500,3,235,28.799999999999997,67.4,3.2,0.2,0.4
30,충청남도,보령시,남포면,관내사전투표,1342,1342,675,579,69,8,0,1331,11,0,50.71374906085649,43.501126972201355,5.184072126220887,0.6010518407212623,0.0
31,충청남도,보령시,남포면,남포면제1투,1117,701,167,493,32,5,0,697,4,416,23.959827833572454,70.73170731707317,4.591104734576758,0.7173601147776184,0.0
32,충청남도,보령시,남포면,남포면제2투,953,594,158,409,12,6,2,587,7,359,26.916524701873932,69.6763202725724,2.0442930153321974,1.0221465076660987,0.34071550255536626
33,충청남도,보령시,남포면,남포면제3투,681,418,133,265,13,5,0,416,2,263,31.971153846153843,63.70192307692307,3.125,1.201923076923077,0.0
34,충청남도,보령시,주산면,관내사전투표,599,598,296,266,25,4,2,593,5,1,49.915682967959526,44.8566610455312,4.215851602023609,0.6745362563237773,0.33726812816188867
35,충청남도,보령시,주산면,주산면제1투,953,626,147,443,28,2,1,621,5,327,23.67149758454106,71.33655394524959,4.508856682769726,0.322061191626409,0.1610305958132045
36,충청남도,보령시,주산면,주산면제2투,362,244,86,152,3,0,0,241,3,118,35.684647302904565,63.07053941908713,1.2448132780082988,0.0,0.0
37,충청남도,보령시,미산면,관내사전투표,291,291,135,131,19,3,0,288,3,0,46.875,45.48611111111111,6.597222222222222,1.0416666666666665,0.0
38,충청남도,보령시,미산면,미산면제1투,360,241,54,175,9,0,2,240,1,119,22.5,72.91666666666666,3.75,0.0,0.8333333333333334
39,충청남도,보령시,미산면,미산면제2투,381,287,74,197,7,1,3,282,5,94,26.24113475177305,69.8581560283688,2.4822695035460995,0.3546099290780142,1.0638297872340425
40,충청남도,보령시,미산면,미산면제3투,303,223,47,168,8,0,0,223,0,80,21.076233183856502,75.33632286995515,3.587443946188341,0.0,0.0
41,충청남도,보령시,성주면,관내사전투표,841,841,478,295,51,9,1,834,7,0,57.31414868105516,35.37170263788969,6.115107913669065,1.079136690647482,0.1199040767386091
42,충청남도,보령시,성주면,성주면제1투,759,492,149,311,23,4,1,488,4,267,30.532786885245898,63.729508196721305,4.713114754098361,0.819672131147541,0.20491803278688525
43,충청남도,보령시,성주면,성주면제2투,364,262,78,171,6,3,0,258,4,102,30.23255813953488,66.27906976744185,2.3255813953488373,1.1627906976744187,0.0
44,충청남도,보령시,대천1동,관내사전투표,2929,2929,1752,923,208,30,1,2914,15,0,60.12354152367879,31.674673987645846,7.137954701441318,1.029512697323267,0.03431708991077557
45,충청남도,보령시,대천1동,대천1동제1투,1091,653,154,464,23,6,0,647,6,438,23.802163833075735,71.71561051004637,3.554868624420402,0.9273570324574961,0.0
46,충청남도,보령시,대천1동,대천1동제2투,923,569,154,385,25,4,0,568,1,354,27.11267605633803,67.78169014084507,4.401408450704225,0.7042253521126761,0.0
47,충청남도,보령시,대천1동,대천1동제3투,1528,948,248,646,41,5,1,941,7,580,26.35494155154091,68.65037194473965,4.357066950053135,0.5313496280552604,0.10626992561105207
48,충청남도,보령시,대천1동,대천1동제4투,1518,1019,301,639,66,6,2,1014,5,499,29.68441814595661,63.01775147928994,6.508875739644971,0.591715976331361,0.19723865877712032
49,충청남도,보령시,대천1동,대천1동제5투,1845,1156,390,666,79,17,0,1152,4,689,33.85416666666667,57.8125,6.857638888888889,1.4756944444444444,0.0
50,충청남도,보령시,대천2동,관내사전투표,3105,3105,1668,1199,200,19,3,3089,16,0,53.998057623826476,38.815150534153446,6.474587245063128,0.6150857882809971,0.09711880867594691
51,충청남도,보령시,대천2동,대천2동제1투,955,572,154,385,27,4,0,570,2,383,27.017543859649123,67.54385964912281,4.736842105263158,0.7017543859649122,0.0
52,충청남도,보령시,대천2동,대천2동제2투,617,381,84,276,18,1,0,379,2,236,22.163588390501317,72.82321899736148,4.749340369393139,0.2638522427440633,0.0
53,충청남도,보령시,대천2동,대천2동제3투,1787,1156,387,692,59,7,1,1146,10,631,33.7696335078534,60.38394415357766,5.148342059336824,0.6108202443280977,0.08726003490401396
54,충청남도,보령시,대천3동,관내사전투표,2736,2736,1718,843,145,20,0,2726,10,0,63.02274394717535,30.924431401320618,5.319148936170213,0.7336757153338225,0.0
55,충청남도,보령시,대천3동,대천3동제1투,1354,793,255,479,46,8,1,789,4,561,32.31939163498099,60.70975918884665,5.830164765525982,1.0139416983523446,0.12674271229404308
56,충청남도,보령시,대천3동,대천3동제2투,1778,1183,423,669,73,13,0,1178,5,595,35.908319185059426,56.79117147707979,6.196943972835315,1.1035653650254669,0.0
57,충청남도,보령시,대천3동,대천3동제3투,1753,1055,329,655,55,5,2,1046,9,698,31.453154875717015,62.619502868068835,5.25812619502868,0.47801147227533464,0.19120458891013384
58,충청남도,보령시,대천3동,대천3동제4투,1327,785,246,471,53,11,1,782,3,542,31.45780051150895,60.230179028132994,6.7774936061381075,1.4066496163682864,0.1278772378516624
59,충청남도,보령시,대천3동,대천3동제5투,1545,1108,553,431,100,14,2,1100,8,437,50.272727272727266,39.18181818181819,9.090909090909092,1.2727272727272727,0.18181818181818182
60,충청남도,보령시,대천4동,관내사전투표,4803,4802,2857,1468,410,41,4,4780,22,1,59.769874476987454,30.711297071129707,8.577405857740587,0.8577405857740585,0.08368200836820083
61,충청남도,보령시,대천4동,대천4동제1투,1771,1040,390,565,65,8,1,1029,11,731,37.90087463556851,54.90767735665695,6.316812439261418,0.7774538386783284,0.09718172983479105
62,충청남도,보령시,대천4동,대천4동제2투,1355,836,208,563,56,2,0,829,7,519,25.090470446320868,67.91314837153196,6.7551266586248495,0.24125452352231602,0.0
63,충청남도,보령시,대천4동,대천4동제3투,2658,1708,690,849,145,14,1,1699,9,950,40.612124779281935,49.97057092407298,8.53443201883461,0.824014125956445,0.05885815185403178
64,충청남도,보령시,대천4동,대천4동제4투,2963,1906,700,1065,117,15,0,1897,9,1057,36.90036900369004,56.14127569847127,6.167633104902478,0.790722192936215,0.0
65,충청남도,보령시,대천5동,관내사전투표,1657,1657,911,613,111,10,3,1648,9,0,55.279126213592235,37.19660194174757,6.735436893203883,0.6067961165048543,0.1820388349514563
66,충청남도,보령시,대천5동,대천5동제1투,1017,558,146,391,18,1,0,556,2,459,26.258992805755394,70.32374100719424,3.237410071942446,0.1798561151079137,0.0
67,충청남도,보령시,대천5동,대천5동제2투,1118,638,211,394,23,3,3,634,4,480,33.2807570977918,62.14511041009464,3.627760252365931,0.47318611987381703,0.47318611987381703
68,충청남도,보령시,대천5동,대천5동제3투,1457,948,237,672,23,7,0,939,9,509,25.23961661341853,71.56549520766772,2.4494142705005326,0.7454739084132056,0.0
69,충청남도,보령시,잘못 투입·구분된 투표지,,0,0,0,0,0,0,0,0,0,0,0.0,0.0,0.0,0.0,0.0
0,충청남도,아산시,거소·선상투표,,414,390,174,115,74,3,3,369,21,24,47.15447154471545,31.16531165311653,20.05420054200542,0.8130081300813009,0.8130081300813009
1,충청남도,아산시,관외사전투표,,24162,24157,13501,6471,3655,234,25,23886,271,5,56.522649250607046,27.09118311981914,15.301850456334254,0.9796533534287867,0.10466381981076782
2,충청남도,아산시,재외투표,,1055,851,583,158,81,20,0,842,9,204,69.23990498812351,18.76484560570071,9.619952494061758,2.375296912114014,0.0
3,충청남도,아산시,염치읍,관내사전투표,1396,1396,831,452,90,10,1,1384,12,0,60.04335260115607,32.65895953757225,6.502890173410404,0.7225433526011561,0.0722543352601156
4,충청남도,아산시,염치읍,염치읍제1투,813,498,136,339,18,2,2,497,1,315,27.364185110663986,68.2092555331992,3.6217303822937628,0.4024144869215292,0.4024144869215292
5,충청남도,아산시,염치읍,염치읍제2투,1198,680,205,427,36,6,0,674,6,518,30.415430267062316,63.353115727002965,5.341246290801187,0.8902077151335311,0.0
6,충청남도,아산시,염치읍,염치읍제3투,1657,1009,380,568,48,9,1,1006,3,648,37.77335984095427,56.461232604373755,4.7713717693836974,0.8946322067594433,0.09940357852882703
7,충청남도,아산시,배방읍,관내사전투표,10744,10744,7630,1933,984,118,4,10669,75,0,71.51560596119599,18.117911706814134,9.222982472584123,1.106008060736714,0.03749179866904115
8,충청남도,아산시,배방읍,배방읍제1투,4192,3096,1458,1152,412,35,4,3061,35,1096,47.631492976151584,37.63475988239138,13.459653707938582,1.1434171839268212,0.1306762495916367
9,충청남도,아산시,배방읍,배방읍제2투,1736,1113,414,587,98,8,0,1107,6,623,37.39837398373984,53.02619692863595,8.85275519421861,0.7226738934056007,0.0
10,충청남도,아산시,배방읍,배방읍제3투,3165,2390,1205,919,217,37,1,2379,11,775,50.65153425809164,38.629676334594365,9.121479613282892,1.5552753257671292,0.04203446826397646
11,충청남도,아산시,배방읍,배방읍제4투,3488,2619,1280,1097,195,29,1,2602,17,869,49.19292851652575,42.15987701767871,7.49423520368947,1.1145272867025366,0.03843197540353574
12,충청남도,아산시,배방읍,배방읍제5투,2435,2021,839,922,217,22,4,2004,17,414,41.86626746506986,46.007984031936125,10.828343313373253,1.097804391217565,0.19960079840319359
13,충청남도,아산시,배방읍,배방읍제6투,3233,2210,937,920,316,22,0,2195,15,1023,42.687927107061505,41.91343963553531,14.39635535307517,1.0022779043280183,0.0
14,충청남도,아산시,배방읍,배방읍제7투,1021,760,272,312,155,9,0,748,12,261,36.36363636363637,41.711229946524064,20.72192513368984,1.2032085561497325,0.0
15,충청남도,아산시,배방읍,배방읍제8투,1778,1230,582,473,151,18,0,1224,6,548,47.549019607843135,38.6437908496732,12.336601307189543,1.4705882352941175,0.0
16,충청남도,아산시,배방읍,배방읍제9투,3481,2090,822,1049,179,24,3,2077,13,1391,39.57631198844487,50.50553683196919,8.618199325950892,1.1555127587867116,0.14443909484833894
17,충청남도,아산시,배방읍,배방읍제10투,2487,1773,960,616,163,26,1,1766,7,714,54.36013590033974,34.88108720271801,9.229898074745186,1.4722536806342015,0.05662514156285391
18,충청남도,아산시,배방읍,배방읍제11투,3345,2433,1230,952,212,30,0,2424,9,912,50.742574257425744,39.273927392739274,8.745874587458747,1.2376237623762376,0.0
19,충청남도,아산시,배방읍,배방읍제12투,4074,2403,1167,935,250,29,1,2382,21,1671,48.99244332493703,39.252728799328295,10.495382031905962,1.2174643157010916,0.041981528127623846
20,충청남도,아산시,배방읍,배방읍제13투,2961,2095,1054,811,184,33,1,2083,12,866,50.60009601536246,38.934229476716276,8.833413346135382,1.584253480556889,0.04800768122899664
21,충청남도,아산시,배방읍,배방읍제14투,2845,1672,703,773,160,24,2,1662,10,1173,42.29843561973526,46.510228640192544,9.626955475330927,1.444043321299639,0.12033694344163659
22,충청남도,아산시,배방읍,배방읍제15투,2732,1498,508,805,155,14,2,1484,14,1234,34.23180592991914,54.24528301886793,10.444743935309972,0.9433962264150944,0.13477088948787064
23,충청남도,아산시,배방읍,배방읍제16투,3089,2366,1196,958,181,22,1,2358,8,723,50.72094995759117,40.62765055131467,7.6759966072943175,0.9329940627650551,0.04240882103477523
24,충청남도,아산시,배방읍,배방읍제17투,1818,1151,525,456,149,11,0,1141,10,667,46.012269938650306,39.9649430324277,13.058720420683612,0.9640666082383873,0.0
25,충청남도,아산시,배방읍,배방읍제18투,3831,2698,1396,997,249,35,1,2678,20,1133,52.12845407020165,37.229275578790144,9.297983569828231,1.3069454817027633,0.03734129947722181
26,충청남도,아산시,배방읍,배방읍제19투,739,516,170,323,18,2,1,514,2,223,33.07392996108949,62.840466926070036,3.501945525291829,0.38910505836575876,0.19455252918287938
27,충청남도,아산시,배방읍,배방읍제20투,1848,1261,475,542,216,13,1,1247,14,587,38.09141940657578,43.464314354450686,17.321571772253407,1.0425020048115476,0.08019246190858059
28,충청남도,아산시,송악면,관내사전투표,1237,1237,745,412,53,18,0,1228,9,0,60.66775244299675,33.55048859934853,4.315960912052117,1.4657980456026058,0.0
29,충청남도,아산시,송악면,송악면제1투,1041,645,178,423,27,11,1,640,5,396,27.8125,66.09375,4.21875,1.7187500000000002,0.15625
30,충청남도,아산시,송악면,송악면제2투,651,401,89,289,14,6,1,399,2,250,22.305764411027567,72.4310776942356,3.508771929824561,1.5037593984962405,0.2506265664160401
31,충청남도,아산시,송악면,송악면제3투,494,351,95,232,20,3,0,350,1,143,27.142857142857142,66.28571428571428,5.714285714285714,0.8571428571428572,0.0
32,충청남도,아산시,탕정면,관내사전투표,7157,7157,4993,1266,791,55,5,7110,47,0,70.22503516174402,17.80590717299578,11.125175808720114,0.7735583684950774,0.07032348804500703
33,충청남도,아산시,탕정면,탕정면제1투,1688,821,232,483,89,9,2,815,6,867,28.46625766871166,59.263803680981596,10.920245398773005,1.1042944785276074,0.245398773006135
34,충청남도,아산시,탕정면,탕정면제2투,2117,1135,456,555,96,16,1,1124,11,982,40.569395017793596,49.37722419928826,8.540925266903916,1.4234875444839856,0.0889679715302491
35,충청남도,아산시,탕정면,탕정면제3투,727,350,92,184,70,0,0,346,4,377,26.589595375722542,53.179190751445084,20.23121387283237,0.0,0.0
36,충청남도,아산시,탕정면,탕정면제4투,3156,2504,1304,903,261,23,1,2492,12,652,52.32744783306581,36.235955056179776,10.473515248796147,0.9229534510433388,0.04012841091492777
37,충청남도,아산시,탕정면,탕정면제5투,2367,1914,1051,637,187,25,0,1900,14,453,55.315789473684205,33.526315789473685,9.842105263157896,1.3157894736842104,0.0
38,충청남도,아산시,탕정면,탕정면제6투,4022,2949,1337,1144,397,40,3,2921,28,1073,45.771995891817866,39.16466963368709,13.59123587812393,1.3693940431359124,0.10270455323519344
39,충청남도,아산시,탕정면,탕정면제7투,4748,3815,2049,1324,369,54,8,3804,11,933,53.86435331230284,34.80546792849632,9.700315457413248,1.4195583596214512,0.2103049421661409
40,충청남도,아산시,탕정면,탕정면제8투,3997,3045,1587,1010,392,41,1,3031,14,952,52.358957439788846,33.322335862751565,12.933025404157044,1.3526888815572418,0.03299241174529858
41,충청남도,아산시,음봉면,관내사전투표,2565,2565,1734,598,192,19,1,2544,21,0,68.16037735849056,23.5062893081761,7.547169811320755,0.7468553459119497,0.039308176100628936
42,충청남도,아산시,음봉면,음봉면제1투,1052,630,186,409,23,4,2,624,6,422,29.807692307692307,65.5448717948718,3.685897435897436,0.641025641025641,0.3205128205128205
43,충청남도,아산시,음봉면,음봉면제2투,2416,1471,621,706,112,19,0,1458,13,945,42.592592592592595,48.42249657064472,7.681755829903978,1.3031550068587106,0.0
44,충청남도,아산시,음봉면,음봉면제3투,1272,780,250,459,58,9,1,777,3,492,32.17503217503218,59.07335907335908,7.4646074646074645,1.1583011583011582,0.1287001287001287
45,충청남도,아산시,음봉면,음봉면제4투,3057,2032,833,1011,162,14,1,2021,11,1025,41.21721919841663,50.024740227610096,8.01583374567046,0.6927263730826323,0.04948045522018803
46,충청남도,아산시,음봉면,음봉면제5투,1184,609,279,262,57,7,0,605,4,575,46.11570247933884,43.30578512396694,9.421487603305785,1.1570247933884297,0.0
47,충청남도,아산시,음봉면,음봉면제6투,2796,2151,1291,684,142,19,1,2137,14,645,60.41179223210108,32.007487131492745,6.644829199812821,0.8890968647636874,0.04679457182966776
48,충청남도,아산시,음봉면,음봉면제7투,2220,1653,791,538,284,13,1,1627,26,567,48.61708666256915,33.06699446834665,17.455439459127227,0.7990165949600493,0.06146281499692685
49,충청남도,아산시,둔포면,관내사전투표,4479,4479,2926,1132,369,26,2,4455,24,0,65.67901234567901,25.409652076318746,8.282828282828284,0.5836139169472503,0.044893378226711564
50,충청남도,아산시,둔포면,둔포면제1투,1675,850,241,537,64,4,0,846,4,825,28.486997635933808,63.47517730496454,7.5650118203309695,0.4728132387706856,0.0
51,충청남도,아산시,둔포면,둔포면제2투,821,523,152,345,17,3,0,517,6,298,29.40038684719536,66.7311411992263,3.2882011605415857,0.5802707930367506,0.0
52,충청남도,아산시,둔포면,둔포면제3투,1251,729,227,443,48,7,0,725,4,522,31.310344827586206,61.10344827586207,6.620689655172414,0.9655172413793104,0.0
53,충청남도,아산시,둔포면,둔포면제4투,4667,2694,1216,1164,263,31,2,2676,18,1973,45.440956651718984,43.49775784753363,9.828101644245143,1.1584454409566518,0.07473841554559044
54,충청남도,아산시,둔포면,둔포면제5투,2157,1175,446,634,83,7,0,1170,5,982,38.11965811965812,54.18803418803419,7.094017094017094,0.5982905982905984,0.0
55,충청남도,아산시,둔포면,둔포면제6투,3526,2238,1180,854,172,22,3,2231,7,1288,52.891080233079336,38.27879874495742,7.7095472882115645,0.9861048857014791,0.1344688480502017
56,충청남도,아산시,영인면,관내사전투표,1784,1784,1073,574,89,16,1,1753,31,0,61.2093553907587,32.74386765544781,5.077010838562464,0.912721049629207,0.057045065601825436
57,충청남도,아산시,영인면,영인면제1투,1008,580,177,363,30,6,1,577,3,428,30.675909878682845,62.911611785095324,5.1993067590987865,1.0398613518197575,0.17331022530329288
58,충청남도,아산시,영인면,영인면제2투,708,480,144,312,18,4,0,478,2,228,30.125523012552303,65.27196652719665,3.765690376569038,0.8368200836820083,0.0
59,충청남도,아산시,영인면,영인면제3투,960,627,174,411,28,5,1,619,8,333,28.109854604200322,66.39741518578353,4.523424878836833,0.8077544426494345,0.16155088852988692
60,충청남도,아산시,영인면,영인면제4투,515,346,125,197,21,0,1,344,2,169,36.337209302325576,57.26744186046512,6.104651162790697,0.0,0.29069767441860467
61,충청남도,아산시,인주면,관내사전투표,1837,1837,1159,515,133,19,1,1827,10,0,63.43732895457034,28.188286808976464,7.2796934865900385,1.0399562123700055,0.05473453749315819
62,충청남도,아산시,인주면,인주면제1투,1015,581,238,300,33,7,0,578,3,434,41.17647058823529,51.903114186851205,5.709342560553633,1.2110726643598615,0.0
63,충청남도,아산시,인주면,인주면제2투,1283,694,210,438,36,6,1,691,3,589,30.390738060781473,63.38639652677279,5.209840810419681,0.8683068017366137,0.1447178002894356
64,충청남도,아산시,인주면,인주면제3투,930,569,202,340,24,2,0,568,1,361,35.563380281690144,59.859154929577464,4.225352112676056,0.35211267605633806,0.0
65,충청남도,아산시,선장면,관내사전투표,787,787,450,279,40,11,0,780,7,0,57.692307692307686,35.76923076923077,5.128205128205128,1.4102564102564104,0.0
66,충청남도,아산시,선장면,선장면제1투,724,470,99,355,11,2,0,467,3,254,21.199143468950748,76.017130620985,2.355460385438972,0.4282655246252677,0.0
67,충청남도,아산시,선장면,선장면제2투,596,390,91,278,17,1,1,388,2,206,23.45360824742268,71.64948453608247,4.381443298969072,0.25773195876288657,0.25773195876288657
68,충청남도,아산시,선장면,선장면제3투,570,369,85,271,11,0,0,367,2,201,23.160762942779293,73.84196185286103,2.997275204359673,0.0,0.0
69,충청남도,아산시,도고면,관내사전투표,1334,1334,741,500,74,11,1,1327,7,0,55.84024114544084,37.67897513187641,5.5764883195177095,0.8289374529012812,0.07535795026375283
70,충청남도,아산시,도고면,도고면제1투,1153,690,176,470,39,1,0,686,4,463,25.65597667638484,68.5131195335277,5.685131195335277,0.1457725947521866,0.0
71,충청남도,아산시,도고면,도고면제2투,667,420,126,275,14,4,0,419,1,247,30.071599045346066,65.63245823389022,3.341288782816229,0.9546539379474941,0.0
72,충청남도,아산시,도고면,도고면제3투,842,586,115,442,22,2,0,581,5,256,19.793459552495698,76.07573149741825,3.7865748709122204,0.34423407917383825,0.0
73,충청남도,아산시,신창면,관내사전투표,3333,3333,2251,821,220,22,2,3316,17,0,67.88299155609168,24.758745476477685,6.634499396863691,0.6634499396863691,0.060313630880579006
74,충청남도,아산시,신창면,신창면제1투,842,480,110,335,30,2,0,477,3,362,23.060796645702304,70.23060796645703,6.289308176100629,0.41928721174004197,0.0
75,충청남도,아산시,신창면,신창면제2투,522,311,76,213,14,3,0,306,5,211,24.836601307189543,69.6078431372549,4.57516339869281,0.9803921568627451,0.0
76,충청남도,아산시,신창면,신창면제3투,1566,910,228,588,78,8,2,904,6,656,25.221238938053098,65.04424778761062,8.628318584070795,0.8849557522123894,0.22123893805309736
77,충청남도,아산시,신창면,신창면제4투,1833,1090,433,552,74,16,3,1078,12,743,40.1669758812616,51.20593692022264,6.8645640074211505,1.4842300556586272,0.27829313543599254
78,충청남도,아산시,신창면,신창면제5투,2025,1280,504,676,81,9,0,1270,10,745,39.68503937007874,53.22834645669291,6.377952755905512,0.7086614173228346,0.0
79,충청남도,아산시,신창면,신창면제6투,3144,1936,883,868,141,28,3,1923,13,1208,45.91783671346854,45.13780551222049,7.332293291731669,1.456058242329693,0.15600624024961
80,충청남도,아산시,신창면,신창면제7투,1487,993,461,463,53,15,0,992,1,494,46.471774193548384,46.67338709677419,5.342741935483871,1.5120967741935485,0.0
81,충청남도,아산시,신창면,신창면제8투,2490,1456,673,614,125,29,1,1442,14,1034,46.67128987517337,42.57975034674064,8.668515950069349,2.0110957004160888,0.06934812760055478
82,충청남도,아산시,온양1동,관내사전투표,3089,3089,1815,984,240,26,3,3068,21,0,59.15906127770535,32.07301173402868,7.822685788787484,0.847457627118644,0.09778357235984356
83,충청남도,아산시,온양1동,온양1동제1투,911,483,126,308,41,3,1,479,4,428,26.304801670146137,64.30062630480167,8.559498956158663,0.6263048016701461,0.20876826722338201
84,충청남도,아산시,온양1동,온양1동제2투,1322,741,210,453,64,8,0,735,6,581,28.57142857142857,61.63265306122449,8.707482993197278,1.0884353741496597,0.0
85,충청남도,아산시,온양1동,온양1동제3투,936,524,151,320,45,1,1,518,6,412,29.150579150579148,61.77606177606177,8.687258687258687,0.19305019305019305,0.19305019305019305
86,충청남도,아산시,온양1동,온양1동제4투,2755,1924,947,764,167,26,2,1906,18,831,49.68520461699895,40.083945435466944,8.761804826862539,1.3641133263378804,0.1049317943336831
87,충청남도,아산시,온양2동,관내사전투표,3423,3423,1986,1123,249,36,1,3395,28,0,58.497790868924895,33.0780559646539,7.334315169366716,1.0603829160530192,0.029455081001472753
88,충청남도,아산시,온양2동,온양2동제1투,1468,887,244,569,64,3,1,881,6,581,27.695800227014754,64.58569807037458,7.264472190692395,0.340522133938706,0.11350737797956867
89,충청남도,아산시,온양2동,온양2동제2투,1567,914,284,574,41,6,1,906,8,653,31.346578366445915,63.35540838852097,4.525386313465784,0.6622516556291391,0.11037527593818984
90,충청남도,아산시,온양2동,온양2동제3투,1060,568,125,395,39,3,1,563,5,492,22.202486678507995,70.15985790408526,6.927175843694494,0.5328596802841918,0.17761989342806395
91,충청남도,아산시,온양2동,온양2동제4투,1896,917,292,507,98,7,1,905,12,979,32.26519337016575,56.02209944751381,10.828729281767956,0.7734806629834254,0.11049723756906078
92,충청남도,아산시,온양3동,관내사전투표,7475,7474,4766,1980,613,67,6,7432,42,1,64.1280947255113,26.641550053821312,8.2481162540366,0.9015069967707212,0.08073196986006459
93,충청남도,아산시,온양3동,온양3동제1투,3349,2259,981,1072,160,29,2,2244,15,1090,43.716577540106954,47.771836007130126,7.130124777183601,1.2923351158645278,0.08912655971479501
94,충청남도,아산시,온양3동,온양3동제2투,2783,1616,501,952,133,13,3,1602,14,1167,31.273408239700373,59.425717852684144,8.302122347066167,0.8114856429463172,0.18726591760299627
95,충청남도,아산시,온양3동,온양3동제3투,3181,2076,884,991,168,24,0,2067,9,1105,42.76729559748428,47.94388001935172,8.127721335268506,1.1611030478955007,0.0
96,충청남도,아산시,온양3동,온양3동제4투,4132,2716,1239,1215,209,37,2,2702,14,1416,45.854922279792746,44.96669133974833,7.735011102886751,1.3693560325684677,0.07401924500370095
97,충청남도,아산시,온양3동,온양3동제5투,3400,2050,655,1175,181,26,2,2039,11,1350,32.123589995095635,57.62628739578225,8.87690044139284,1.2751348700343306,0.0980872976949485
98,충청남도,아산시,온양3동,온양3동제6투,3012,2247,1177,832,190,32,3,2234,13,765,52.6857654431513,37.24261414503133,8.504923903312445,1.432408236347359,0.13428827215756492
99,충청남도,아산시,온양3동,온양3동제7투,1802,1360,736,487,106,19,2,1350,10,442,54.51851851851852,36.074074074074076,7.851851851851851,1.4074074074074074,0.14814814814814814
100,충청남도,아산시,온양4동,관내사전투표,2680,2680,1742,737,173,15,2,2669,11,0,65.26789059572874,27.613338328962158,6.481828400149869,0.5620082427875608,0.07493443237167478
101,충청남도,아산시,온양4동,온양4동제1투,2233,1572,671,732,129,25,3,1560,12,661,43.01282051282052,46.92307692307692,8.269230769230768,1.6025641025641024,0.19230769230769232
102,충청남도,아산시,온양4동,온양4동제2투,3577,2323,957,1157,172,22,1,2309,14,1254,41.44651364226938,50.108271979211786,7.449112169770464,0.9527934170636638,0.043308791684711995
103,충청남도,아산시,온양4동,온양4동제3투,1349,877,258,562,44,7,1,872,5,472,29.587155963302752,64.44954128440367,5.045871559633028,0.8027522935779817,0.11467889908256881
104,충청남도,아산시,온양4동,온양4동제4투,1514,833,357,409,56,7,1,830,3,681,43.01204819277108,49.27710843373494,6.746987951807229,0.8433734939759037,0.12048192771084339
105,충청남도,아산시,온양4동,온양4동제5투,1321,840,376,392,50,14,1,833,7,481,45.13805522208884,47.05882352941176,6.002400960384153,1.680672268907563,0.12004801920768307
106,충청남도,아산시,온양5동,관내사전투표,4056,4056,2673,1053,263,42,1,4032,24,0,66.29464285714286,26.11607142857143,6.5228174603174605,1.0416666666666665,0.0248015873015873
107,충청남도,아산시,온양5동,온양5동제1투,3486,2492,1292,959,184,35,5,2475,17,994,52.20202020202021,38.74747474747475,7.434343434343435,1.4141414141414141,0.20202020202020202
108,충청남도,아산시,온양5동,온양5동제2투,2906,1753,607,992,123,14,3,1739,14,1153,34.905117883841285,57.044278320874064,7.073030477285797,0.8050603795284648,0.17251293847038526
109,충청남도,아산시,온양5동,온양5동제3투,1302,846,257,530,53,5,0,845,1,456,30.414201183431956,62.721893491124256,6.272189349112427,0.591715976331361,0.0
110,충청남도,아산시,온양5동,온양5동제4투,2698,1750,591,980,136,24,1,1732,18,948,34.122401847575055,56.581986143187066,7.852193995381063,1.3856812933025404,0.057736720554272515
111,충청남도,아산시,온양5동,온양5동제5투,1447,692,294,295,86,8,2,685,7,755,42.91970802919708,43.06569343065693,12.554744525547445,1.167883211678832,0.291970802919708
112,충청남도,아산시,온양6동,관내사전투표,4042,4042,2844,935,205,37,1,4022,20,0,70.71108901044256,23.24714072600696,5.096966683242169,0.9199403281949279,0.02486325211337643
113,충청남도,아산시,온양6동,온양6동제1투,2040,1250,502,634,96,12,0,1244,6,790,40.353697749196144,50.964630225080384,7.717041800643088,0.964630225080386,0.0
114,충청남도,아산시,온양6동,온양6동제2투,2107,1487,656,706,92,19,2,1475,12,620,44.474576271186436,47.86440677966102,6.237288135593221,1.2881355932203389,0.13559322033898305
115,충청남도,아산시,온양6동,온양6동제3투,855,530,161,345,11,4,4,525,5,325,30.666666666666664,65.71428571428571,2.0952380952380953,0.7619047619047619,0.7619047619047619
116,충청남도,아산시,온양6동,온양6동제4투,2347,1482,607,728,123,12,3,1473,9,865,41.208418194161574,49.42294636795655,8.350305498981669,0.8146639511201629,0.20366598778004072
117,충청남도,아산시,온양6동,온양6동제5투,1986,1221,509,648,46,9,1,1213,8,765,41.962077493816984,53.42126957955482,3.7922506183017313,0.741962077493817,0.08244023083264633
118,충청남도,아산시,온양6동,온양6동제6투,2010,1382,611,633,103,23,4,1374,8,628,44.46870451237264,46.069868995633186,7.496360989810771,1.6739446870451238,0.2911208151382824
119,충청남도,아산시,온양6동,온양6동제7투,2508,1941,1040,710,151,27,1,1929,12,567,53.91394504924831,36.8066355624676,7.82789009849663,1.3996889580093312,0.05184033177812338
120,충청남도,아산시,온양6동,온양6동제8투,2057,1536,816,552,133,24,2,1527,9,521,53.43811394891945,36.14931237721022,8.70988867059594,1.5717092337917484,0.13097576948264572
121,충청남도,아산시,잘못 투입·구분된 투표지,,0,1,1,0,0,0,0,1,0,-1,100.0,0.0,0.0,0.0,0.0
0,충청남도,서산시,거소·선상투표,,392,364,134,149,48,5,3,339,25,28,39.52802359882006,43.95280235988201,14.15929203539823,1.4749262536873156,0.8849557522123894
1,충청남도,서산시,관외사전투표,,9589,9588,4963,2911,1490,92,13,9469,119,1,52.413137606927876,30.742422642306472,15.73555813707889,0.9715915091350724,0.137290104551695
2,충청남도,서산시,재외투표,,468,377,264,60,45,8,0,377,0,91,70.026525198939,15.915119363395224,11.936339522546419,2.122015915119363,0.0
3,충청남도,서산시,대산읍,관내사전투표,3449,3449,2260,839,293,30,5,3427,22,0,65.94689232564926,24.482054274875985,8.549751969652759,0.8754012255617158,0.14590020426028597
4,충청남도,서산시,대산읍,대산읍제1투,2458,1471,621,720,108,10,3,1462,9,987,42.476060191518464,49.247606019151846,7.387140902872777,0.6839945280437756,0.2051983584131327
5,충청남도,서산시,대산읍,대산읍제2투,552,347,130,206,7,0,0,343,4,205,37.90087463556851,60.05830903790087,2.0408163265306123,0.0,0.0
6,충청남도,서산시,대산읍,대산읍제3투,862,524,199,263,50,7,1,520,4,338,38.26923076923077,50.57692307692307,9.615384615384617,1.3461538461538463,0.19230769230769232
7,충청남도,서산시,대산읍,대산읍제4투,1038,694,310,295,76,8,1,690,4,344,44.927536231884055,42.7536231884058,11.014492753623188,1.1594202898550725,0.14492753623188406
8,충청남도,서산시,대산읍,대산읍제5투,1783,979,354,554,51,15,1,975,4,804,36.30769230769231,56.820512820512825,5.230769230769231,1.5384615384615385,0.10256410256410256
9,충청남도,서산시,대산읍,대산읍제6투,729,483,178,271,29,2,2,482,1,246,36.92946058091287,56.22406639004149,6.016597510373444,0.4149377593360996,0.4149377593360996
10,충청남도,서산시,인지면,관내사전투표,2109,2109,1266,699,114,10,5,2094,15,0,60.458452722063036,33.3810888252149,5.444126074498568,0.4775549188156638,0.2387774594078319
11,충청남도,서산시,인지면,인지면제1투,2569,1530,537,895,75,15,1,1523,7,1039,35.25935653315824,58.76559422193039,4.9244911359159556,0.984898227183191,0.06565988181221273
12,충청남도,서산시,인지면,인지면제2투,672,396,116,258,18,3,0,395,1,276,29.367088607594937,65.31645569620254,4.556962025316456,0.7594936708860759,0.0
13,충청남도,서산시,인지면,인지면제3투,756,460,128,304,19,6,0,457,3,296,28.00875273522976,66.52078774617067,4.157549234135667,1.312910284463895,0.0
14,충청남도,서산시,부석면,관내사전투표,1142,1142,632,423,68,14,0,1137,5,0,55.584872471416006,37.203166226912934,5.980650835532102,1.2313104661389622,0.0
15,충청남도,서산시,부석면,부석면제1투,1105,658,208,416,23,3,2,652,6,447,31.901840490797547,63.80368098159509,3.52760736196319,0.4601226993865031,0.3067484662576687
16,충청남도,서산시,부석면,부석면제2투,1011,558,181,350,22,2,0,555,3,453,32.612612612612615,63.06306306306306,3.963963963963964,0.36036036036036034,0.0
17,충청남도,서산시,부석면,부석면제3투,606,349,92,237,16,2,0,347,2,257,26.512968299711815,68.29971181556196,4.610951008645533,0.5763688760806917,0.0
18,충청남도,서산시,부석면,부석면제4투,660,434,166,250,12,2,0,430,4,226,38.604651162790695,58.139534883720934,2.7906976744186047,0.46511627906976744,0.0
19,충청남도,서산시,팔봉면,관내사전투표,920,920,459,390,56,6,2,913,7,0,50.273822562979184,42.716319824753555,6.133625410733845,0.6571741511500547,0.21905805038335158
20,충청남도,서산시,팔봉면,팔봉면제1투,1229,782,229,523,21,4,2,779,3,447,29.396662387676507,67.13735558408216,2.6957637997432604,0.5134788189987163,0.25673940949935814
21,충청남도,서산시,팔봉면,팔봉면제2투,697,443,115,305,18,0,2,440,3,254,26.136363636363637,69.31818181818183,4.090909090909091,0.0,0.45454545454545453
22,충청남도,서산시,팔봉면,팔봉면제3투,61,27,5,21,0,0,1,27,0,34,18.51851851851852,77.77777777777779,0.0,0.0,3.7037037037037033
23,충청남도,서산시,지곡면,관내사전투표,1879,1879,1156,579,110,19,0,1864,15,0,62.01716738197425,31.06223175965665,5.901287553648069,1.01931330472103,0.0
24,충청남도,서산시,지곡면,지곡면제1투,2003,1169,331,765,62,2,1,1161,8,834,28.5099052540913,65.89147286821705,5.340223944875108,0.17226528854435832,0.08613264427217916
25,충청남도,서산시,지곡면,지곡면제2투,2526,1647,768,743,109,15,0,1635,12,879,46.972477064220186,45.4434250764526,6.666666666666667,0.9174311926605505,0.0
26,충청남도,서산시,성연면,관내사전투표,3788,3788,2654,718,354,25,5,3756,32,0,70.66027689030884,19.116080937167197,9.424920127795527,0.6656017039403621,0.13312034078807242
27,충청남도,서산시,성연면,성연면제1투,1394,811,242,519,38,2,0,801,10,583,30.21223470661673,64.7940074906367,4.7440699126092385,0.24968789013732834,0.0
28,충청남도,서산시,성연면,성연면제2투,3385,2143,1079,796,231,22,1,2129,14,1242,50.68107092531705,37.38844527947393,10.85016439643025,1.0333489901362143,0.046970408642555195
29,충청남도,서산시,성연면,성연면제3투,3133,2049,1027,753,228,26,3,2037,12,1084,50.41728031418753,36.96612665684831,11.192930780559648,1.2763868433971526,0.14727540500736377
30,충청남도,서산시,음암면,관내사전투표,1861,1861,1129,574,113,22,3,1841,20,0,61.32536664856056,31.1787072243346,6.137968495382944,1.1950027159152634,0.16295491580662683
31,충청남도,서산시,음암면,음암면제1투,1520,868,240,578,38,3,1,860,8,652,27.906976744186046,67.2093023255814,4.4186046511627906,0.3488372093023256,0.11627906976744186
32,충청남도,서산시,음암면,음암면제2투,2127,1288,485,700,74,10,3,1272,16,839,38.12893081761006,55.0314465408805,5.817610062893082,0.7861635220125787,0.2358490566037736
33,충청남도,서산시,음암면,음암면제3투,1227,806,333,404,44,11,1,793,13,421,41.992433795712486,50.945775535939475,5.548549810844893,1.3871374527112232,0.12610340479192939
34,충청남도,서산시,음암면,음암면제4투,695,470,130,310,23,1,3,467,3,225,27.8372591006424,66.38115631691649,4.925053533190578,0.21413276231263384,0.6423982869379015
35,충청남도,서산시,운산면,관내사전투표,1293,1293,684,535,55,11,2,1287,6,0,53.14685314685315,41.56954156954157,4.273504273504273,0.8547008547008548,0.1554001554001554
36,충청남도,서산시,운산면,운산면제1투,1606,959,249,661,40,4,1,955,4,647,26.07329842931937,69.21465968586388,4.18848167539267,0.41884816753926707,0.10471204188481677
37,충청남도,서산시,운산면,운산면제2투,649,457,111,330,9,1,0,451,6,192,24.6119733924612,73.17073170731707,1.9955654101995564,0.22172949002217296,0.0
38,충청남도,서산시,운산면,운산면제3투,719,471,172,268,23,3,1,467,4,248,36.83083511777302,57.38758029978587,4.925053533190578,0.6423982869379015,0.21413276231263384
39,충청남도,서산시,해미면,관내사전투표,2612,2612,1373,960,238,17,3,2591,21,0,52.991123118487074,37.05133153222694,9.185642609031262,0.6561173292165187,0.11578541103820918
40,충청남도,서산시,해미면,해미면제1투,1444,844,254,542,38,5,1,840,4,600,30.238095238095237,64.52380952380953,4.523809523809524,0.5952380952380952,0.11904761904761905
41,충청남도,서산시,해미면,해미면제2투,1047,630,173,425,25,2,0,625,5,417,27.68,68.0,4.0,0.32,0.0
42,충청남도,서산시,해미면,해미면제3투,1684,911,237,624,40,3,1,905,6,773,26.1878453038674,68.95027624309392,4.41988950276243,0.3314917127071823,0.11049723756906078
43,충청남도,서산시,고북면,관내사전투표,952,952,533,311,91,12,5,952,0,0,55.98739495798319,32.668067226890756,9.558823529411764,1.2605042016806722,0.5252100840336135
44,충청남도,서산시,고북면,고북면제1투,1372,854,251,551,37,5,3,847,7,518,29.634002361275087,65.05312868949233,4.368358913813459,0.5903187721369539,0.3541912632821724
45,충청남도,서산시,고북면,고북면제2투,1120,693,249,347,82,5,1,684,9,427,36.40350877192983,50.73099415204678,11.988304093567251,0.7309941520467835,0.14619883040935672
46,충청남도,서산시,고북면,고북면제3투,835,509,175,309,21,2,0,507,2,326,34.51676528599605,60.946745562130175,4.142011834319527,0.39447731755424065,0.0
47,충청남도,서산시,부춘동,관내사전투표,5608,5608,3490,1603,416,53,4,5566,42,0,62.70212001437297,28.799856270211997,7.4739489759252615,0.9522098454904778,0.07186489399928135
48,충청남도,서산시,부춘동,부춘동제1투,1647,847,259,528,45,11,2,845,2,800,30.650887573964496,62.48520710059171,5.325443786982249,1.301775147928994,0.2366863905325444
49,충청남도,서산시,부춘동,부춘동제2투,1818,1174,409,649,105,5,2,1170,4,644,34.957264957264954,55.47008547008547,8.974358974358974,0.4273504273504274,0.17094017094017094
50,충청남도,서산시,부춘동,부춘동제3투,2810,1738,635,917,166,7,4,1729,9,1072,36.72643146327357,53.036437246963565,9.600925390399075,0.4048582995951417,0.23134759976865238
51,충청남도,서산시,부춘동,부춘동제4투,1816,1106,406,602,71,15,1,1095,11,710,37.077625570776256,54.977168949771695,6.4840182648401825,1.36986301369863,0.091324200913242
52,충청남도,서산시,부춘동,부춘동제5투,1997,1324,501,676,109,19,0,1305,19,673,38.39080459770115,51.8007662835249,8.352490421455938,1.4559386973180077,0.0
53,충청남도,서산시,동문1동,관내사전투표,3986,3986,2422,1215,273,47,6,3963,23,0,61.115316679283374,30.658591975775927,6.888720666161999,1.1859702245773405,0.1514004542013626
54,충청남도,서산시,동문1동,동문1동제1투,1702,884,280,525,64,8,0,877,7,818,31.92702394526796,59.863169897377425,7.297605473204105,0.9122006841505131,0.0
55,충청남도,서산시,동문1동,동문1동제2투,2536,1488,409,991,67,8,2,1477,11,1048,27.691266079891676,67.09546377792823,4.536222071767095,0.5416384563303994,0.13540961408259986
56,충청남도,서산시,동문1동,동문1동제3투,3233,2029,756,1078,154,25,2,2015,14,1204,37.51861042183623,53.49875930521092,7.642679900744417,1.240694789081886,0.09925558312655086
57,충청남도,서산시,동문1동,동문1동제4투,1594,1083,427,556,76,17,0,1076,7,511,39.68401486988847,51.6728624535316,7.063197026022305,1.5799256505576207,0.0
58,충청남도,서산시,동문2동,관내사전투표,1772,1772,1053,560,120,23,3,1759,13,0,59.86355884025014,31.836270608300172,6.822057987492894,1.3075611142694712,0.17055144968732233
59,충청남도,서산시,동문2동,동문2동제1투,977,524,164,331,26,0,1,522,2,453,31.417624521072796,63.40996168582376,4.980842911877394,0.0,0.19157088122605362
60,충청남도,서산시,동문2동,동문2동제2투,1423,855,245,544,50,7,0,846,9,568,28.959810874704488,64.30260047281324,5.91016548463357,0.8274231678486997,0.0
61,충청남도,서산시,동문2동,동문2동제3투,2449,1593,521,936,102,17,3,1579,14,856,32.99556681443952,59.27802406586448,6.459784673844206,1.0766307789740341,0.18999366687777072
62,충청남도,서산시,수석동,관내사전투표,3971,3971,2542,1080,284,36,2,3944,27,0,64.4523326572008,27.38336713995943,7.200811359026369,0.9127789046653144,0.05070993914807302
63,충청남도,서산시,수석동,수석동제1투,2799,1836,828,800,163,24,3,1818,18,963,45.54455445544555,44.00440044004401,8.965896589658966,1.3201320132013201,0.16501650165016502
64,충청남도,서산시,수석동,수석동제2투,3474,2061,675,1157,198,16,0,2046,15,1413,32.99120234604106,56.54936461388075,9.67741935483871,0.7820136852394917,0.0
65,충청남도,서산시,수석동,수석동제3투,923,568,185,352,22,5,0,564,4,355,32.801418439716315,62.4113475177305,3.900709219858156,0.8865248226950355,0.0
66,충청남도,서산시,수석동,수석동제4투,1942,1275,450,725,69,17,2,1263,12,667,35.62945368171022,57.40300870942201,5.463182897862233,1.3460015835312746,0.1583531274742676
67,충청남도,서산시,석남동,관내사전투표,6254,6254,4129,1456,546,70,3,6204,50,0,66.5538362346873,23.468729851708574,8.800773694390715,1.1283043197936815,0.04835589941972921
68,충청남도,서산시,석남동,석남동제1투,3242,1864,700,979,156,17,1,1853,11,1378,37.776578521316786,52.83324338909876,8.41878035617917,0.9174311926605505,0.053966540744738264
69,충청남도,서산시,석남동,석남동제2투,3619,2163,860,1032,221,31,3,2147,16,1456,40.05589194224499,48.06707033069399,10.293432696786214,1.4438751746623195,0.13972985561248255
70,충청남도,서산시,석남동,석남동제3투,3148,2356,1163,931,217,34,3,2348,8,792,49.531516183986376,39.65076660988075,9.24190800681431,1.4480408858603067,0.12776831345826234
71,충청남도,서산시,석남동,석남동제4투,2252,1413,558,747,88,11,1,1405,8,839,39.7153024911032,53.167259786476876,6.263345195729538,0.7829181494661922,0.0711743772241993
72,충청남도,서산시,석남동,석남동제5투,941,572,156,382,24,7,0,569,3,369,27.416520210896312,67.13532513181019,4.21792618629174,1.2302284710017575,0.0
73,충청남도,서산시,석남동,석남동제6투,3101,2003,891,951,121,28,3,1994,9,1098,44.684052156469406,47.693079237713135,6.068204613841525,1.4042126379137412,0.15045135406218654
74,충청남도,서산시,석남동,석남동제7투,1692,1328,648,532,124,16,3,1323,5,364,48.97959183673469,40.21164021164021,9.372637944066515,1.2093726379440666,0.22675736961451248
75,충청남도,서산시,잘못 투입·구분된 투표지,,0,1,1,0,0,0,0,1,0,-1,100.0,0.0,0.0,0.0,0.0
0,충청남도,태안군,거소·선상투표,,131,121,52,49,9,1,2,113,8,10,46.017699115044245,43.36283185840708,7.964601769911504,0.8849557522123894,1.7699115044247788
1,충청남도,태안군,관외사전투표,,4493,4489,2317,1584,492,45,3,4441,48,4,52.1729340238685,35.667642422877734,11.07858590407566,1.013285296104481,0.06755235307363207
2,충청남도,태안군,재외투표,,179,149,103,23,20,3,0,149,0,30,69.12751677852349,15.436241610738255,13.422818791946309,2.013422818791946,0.0
3,충청남도,태안군,태안읍,관내사전투표,7245,7245,4260,2383,483,69,6,7201,44,0,59.15845021524788,33.092626024163316,6.707401749756977,0.9582002499652825,0.08332176086654632
4,충청남도,태안군,태안읍,태안읍제1투,1720,1065,325,673,54,10,1,1063,2,655,30.57384760112888,63.31138287864534,5.079962370649106,0.940733772342427,0.09407337723424271
5,충청남도,태안군,태안읍,태안읍제2투,1070,671,247,393,25,2,0,667,4,399,37.031484257871064,58.920539730134934,3.7481259370314843,0.29985007496251875,0.0
6,충청남도,태안군,태안읍,태안읍제3투,1291,824,221,570,29,1,0,821,3,467,26.9183922046285,69.42752740560292,3.5322777101096223,0.12180267965895249,0.0
7,충청남도,태안군,태안읍,태안읍제4투,699,496,171,289,29,3,0,492,4,203,34.756097560975604,58.739837398373986,5.894308943089431,0.6097560975609756,0.0
8,충청남도,태안군,태안읍,태안읍제5투,1877,1145,364,693,70,11,0,1138,7,732,31.985940246045697,60.89630931458699,6.151142355008787,0.9666080843585236,0.0
9,충청남도,태안군,태안읍,태안읍제6투,3296,1941,613,1170,121,20,0,1924,17,1355,31.860706860706863,60.810810810810814,6.288981288981289,1.0395010395010396,0.0
10,충청남도,태안군,태안읍,태안읍제7투,1402,882,244,600,29,4,1,878,4,520,27.790432801822323,68.3371298405467,3.3029612756264237,0.45558086560364464,0.11389521640091116
11,충청남도,태안군,태안읍,태안읍제8투,4346,2719,944,1515,206,32,3,2700,19,1627,34.96296296296296,56.111111111111114,7.629629629629629,1.1851851851851851,0.1111111111111111
12,충청남도,태안군,안면읍,관내사전투표,2261,2261,1281,832,102,17,3,2235,26,0,57.31543624161074,37.225950782997764,4.563758389261745,0.7606263982102908,0.1342281879194631
13,충청남도,태안군,안면읍,안면읍제1투,1776,974,294,627,36,6,2,965,9,802,30.466321243523314,64.9740932642487,3.730569948186528,0.6217616580310881,0.20725388601036268
14,충청남도,태안군,안면읍,안면읍제2투,837,477,164,295,13,0,0,472,5,360,34.74576271186441,62.5,2.754237288135593,0.0,0.0
15,충청남도,태안군,안면읍,안면읍제3투,1365,902,290,581,22,4,1,898,4,463,32.29398663697104,64.69933184855235,2.4498886414253898,0.4454342984409799,0.11135857461024498
16,충청남도,태안군,안면읍,안면읍제4투,427,269,86,180,1,0,0,267,2,158,32.20973782771536,67.41573033707866,0.37453183520599254,0.0,0.0
17,충청남도,태안군,고남면,관내사전투표,512,512,268,210,26,3,2,509,3,0,52.652259332023576,41.2573673870334,5.1080550098231825,0.5893909626719057,0.3929273084479371
18,충청남도,태안군,고남면,고남면투표소,1349,806,268,505,24,0,3,800,6,543,33.5,63.125,3.0,0.0,0.375
19,충청남도,태안군,남면,관내사전투표,1153,1153,655,423,58,10,0,1146,7,0,57.15532286212914,36.910994764397905,5.06108202443281,0.8726003490401396,0.0
20,충청남도,태안군,남면,남면제1투,885,568,171,353,23,6,4,557,11,317,30.700179533213646,63.37522441651705,4.129263913824058,1.0771992818671454,0.718132854578097
21,충청남도,태안군,남면,남면제2투,630,408,109,281,10,2,0,402,6,222,27.114427860696516,69.90049751243781,2.4875621890547266,0.4975124378109453,0.0
22,충청남도,태안군,남면,남면제3투,1005,569,163,378,18,3,2,564,5,436,28.900709219858157,67.02127659574468,3.1914893617021276,0.5319148936170213,0.3546099290780142
23,충청남도,태안군,근흥면,관내사전투표,1390,1390,715,595,63,6,0,1379,11,0,51.84916606236403,43.14720812182741,4.568527918781726,0.43509789702683105,0.0
24,충청남도,태안군,근흥면,근흥면제1투,1021,635,151,456,16,4,4,631,4,386,23.93026941362916,72.2662440570523,2.535657686212361,0.6339144215530903,0.6339144215530903
25,충청남도,태안군,근흥면,근흥면제2투,915,572,167,373,24,2,1,567,5,343,29.453262786596117,65.78483245149911,4.232804232804233,0.3527336860670194,0.1763668430335097
26,충청남도,태안군,근흥면,근흥면제3투,1261,765,235,502,18,3,1,759,6,496,30.96179183135705,66.13965744400528,2.371541501976284,0.3952569169960474,0.13175230566534915
27,충청남도,태안군,근흥면,근흥면제4투,54,48,8,38,0,0,0,46,2,6,17.391304347826086,82.6086956521739,0.0,0.0,0.0
28,충청남도,태안군,소원면,관내사전투표,1601,1601,825,696,58,10,1,1590,11,0,51.886792452830186,43.77358490566038,3.647798742138365,0.628930817610063,0.06289308176100629
29,충청남도,태안군,소원면,소원면제1투,1694,948,261,652,26,1,1,941,7,746,27.73645058448459,69.28799149840596,2.763018065887354,0.10626992561105207,0.10626992561105207
30,충청남도,태안군,소원면,소원면제2투,1211,780,261,489,16,7,0,773,7,431,33.76455368693402,63.26002587322122,2.069857697283312,0.9055627425614489,0.0
31,충청남도,태안군,원북면,관내사전투표,1183,1183,618,464,89,7,0,1178,5,0,52.46179966044142,39.38879456706282,7.555178268251274,0.5942275042444821,0.0
32,충청남도,태안군,원북면,원북면제1투,1113,689,179,459,38,4,1,681,8,424,26.284875183553595,67.40088105726872,5.580029368575625,0.5873715124816447,0.14684287812041116
33,충청남도,태안군,원북면,원북면제2투,716,490,135,336,9,5,1,486,4,226,27.77777777777778,69.1358024691358,1.8518518518518516,1.02880658436214,0.205761316872428
34,충청남도,태안군,원북면,원북면제3투,721,464,125,315,15,3,0,458,6,257,27.292576419213976,68.77729257641921,3.2751091703056767,0.6550218340611353,0.0
35,충청남도,태안군,이원면,관내사전투표,664,664,339,293,25,3,2,662,2,0,51.20845921450151,44.259818731117825,3.7764350453172204,0.4531722054380665,0.3021148036253776
36,충청남도,태안군,이원면,이원면제1투,621,404,103,284,12,2,0,401,3,217,25.6857855361596,70.82294264339151,2.9925187032418954,0.4987531172069825,0.0
37,충청남도,태안군,이원면,이원면제2투,513,298,84,203,9,1,1,298,0,215,28.187919463087248,68.12080536912751,3.0201342281879198,0.33557046979865773,0.33557046979865773
38,충청남도,태안군,잘못 투입·구분된 투표지,,0,0,0,0,0,0,0,0,0,0,0.0,0.0,0.0,0.0,0.0
0,충청남도,금산군,거소·선상투표,,62,58,27,19,11,0,0,57,1,4,47.368421052631575,33.33333333333333,19.298245614035086,0.0,0.0
1,충청남도,금산군,관외사전투표,,3969,3969,2116,1360,408,36,5,3925,44,0,53.910828025477706,34.64968152866242,10.394904458598726,0.9171974522292993,0.12738853503184713
2,충청남도,금산군,재외투표,,182,155,98,44,9,4,0,155,0,27,63.2258064516129,28.387096774193548,5.806451612903226,2.5806451612903225,0.0
3,충청남도,금산군,금산읍,관내사전투표,5763,5763,3559,1768,338,53,7,5725,38,0,62.16593886462882,30.882096069868997,5.903930131004366,0.925764192139738,0.12227074235807861
4,충청남도,금산군,금산읍,금산읍제1투,1425,855,263,536,41,5,2,847,8,570,31.05076741440378,63.282172373081465,4.8406139315230226,0.5903187721369539,0.23612750885478156
5,충청남도,금산군,금산읍,금산읍제2투,1043,717,255,427,28,4,1,715,2,326,35.66433566433567,59.72027972027972,3.9160839160839163,0.5594405594405595,0.13986013986013987
6,충청남도,금산군,금산읍,금산읍제3투,2385,1460,556,806,76,11,4,1453,7,925,38.26565726083964,55.47143840330351,5.230557467309016,0.7570543702684102,0.27529249827942187
7,충청남도,금산군,금산읍,금산읍제4투,975,670,208,423,22,8,2,663,7,305,31.372549019607842,63.80090497737556,3.3182503770739067,1.206636500754148,0.301659125188537
8,충청남도,금산군,금산읍,금산읍제5투,1232,840,295,481,49,5,3,833,7,392,35.414165666266506,57.74309723889556,5.88235294117647,0.6002400960384154,0.36014405762304924
9,충청남도,금산군,금산읍,금산읍제6투,1126,745,254,456,25,3,1,739,6,381,34.37077131258457,61.70500676589986,3.3829499323410013,0.40595399188092013,0.13531799729364005
10,충청남도,금산군,금산읍,금산읍제7투,2964,1872,791,929,119,18,1,1858,14,1092,42.57265877287406,50.0,6.404736275565123,0.9687836383207751,0.05382131324004305
11,충청남도,금산군,금산읍,금산읍제8투,1318,888,259,572,39,6,0,876,12,430,29.5662100456621,65.29680365296804,4.4520547945205475,0.684931506849315,0.0
12,충청남도,금산군,금성면,관내사전투표,572,572,340,190,29,5,1,565,7,0,60.17699115044248,33.6283185840708,5.132743362831858,0.8849557522123894,0.17699115044247787
13,충청남도,금산군,금성면,금성면제1투,1179,710,221,455,23,4,0,703,7,469,31.436699857752487,64.7226173541963,3.2716927453769555,0.5689900426742532,0.0
14,충청남도,금산군,금성면,금성면제2투,701,420,152,248,15,1,1,417,3,281,36.45083932853717,59.47242206235012,3.597122302158273,0.2398081534772182,0.2398081534772182
15,충청남도,금산군,제원면,관내사전투표,674,674,415,227,22,6,0,670,4,0,61.940298507462686,33.88059701492537,3.2835820895522385,0.8955223880597015,0.0
16,충청남도,금산군,제원면,제원면제1투,1137,723,179,501,37,3,0,720,3,414,24.86111111111111,69.58333333333333,5.138888888888888,0.4166666666666667,0.0
17,충청남도,금산군,제원면,제원면제2투,501,334,108,216,9,0,0,333,1,167,32.432432432432435,64.86486486486487,2.7027027027027026,0.0,0.0
18,충청남도,금산군,부리면,관내사전투표,490,490,249,215,18,2,0,484,6,0,51.446280991735534,44.421487603305785,3.71900826446281,0.4132231404958678,0.0
19,충청남도,금산군,부리면,부리면제1투,900,542,150,359,26,1,1,537,5,358,27.932960893854748,66.85288640595903,4.8417132216014895,0.186219739292365,0.186219739292365
20,충청남도,금산군,부리면,부리면제2투,551,359,117,223,11,5,0,356,3,192,32.86516853932584,62.64044943820225,3.089887640449438,1.4044943820224718,0.0
21,충청남도,금산군,군북면,관내사전투표,297,297,171,108,15,2,0,296,1,0,57.770270270270274,36.486486486486484,5.0675675675675675,0.6756756756756757,0.0
22,충청남도,금산군,군북면,군북면제1투,435,268,70,185,9,2,0,266,2,167,26.31578947368421,69.54887218045113,3.3834586466165413,0.7518796992481203,0.0
23,충청남도,금산군,군북면,군북면제2투,711,485,158,298,21,3,2,482,3,226,32.780082987551864,61.82572614107884,4.356846473029045,0.6224066390041494,0.4149377593360996
24,충청남도,금산군,군북면,군북면제3투,336,233,77,146,9,1,0,233,0,103,33.047210300429185,62.66094420600859,3.862660944206009,0.4291845493562232,0.0
25,충청남도,금산군,남일면,관내사전투표,531,531,324,181,22,1,1,529,2,0,61.247637051039696,34.215500945179585,4.158790170132325,0.1890359168241966,0.1890359168241966
26,충청남도,금산군,남일면,남일면제1투,1133,705,216,452,25,2,0,695,10,428,31.07913669064748,65.03597122302158,3.597122302158273,0.28776978417266186,0.0
27,충청남도,금산군,남일면,남일면제2투,436,273,73,194,3,2,0,272,1,163,26.838235294117645,71.32352941176471,1.1029411764705883,0.7352941176470588,0.0
28,충청남도,금산군,남이면,관내사전투표,362,362,200,131,24,3,0,358,4,0,55.865921787709496,36.592178770949715,6.70391061452514,0.8379888268156425,0.0
29,충청남도,금산군,남이면,남이면제1투,749,468,175,262,19,1,3,460,8,281,38.04347826086957,56.95652173913044,4.130434782608695,0.21739130434782608,0.6521739130434783
30,충청남도,금산군,남이면,남이면제2투,421,275,102,157,10,5,0,274,1,146,37.22627737226277,57.299270072992705,3.64963503649635,1.824817518248175,0.0
31,충청남도,금산군,진산면,관내사전투표,769,769,371,356,34,2,2,765,4,0,48.49673202614379,46.5359477124183,4.444444444444445,0.261437908496732,0.261437908496732
32,충청남도,금산군,진산면,진산면제1투,1146,744,202,504,30,2,0,738,6,402,27.371273712737125,68.29268292682927,4.0650406504065035,0.27100271002710025,0.0
33,충청남도,금산군,진산면,진산면제2투,601,403,118,253,24,1,0,396,7,198,29.797979797979796,63.888888888888886,6.0606060606060606,0.25252525252525254,0.0
34,충청남도,금산군,복수면,관내사전투표,563,563,295,242,19,1,1,558,5,0,52.867383512544805,43.36917562724014,3.405017921146954,0.17921146953405018,0.17921146953405018
35,충청남도,금산군,복수면,복수면제1투,886,532,131,379,19,1,1,531,1,354,24.670433145009415,71.37476459510358,3.5781544256120528,0.18832391713747645,0.18832391713747645
36,충청남도,금산군,복수면,복수면제2투,891,579,166,379,27,2,2,576,3,312,28.819444444444443,65.79861111111111,4.6875,0.3472222222222222,0.3472222222222222
37,충청남도,금산군,추부면,관내사전투표,1528,1528,920,511,81,9,1,1522,6,0,60.44678055190539,33.5742444152431,5.321944809461235,0.5913272010512484,0.0657030223390276
38,충청남도,금산군,추부면,추부면제1투,1737,942,326,544,62,2,1,935,7,795,34.8663101604278,58.18181818181818,6.631016042780749,0.21390374331550802,0.10695187165775401
39,충청남도,금산군,추부면,추부면제2투,900,578,189,350,31,2,2,574,4,322,32.926829268292686,60.97560975609756,5.400696864111499,0.34843205574912894,0.34843205574912894
40,충청남도,금산군,추부면,추부면제3투,947,630,177,417,28,3,0,625,5,317,28.32,66.72,4.4799999999999995,0.48,0.0
41,충청남도,금산군,잘못 투입·구분된 투표지,,0,0,0,0,0,0,0,0,0,0,0.0,0.0,0.0,0.0,0.0
0,충청남도,논산시,거소·선상투표,,207,200,84,79,28,1,1,193,7,7,43.523316062176164,40.932642487046635,14.507772020725387,0.5181347150259068,0.5181347150259068
1,충청남도,논산시,관외사전투표,,7050,7048,3912,2091,861,81,11,6956,92,2,56.2392179413456,30.060379528464637,12.377803335250144,1.1644623346751006,0.15813686026451984
2,충청남도,논산시,재외투표,,379,311,212,73,23,3,0,311,0,68,68.16720257234726,23.47266881028939,7.395498392282958,0.964630225080386,0.0
3,충청남도,논산시,강경읍,관내사전투표,1995,1994,1353,534,85,9,1,1982,12,1,68.26437941473259,26.942482341069628,4.288597376387488,0.45408678102926336,0.050454086781029264
4,충청남도,논산시,강경읍,강경읍제1투,746,453,185,238,25,1,0,449,4,293,41.202672605790646,53.00668151447662,5.56792873051225,0.22271714922048996,0.0
5,충청남도,논산시,강경읍,강경읍제2투,427,278,109,153,14,1,0,277,1,149,39.35018050541516,55.23465703971119,5.054151624548736,0.36101083032490977,0.0
6,충청남도,논산시,강경읍,강경읍제3투,1816,1142,506,573,56,4,0,1139,3,674,44.42493415276558,50.30728709394205,4.916593503072871,0.35118525021949076,0.0
7,충청남도,논산시,강경읍,강경읍제4투,1356,804,380,380,32,3,1,796,8,552,47.73869346733669,47.73869346733669,4.0201005025125625,0.37688442211055273,0.12562814070351758
8,충청남도,논산시,연무읍,관내사전투표,3412,3412,2082,1001,268,33,3,3387,25,0,61.47032772364924,29.554177738411575,7.912607026867434,0.9743135518157661,0.08857395925597875
9,충청남도,논산시,연무읍,연무읍제1투,2276,1362,557,713,73,11,0,1354,8,914,41.13737075332349,52.65878877400295,5.391432791728213,0.8124076809453471,0.0
10,충청남도,논산시,연무읍,연무읍제2투,2288,1303,505,689,80,18,2,1294,9,985,39.02627511591963,53.245749613601234,6.182380216383308,1.3910355486862442,0.1545595054095827
11,충청남도,논산시,연무읍,연무읍제3투,1169,625,220,362,32,5,0,619,6,544,35.54119547657512,58.48142164781906,5.169628432956381,0.8077544426494345,0.0
12,충청남도,논산시,연무읍,연무읍제4투,1210,763,339,379,31,4,1,754,9,447,44.96021220159151,50.265251989389924,4.111405835543767,0.5305039787798408,0.1326259946949602
13,충청남도,논산시,성동면,관내사전투표,887,887,540,303,33,7,1,884,3,0,61.085972850678736,34.276018099547514,3.733031674208145,0.7918552036199095,0.11312217194570137
14,충청남도,논산시,성동면,성동면제1투,624,362,137,207,13,2,2,361,1,262,37.95013850415512,57.340720221606645,3.6011080332409975,0.554016620498615,0.554016620498615
15,충청남도,논산시,성동면,성동면제2투,820,516,185,308,15,0,1,509,7,304,36.345776031434184,60.51080550098232,2.9469548133595285,0.0,0.19646365422396855
16,충청남도,논산시,성동면,성동면제3투,1000,648,212,407,24,1,2,646,2,352,32.81733746130031,63.00309597523219,3.7151702786377707,0.15479876160990713,0.30959752321981426
17,충청남도,논산시,광석면,관내사전투표,933,933,546,318,57,4,0,925,8,0,59.027027027027025,34.37837837837838,6.162162162162162,0.43243243243243246,0.0
18,충청남도,논산시,광석면,광석면제1투,1009,635,183,418,25,5,1,632,3,374,28.955696202531644,66.13924050632912,3.9556962025316458,0.7911392405063291,0.15822784810126583
19,충청남도,논산시,광석면,광석면제2투,534,351,121,210,15,5,0,351,0,183,34.472934472934476,59.82905982905983,4.273504273504273,1.4245014245014245,0.0
20,충청남도,논산시,광석면,광석면제3투,928,588,173,381,24,5,1,584,4,340,29.62328767123288,65.23972602739725,4.10958904109589,0.8561643835616438,0.17123287671232876
21,충청남도,논산시,노성면,관내사전투표,631,630,340,215,60,5,1,621,9,1,54.750402576489535,34.62157809983897,9.66183574879227,0.8051529790660225,0.1610305958132045
22,충청남도,논산시,노성면,노성면제1투,991,635,175,434,15,8,0,632,3,356,27.689873417721518,68.67088607594937,2.3734177215189876,1.2658227848101267,0.0
23,충청남도,논산시,노성면,노성면제2투,744,460,136,297,24,0,2,459,1,284,29.629629629629626,64.70588235294117,5.228758169934641,0.0,0.4357298474945534
24,충청남도,논산시,상월면,관내사전투표,963,963,591,306,38,14,1,950,13,0,62.21052631578947,32.21052631578947,4.0,1.4736842105263157,0.10526315789473684
25,충청남도,논산시,상월면,상월면제1투,986,613,241,340,25,1,0,607,6,373,39.70345963756178,56.01317957166392,4.118616144975288,0.16474464579901155,0.0
26,충청남도,논산시,상월면,상월면제2투,934,536,208,302,18,6,0,534,2,398,38.951310861423224,56.55430711610487,3.3707865168539324,1.1235955056179776,0.0
27,충청남도,논산시,부적면,관내사전투표,1151,1151,702,365,62,13,2,1144,7,0,61.36363636363637,31.905594405594407,5.419580419580419,1.1363636363636365,0.17482517482517482
28,충청남도,논산시,부적면,부적면제1투,936,554,204,320,25,2,0,551,3,382,37.02359346642468,58.076225045372055,4.537205081669692,0.3629764065335753,0.0
29,충청남도,논산시,부적면,부적면제2투,609,408,133,251,17,2,0,403,5,201,33.002481389578165,62.28287841191067,4.218362282878412,0.49627791563275436,0.0
30,충청남도,논산시,부적면,부적면제3투,494,352,107,225,18,2,0,352,0,142,30.39772727272727,63.92045454545454,5.113636363636364,0.5681818181818182,0.0
31,충청남도,논산시,연산면,관내사전투표,1477,1477,834,526,79,18,2,1459,18,0,57.16244002741604,36.052090472926665,5.414667580534613,1.233721727210418,0.1370801919122687
32,충청남도,논산시,연산면,연산면제1투,1484,952,281,619,39,8,2,949,3,532,29.610115911485774,65.22655426765016,4.10958904109589,0.8429926238145415,0.21074815595363539
33,충청남도,논산시,연산면,연산면제2투,1135,632,182,412,26,3,1,624,8,503,29.166666666666668,66.02564102564102,4.166666666666666,0.4807692307692308,0.16025641025641024
34,충청남도,논산시,연산면,연산면제3투,871,574,164,383,15,6,2,570,4,297,28.771929824561404,67.19298245614034,2.631578947368421,1.0526315789473684,0.3508771929824561
35,충청남도,논산시,벌곡면,관내사전투표,602,602,341,224,18,3,2,588,14,0,57.993197278911566,38.095238095238095,3.061224489795918,0.5102040816326531,0.3401360544217687
36,충청남도,논산시,벌곡면,벌곡면제1투,706,445,141,274,26,1,1,443,2,261,31.82844243792325,61.8510158013544,5.8690744920993225,0.2257336343115124,0.2257336343115124
37,충청남도,논산시,벌곡면,벌곡면제2투,634,428,101,308,12,2,0,423,5,206,23.87706855791962,72.81323877068559,2.8368794326241136,0.4728132387706856,0.0
38,충청남도,논산시,양촌면,관내사전투표,1378,1378,769,520,66,8,3,1366,12,0,56.29575402635432,38.06734992679356,4.831625183016105,0.5856515373352855,0.21961932650073207
39,충청남도,논산시,양촌면,양촌면제1투,834,498,164,303,21,3,2,493,5,336,33.2657200811359,61.4604462474645,4.259634888438134,0.6085192697768762,0.4056795131845842
40,충청남도,논산시,양촌면,양촌면제2투,745,374,101,251,18,2,0,372,2,371,27.1505376344086,67.47311827956989,4.838709677419355,0.5376344086021506,0.0
41,충청남도,논산시,양촌면,양촌면제3투,1497,981,287,578,99,9,1,974,7,516,29.466119096509242,59.34291581108829,10.164271047227926,0.9240246406570842,0.10266940451745381
42,충청남도,논산시,가야곡면,관내사전투표,818,818,436,330,40,8,0,814,4,0,53.56265356265356,40.54054054054054,4.914004914004914,0.9828009828009828,0.0
43,충청남도,논산시,가야곡면,가야곡면제1투,787,474,148,304,17,1,0,470,4,313,31.48936170212766,64.68085106382979,3.6170212765957444,0.2127659574468085,0.0
44,충청남도,논산시,가야곡면,가야곡면제2투,567,387,125,239,16,3,1,384,3,180,32.55208333333333,62.239583333333336,4.166666666666666,0.78125,0.26041666666666663
45,충청남도,논산시,가야곡면,가야곡면제3투,656,411,140,251,15,1,3,410,1,245,34.146341463414636,61.21951219512195,3.6585365853658534,0.24390243902439024,0.7317073170731708
46,충청남도,논산시,은진면,관내사전투표,1284,1284,778,400,87,11,1,1277,7,0,60.92404072043853,31.323414252153487,6.812842599843383,0.8613938919342208,0.07830853563038372
47,충청남도,논산시,은진면,은진면제1투,918,542,203,302,32,1,0,538,4,376,37.732342007434944,56.13382899628253,5.947955390334572,0.18587360594795538,0.0
48,충청남도,논산시,은진면,은진면제2투,531,346,118,207,15,3,0,343,3,185,34.40233236151604,60.34985422740525,4.373177842565598,0.8746355685131195,0.0
49,충청남도,논산시,은진면,은진면제3투,851,483,178,260,35,5,0,478,5,368,37.238493723849366,54.39330543933054,7.322175732217573,1.0460251046025104,0.0
50,충청남도,논산시,채운면,관내사전투표,721,721,481,208,27,2,0,718,3,0,66.991643454039,28.969359331476323,3.7604456824512535,0.2785515320334262,0.0
51,충청남도,논산시,채운면,채운면제1투,657,440,133,280,20,2,0,435,5,217,30.574712643678158,64.36781609195403,4.597701149425287,0.45977011494252873,0.0
52,충청남도,논산시,채운면,채운면제2투,546,386,143,224,11,4,1,383,3,160,37.33681462140992,58.485639686684074,2.8720626631853787,1.0443864229765014,0.26109660574412535
53,충청남도,논산시,취암동,관내사전투표,7151,7150,4766,1737,540,55,6,7104,46,1,67.08896396396396,24.451013513513516,7.601351351351352,0.7742117117117117,0.08445945945945946
54,충청남도,논산시,취암동,취암동제1투,1978,1134,377,691,51,7,1,1127,7,844,33.451641526175685,61.31322094055013,4.525288376220053,0.6211180124223602,0.08873114463176575
55,충청남도,논산시,취암동,취암동제2투,3150,1690,665,863,133,13,2,1676,14,1460,39.67780429594272,51.491646778042956,7.935560859188544,0.7756563245823389,0.11933174224343676
56,충청남도,논산시,취암동,취암동제3투,3696,2169,842,1148,147,16,1,2154,15,1527,39.09006499535748,53.29619312906221,6.8245125348189415,0.7428040854224698,0.04642525533890436
57,충청남도,논산시,취암동,취암동제4투,1021,667,204,430,21,9,1,665,2,354,30.67669172932331,64.66165413533834,3.1578947368421053,1.3533834586466165,0.15037593984962408
58,충청남도,논산시,취암동,취암동제5투,1617,1126,476,564,56,19,2,1117,9,491,42.614145031333926,50.49239033124441,5.0134288272157566,1.7009847806624887,0.17905102954341987
59,충청남도,논산시,취암동,취암동제6투,1505,973,351,543,56,16,0,966,7,532,36.33540372670808,56.2111801242236,5.797101449275362,1.6563146997929608,0.0
60,충청남도,논산시,취암동,취암동제7투,2346,1499,687,686,97,14,2,1486,13,847,46.23149394347241,46.16419919246299,6.527590847913863,0.9421265141318977,0.13458950201884254
61,충청남도,논산시,취암동,취암동제8투,2937,1987,932,886,139,18,1,1976,11,950,47.16599190283401,44.83805668016194,7.034412955465587,0.9109311740890688,0.05060728744939271
62,충청남도,논산시,부창동,관내사전투표,2074,2074,1322,599,123,16,4,2064,10,0,64.05038759689923,29.021317829457367,5.959302325581396,0.7751937984496124,0.1937984496124031
63,충청남도,논산시,부창동,부창동제1투,1917,1304,536,687,57,15,2,1297,7,613,41.32613723978412,52.96838858905166,4.394757131842714,1.156515034695451,0.15420200462606012
64,충청남도,논산시,부창동,부창동제2투,1291,780,260,466,41,5,3,775,5,511,33.5483870967742,60.12903225806452,5.290322580645161,0.6451612903225806,0.3870967741935484
65,충청남도,논산시,부창동,부창동제3투,3439,2254,995,1105,116,20,2,2238,16,1185,44.459338695263625,49.37444146559428,5.183199285075961,0.8936550491510277,0.08936550491510277
66,충청남도,논산시,부창동,부창동제4투,2645,1720,763,838,90,16,3,1710,10,925,44.61988304093567,49.005847953216374,5.263157894736842,0.9356725146198831,0.17543859649122806
67,충청남도,논산시,잘못 투입·구분된 투표지,,0,1,0,1,0,0,0,1,0,-1,0.0,100.0,0.0,0.0,0.0
0,충청남도,계룡시,거소·선상투표,,84,83,23,40,13,0,2,78,5,1,29.48717948717949,51.28205128205128,16.666666666666664,0.0,2.564102564102564
1,충청남도,계룡시,관외사전투표,,4530,4530,2414,1358,680,38,2,4492,38,0,53.739982190560994,30.23152270703473,15.138023152270705,0.8459483526268923,0.04452359750667854
2,충청남도,계룡시,재외투표,,207,166,110,32,23,1,0,166,0,41,66.26506024096386,19.27710843373494,13.855421686746988,0.6024096385542169,0.0
3,충청남도,계룡시,두마면,관내사전투표,2527,2527,1699,616,162,26,1,2504,23,0,67.8514376996805,24.600638977635782,6.469648562300319,1.038338658146965,0.039936102236421724
4,충청남도,계룡시,두마면,두마면제1투,1539,1124,335,713,61,10,1,1120,4,415,29.910714285714285,63.660714285714285,5.446428571428571,0.8928571428571428,0.08928571428571429
5,충청남도,계룡시,두마면,두마면제2투,2253,1651,607,892,123,16,3,1641,10,602,36.98964046313223,54.35709932967703,7.495429616087751,0.9750152346130408,0.18281535648994515
6,충청남도,계룡시,두마면,두마면제3투,3106,2302,954,1061,251,15,3,2284,18,804,41.76882661996497,46.453590192644484,10.989492119089316,0.6567425569176882,0.13134851138353765
7,충청남도,계룡시,엄사면,관내사전투표,3322,3322,2201,886,186,27,2,3302,20,0,66.65657177468202,26.83222289521502,5.632949727437916,0.8176862507571169,0.06056935190793458
8,충청남도,계룡시,엄사면,엄사면제1투,3202,2210,701,1332,141,21,2,2197,13,992,31.907146108329542,60.628129267182516,6.417842512517069,0.9558488848429678,0.09103322712790168
9,충청남도,계룡시,엄사면,엄사면제2투,1882,1262,380,766,103,5,1,1255,7,620,30.278884462151396,61.03585657370518,8.207171314741036,0.398406374501992,0.0796812749003984
10,충청남도,계룡시,엄사면,엄사면제3투,1510,1060,339,630,77,5,2,1053,7,450,32.193732193732195,59.82905982905983,7.31244064577398,0.4748338081671415,0.1899335232668566
11,충청남도,계룡시,엄사면,엄사면제4투,1920,1248,438,711,79,8,1,1237,11,672,35.40824575586095,57.47776879547292,6.386418755052546,0.6467259498787389,0.08084074373484236
12,충청남도,계룡시,엄사면,엄사면제5투,645,422,119,281,18,2,1,421,1,223,28.26603325415677,66.7458432304038,4.275534441805226,0.4750593824228029,0.23752969121140144
13,충청남도,계룡시,신도안면,관내사전투표,2297,2297,1250,685,320,16,3,2274,23,0,54.96921723834652,30.123131046613892,14.072119613016712,0.7036059806508356,0.13192612137203166
14,충청남도,계룡시,신도안면,신도안면제1투,812,516,134,296,73,7,0,510,6,296,26.27450980392157,58.03921568627452,14.313725490196077,1.3725490196078431,0.0
15,충청남도,계룡시,신도안면,신도안면제2투,1857,1386,411,776,170,22,0,1379,7,471,29.804205946337923,56.272661348803474,12.327773749093545,1.5953589557650472,0.0
16,충청남도,계룡시,금암동,관내사전투표,2115,2115,1419,522,145,15,0,2101,14,0,67.5392670157068,24.845311756306522,6.901475487862922,0.7139457401237506,0.0
17,충청남도,계룡시,금암동,금암동제1투,2263,1601,511,964,94,16,2,1587,14,662,32.199117832388154,60.74354127284184,5.923125393824827,1.0081915563957151,0.1260239445494644
18,충청남도,계룡시,금암동,금암동제2투,1768,1247,365,771,91,8,0,1235,12,521,29.554655870445345,62.42914979757085,7.368421052631578,0.6477732793522267,0.0
19,충청남도,계룡시,잘못 투입·구분된 투표지,,0,0,0,0,0,0,0,0,0,0,0.0,0.0,0.0,0.0,0.0
0,충청남도,부여군,거소·선상투표,,229,220,72,103,27,8,0,210,10,9,34.285714285714285,49.047619047619044,12.857142857142856,3.8095238095238098,0.0
1,충청남도,부여군,관외사전투표,,3999,3999,2065,1354,499,40,3,3961,38,0,52.133299671800046,34.18328704872507,12.597828831103255,1.009845998485231,0.07573844988639232
2,충청남도,부여군,재외투표,,206,149,104,27,12,4,0,147,2,57,70.74829931972789,18.367346938775512,8.16326530612245,2.7210884353741496,0.0
3,충청남도,부여군,부여읍,관내사전투표,4616,4616,2666,1569,299,45,5,4584,32,0,58.15881326352531,34.22774869109947,6.522687609075044,0.981675392670157,0.10907504363001745
4,충청남도,부여군,부여읍,부여읍제1투,1187,783,194,528,53,3,2,780,3,404,24.871794871794872,67.6923076923077,6.794871794871795,0.38461538461538464,0.2564102564102564
5,충청남도,부여군,부여읍,부여읍제2투,1026,670,185,448,27,4,0,664,6,356,27.86144578313253,67.46987951807229,4.066265060240964,0.6024096385542169,0.0
6,충청남도,부여군,부여읍,부여읍제3투,1154,819,205,584,23,2,0,814,5,335,25.184275184275183,71.74447174447175,2.8255528255528257,0.2457002457002457,0.0
7,충청남도,부여군,부여읍,부여읍제4투,844,581,135,416,23,1,0,575,6,263,23.47826086956522,72.34782608695653,4.0,0.17391304347826086,0.0
8,충청남도,부여군,부여읍,부여읍제5투,1776,1232,380,759,77,8,0,1224,8,544,31.045751633986928,62.00980392156863,6.290849673202614,0.6535947712418301,0.0
9,충청남도,부여군,부여읍,부여읍제6투,1250,849,324,461,50,9,0,844,5,401,38.388625592417064,54.62085308056872,5.924170616113744,1.066350710900474,0.0
10,충청남도,부여군,부여읍,부여읍제7투,1109,659,169,444,38,2,0,653,6,450,25.880551301684534,67.99387442572741,5.819295558958652,0.3062787136294028,0.0
11,충청남도,부여군,부여읍,부여읍제8투,1003,641,156,456,19,5,0,636,5,362,24.528301886792452,71.69811320754717,2.9874213836477987,0.7861635220125787,0.0
12,충청남도,부여군,부여읍,부여읍제9투,1101,699,236,422,30,7,0,695,4,402,33.9568345323741,60.71942446043166,4.316546762589928,1.0071942446043165,0.0
13,충청남도,부여군,규암면,관내사전투표,2037,2037,1167,701,131,24,2,2025,12,0,57.62962962962963,34.617283950617285,6.469135802469136,1.1851851851851851,0.09876543209876544
14,충청남도,부여군,규암면,규암면제1투,1749,1092,326,699,53,6,1,1085,7,657,30.046082949308754,64.42396313364056,4.88479262672811,0.5529953917050692,0.09216589861751152
15,충청남도,부여군,규암면,규암면제2투,2384,1521,574,837,88,9,0,1508,13,863,38.06366047745358,55.50397877984084,5.835543766578249,0.5968169761273209,0.0
16,충청남도,부여군,규암면,규암면제3투,1132,786,291,447,38,5,1,782,4,346,37.212276214833764,57.1611253196931,4.859335038363171,0.639386189258312,0.1278772378516624
17,충청남도,부여군,규암면,규암면제4투,946,659,178,432,35,6,0,651,8,287,27.342549923195087,66.3594470046083,5.376344086021505,0.9216589861751152,0.0
18,충청남도,부여군,은산면,관내사전투표,1103,1103,522,519,38,6,1,1086,17,0,48.06629834254144,47.790055248618785,3.4990791896869244,0.5524861878453038,0.09208103130755065
19,충청남도,부여군,은산면,은산면제1투,1110,694,159,489,34,7,0,689,5,416,23.076923076923077,70.97242380261248,4.934687953555878,1.0159651669085632,0.0
20,충청남도,부여군,은산면,은산면제2투,484,296,88,189,16,2,0,295,1,188,29.830508474576273,64.0677966101695,5.423728813559322,0.6779661016949152,0.0
21,충청남도,부여군,은산면,은산면제3투,453,252,55,187,4,1,1,248,4,201,22.177419354838708,75.40322580645162,1.6129032258064515,0.4032258064516129,0.4032258064516129
22,충청남도,부여군,외산면,관내사전투표,729,729,349,342,23,8,0,722,7,0,48.337950138504155,47.368421052631575,3.1855955678670362,1.10803324099723,0.0
23,충청남도,부여군,외산면,외산면투표소,1173,747,205,500,28,7,2,742,5,426,27.628032345013477,67.38544474393531,3.7735849056603774,0.9433962264150944,0.2695417789757413
24,충청남도,부여군,내산면,관내사전투표,375,375,202,162,9,0,0,373,2,0,54.15549597855228,43.43163538873995,2.4128686327077746,0.0,0.0
25,충청남도,부여군,내산면,내산면투표소,900,572,181,373,15,0,0,569,3,328,31.810193321616868,65.5536028119508,2.6362038664323375,0.0,0.0
26,충청남도,부여군,구룡면,관내사전투표,569,569,339,204,19,2,2,566,3,0,59.8939929328622,36.042402826855124,3.356890459363958,0.35335689045936397,0.35335689045936397
27,충청남도,부여군,구룡면,구룡면투표소,1387,843,270,533,25,3,2,833,10,544,32.41296518607443,63.985594237695075,3.0012004801920766,0.36014405762304924,0.24009603841536614
28,충청남도,부여군,홍산면,관내사전투표,903,903,477,365,47,4,0,893,10,0,53.41545352743561,40.87346024636058,5.263157894736842,0.4479283314669653,0.0
29,충청남도,부여군,홍산면,홍산면제1투,1126,704,209,459,26,3,1,698,6,422,29.942693409742123,65.7593123209169,3.7249283667621778,0.42979942693409745,0.14326647564469913
30,충청남도,부여군,홍산면,홍산면제2투,380,228,67,146,11,0,1,225,3,152,29.777777777777775,64.88888888888889,4.888888888888889,0.0,0.4444444444444444
31,충청남도,부여군,옥산면,관내사전투표,404,404,208,168,25,3,0,404,0,0,51.48514851485149,41.584158415841586,6.188118811881188,0.7425742574257426,0.0
32,충청남도,부여군,옥산면,옥산면투표소,753,488,131,331,17,3,1,483,5,265,27.12215320910973,68.53002070393374,3.5196687370600417,0.6211180124223602,0.2070393374741201
33,충청남도,부여군,남면,관내사전투표,420,420,222,178,14,1,1,416,4,0,53.36538461538461,42.78846153846153,3.3653846153846154,0.2403846153846154,0.2403846153846154
34,충청남도,부여군,남면,남면투표소,1050,698,199,474,19,2,1,695,3,352,28.633093525179852,68.20143884892086,2.7338129496402876,0.28776978417266186,0.14388489208633093
35,충청남도,부여군,충화면,관내사전투표,293,293,138,125,20,3,1,287,6,0,48.08362369337979,43.55400696864111,6.968641114982578,1.0452961672473868,0.34843205574912894
36,충청남도,부여군,충화면,충화면투표소,629,401,107,285,4,2,1,399,2,228,26.81704260651629,71.42857142857143,1.0025062656641603,0.5012531328320802,0.2506265664160401
37,충청남도,부여군,양화면,관내사전투표,389,389,186,186,12,3,0,387,2,0,48.06201550387597,48.06201550387597,3.10077519379845,0.7751937984496124,0.0
38,충청남도,부여군,양화면,양화면제1투,386,271,48,217,3,1,0,269,2,115,17.843866171003718,80.66914498141264,1.1152416356877324,0.37174721189591076,0.0
39,충청남도,부여군,양화면,양화면제2투,583,372,135,219,11,3,0,368,4,211,36.684782608695656,59.5108695652174,2.989130434782609,0.8152173913043478,0.0
40,충청남도,부여군,임천면,관내사전투표,733,733,358,339,22,7,0,726,7,0,49.311294765840216,46.69421487603306,3.0303030303030303,0.9641873278236914,0.0
41,충청남도,부여군,임천면,임천면제1투,940,583,156,392,25,1,1,575,8,357,27.1304347826087,68.17391304347827,4.3478260869565215,0.17391304347826086,0.17391304347826086
42,충청남도,부여군,임천면,임천면제2투,577,312,102,196,8,3,0,309,3,265,33.00970873786408,63.43042071197411,2.5889967637540456,0.9708737864077669,0.0
43,충청남도,부여군,장암면,관내사전투표,739,739,378,318,36,3,0,735,4,0,51.42857142857142,43.26530612244898,4.8979591836734695,0.40816326530612246,0.0
44,충청남도,부여군,장암면,장암면제1투,362,214,57,150,7,0,0,214,0,148,26.635514018691588,70.09345794392523,3.2710280373831773,0.0,0.0
45,충청남도,부여군,장암면,장암면제2투,523,290,76,201,8,2,0,287,3,233,26.480836236933797,70.03484320557492,2.7874564459930316,0.6968641114982579,0.0
46,충청남도,부여군,장암면,장암면제3투,615,352,97,230,17,5,0,349,3,263,27.793696275071632,65.90257879656161,4.871060171919771,1.4326647564469914,0.0
47,충청남도,부여군,세도면,관내사전투표,754,754,454,269,19,6,2,750,4,0,60.53333333333333,35.86666666666667,2.533333333333333,0.8,0.26666666666666666
48,충청남도,부여군,세도면,세도면제1투,894,529,161,342,22,0,0,525,4,365,30.666666666666664,65.14285714285715,4.190476190476191,0.0,0.0
49,충청남도,부여군,세도면,세도면제2투,830,554,222,309,15,3,0,549,5,276,40.43715846994536,56.284153005464475,2.73224043715847,0.546448087431694,0.0
50,충청남도,부여군,석성면,관내사전투표,746,746,420,275,38,7,1,741,5,0,56.68016194331984,37.11201079622132,5.128205128205128,0.9446693657219973,0.1349527665317139
51,충청남도,부여군,석성면,석성면제1투,855,523,120,377,21,1,0,519,4,332,23.121387283236995,72.63969171483622,4.046242774566474,0.1926782273603083,0.0
52,충청남도,부여군,석성면,석성면제2투,640,408,149,241,16,0,0,406,2,232,36.69950738916256,59.35960591133005,3.9408866995073892,0.0,0.0
53,충청남도,부여군,초촌면,관내사전투표,469,469,259,184,19,3,1,466,3,0,55.5793991416309,39.48497854077253,4.07725321888412,0.6437768240343348,0.2145922746781116
54,충청남도,부여군,초촌면,초촌면제1투,732,462,150,290,13,6,0,459,3,270,32.6797385620915,63.18082788671025,2.832244008714597,1.3071895424836601,0.0
55,충청남도,부여군,초촌면,초촌면제2투,462,293,98,170,18,1,0,287,6,169,34.146341463414636,59.23344947735192,6.2717770034843205,0.34843205574912894,0.0
56,충청남도,부여군,잘못 투입·구분된 투표지,,0,0,0,0,0,0,0,0,0,0,0.0,0.0,0.0,0.0,0.0
0,충청남도,서천군,거소·선상투표,,118,113,55,46,8,0,1,110,3,5,50.0,41.81818181818181,7.2727272727272725,0.0,0.9090909090909091
1,충청남도,서천군,관외사전투표,,3268,3268,1787,1044,366,34,8,3239,29,0,55.17134918184625,32.23217042297005,11.299783883914788,1.0497066995986415,0.2469898116702686
2,충청남도,서천군,재외투표,,184,147,101,32,11,3,0,147,0,37,68.70748299319727,21.768707482993197,7.482993197278912,2.0408163265306123,0.0
3,충청남도,서천군,장항읍,관내사전투표,2879,2879,1734,936,160,24,3,2857,22,0,60.69303465173259,32.761638081904096,5.6002800140007,0.840042002100105,0.10500525026251313
4,충청남도,서천군,장항읍,장항읍제1투,1366,824,304,465,38,6,2,815,9,542,37.30061349693251,57.05521472392638,4.662576687116564,0.7361963190184049,0.245398773006135
5,충청남도,서천군,장항읍,장항읍제2투,1541,893,357,479,47,5,1,889,4,648,40.15748031496063,53.88076490438694,5.286839145106861,0.562429696287964,0.11248593925759282
6,충청남도,서천군,장항읍,장항읍제3투,1687,1051,385,597,47,11,1,1041,10,636,36.983669548511045,57.34870317002881,4.514889529298751,1.0566762728146013,0.09606147934678194
7,충청남도,서천군,장항읍,장항읍제4투,1328,790,275,456,41,6,1,779,11,538,35.30166880616174,58.536585365853654,5.263157894736842,0.7702182284980745,0.12836970474967907
8,충청남도,서천군,서천읍,관내사전투표,3483,3483,2040,1204,176,31,4,3455,28,0,59.04486251808972,34.84804630969609,5.094066570188134,0.8972503617945007,0.11577424023154848
9,충청남도,서천군,서천읍,서천읍제1투,1259,788,252,490,28,12,1,783,5,471,32.18390804597701,62.57982120051086,3.5759897828863343,1.532567049808429,0.1277139208173691
10,충청남도,서천군,서천읍,서천읍제2투,944,536,152,345,32,3,0,532,4,408,28.57142857142857,64.84962406015038,6.015037593984962,0.5639097744360901,0.0
11,충청남도,서천군,서천읍,서천읍제3투,1068,642,213,398,23,4,0,638,4,426,33.38557993730408,62.38244514106584,3.605015673981191,0.6269592476489028,0.0
12,충청남도,서천군,서천읍,서천읍제4투,1216,820,275,491,45,2,0,813,7,396,33.82533825338253,60.39360393603936,5.535055350553505,0.24600246002460024,0.0
13,충청남도,서천군,서천읍,서천읍제5투,2149,1419,538,771,82,17,2,1410,9,730,38.156028368794324,54.680851063829785,5.815602836879433,1.2056737588652482,0.14184397163120568
14,충청남도,서천군,마서면,관내사전투표,1009,1009,624,313,51,9,4,1001,8,0,62.33766233766234,31.26873126873127,5.094905094905095,0.8991008991008992,0.3996003996003996
15,충청남도,서천군,마서면,마서면제1투,814,484,179,285,14,2,0,480,4,330,37.291666666666664,59.375,2.9166666666666665,0.4166666666666667,0.0
16,충청남도,서천군,마서면,마서면제2투,973,601,210,363,20,2,1,596,5,372,35.23489932885906,60.90604026845637,3.3557046979865772,0.33557046979865773,0.16778523489932887
17,충청남도,서천군,마서면,마서면제3투,970,530,204,304,17,1,1,527,3,440,38.70967741935484,57.685009487666036,3.225806451612903,0.18975332068311196,0.18975332068311196
18,충청남도,서천군,화양면,관내사전투표,541,541,310,206,15,3,0,534,7,0,58.052434456928836,38.57677902621723,2.8089887640449436,0.5617977528089888,0.0
19,충청남도,서천군,화양면,화양면제1투,717,439,150,271,9,4,1,435,4,278,34.48275862068966,62.29885057471264,2.0689655172413794,0.9195402298850575,0.22988505747126436
20,충청남도,서천군,화양면,화양면제2투,506,308,86,207,10,0,2,305,3,198,28.196721311475407,67.8688524590164,3.278688524590164,0.0,0.6557377049180327
21,충청남도,서천군,기산면,관내사전투표,459,459,244,185,23,3,3,458,1,0,53.275109170305676,40.39301310043668,5.021834061135371,0.6550218340611353,0.6550218340611353
22,충청남도,서천군,기산면,기산면투표소,841,529,190,310,19,3,0,522,7,312,36.39846743295019,59.38697318007663,3.6398467432950192,0.5747126436781609,0.0
23,충청남도,서천군,한산면,관내사전투표,820,820,438,334,35,5,2,814,6,0,53.8083538083538,41.03194103194103,4.2997542997543,0.6142506142506142,0.2457002457002457
24,충청남도,서천군,한산면,한산면투표소,1259,765,248,475,25,4,3,755,10,494,32.847682119205295,62.913907284768214,3.3112582781456954,0.5298013245033113,0.3973509933774834
25,충청남도,서천군,마산면,관내사전투표,335,335,193,120,16,1,1,331,4,0,58.30815709969789,36.25377643504532,4.833836858006042,0.3021148036253776,0.3021148036253776
26,충청남도,서천군,마산면,마산면투표소,860,565,205,334,19,0,2,560,5,295,36.607142857142854,59.64285714285714,3.392857142857143,0.0,0.35714285714285715
27,충청남도,서천군,시초면,관내사전투표,320,320,157,137,23,0,0,317,3,0,49.52681388012618,43.217665615141954,7.255520504731862,0.0,0.0
28,충청남도,서천군,시초면,시초면투표소,691,423,119,277,18,3,1,418,5,268,28.4688995215311,66.26794258373205,4.30622009569378,0.7177033492822966,0.23923444976076555
29,충청남도,서천군,문산면,관내사전투표,352,352,170,160,14,6,1,351,1,0,48.433048433048434,45.58404558404558,3.9886039886039883,1.7094017094017095,0.2849002849002849
30,충청남도,서천군,문산면,문산면투표소,706,455,121,320,11,0,0,452,3,251,26.769911504424783,70.79646017699115,2.433628318584071,0.0,0.0
31,충청남도,서천군,판교면,관내사전투표,677,676,320,317,31,1,0,669,7,1,47.832585949177876,47.384155455904335,4.633781763826607,0.14947683109118087,0.0
32,충청남도,서천군,판교면,판교면투표소,1022,635,156,455,19,0,1,631,4,387,24.722662440570524,72.10776545166404,3.011093502377179,0.0,0.15847860538827258
33,충청남도,서천군,종천면,관내사전투표,609,609,362,217,24,2,0,605,4,0,59.83471074380166,35.86776859504132,3.9669421487603307,0.3305785123966942,0.0
34,충청남도,서천군,종천면,종천면제1투,574,369,111,240,9,4,0,364,5,205,30.494505494505496,65.93406593406593,2.4725274725274726,1.098901098901099,0.0
35,충청남도,서천군,종천면,종천면제2투,629,363,100,245,12,2,0,359,4,266,27.85515320334262,68.24512534818942,3.3426183844011144,0.5571030640668524,0.0
36,충청남도,서천군,비인면,관내사전투표,912,912,525,353,24,3,2,907,5,0,57.88313120176406,38.919514884233735,2.6460859977949283,0.33076074972436603,0.2205071664829107
37,충청남도,서천군,비인면,비인면제1투,1009,625,194,403,17,3,2,619,6,384,31.340872374798064,65.10500807754443,2.7463651050080773,0.48465266558966075,0.32310177705977383
38,충청남도,서천군,비인면,비인면제2투,599,315,124,171,13,4,0,312,3,284,39.743589743589745,54.807692307692314,4.166666666666666,1.282051282051282,0.0
39,충청남도,서천군,서면,관내사전투표,1038,1038,629,342,53,10,0,1034,4,0,60.83172147001934,33.07543520309478,5.1257253384912955,0.9671179883945842,0.0
40,충청남도,서천군,서면,서면제1투,928,541,182,343,12,1,1,539,2,387,33.76623376623377,63.63636363636363,2.2263450834879404,0.1855287569573284,0.1855287569573284
41,충청남도,서천군,서면,서면제2투,1391,828,319,452,44,4,2,821,7,563,38.85505481120585,55.05481120584653,5.35931790499391,0.48721071863580995,0.24360535931790497
42,충청남도,서천군,잘못 투입·구분된 투표지,,0,1,1,0,0,0,0,1,0,-1,100.0,0.0,0.0,0.0,0.0
0,충청남도,홍성군,거소·선상투표,,209,197,74,81,33,3,2,193,4,12,38.34196891191709,41.968911917098445,17.098445595854923,1.5544041450777202,1.0362694300518136
1,충청남도,홍성군,관외사전투표,,7572,7571,4091,2253,1034,104,9,7491,80,1,54.61220130823655,30.076091309571485,13.803230543318648,1.3883326658657056,0.12014417300760913
2,충청남도,홍성군,재외투표,,309,249,177,43,18,5,0,243,6,60,72.8395061728395,17.695473251028808,7.4074074074074066,2.05761316872428,0.0
3,충청남도,홍성군,홍성읍,관내사전투표,7347,7347,4157,2641,440,64,6,7308,39,0,56.882868089764635,36.138478379857695,6.0207991242474,0.875752599890531,0.08210180623973727
4,충청남도,홍성군,홍성읍,홍성읍제1투,1627,1067,283,713,50,7,3,1056,11,560,26.799242424242426,67.51893939393939,4.734848484848484,0.6628787878787878,0.2840909090909091
5,충청남도,홍성군,홍성읍,홍성읍제2투,2016,1363,422,866,58,10,2,1358,5,653,31.075110456553755,63.770250368188506,4.270986745213549,0.7363770250368188,0.14727540500736377
6,충청남도,홍성군,홍성읍,홍성읍제3투,2861,1610,591,885,102,20,3,1601,9,1251,36.91442848219862,55.27795128044972,6.37101811367895,1.2492192379762648,0.18738288569643974
7,충청남도,홍성군,홍성읍,홍성읍제4투,1663,958,305,601,33,7,1,947,11,705,32.20696937697994,63.463569165786694,3.4846884899683213,0.7391763463569165,0.10559662090813093
8,충청남도,홍성군,홍성읍,홍성읍제5투,2501,1415,490,841,63,10,2,1406,9,1086,34.85064011379801,59.81507823613087,4.480796586059744,0.7112375533428165,0.1422475106685633
9,충청남도,홍성군,홍성읍,홍성읍제6투,2900,1869,523,1208,109,15,1,1856,13,1031,28.17887931034483,65.08620689655173,5.872844827586207,0.8081896551724138,0.05387931034482758
10,충청남도,홍성군,홍성읍,홍성읍제7투,2884,1762,591,1036,111,17,3,1758,4,1122,33.617747440273035,58.93060295790671,6.313993174061433,0.9670079635949944,0.17064846416382254
11,충청남도,홍성군,홍성읍,홍성읍제8투,3562,2143,879,1068,162,20,4,2133,10,1419,41.20956399437412,50.07032348804501,7.59493670886076,0.9376465072667605,0.1875293014533521
12,충청남도,홍성군,광천읍,관내사전투표,2392,2392,1084,1173,92,22,3,2374,18,0,45.66133108677338,49.41027801179444,3.8753159224936815,0.9267059814658803,0.12636899747262004
13,충청남도,홍성군,광천읍,광천읍제1투,1335,803,174,592,27,3,2,798,5,532,21.804511278195488,74.18546365914787,3.3834586466165413,0.37593984962406013,0.2506265664160401
14,충청남도,홍성군,광천읍,광천읍제2투,1622,951,266,647,23,4,1,941,10,671,28.26780021253985,68.75664187035069,2.4442082890541976,0.4250797024442083,0.10626992561105207
15,충청남도,홍성군,광천읍,광천읍제3투,1483,889,228,613,34,3,1,879,10,594,25.938566552901023,69.73833902161547,3.8680318543799777,0.3412969283276451,0.11376564277588168
16,충청남도,홍성군,홍북읍,관내사전투표,6685,6685,4513,1410,628,71,4,6626,59,0,68.11047389073347,21.27980682161183,9.477814669483852,1.0715363718683972,0.06036824630244491
17,충청남도,홍성군,홍북읍,홍북읍제1투,1100,729,211,467,35,10,3,726,3,371,29.0633608815427,64.32506887052341,4.820936639118457,1.3774104683195594,0.4132231404958678
18,충청남도,홍성군,홍북읍,홍북읍제2투,781,464,152,287,22,2,0,463,1,317,32.82937365010799,61.98704103671706,4.751619870410368,0.4319654427645789,0.0
19,충청남도,홍성군,홍북읍,홍북읍제3투,614,387,133,233,18,3,0,387,0,227,34.366925064599485,60.20671834625323,4.651162790697675,0.7751937984496124,0.0
20,충청남도,홍성군,홍북읍,홍북읍제4투,1800,1154,469,569,99,11,0,1148,6,646,40.853658536585364,49.56445993031359,8.623693379790941,0.9581881533101044,0.0
21,충청남도,홍성군,홍북읍,홍북읍제5투,2017,1438,645,634,130,21,0,1430,8,579,45.10489510489511,44.33566433566434,9.090909090909092,1.4685314685314685,0.0
22,충청남도,홍성군,홍북읍,홍북읍제6투,1876,1275,570,570,113,11,2,1266,9,601,45.023696682464454,45.023696682464454,8.925750394944707,0.8688783570300158,0.1579778830963665
23,충청남도,홍성군,홍북읍,홍북읍제7투,2821,1800,763,791,204,25,0,1783,17,1021,42.79304542905216,44.363432417274254,11.441390914189569,1.4021312394840157,0.0
24,충청남도,홍성군,홍북읍,홍북읍제8투,2437,1712,794,736,147,24,2,1703,9,725,46.623605402231355,43.21785085143864,8.631826189078097,1.4092777451556078,0.11743981209630064
25,충청남도,홍성군,홍북읍,홍북읍제9투,2391,1628,701,703,188,19,3,1614,14,763,43.432465923172245,43.556381660470876,11.648079306071871,1.1771995043370507,0.18587360594795538
26,충청남도,홍성군,금마면,관내사전투표,925,925,534,315,55,10,1,915,10,0,58.36065573770492,34.42622950819672,6.0109289617486334,1.092896174863388,0.1092896174863388
27,충청남도,홍성군,금마면,금마면제1투,579,370,105,252,7,1,2,367,3,209,28.610354223433244,68.66485013623979,1.9073569482288828,0.2724795640326975,0.544959128065395
28,충청남도,홍성군,금마면,금마면제2투,606,395,125,253,10,4,0,392,3,211,31.887755102040817,64.54081632653062,2.5510204081632653,1.0204081632653061,0.0
29,충청남도,홍성군,금마면,금마면제3투,927,599,205,358,29,4,0,596,3,328,34.395973154362416,60.06711409395973,4.865771812080537,0.6711409395973155,0.0
30,충청남도,홍성군,홍동면,관내사전투표,912,912,568,238,38,63,1,908,4,0,62.55506607929515,26.21145374449339,4.185022026431718,6.938325991189427,0.11013215859030838
31,충청남도,홍성군,홍동면,홍동면제1투,763,475,171,253,21,20,3,468,7,288,36.53846153846153,54.059829059829056,4.487179487179487,4.273504273504273,0.641025641025641
32,충청남도,홍성군,홍동면,홍동면제2투,513,330,121,194,12,0,1,328,2,183,36.890243902439025,59.14634146341463,3.6585365853658534,0.0,0.3048780487804878
33,충청남도,홍성군,홍동면,홍동면제3투,737,494,136,340,13,2,1,492,2,243,27.64227642276423,69.10569105691057,2.642276422764228,0.40650406504065045,0.20325203252032523
34,충청남도,홍성군,장곡면,관내사전투표,633,633,330,251,41,9,0,631,2,0,52.29793977812995,39.77812995245642,6.497622820919176,1.4263074484944533,0.0
35,충청남도,홍성군,장곡면,장곡면제1투,814,475,128,318,21,3,1,471,4,339,27.176220806794056,67.51592356687898,4.45859872611465,0.6369426751592357,0.21231422505307856
36,충청남도,홍성군,장곡면,장곡면제2투,377,233,76,147,6,3,0,232,1,144,32.758620689655174,63.36206896551724,2.586206896551724,1.293103448275862,0.0
37,충청남도,홍성군,장곡면,장곡면제3투,585,353,91,242,12,2,0,347,6,232,26.22478386167147,69.7406340057637,3.45821325648415,0.5763688760806917,0.0
38,충청남도,홍성군,은하면,관내사전투표,495,495,245,217,23,7,1,493,2,0,49.69574036511156,44.01622718052739,4.665314401622718,1.4198782961460445,0.2028397565922921
39,충청남도,홍성군,은하면,은하면제1투,923,532,132,366,16,4,1,519,13,391,25.43352601156069,70.52023121387283,3.0828516377649327,0.7707129094412332,0.1926782273603083
40,충청남도,홍성군,은하면,은하면제2투,426,283,44,226,8,1,0,279,4,143,15.770609318996415,81.00358422939068,2.867383512544803,0.35842293906810035,0.0
41,충청남도,홍성군,결성면,관내사전투표,583,583,265,271,26,7,2,571,12,0,46.409807355516634,47.46059544658494,4.553415061295972,1.2259194395796849,0.3502626970227671
42,충청남도,홍성군,결성면,결성면제1투,790,497,104,372,18,1,0,495,2,293,21.01010101010101,75.15151515151514,3.6363636363636362,0.20202020202020202,0.0
43,충청남도,홍성군,결성면,결성면제2투,419,298,69,208,11,1,2,291,7,121,23.711340206185564,71.47766323024055,3.7800687285223367,0.3436426116838488,0.6872852233676976
44,충청남도,홍성군,서부면,관내사전투표,889,889,418,424,38,5,0,885,4,0,47.2316384180791,47.909604519774014,4.293785310734463,0.5649717514124294,0.0
45,충청남도,홍성군,서부면,서부면제1투,884,507,150,333,18,2,0,503,4,377,29.82107355864811,66.2027833001988,3.5785288270377733,0.3976143141153081,0.0
46,충청남도,홍성군,서부면,서부면제2투,921,555,133,388,24,4,0,549,6,366,24.225865209471767,70.67395264116576,4.371584699453552,0.7285974499089253,0.0
47,충청남도,홍성군,갈산면,관내사전투표,1071,1071,471,519,63,6,0,1059,12,0,44.47592067988669,49.008498583569406,5.94900849858357,0.56657223796034,0.0
48,충청남도,홍성군,갈산면,갈산면제1투,1290,759,184,540,30,1,1,756,3,531,24.33862433862434,71.42857142857143,3.968253968253968,0.13227513227513227,0.13227513227513227
49,충청남도,홍성군,갈산면,갈산면제2투,324,236,57,166,7,2,1,233,3,88,24.463519313304722,71.24463519313305,3.004291845493562,0.8583690987124464,0.4291845493562232
50,충청남도,홍성군,갈산면,갈산면제3투,448,270,95,156,17,1,0,269,1,178,35.31598513011153,57.99256505576208,6.319702602230483,0.37174721189591076,0.0
51,충청남도,홍성군,구항면,관내사전투표,1405,1405,863,424,81,21,3,1392,13,0,61.99712643678161,30.45977011494253,5.818965517241379,1.5086206896551724,0.21551724137931033
52,충청남도,홍성군,구항면,구항면제1투,1153,719,202,471,41,1,0,715,4,434,28.251748251748253,65.87412587412588,5.734265734265734,0.13986013986013987,0.0
53,충청남도,홍성군,구항면,구항면제2투,931,577,181,370,16,3,3,573,4,354,31.588132635253054,64.57242582897034,2.7923211169284468,0.5235602094240838,0.5235602094240838
54,충청남도,홍성군,잘못 투입·구분된 투표지,,0,0,0,0,0,0,0,0,0,0,0.0,0.0,0.0,0.0,0.0
0,충청남도,청양군,거소·선상투표,,56,53,14,27,9,0,0,50,3,3,28.000000000000004,54.0,18.0,0.0,0.0
1,충청남도,청양군,관외사전투표,,2619,2618,1284,977,300,21,4,2586,32,1,49.651972157772626,37.780355761794276,11.600928074245939,0.8120649651972157,0.15467904098994587
2,충청남도,청양군,재외투표,,92,76,51,15,10,0,0,76,0,16,67.10526315789474,19.736842105263158,13.157894736842104,0.0,0.0
3,충청남도,청양군,청양읍,관내사전투표,2832,2832,1411,1176,195,17,4,2803,29,0,50.33892258294684,41.95504816268284,6.956831965750982,0.6064930431680342,0.14270424545130217
4,충청남도,청양군,청양읍,청양읍제1투,1045,669,158,472,32,4,0,666,3,376,23.723723723723726,70.87087087087087,4.804804804804805,0.6006006006006006,0.0
5,충청남도,청양군,청양읍,청양읍제2투,1866,1143,324,726,75,10,0,1135,8,723,28.54625550660793,63.964757709251096,6.607929515418502,0.881057268722467,0.0
6,충청남도,청양군,청양읍,청양읍제3투,1242,727,195,459,58,8,3,723,4,515,26.970954356846473,63.48547717842323,8.022130013831259,1.1065006915629323,0.4149377593360996
7,충청남도,청양군,청양읍,청양읍제4투,1061,693,184,460,35,9,1,689,4,368,26.705370101596515,66.76342525399129,5.079825834542816,1.3062409288824384,0.14513788098693758
8,충청남도,청양군,운곡면,관내사전투표,501,501,227,243,24,5,1,500,1,0,45.4,48.6,4.8,1.0,0.2
9,충청남도,청양군,운곡면,운곡면투표소,1213,757,157,566,22,6,1,752,5,456,20.877659574468087,75.2659574468085,2.925531914893617,0.7978723404255319,0.13297872340425532
10,충청남도,청양군,대치면,관내사전투표,622,622,317,255,40,4,0,616,6,0,51.461038961038966,41.396103896103895,6.493506493506493,0.6493506493506493,0.0
11,충청남도,청양군,대치면,대치면제1투,624,391,76,295,13,3,0,387,4,233,19.638242894056848,76.22739018087856,3.359173126614987,0.7751937984496124,0.0
12,충청남도,청양군,대치면,대치면제2투,616,416,95,309,8,2,0,414,2,200,22.946859903381643,74.63768115942028,1.932367149758454,0.4830917874396135,0.0
13,충청남도,청양군,정산면,관내사전투표,964,964,495,384,70,4,0,953,11,0,51.941238195173135,40.29380902413431,7.345225603357817,0.4197271773347324,0.0
14,충청남도,청양군,정산면,정산면제1투,968,585,163,386,27,4,1,581,4,383,28.055077452667813,66.43717728055077,4.647160068846816,0.6884681583476765,0.17211703958691912
15,충청남도,청양군,정산면,정산면제2투,856,511,140,332,31,2,0,505,6,345,27.722772277227726,65.74257425742574,6.138613861386139,0.39603960396039606,0.0
16,충청남도,청양군,목면,관내사전투표,336,336,190,124,15,5,0,334,2,0,56.886227544910184,37.12574850299401,4.491017964071856,1.4970059880239521,0.0
17,충청남도,청양군,목면,목면제1투,420,249,57,175,8,3,1,244,5,171,23.36065573770492,71.72131147540983,3.278688524590164,1.2295081967213115,0.4098360655737705
18,충청남도,청양군,목면,목면제2투,382,264,89,156,13,2,1,261,3,118,34.099616858237546,59.77011494252874,4.980842911877394,0.7662835249042145,0.38314176245210724
19,충청남도,청양군,청남면,관내사전투표,404,404,217,160,19,1,1,398,6,0,54.52261306532663,40.20100502512563,4.773869346733668,0.25125628140703515,0.25125628140703515
20,충청남도,청양군,청남면,청남면투표소,1050,675,158,479,28,3,0,668,7,375,23.652694610778443,71.7065868263473,4.191616766467066,0.4491017964071856,0.0
21,충청남도,청양군,장평면,관내사전투표,496,496,258,213,21,1,2,495,1,0,52.121212121212125,43.03030303030303,4.242424242424243,0.20202020202020202,0.40404040404040403
22,충청남도,청양군,장평면,장평면제1투,588,382,123,237,17,2,1,380,2,206,32.36842105263158,62.36842105263158,4.473684210526316,0.5263157894736842,0.2631578947368421
23,충청남도,청양군,장평면,장평면제2투,331,230,60,151,10,2,1,224,6,101,26.785714285714285,67.41071428571429,4.464285714285714,0.8928571428571428,0.4464285714285714
24,충청남도,청양군,장평면,장평면제3투,373,244,85,148,10,0,0,243,1,129,34.97942386831276,60.90534979423868,4.11522633744856,0.0,0.0
25,충청남도,청양군,남양면,관내사전투표,692,692,373,270,33,7,2,685,7,0,54.45255474452555,39.416058394160586,4.817518248175182,1.0218978102189782,0.291970802919708
26,충청남도,청양군,남양면,남양면제1투,1054,605,151,425,20,3,0,599,6,449,25.208681135225376,70.95158597662771,3.33889816360601,0.5008347245409015,0.0
27,충청남도,청양군,남양면,남양면제2투,451,269,79,183,5,1,0,268,1,182,29.47761194029851,68.28358208955224,1.8656716417910446,0.3731343283582089,0.0
28,충청남도,청양군,화성면,관내사전투표,524,524,258,236,21,5,1,521,3,0,49.520153550863725,45.297504798464495,4.030710172744722,0.9596928982725527,0.19193857965451055
29,충청남도,청양군,화성면,화성면투표소,1192,726,190,497,22,6,2,717,9,466,26.499302649930268,69.31659693165969,3.0683403068340307,0.8368200836820083,0.2789400278940028
30,충청남도,청양군,비봉면,관내사전투표,501,501,273,185,32,3,3,496,5,0,55.04032258064516,37.29838709677419,6.451612903225806,0.6048387096774194,0.6048387096774194
31,충청남도,청양군,비봉면,비봉면제1투,751,477,140,311,19,3,2,475,2,274,29.47368421052631,65.47368421052632,4.0,0.631578947368421,0.42105263157894735
32,충청남도,청양군,비봉면,비봉면제2투,443,293,96,181,12,4,0,293,0,150,32.76450511945392,61.774744027303754,4.09556313993174,1.3651877133105803,0.0
33,충청남도,청양군,잘못 투입·구분된 투표지,,0,0,0,0,0,0,0,0,0,0,0.0,0.0,0.0,0.0,0.0
0,충청남도,예산군,거소·선상투표,,141,128,48,50,13,4,1,116,12,13,41.37931034482759,43.103448275862064,11.206896551724139,3.4482758620689653,0.8620689655172413
1,충청남도,예산군,관외사전투표,,6735,6734,3574,2202,811,70,9,6666,68,1,53.615361536153614,33.033303330333034,12.166216621662167,1.05010501050105,0.135013501350135
2,충청남도,예산군,재외투표,,255,203,139,40,17,4,0,200,3,52,69.5,20.0,8.5,2.0,0.0
3,충청남도,예산군,예산읍,관내사전투표,5304,5300,2779,2116,332,38,4,5269,31,4,52.742455873979885,40.15942304042513,6.301005883469349,0.7211994685898653,0.07591573353577528
4,충청남도,예산군,예산읍,예산읍제1투,1665,1007,193,761,43,6,1,1004,3,658,19.223107569721115,75.79681274900398,4.282868525896414,0.5976095617529881,0.099601593625498
5,충청남도,예산군,예산읍,예산읍제2투,2009,1425,430,909,69,11,1,1420,5,584,30.28169014084507,64.01408450704226,4.859154929577465,0.7746478873239436,0.07042253521126761
6,충청남도,예산군,예산읍,예산읍제3투,1894,1186,265,854,47,5,1,1172,14,708,22.610921501706486,72.86689419795222,4.010238907849829,0.42662116040955633,0.08532423208191127
7,충청남도,예산군,예산읍,예산읍제4투,1551,1010,272,674,50,5,0,1001,9,541,27.172827172827173,67.33266733266733,4.9950049950049955,0.4995004995004995,0.0
8,충청남도,예산군,예산읍,예산읍제5투,1731,1080,335,667,58,10,3,1073,7,651,31.220876048462255,62.16216216216216,5.405405405405405,0.9319664492078285,0.27958993476234856
9,충청남도,예산군,예산읍,예산읍제6투,2174,1343,430,813,77,9,2,1331,12,831,32.30653643876784,61.08189331329827,5.785123966942149,0.67618332081142,0.15026296018031557
10,충청남도,예산군,예산읍,예산읍제7투,2367,1517,507,901,87,10,3,1508,9,850,33.62068965517241,59.748010610079575,5.769230769230769,0.6631299734748011,0.1989389920424403
11,충청남도,예산군,예산읍,예산읍제8투,1526,1003,223,746,25,3,2,999,4,523,22.32232232232232,74.67467467467468,2.5025025025025025,0.3003003003003003,0.20020020020020018
12,충청남도,예산군,예산읍,예산읍제9투,2482,1639,429,1115,78,9,0,1631,8,843,26.30288166768853,68.3629675045984,4.782342121397916,0.5518087063151441,0.0
13,충청남도,예산군,예산읍,예산읍제10투,1053,725,166,519,27,4,0,716,9,328,23.18435754189944,72.48603351955308,3.7709497206703912,0.5586592178770949,0.0
14,충청남도,예산군,삽교읍,관내사전투표,2240,2240,1060,1014,128,17,2,2221,19,0,47.726249437190454,45.65511031067087,5.763169743358847,0.765420981539847,0.09004952723998198
15,충청남도,예산군,삽교읍,삽교읍제1투,2321,1374,292,996,62,14,1,1365,9,947,21.39194139194139,72.96703296703296,4.542124542124542,1.0256410256410255,0.07326007326007326
16,충청남도,예산군,삽교읍,삽교읍제2투,2666,1850,736,879,192,29,1,1837,13,816,40.065323897659226,47.84975503538378,10.451823625476319,1.5786608600979857,0.05443658138268917
17,충청남도,예산군,삽교읍,삽교읍제3투,1303,725,184,502,29,3,3,721,4,578,25.52011095700416,69.62552011095701,4.0221914008321775,0.4160887656033287,0.4160887656033287
18,충청남도,예산군,삽교읍,삽교읍제4투,2983,2026,875,889,216,33,2,2015,11,957,43.424317617866,44.11910669975186,10.719602977667494,1.6377171215880892,0.09925558312655086
19,충청남도,예산군,대술면,관내사전투표,627,627,308,286,28,1,0,623,4,0,49.43820224719101,45.90690208667737,4.49438202247191,0.16051364365971107,0.0
20,충청남도,예산군,대술면,대술면투표소,1438,912,224,628,44,4,0,900,12,526,24.88888888888889,69.77777777777779,4.888888888888889,0.4444444444444444,0.0
21,충청남도,예산군,신양면,관내사전투표,746,746,315,379,33,10,1,738,8,0,42.68292682926829,51.355013550135496,4.471544715447155,1.3550135501355014,0.13550135501355012
22,충청남도,예산군,신양면,신양면투표소,1751,1150,270,816,46,3,1,1136,14,601,23.767605633802816,71.83098591549296,4.049295774647888,0.2640845070422535,0.08802816901408451
23,충청남도,예산군,광시면,관내사전투표,753,753,296,413,34,3,2,748,5,0,39.57219251336899,55.213903743315505,4.545454545454546,0.4010695187165776,0.267379679144385
24,충청남도,예산군,광시면,광시면투표소,1723,1057,234,769,42,4,1,1050,7,666,22.285714285714285,73.23809523809524,4.0,0.38095238095238093,0.09523809523809523
25,충청남도,예산군,대흥면,관내사전투표,262,262,129,105,25,3,0,262,0,0,49.23664122137404,40.0763358778626,9.541984732824428,1.1450381679389312,0.0
26,충청남도,예산군,대흥면,대흥면제1투,451,296,57,229,6,1,0,293,3,155,19.453924914675767,78.15699658703072,2.04778156996587,0.3412969283276451,0.0
27,충청남도,예산군,대흥면,대흥면제2투,643,455,76,361,12,2,1,452,3,188,16.8141592920354,79.86725663716814,2.6548672566371683,0.4424778761061947,0.22123893805309736
28,충청남도,예산군,응봉면,관내사전투표,675,675,334,274,51,8,1,668,7,0,50.0,41.01796407185629,7.634730538922156,1.1976047904191618,0.14970059880239522
29,충청남도,예산군,응봉면,응봉면제1투,938,586,116,434,27,3,0,580,6,352,20.0,74.82758620689656,4.655172413793104,0.5172413793103449,0.0
30,충청남도,예산군,응봉면,응봉면제2투,499,316,71,235,6,2,1,315,1,183,22.53968253968254,74.60317460317461,1.9047619047619049,0.6349206349206349,0.31746031746031744
31,충청남도,예산군,덕산면,관내사전투표,1906,1906,950,823,102,16,3,1894,12,0,50.158394931362196,43.45300950369588,5.385427666314678,0.8447729672650475,0.15839493136219643
32,충청남도,예산군,덕산면,덕산면제1투,2001,1208,325,816,52,6,2,1201,7,793,27.060782681099084,67.94338051623647,4.329725228975854,0.4995836802664446,0.16652789342214822
33,충청남도,예산군,덕산면,덕산면제2투,997,626,145,455,23,2,0,625,1,371,23.200000000000003,72.8,3.6799999999999997,0.32,0.0
34,충청남도,예산군,덕산면,덕산면제3투,836,537,127,375,27,2,0,531,6,299,23.91713747645951,70.62146892655367,5.084745762711865,0.3766478342749529,0.0
35,충청남도,예산군,봉산면,관내사전투표,485,485,228,231,23,1,0,483,2,0,47.20496894409938,47.82608695652174,4.761904761904762,0.2070393374741201,0.0
36,충청남도,예산군,봉산면,봉산면투표소,1407,878,188,627,44,6,1,866,12,529,21.709006928406467,72.40184757505773,5.080831408775981,0.6928406466512702,0.11547344110854503
37,충청남도,예산군,고덕면,관내사전투표,1116,1116,533,500,74,4,2,1113,3,0,47.88858939802336,44.923629829290206,6.64869721473495,0.3593890386343217,0.17969451931716085
38,충청남도,예산군,고덕면,고덕면제1투,1501,905,224,650,23,4,1,902,3,596,24.833702882483372,72.06208425720621,2.549889135254989,0.4434589800443459,0.11086474501108648
39,충청남도,예산군,고덕면,고덕면제2투,595,386,109,259,14,3,0,385,1,209,28.31168831168831,67.27272727272727,3.6363636363636362,0.7792207792207793,0.0
40,충청남도,예산군,고덕면,고덕면제3투,466,324,99,199,12,8,1,319,5,142,31.03448275862069,62.38244514106584,3.761755485893417,2.507836990595611,0.3134796238244514
41,충청남도,예산군,신암면,관내사전투표,1312,1312,682,531,79,14,2,1308,4,0,52.14067278287462,40.596330275229356,6.039755351681957,1.0703363914373087,0.1529051987767584
42,충청남도,예산군,신암면,신암면제1투,1462,871,209,607,42,5,0,863,8,591,24.21784472769409,70.33603707995366,4.866743916570105,0.5793742757821553,0.0
43,충청남도,예산군,신암면,신암면제2투,574,369,123,239,5,1,0,368,1,205,33.42391304347826,64.94565217391305,1.358695652173913,0.2717391304347826,0.0
44,충청남도,예산군,오가면,관내사전투표,1080,1080,495,515,59,2,1,1072,8,0,46.17537313432835,48.0410447761194,5.503731343283582,0.18656716417910446,0.09328358208955223
45,충청남도,예산군,오가면,오가면제1투,1378,841,170,618,38,6,1,833,8,537,20.408163265306122,74.18967587034814,4.561824729891957,0.7202881152460985,0.12004801920768307
46,충청남도,예산군,오가면,오가면제2투,1033,643,160,445,23,5,0,633,10,390,25.27646129541864,70.30015797788309,3.6334913112164293,0.7898894154818324,0.0
47,충청남도,예산군,잘못 투입·구분된 투표지,,0,4,1,3,0,0,0,4,0,-4,25.0,75.0,0.0,0.0,0.0
0,충청남도,당진시,거소·선상투표,,224,206,73,82,31,2,4,192,14,18,38.02083333333333,42.70833333333333,16.145833333333336,1.0416666666666665,2.083333333333333
1,충청남도,당진시,관외사전투표,,9669,9668,5072,3141,1250,84,19,9566,102,1,53.021116454108295,32.8350407693916,13.067112690779844,0.8781099728204057,0.19862011289985365
2,충청남도,당진시,재외투표,,407,317,227,55,26,7,1,316,1,90,71.83544303797468,17.405063291139243,8.227848101265822,2.2151898734177213,0.31645569620253167
3,충청남도,당진시,당진1동,관내사전투표,6486,6486,4036,1893,443,56,3,6431,55,0,62.75851345047426,29.43554657129529,6.888508785569895,0.8707821489659462,0.046649043694604264
4,충청남도,당진시,당진1동,당진1동제1투,2853,1643,662,808,144,21,1,1636,7,1210,40.46454767726161,49.38875305623472,8.80195599022005,1.2836185819070904,0.061124694376528114
5,충청남도,당진시,당진1동,당진1동제2투,3084,1767,620,1013,106,11,2,1752,15,1317,35.38812785388128,57.81963470319634,6.050228310502283,0.6278538812785388,0.1141552511415525
6,충청남도,당진시,당진1동,당진1동제3투,3030,1712,567,993,116,21,4,1701,11,1318,33.33333333333333,58.377425044091716,6.819517930629042,1.2345679012345678,0.23515579071134626
7,충청남도,당진시,당진1동,당진1동제4투,2974,1673,744,762,139,15,2,1662,11,1301,44.765342960288805,45.84837545126354,8.363417569193743,0.9025270758122743,0.12033694344163659
8,충청남도,당진시,당진1동,당진1동제5투,5220,3711,1843,1433,352,53,3,3684,27,1509,50.0271444082519,38.897937024972855,9.554831704668839,1.4386536373507057,0.08143322475570033
9,충청남도,당진시,당진1동,당진1동제6투,3238,2402,1160,933,261,28,1,2383,19,836,48.67813680234998,39.152328997062526,10.952580780528745,1.1749895090222409,0.0419639110365086
10,충청남도,당진시,당진2동,관내사전투표,4207,4207,2830,996,294,52,7,4179,28,0,67.71955013161043,23.833452979181622,7.035175879396985,1.2443168222062695,0.16750418760469013
11,충청남도,당진시,당진2동,당진2동제1투,434,288,70,206,9,2,0,287,1,146,24.390243902439025,71.77700348432056,3.1358885017421603,0.6968641114982579,0.0
12,충청남도,당진시,당진2동,당진2동제2투,2564,1498,529,848,95,18,0,1490,8,1066,35.50335570469799,56.91275167785235,6.375838926174497,1.2080536912751678,0.0
13,충청남도,당진시,당진2동,당진2동제3투,1372,842,331,455,39,9,1,835,7,530,39.64071856287425,54.49101796407185,4.6706586826347305,1.0778443113772456,0.11976047904191617
14,충청남도,당진시,당진2동,당진2동제4투,2588,1758,891,730,101,24,4,1750,8,830,50.91428571428571,41.714285714285715,5.771428571428571,1.3714285714285714,0.2285714285714286
15,충청남도,당진시,당진2동,당진2동제5투,4091,2616,1106,1253,206,25,3,2593,23,1475,42.65329733898959,48.322406478981875,7.944465869649055,0.9641342074816814,0.11569610489780179
16,충청남도,당진시,당진3동,관내사전투표,5571,5571,3832,1180,484,39,2,5537,34,0,69.2071518873036,21.311179338992233,8.74119559328156,0.7043525374751671,0.036120642947444465
17,충청남도,당진시,당진3동,당진3동제1투,2885,1750,667,937,129,7,1,1741,9,1135,38.311315336013784,53.819643882825964,7.409534750143595,0.402067777139575,0.05743825387708214
18,충청남도,당진시,당진3동,당진3동제2투,1902,1261,493,657,82,20,1,1253,8,641,39.34557063048683,52.434158020750196,6.5442936951316835,1.596169193934557,0.07980845969672785
19,충청남도,당진시,당진3동,당진3동제3투,1313,909,385,424,83,11,1,904,5,404,42.588495575221245,46.902654867256636,9.18141592920354,1.2168141592920354,0.11061946902654868
20,충청남도,당진시,당진3동,당진3동제4투,1698,940,375,485,64,8,2,934,6,758,40.149892933618844,51.92719486081371,6.852248394004283,0.8565310492505354,0.21413276231263384
21,충청남도,당진시,합덕읍,관내사전투표,2249,2249,1323,772,118,21,0,2234,15,0,59.22112802148612,34.556848701880035,5.282005371530887,0.9400179051029544,0.0
22,충청남도,당진시,합덕읍,합덕읍제1투,799,517,109,388,11,2,0,510,7,282,21.372549019607842,76.07843137254902,2.156862745098039,0.39215686274509803,0.0
23,충청남도,당진시,합덕읍,합덕읍제2투,1004,572,158,391,14,6,1,570,2,432,27.719298245614034,68.59649122807018,2.456140350877193,1.0526315789473684,0.17543859649122806
24,충청남도,당진시,합덕읍,합덕읍제3투,1598,836,247,542,38,4,2,833,3,762,29.65186074429772,65.06602641056422,4.561824729891957,0.4801920768307323,0.24009603841536614
25,충청남도,당진시,합덕읍,합덕읍제4투,674,403,123,263,13,2,0,401,2,271,30.673316708229425,65.5860349127182,3.2418952618453867,0.4987531172069825,0.0
26,충청남도,당진시,합덕읍,합덕읍제5투,824,515,156,337,16,1,3,513,2,309,30.409356725146196,65.69200779727096,3.1189083820662766,0.1949317738791423,0.5847953216374269
27,충청남도,당진시,송악읍,관내사전투표,6737,6737,4763,1502,398,43,6,6712,25,0,70.96245530393325,22.37783075089392,5.9296781883194285,0.6406436233611442,0.08939213349225268
28,충청남도,당진시,송악읍,송악읍제1투,3889,2459,1176,1046,201,19,5,2447,12,1430,48.058847568451164,42.74621986105435,8.214139762975071,0.7764609726195342,0.2043318348998774
29,충청남도,당진시,송악읍,송악읍제2투,684,430,149,268,9,0,0,426,4,254,34.97652582159624,62.91079812206573,2.112676056338028,0.0,0.0
30,충청남도,당진시,송악읍,송악읍제3투,2782,1710,691,911,83,12,0,1697,13,1072,40.71891573364761,53.68296994696523,4.890984089569829,0.7071302298173248,0.0
31,충청남도,당진시,송악읍,송악읍제4투,1923,1043,392,609,34,8,0,1043,0,880,37.58389261744966,58.38926174496645,3.2598274209012463,0.7670182166826461,0.0
32,충청남도,당진시,송악읍,송악읍제5투,3304,1949,880,921,112,22,2,1937,12,1355,45.43107898812597,47.54775425916365,5.782137325761487,1.1357769747031492,0.10325245224574084
33,충청남도,당진시,송악읍,송악읍제6투,3412,2069,1114,800,126,18,3,2061,8,1343,54.05143134400776,38.81610868510432,6.11353711790393,0.8733624454148471,0.1455604075691412
34,충청남도,당진시,고대면,관내사전투표,2227,2227,1377,699,117,15,2,2210,17,0,62.30769230769231,31.628959276018097,5.294117647058823,0.6787330316742082,0.09049773755656108
35,충청남도,당진시,고대면,고대면제1투,1080,676,182,457,22,8,1,670,6,404,27.164179104477608,68.2089552238806,3.2835820895522385,1.1940298507462688,0.1492537313432836
36,충청남도,당진시,고대면,고대면제2투,1520,846,276,519,39,3,1,838,8,674,32.93556085918855,61.93317422434368,4.6539379474940334,0.35799522673031026,0.11933174224343676
37,충청남도,당진시,고대면,고대면제3투,753,442,131,300,9,2,0,442,0,311,29.638009049773757,67.87330316742081,2.0361990950226243,0.4524886877828055,0.0
38,충청남도,당진시,석문면,관내사전투표,2630,2630,1689,707,183,33,1,2613,17,0,64.63834672789896,27.05702257941064,7.003444316877153,1.2629161882893225,0.03827018752391887
39,충청남도,당진시,석문면,석문면제1투,2056,1136,427,619,66,15,0,1127,9,920,37.88819875776397,54.924578527063,5.8562555456965395,1.3309671694764862,0.0
40,충청남도,당진시,석문면,석문면제2투,2121,1184,417,702,48,11,1,1179,5,937,35.36895674300254,59.541984732824424,4.071246819338422,0.9329940627650551,0.08481764206955046
41,충청남도,당진시,석문면,석문면제3투,192,127,24,89,9,1,1,124,3,65,19.35483870967742,71.7741935483871,7.258064516129033,0.8064516129032258,0.8064516129032258
42,충청남도,당진시,석문면,석문면제4투,348,242,104,130,6,0,0,240,2,106,43.333333333333336,54.166666666666664,2.5,0.0,0.0
43,충청남도,당진시,대호지면,관내사전투표,456,456,229,187,32,4,2,454,2,0,50.440528634361236,41.18942731277533,7.048458149779736,0.881057268722467,0.4405286343612335
44,충청남도,당진시,대호지면,대호지면제1투,865,546,150,362,27,3,0,542,4,319,27.67527675276753,66.78966789667896,4.981549815498155,0.5535055350553505,0.0
45,충청남도,당진시,대호지면,대호지면제2투,580,388,126,235,19,4,0,384,4,192,32.8125,61.197916666666664,4.947916666666666,1.0416666666666665,0.0
46,충청남도,당진시,정미면,관내사전투표,921,920,502,336,52,6,5,901,19,1,55.71587125416204,37.29189789123196,5.771365149833518,0.6659267480577136,0.5549389567147613
47,충청남도,당진시,정미면,정미면제1투,1415,799,198,552,39,6,0,795,4,616,24.90566037735849,69.43396226415094,4.905660377358491,0.7547169811320755,0.0
48,충청남도,당진시,정미면,정미면제2투,717,455,145,289,16,2,2,454,1,262,31.938325991189426,63.65638766519823,3.524229074889868,0.4405286343612335,0.4405286343612335
49,충청남도,당진시,면천면,관내사전투표,1003,1003,557,378,54,6,1,996,7,0,55.92369477911646,37.95180722891566,5.421686746987952,0.6024096385542169,0.1004016064257028
50,충청남도,당진시,면천면,면천면제1투,1366,837,216,589,24,3,0,832,5,529,25.961538461538463,70.79326923076923,2.8846153846153846,0.3605769230769231,0.0
51,충청남도,당진시,면천면,면천면제2투,633,404,116,271,10,3,0,400,4,229,28.999999999999996,67.75,2.5,0.75,0.0
52,충청남도,당진시,순성면,관내사전투표,1165,1165,688,381,66,21,1,1157,8,0,59.464131374243735,32.92999135695765,5.704407951598963,1.8150388936905792,0.08643042350907519
53,충청남도,당진시,순성면,순성면제1투,1617,967,278,621,54,8,1,962,5,650,28.8981288981289,64.55301455301455,5.613305613305614,0.8316008316008316,0.10395010395010396
54,충청남도,당진시,순성면,순성면제2투,620,381,103,266,7,1,2,379,2,239,27.176781002638524,70.18469656992085,1.8469656992084433,0.2638522427440633,0.5277044854881267
55,충청남도,당진시,순성면,순성면제3투,682,439,151,274,9,4,0,438,1,243,34.47488584474886,62.55707762557078,2.054794520547945,0.91324200913242,0.0
56,충청남도,당진시,우강면,관내사전투표,1155,1155,642,437,60,9,0,1148,7,0,55.92334494773519,38.066202090592334,5.2264808362369335,0.7839721254355401,0.0
57,충청남도,당진시,우강면,우강면제1투,2266,1355,403,865,65,11,2,1346,9,911,29.940564635958395,64.26448736998515,4.829123328380387,0.8172362555720655,0.1485884101040119
58,충청남도,당진시,우강면,우강면제2투,442,311,116,183,8,2,0,309,2,131,37.54045307443366,59.22330097087378,2.5889967637540456,0.6472491909385114,0.0
59,충청남도,당진시,우강면,우강면제3투,509,311,101,202,4,3,0,310,1,198,32.58064516129032,65.16129032258064,1.2903225806451613,0.967741935483871,0.0
60,충청남도,당진시,신평면,관내사전투표,3770,3770,2466,1050,206,31,5,3758,12,0,65.62001064395955,27.940393826503456,5.481639169771155,0.8249068653539117,0.13304949441192124
61,충청남도,당진시,신평면,신평면제1투,1902,1198,421,710,53,9,3,1196,2,704,35.20066889632107,59.36454849498328,4.431438127090301,0.7525083612040134,0.2508361204013378
62,충청남도,당진시,신평면,신평면제2투,3781,2252,980,1079,137,35,2,2233,19,1529,43.8871473354232,48.32064487236901,6.135244066278549,1.5673981191222568,0.08956560680698611
63,충청남도,당진시,신평면,신평면제3투,866,535,135,364,29,3,1,532,3,331,25.375939849624064,68.42105263157895,5.451127819548872,0.5639097744360901,0.18796992481203006
64,충청남도,당진시,신평면,신평면제4투,1366,843,288,518,28,4,0,838,5,523,34.36754176610978,61.813842482100235,3.341288782816229,0.47732696897374705,0.0
65,충청남도,당진시,송산면,관내사전투표,3294,3294,2141,864,240,22,2,3269,25,0,65.49403487304987,26.430100948302233,7.341694707861731,0.672988681553992,0.0611807892321811
66,충청남도,당진시,송산면,송산면제1투,1430,843,316,460,52,10,1,839,4,587,37.66388557806913,54.82717520858165,6.197854588796186,1.1918951132300357,0.11918951132300357
67,충청남도,당진시,송산면,송산면제2투,1358,734,219,474,36,4,0,733,1,624,29.877216916780352,64.66575716234652,4.911323328785812,0.5457025920873124,0.0
68,충청남도,당진시,송산면,송산면제3투,3401,1888,881,825,152,21,2,1881,7,1513,46.836788942052095,43.859649122807014,8.080808080808081,1.1164274322169059,0.10632642211589581
69,충청남도,당진시,잘못 투입·구분된 투표지,,0,0,0,0,0,0,0,0,0,0,0.0,0.0,0.0,0.0,0.0
0,충청남도,천안시서북구,거소·선상투표,,398,382,137,116,101,4,1,359,23,16,38.16155988857939,32.31197771587744,28.133704735376046,1.1142061281337048,0.2785515320334262
1,충청남도,천안시서북구,관외사전투표,,27184,27168,15441,7093,4024,275,35,26868,300,16,57.469852612773565,26.399434271252048,14.976924222122973,1.0235224058359387,0.1302664880154831
2,충청남도,천안시서북구,재외투표,,1253,1017,694,181,110,16,2,1003,14,236,69.19242273180458,18.045862412761714,10.967098703888336,1.5952143569292123,0.19940179461615154
3,충청남도,천안시서북구,성환읍,관내사전투표,4730,4730,2769,1569,320,36,4,4698,32,0,58.93997445721584,33.39719029374202,6.811409110259685,0.7662835249042145,0.08514261387824607
4,충청남도,천안시서북구,성환읍,성환읍제1투,1358,849,252,533,53,9,1,848,1,509,29.71698113207547,62.85377358490566,6.25,1.0613207547169812,0.1179245283018868
5,충청남도,천안시서북구,성환읍,성환읍제2투,2161,1300,400,779,95,13,1,1288,12,861,31.05590062111801,60.48136645962733,7.375776397515528,1.0093167701863355,0.07763975155279502
6,충청남도,천안시서북구,성환읍,성환읍제3투,1469,1027,449,504,57,13,0,1023,4,442,43.89051808406647,49.266862170087975,5.571847507331378,1.270772238514174,0.0
7,충청남도,천안시서북구,성환읍,성환읍제4투,576,397,116,252,26,2,1,397,0,179,29.219143576826195,63.476070528967256,6.54911838790932,0.5037783375314862,0.2518891687657431
8,충청남도,천안시서북구,성환읍,성환읍제5투,756,508,173,315,15,4,0,507,1,248,34.12228796844182,62.1301775147929,2.9585798816568047,0.7889546351084813,0.0
9,충청남도,천안시서북구,성환읍,성환읍제6투,1382,867,267,544,43,4,0,858,9,515,31.11888111888112,63.4032634032634,5.011655011655012,0.4662004662004662,0.0
10,충청남도,천안시서북구,성환읍,성환읍제7투,1911,1044,317,633,80,4,1,1035,9,867,30.628019323671495,61.15942028985507,7.729468599033816,0.3864734299516908,0.0966183574879227
11,충청남도,천안시서북구,성환읍,성환읍제8투,570,384,125,232,20,6,0,383,1,186,32.637075718015666,60.574412532637076,5.221932114882506,1.5665796344647518,0.0
12,충청남도,천안시서북구,성환읍,성환읍제9투,2190,1356,535,719,77,13,3,1347,9,834,39.71789161098738,53.37787676317743,5.716406829992576,0.9651076466221231,0.22271714922048996
13,충청남도,천안시서북구,성환읍,성환읍제10투,1867,1292,605,556,88,27,1,1277,15,575,47.37666405638215,43.539545810493344,6.891151135473766,2.11433046202036,0.07830853563038372
14,충청남도,천안시서북구,성거읍,관내사전투표,3246,3245,2149,835,211,25,4,3224,21,1,66.65632754342433,25.899503722084365,6.544665012406947,0.7754342431761787,0.12406947890818859
15,충청남도,천안시서북구,성거읍,성거읍제1투,2499,1458,659,693,82,12,3,1449,9,1041,45.47964113181504,47.82608695652174,5.659075224292615,0.8281573498964804,0.2070393374741201
16,충청남도,천안시서북구,성거읍,성거읍제2투,1397,880,296,534,42,4,1,877,3,517,33.75142531356899,60.889395667046756,4.789053591790194,0.45610034207525657,0.11402508551881414
17,충청남도,천안시서북구,성거읍,성거읍제3투,3914,2587,1244,1060,219,39,1,2563,24,1327,48.53687085446742,41.357783847054236,8.54467420991026,1.521654311353882,0.03901677721420211
18,충청남도,천안시서북구,성거읍,성거읍제4투,2255,1355,483,721,109,25,2,1340,15,900,36.04477611940298,53.80597014925373,8.134328358208954,1.8656716417910446,0.1492537313432836
19,충청남도,천안시서북구,성거읍,성거읍제5투,1321,757,229,467,50,6,1,753,4,564,30.411686586985393,62.01859229747676,6.640106241699867,0.796812749003984,0.13280212483399734
20,충청남도,천안시서북구,성거읍,성거읍제6투,1563,1092,493,497,90,6,1,1087,5,471,45.3541858325667,45.722171113155476,8.27966881324747,0.5519779208831647,0.09199632014719411
21,충청남도,천안시서북구,직산읍,관내사전투표,5707,5707,3696,1426,485,49,5,5661,46,0,65.2888182299947,25.18989577813107,8.567390920332096,0.8655714538067479,0.08832361773538244
22,충청남도,천안시서북구,직산읍,직산읍제1투,1131,779,220,511,37,5,0,773,6,352,28.46054333764554,66.10608020698578,4.786545924967658,0.646830530401035,0.0
23,충청남도,천안시서북구,직산읍,직산읍제2투,3213,1937,871,835,190,28,1,1925,12,1276,45.246753246753244,43.37662337662337,9.87012987012987,1.4545454545454546,0.05194805194805195
24,충청남도,천안시서북구,직산읍,직산읍제3투,1831,1125,361,686,65,6,2,1120,5,706,32.23214285714286,61.25000000000001,5.803571428571429,0.5357142857142857,0.17857142857142858
25,충청남도,천안시서북구,직산읍,직산읍제4투,1820,1013,392,512,89,8,2,1003,10,807,39.0827517447657,51.046859421734794,8.873379860418744,0.7976071784646062,0.19940179461615154
26,충청남도,천안시서북구,직산읍,직산읍제5투,1802,1054,530,416,86,13,1,1046,8,748,50.66921606118547,39.77055449330784,8.221797323135755,1.24282982791587,0.09560229445506692
27,충청남도,천안시서북구,직산읍,직산읍제6투,2161,1346,593,639,83,18,4,1337,9,815,44.3530291697831,47.793567688855646,6.207928197456993,1.3462976813762155,0.2991772625280479
28,충청남도,천안시서북구,입장면,관내사전투표,2468,2469,1486,794,149,24,1,2454,15,-1,60.55419722901385,32.355338223308884,6.071719641401793,0.9779951100244498,0.040749796251018745
29,충청남도,천안시서북구,입장면,입장면제1투,1576,898,292,528,56,7,2,885,13,678,32.994350282485875,59.66101694915255,6.3276836158192085,0.7909604519774011,0.22598870056497175
30,충청남도,천안시서북구,입장면,입장면제2투,676,455,136,279,26,7,1,449,6,221,30.28953229398664,62.1380846325167,5.79064587973274,1.55902004454343,0.22271714922048996
31,충청남도,천안시서북구,입장면,입장면제3투,1931,1162,366,731,53,2,0,1152,10,769,31.770833333333332,63.454861111111114,4.600694444444445,0.1736111111111111,0.0
32,충청남도,천안시서북구,입장면,입장면제4투,612,407,130,250,22,2,0,404,3,205,32.17821782178218,61.88118811881188,5.445544554455446,0.49504950495049505,0.0
33,충청남도,천안시서북구,성정1동,관내사전투표,1971,1971,1214,578,146,20,0,1958,13,0,62.00204290091931,29.519918283963225,7.456588355464761,1.0214504596527068,0.0
34,충청남도,천안시서북구,성정1동,성정1동제1투,1816,1146,403,633,93,6,2,1137,9,670,35.44415127528584,55.67282321899736,8.179419525065963,0.5277044854881267,0.1759014951627089
35,충청남도,천안시서북구,성정1동,성정1동제2투,3364,1736,620,955,135,16,0,1726,10,1628,35.92120509849362,55.330243337195824,7.821552723059096,0.9269988412514484,0.0
36,충청남도,천안시서북구,성정1동,성정1동제3투,3185,1645,554,947,113,11,2,1627,18,1540,34.05039950829748,58.20528580208973,6.945298094652736,0.6760909649661955,0.1229256299938537
37,충청남도,천안시서북구,성정1동,성정1동제4투,2882,2058,742,1106,174,22,3,2047,11,824,36.24816805080606,54.030288226673186,8.500244259892526,1.074743527112848,0.14655593551538837
38,충청남도,천안시서북구,성정2동,관내사전투표,3530,3530,2218,936,298,41,3,3496,34,0,63.443935926773456,26.773455377574372,8.524027459954233,1.1727688787185355,0.08581235697940504
39,충청남도,천안시서북구,성정2동,성정2동제1투,1293,659,273,301,73,6,0,653,6,634,41.807044410413475,46.094946401225116,11.179173047473201,0.9188361408882083,0.0
40,충청남도,천안시서북구,성정2동,성정2동제2투,3312,1810,652,943,172,24,2,1793,17,1502,36.36363636363637,52.593418851087556,9.592861126603458,1.3385387618516453,0.11154489682097045
41,충청남도,천안시서북구,성정2동,성정2동제3투,2907,1723,644,908,141,19,3,1715,8,1184,37.55102040816327,52.944606413994165,8.221574344023324,1.1078717201166182,0.1749271137026239
42,충청남도,천안시서북구,성정2동,성정2동제4투,2751,1163,416,618,110,9,1,1154,9,1588,36.04852686308492,53.552859618717505,9.532062391681109,0.779896013864818,0.08665511265164644
43,충청남도,천안시서북구,성정2동,성정2동제5투,4558,1904,701,913,247,22,2,1885,19,2654,37.188328912466844,48.43501326259947,13.10344827586207,1.16710875331565,0.10610079575596816
44,충청남도,천안시서북구,성정2동,성정2동제6투,3023,1045,403,461,156,6,0,1026,19,1978,39.278752436647174,44.9317738791423,15.204678362573098,0.5847953216374269,0.0
45,충청남도,천안시서북구,쌍용1동,관내사전투표,2562,2562,1587,718,211,25,1,2542,20,0,62.43115656963021,28.24547600314713,8.300550747442959,0.9834775767112509,0.03933910306845004
46,충청남도,천안시서북구,쌍용1동,쌍용1동제1투,1999,1225,386,729,86,11,0,1212,13,774,31.84818481848185,60.148514851485146,7.095709570957095,0.9075907590759077,0.0
47,충청남도,천안시서북구,쌍용1동,쌍용1동제2투,1987,1166,372,676,96,13,2,1159,7,821,32.09663503019844,58.326143226919754,8.283002588438308,1.1216566005176878,0.1725625539257981
48,충청남도,천안시서북구,쌍용1동,쌍용1동제3투,2004,1311,507,663,114,14,2,1300,11,693,39.0,51.0,8.76923076923077,1.0769230769230769,0.15384615384615385
49,충청남도,천안시서북구,쌍용1동,쌍용1동제4투,2088,1437,537,791,84,14,1,1427,10,651,37.63139453398738,55.43097407147862,5.886475122634898,0.9810791871058164,0.0700770847932726
50,충청남도,천안시서북구,쌍용2동,관내사전투표,5667,5667,3656,1382,538,49,9,5634,33,0,64.89172878949236,24.52964146254881,9.549165779197729,0.8697195598154064,0.1597444089456869
51,충청남도,천안시서북구,쌍용2동,쌍용2동제1투,2685,1753,609,964,149,17,1,1740,13,932,35.0,55.40229885057472,8.563218390804597,0.9770114942528736,0.05747126436781609
52,충청남도,천안시서북구,쌍용2동,쌍용2동제2투,1981,1315,523,669,98,10,0,1300,15,666,40.23076923076923,51.46153846153846,7.538461538461538,0.7692307692307693,0.0
53,충청남도,천안시서북구,쌍용2동,쌍용2동제3투,1837,1094,431,517,122,13,1,1084,10,743,39.760147601476014,47.69372693726937,11.254612546125461,1.1992619926199262,0.09225092250922509
54,충청남도,천안시서북구,쌍용2동,쌍용2동제4투,3233,2393,1106,1002,242,25,2,2377,16,840,46.52923853596971,42.15397559949516,10.18090029448885,1.051745898190997,0.08413967185527976
55,충청남도,천안시서북구,쌍용2동,쌍용2동제5투,1380,857,343,405,93,10,0,851,6,523,40.305522914218564,47.591069330199765,10.928319623971799,1.1750881316098707,0.0
56,충청남도,천안시서북구,쌍용2동,쌍용2동제6투,2427,1749,734,849,134,18,4,1739,10,678,42.208165612420935,48.821161587119036,7.7055779183438755,1.0350776308223115,0.23001725129384704
57,충청남도,천안시서북구,쌍용2동,쌍용2동제7투,2641,2055,944,906,165,26,2,2043,12,586,46.20655898188938,44.34654919236417,8.076358296622614,1.2726382770435634,0.09789525208027411
58,충청남도,천안시서북구,쌍용2동,쌍용2동제8투,3943,2703,1063,1386,209,19,3,2680,23,1240,39.66417910447761,51.71641791044777,7.798507462686567,0.7089552238805971,0.11194029850746269
59,충청남도,천안시서북구,쌍용3동,관내사전투표,4664,4664,3113,1109,381,34,2,4639,25,0,67.1049795214486,23.90601422720414,8.2129769346842,0.7329165768484587,0.04311273981461522
60,충청남도,천안시서북구,쌍용3동,쌍용3동제1투,2122,1437,516,790,115,8,0,1429,8,685,36.109167249825056,55.28341497550735,8.047585724282715,0.5598320503848845,0.0
61,충청남도,천안시서북구,쌍용3동,쌍용3동제2투,1829,1123,429,616,51,13,4,1113,10,706,38.544474393531,55.34591194968554,4.5822102425876015,1.1680143755615455,0.3593890386343217
62,충청남도,천안시서북구,쌍용3동,쌍용3동제3투,1223,778,292,401,61,12,0,766,12,445,38.1201044386423,52.34986945169713,7.963446475195822,1.5665796344647518,0.0
63,충청남도,천안시서북구,쌍용3동,쌍용3동제4투,1591,956,429,425,78,15,0,947,9,635,45.30095036958817,44.87856388595565,8.236536430834214,1.583949313621964,0.0
64,충청남도,천안시서북구,쌍용3동,쌍용3동제5투,1696,1145,508,489,128,8,1,1134,11,551,44.79717813051146,43.12169312169312,11.28747795414462,0.7054673721340388,0.08818342151675485
65,충청남도,천안시서북구,쌍용3동,쌍용3동제6투,1774,1427,478,784,142,18,0,1422,5,347,33.61462728551336,55.13361462728551,9.985935302390999,1.2658227848101267,0.0
66,충청남도,천안시서북구,백석동,관내사전투표,4697,4697,3230,999,402,42,5,4678,19,0,69.04660111158614,21.35528003420265,8.593415989739205,0.8978195810175289,0.10688328345446774
67,충청남도,천안시서북구,백석동,백석동제1투,1961,1342,578,582,157,14,1,1332,10,619,43.393393393393396,43.69369369369369,11.786786786786786,1.0510510510510511,0.07507507507507508
68,충청남도,천안시서북구,백석동,백석동제2투,1665,1207,502,611,70,15,0,1198,9,458,41.90317195325542,51.0016694490818,5.843071786310518,1.2520868113522539,0.0
69,충청남도,천안시서북구,백석동,백석동제3투,2405,1692,726,829,115,14,1,1685,7,713,43.08605341246291,49.19881305637982,6.824925816023739,0.830860534124629,0.05934718100890207
70,충청남도,천안시서북구,백석동,백석동제4투,3277,2224,1021,948,202,28,1,2200,24,1053,46.409090909090914,43.09090909090909,9.181818181818182,1.2727272727272727,0.045454545454545456
71,충청남도,천안시서북구,백석동,백석동제5투,2639,1955,958,801,166,17,8,1950,5,684,49.128205128205124,41.07692307692308,8.512820512820513,0.8717948717948718,0.41025641025641024
72,충청남도,천안시서북구,백석동,백석동제6투,4024,2834,1255,1211,317,27,6,2816,18,1190,44.56676136363637,43.00426136363637,11.257102272727272,0.9588068181818182,0.2130681818181818
73,충청남도,천안시서북구,백석동,백석동제7투,2661,2186,1163,766,214,26,3,2172,14,475,53.5451197053407,35.2670349907919,9.85267034990792,1.1970534069981584,0.13812154696132595
74,충청남도,천안시서북구,백석동,백석동제8투,2286,1818,1016,595,175,24,0,1810,8,468,56.132596685082866,32.87292817679558,9.668508287292818,1.3259668508287292,0.0
75,충청남도,천안시서북구,백석동,백석동제9투,1775,1249,530,570,128,12,1,1241,8,526,42.7074939564867,45.93070104754231,10.314262691377921,0.9669621273166802,0.08058017727639001
76,충청남도,천안시서북구,불당1동,관내사전투표,3909,3909,2593,803,425,50,3,3874,35,0,66.9334021683015,20.72792978833247,10.970573051109964,1.2906556530717606,0.07743933918430562
77,충청남도,천안시서북구,불당1동,불당1동제1투,3139,2391,1102,1037,202,31,0,2372,19,748,46.45868465430017,43.71838111298482,8.51602023608769,1.3069139966273187,0.0
78,충청남도,천안시서북구,불당1동,불당1동제2투,2377,1809,919,676,174,28,2,1799,10,568,51.08393551973318,37.57643135075042,9.672040022234576,1.556420233463035,0.11117287381878821
79,충청남도,천안시서북구,불당1동,불당1동제3투,2046,1399,630,593,143,21,1,1388,11,647,45.38904899135447,42.72334293948127,10.302593659942364,1.5129682997118155,0.07204610951008646
80,충청남도,천안시서북구,불당1동,불당1동제4투,2674,1853,775,866,175,26,2,1844,9,821,42.02819956616052,46.963123644251624,9.490238611713666,1.4099783080260302,0.10845986984815618
81,충청남도,천안시서북구,불당1동,불당1동제5투,1331,882,327,421,122,8,0,878,4,449,37.24373576309795,47.9498861047836,13.895216400911162,0.9111617312072893,0.0
82,충청남도,천안시서북구,불당1동,불당1동제6투,2735,2013,770,986,228,20,1,2005,8,722,38.403990024937656,49.17705735660848,11.371571072319203,0.997506234413965,0.04987531172069825
83,충청남도,천안시서북구,불당1동,불당1동제7투,3475,2596,1220,953,363,35,1,2572,24,879,47.43390357698289,37.052877138413685,14.11353032659409,1.3608087091757388,0.038880248833592534
84,충청남도,천안시서북구,불당2동,관내사전투표,6513,6513,4263,1355,770,68,8,6464,49,0,65.94987623762376,20.962252475247524,11.912128712871286,1.051980198019802,0.12376237623762376
85,충청남도,천안시서북구,불당2동,불당2동제1투,3560,2805,1222,1239,281,41,2,2785,20,755,43.87791741472172,44.488330341113105,10.089766606822263,1.4721723518850987,0.0718132854578097
86,충청남도,천안시서북구,불당2동,불당2동제2투,2682,1955,806,904,215,17,1,1943,12,727,41.482243952650535,46.5259907359753,11.065362840967575,0.8749356664951106,0.0514668039114771
87,충청남도,천안시서북구,불당2동,불당2동제3투,2369,1825,795,792,209,22,0,1818,7,544,43.72937293729373,43.56435643564357,11.496149614961496,1.21012101210121,0.0
88,충청남도,천안시서북구,불당2동,불당2동제4투,3321,2516,1194,1030,239,33,1,2497,19,805,47.81738085702843,41.24949939927913,9.571485782939527,1.3215859030837005,0.040048057669203045
89,충청남도,천안시서북구,불당2동,불당2동제5투,2974,2266,1119,822,271,26,2,2240,26,708,49.955357142857146,36.69642857142857,12.098214285714286,1.1607142857142858,0.08928571428571429
90,충청남도,천안시서북구,불당2동,불당2동제6투,3230,2212,923,973,277,21,1,2195,17,1018,42.0501138952164,44.32801822323462,12.619589977220958,0.9567198177676537,0.04555808656036447
91,충청남도,천안시서북구,부성1동,관내사전투표,7615,7615,4869,1495,1111,70,9,7554,61,0,64.45591739475775,19.79083929044215,14.707439767010854,0.9266613714588299,0.11914217633042098
92,충청남도,천안시서북구,부성1동,부성1동제1투,1857,1276,532,576,138,17,3,1266,10,581,42.022116903633496,45.497630331753555,10.90047393364929,1.3428120063191153,0.23696682464454977
93,충청남도,천안시서북구,부성1동,부성1동제2투,4343,2918,1129,1330,401,30,4,2894,24,1425,39.01174844505874,45.95715272978577,13.856254319281271,1.0366275051831375,0.138217000691085
94,충청남도,천안시서북구,부성1동,부성1동제3투,687,455,157,268,21,4,0,450,5,232,34.88888888888889,59.55555555555555,4.666666666666667,0.8888888888888888,0.0
95,충청남도,천안시서북구,부성1동,부성1동제4투,1922,1391,585,656,122,10,1,1374,17,531,42.5764192139738,47.74381368267831,8.879184861717611,0.727802037845706,0.0727802037845706
96,충청남도,천안시서북구,부성1동,부성1동제5투,2765,1694,789,677,193,22,2,1683,11,1071,46.88057040998218,40.22578728461082,11.467617349970292,1.3071895424836601,0.11883541295306002
97,충청남도,천안시서북구,부성1동,부성1동제6투,1177,826,404,334,70,11,0,819,7,351,49.32844932844933,40.78144078144078,8.547008547008547,1.3431013431013432,0.0
98,충청남도,천안시서북구,부성1동,부성1동제7투,2357,1491,679,623,152,23,2,1479,12,866,45.909398242055445,42.12305611899932,10.277214334009466,1.555104800540906,0.1352265043948614
99,충청남도,천안시서북구,부성1동,부성1동제8투,2479,1709,720,736,217,16,2,1691,18,770,42.57835600236547,43.524541691306915,12.83264340626848,0.9461856889414548,0.11827321111768185
100,충청남도,천안시서북구,부성1동,부성1동제9투,4355,2032,710,895,382,20,3,2010,22,2323,35.32338308457712,44.527363184079604,19.00497512437811,0.9950248756218906,0.1492537313432836
101,충청남도,천안시서북구,부성1동,부성1동제10투,2449,1899,930,744,186,18,4,1882,17,550,49.41551540913922,39.53241232731137,9.883103081827842,0.9564293304994688,0.21253985122210414
102,충청남도,천안시서북구,부성1동,부성1동제11투,3350,2352,1084,982,245,26,0,2337,15,998,46.384253316217375,42.01968335472828,10.483525887890458,1.1125374411638853,0.0
103,충청남도,천안시서북구,부성1동,부성1동제12투,3146,2247,942,956,313,22,3,2236,11,899,42.12880143112701,42.75491949910555,13.998211091234348,0.9838998211091234,0.13416815742397137
104,충청남도,천안시서북구,부성1동,부성1동제13투,2184,1767,852,666,215,29,1,1763,4,417,48.32671582529779,37.776517300056724,12.195121951219512,1.6449234259784458,0.05672149744753262
105,충청남도,천안시서북구,부성2동,관내사전투표,9162,9162,6280,1738,994,79,7,9098,64,0,69.02615959551551,19.103099582325786,10.925478127060892,0.8683227082875358,0.07693998681028798
106,충청남도,천안시서북구,부성2동,부성2동제1투,2958,2177,1207,698,236,25,3,2169,8,781,55.647763946519134,32.18072844628861,10.880590133702167,1.1526048870447212,0.13831258644536654
107,충청남도,천안시서북구,부성2동,부성2동제2투,2955,2160,992,927,205,20,3,2147,13,795,46.204005589194225,43.176525384257104,9.548206800186307,0.9315323707498836,0.13972985561248255
108,충청남도,천안시서북구,부성2동,부성2동제3투,3380,2344,1122,972,211,28,1,2334,10,1036,48.0719794344473,41.645244215938305,9.040274207369322,1.1996572407883461,0.042844901456726654
109,충청남도,천안시서북구,부성2동,부성2동제4투,2676,1211,471,519,196,9,1,1196,15,1465,39.381270903010034,43.39464882943144,16.387959866220736,0.7525083612040134,0.08361204013377926
110,충청남도,천안시서북구,부성2동,부성2동제5투,3014,1856,832,768,214,20,1,1835,21,1158,45.340599455040866,41.85286103542234,11.662125340599456,1.08991825613079,0.05449591280653951
111,충청남도,천안시서북구,부성2동,부성2동제6투,2841,1602,690,685,184,28,4,1591,11,1239,43.36895034569453,43.05468258956631,11.565053425518542,1.759899434318039,0.251414204902577
112,충청남도,천안시서북구,부성2동,부성2동제7투,2424,1642,754,728,123,27,0,1632,10,782,46.200980392156865,44.6078431372549,7.536764705882352,1.6544117647058825,0.0
113,충청남도,천안시서북구,부성2동,부성2동제8투,2667,1746,886,626,192,25,3,1732,14,921,51.15473441108544,36.1431870669746,11.085450346420323,1.443418013856813,0.17321016166281755
114,충청남도,천안시서북구,부성2동,부성2동제9투,1750,1359,751,392,186,17,3,1349,10,391,55.67086730911787,29.058561897702003,13.787991104521868,1.2601927353595257,0.2223869532987398
115,충청남도,천안시서북구,부성2동,부성2동제10투,3754,2634,1207,1053,328,27,5,2620,14,1120,46.06870229007634,40.19083969465649,12.51908396946565,1.0305343511450382,0.19083969465648853
116,충청남도,천안시서북구,부성2동,부성2동제11투,2757,2249,1213,740,245,31,0,2229,20,508,54.419021982951996,33.198743831314495,10.991475998205473,1.3907581875280395,0.0
117,충청남도,천안시서북구,부성2동,부성2동제12투,2462,1968,1006,660,259,27,3,1955,13,494,51.45780051150896,33.75959079283887,13.248081841432224,1.381074168797954,0.1534526854219949
118,충청남도,천안시서북구,부성2동,부성2동제13투,3279,2257,1130,809,288,18,0,2245,12,1022,50.33407572383074,36.03563474387528,12.828507795100222,0.8017817371937639,0.0
119,충청남도,천안시서북구,잘못 투입·구분된 투표지,,0,15,5,4,6,0,0,15,0,-15,33.33333333333333,26.666666666666668,40.0,0.0,0.0
0,충청남도,천안시동남구,거소·선상투표,,352,337,159,105,63,1,1,329,8,15,48.328267477203646,31.914893617021278,19.148936170212767,0.303951367781155,0.303951367781155
1,충청남도,천안시동남구,관외사전투표,,19380,19375,11084,5132,2747,189,34,19186,189,5,57.77129156676744,26.748670905868867,14.317731679349526,0.985093297195872,0.177212550818305
2,충청남도,천안시동남구,재외투표,,985,809,564,144,80,14,2,804,5,176,70.1492537313433,17.91044776119403,9.950248756218906,1.7412935323383085,0.24875621890547264
3,충청남도,천안시동남구,목천읍,관내사전투표,3323,3323,2179,917,173,33,1,3303,20,0,65.97033000302756,27.762640024220403,5.237662730850742,0.9990917347865577,0.030275507114744173
4,충청남도,천안시동남구,목천읍,목천읍제1투,2456,1458,459,909,73,6,2,1449,9,998,31.67701863354037,62.732919254658384,5.037957211870255,0.4140786749482402,0.13802622498274672
5,충청남도,천안시동남구,목천읍,목천읍제2투,1702,1040,361,604,60,6,1,1032,8,662,34.980620155038764,58.52713178294574,5.813953488372093,0.5813953488372093,0.09689922480620156
6,충청남도,천안시동남구,목천읍,목천읍제3투,656,468,138,305,14,7,1,465,3,188,29.677419354838708,65.59139784946237,3.010752688172043,1.5053763440860215,0.21505376344086022
7,충청남도,천안시동남구,목천읍,목천읍제4투,1962,1282,537,643,80,14,2,1276,6,680,42.0846394984326,50.391849529780565,6.269592476489027,1.09717868338558,0.1567398119122257
8,충청남도,천안시동남구,목천읍,목천읍제5투,2599,1786,918,710,120,21,6,1775,11,813,51.71830985915493,40.0,6.760563380281689,1.1830985915492958,0.3380281690140845
9,충청남도,천안시동남구,목천읍,목천읍제6투,1154,745,350,332,52,4,1,739,6,409,47.36129905277402,44.9255751014885,7.036535859269283,0.5412719891745602,0.13531799729364005
10,충청남도,천안시동남구,목천읍,목천읍제7투,3787,2328,1094,1026,166,24,4,2314,14,1459,47.27744165946413,44.338807260155576,7.17372515125324,1.0371650821089022,0.17286084701815038
11,충청남도,천안시동남구,풍세면,관내사전투표,2461,2461,1613,594,203,30,1,2441,20,0,66.07947562474395,24.33428922572716,8.316263826300696,1.2290045063498567,0.04096681687832855
12,충청남도,천안시동남구,풍세면,풍세면제1투,4377,2581,997,1302,242,24,2,2567,14,1796,38.839111803661865,50.720685625243476,9.42734709777951,0.9349435138293729,0.07791195948578107
13,충청남도,천안시동남구,풍세면,풍세면제2투,522,357,84,244,21,5,0,354,3,165,23.728813559322035,68.92655367231639,5.932203389830509,1.4124293785310735,0.0
14,충청남도,천안시동남구,풍세면,풍세면제3투,1130,704,190,457,41,8,1,697,7,426,27.259684361549496,65.56671449067431,5.88235294117647,1.1477761836441895,0.1434720229555237
15,충청남도,천안시동남구,광덕면,관내사전투표,753,753,452,273,21,4,0,750,3,0,60.266666666666666,36.4,2.8000000000000003,0.5333333333333333,0.0
16,충청남도,천안시동남구,광덕면,광덕면제1투,1127,821,136,654,25,1,0,816,5,306,16.666666666666664,80.14705882352942,3.063725490196078,0.12254901960784313,0.0
17,충청남도,천안시동남구,광덕면,광덕면제2투,932,631,169,434,19,6,0,628,3,301,26.910828025477706,69.10828025477707,3.0254777070063694,0.9554140127388535,0.0
18,충청남도,천안시동남구,광덕면,광덕면제3투,654,419,127,269,12,6,1,415,4,235,30.602409638554217,64.81927710843374,2.891566265060241,1.4457831325301205,0.24096385542168677
19,충청남도,천안시동남구,북면,관내사전투표,702,702,389,254,31,9,6,689,13,0,56.45863570391872,36.86502177068215,4.499274310595065,1.3062409288824384,0.8708272859216255
20,충청남도,천안시동남구,북면,북면제1투,1671,963,308,588,50,8,2,956,7,708,32.21757322175732,61.50627615062761,5.230125523012552,0.8368200836820083,0.20920502092050208
21,충청남도,천안시동남구,북면,북면제2투,861,566,105,426,26,4,2,563,3,295,18.650088809946713,75.66607460035524,4.618117229129663,0.7104795737122558,0.3552397868561279
22,충청남도,천안시동남구,성남면,관내사전투표,1195,1195,686,421,64,14,1,1186,9,0,57.84148397976391,35.49747048903878,5.396290050590219,1.1804384485666104,0.08431703204047217
23,충청남도,천안시동남구,성남면,성남면제1투,691,419,131,269,13,1,1,415,4,272,31.566265060240962,64.81927710843374,3.132530120481928,0.24096385542168677,0.24096385542168677
24,충청남도,천안시동남구,성남면,성남면제2투,1074,631,145,455,18,5,2,625,6,443,23.200000000000003,72.8,2.88,0.8,0.32
25,충청남도,천안시동남구,수신면,관내사전투표,907,907,542,297,53,6,3,901,6,0,60.15538290788013,32.963374028856826,5.88235294117647,0.6659267480577136,0.3329633740288568
26,충청남도,천안시동남구,수신면,수신면제1투,878,544,140,363,32,6,0,541,3,334,25.87800369685767,67.09796672828097,5.914972273567468,1.1090573012939002,0.0
27,충청남도,천안시동남구,수신면,수신면제2투,396,234,61,163,7,3,0,234,0,162,26.06837606837607,69.65811965811966,2.9914529914529915,1.282051282051282,0.0
28,충청남도,천안시동남구,병천면,관내사전투표,2147,2147,1185,744,189,16,4,2138,9,0,55.42563143124415,34.79887745556595,8.840037418147801,0.7483629560336763,0.18709073900841908
29,충청남도,천안시동남구,병천면,병천면제1투,2175,1195,360,742,77,11,1,1191,4,980,30.22670025188917,62.300587741393784,6.465155331654072,0.9235936188077246,0.08396305625524769
30,충청남도,천안시동남구,병천면,병천면제2투,966,603,191,388,18,2,0,599,4,363,31.886477462437394,64.77462437395658,3.005008347245409,0.333889816360601,0.0
31,충청남도,천안시동남구,병천면,병천면제3투,514,350,121,216,9,0,1,347,3,164,34.87031700288185,62.2478386167147,2.5936599423631126,0.0,0.2881844380403458
32,충청남도,천안시동남구,동면,관내사전투표,603,603,296,259,36,5,2,598,5,0,49.49832775919732,43.31103678929766,6.0200668896321075,0.8361204013377926,0.33444816053511706
33,충청남도,천안시동남구,동면,동면투표소,1119,674,166,460,35,5,1,667,7,445,24.887556221889056,68.96551724137932,5.247376311844078,0.7496251874062968,0.14992503748125938
34,충청남도,천안시동남구,중앙동,관내사전투표,1707,1707,933,657,92,9,1,1692,15,0,55.14184397163121,38.82978723404255,5.4373522458628845,0.5319148936170213,0.0591016548463357
35,충청남도,천안시동남구,중앙동,중앙동제1투,1580,866,220,592,47,5,0,864,2,714,25.462962962962965,68.51851851851852,5.439814814814815,0.5787037037037037,0.0
36,충청남도,천안시동남구,중앙동,중앙동제2투,1533,924,306,547,54,8,0,915,9,609,33.442622950819676,59.78142076502733,5.901639344262295,0.8743169398907104,0.0
37,충청남도,천안시동남구,문성동,관내사전투표,2007,2007,1193,605,164,22,3,1987,20,0,60.04026170105688,30.447911424257672,8.25364871665828,1.1071967790639154,0.1509813789632612
38,충청남도,천안시동남구,문성동,문성동제1투,2031,1178,367,700,90,10,3,1170,8,853,31.367521367521366,59.82905982905983,7.6923076923076925,0.8547008547008548,0.2564102564102564
39,충청남도,천안시동남구,문성동,문성동제2투,2362,1764,761,776,181,25,3,1746,18,598,43.585337915234824,44.44444444444444,10.36655211912944,1.43184421534937,0.1718213058419244
40,충청남도,천안시동남구,원성1동,관내사전투표,1645,1645,938,546,133,14,2,1633,12,0,57.44029393753828,33.435394978567054,8.14451928965095,0.8573178199632578,0.1224739742804654
41,충청남도,천안시동남구,원성1동,원성1동제1투,1561,945,303,573,49,14,1,940,5,616,32.234042553191486,60.95744680851064,5.212765957446808,1.4893617021276597,0.10638297872340426
42,충청남도,천안시동남구,원성1동,원성1동제2투,831,464,129,301,26,3,0,459,5,367,28.104575163398692,65.57734204793029,5.664488017429194,0.6535947712418301,0.0
43,충청남도,천안시동남구,원성1동,원성1동제3투,1096,644,176,425,38,2,0,641,3,452,27.45709828393136,66.30265210608425,5.928237129485179,0.31201248049922,0.0
44,충청남도,천안시동남구,원성1동,원성1동제4투,1535,1006,336,579,70,15,0,1000,6,529,33.6,57.9,7.000000000000001,1.5,0.0
45,충청남도,천안시동남구,원성2동,관내사전투표,2426,2426,1437,796,157,21,2,2413,13,0,59.552424368006626,32.98798176543721,6.506423539162867,0.870285951098218,0.08288437629506838
46,충청남도,천안시동남구,원성2동,원성2동제1투,669,432,114,284,28,2,0,428,4,237,26.635514018691588,66.35514018691589,6.5420560747663545,0.46728971962616817,0.0
47,충청남도,천안시동남구,원성2동,원성2동제2투,2254,1412,434,858,97,12,1,1402,10,842,30.955777460770328,61.19828815977175,6.9186875891583455,0.8559201141226819,0.07132667617689016
48,충청남도,천안시동남구,원성2동,원성2동제3투,2844,1601,434,1031,113,12,0,1590,11,1243,27.29559748427673,64.84276729559748,7.1069182389937104,0.7547169811320755,0.0
49,충청남도,천안시동남구,봉명동,관내사전투표,2452,2452,1487,733,208,17,1,2446,6,0,60.793131643499585,29.967293540474245,8.503679476696648,0.6950122649223222,0.04088307440719542
50,충청남도,천안시동남구,봉명동,봉명동제1투,1716,855,330,457,53,6,1,847,8,861,38.961038961038966,53.955135773317586,6.257378984651712,0.7083825265643447,0.11806375442739078
51,충청남도,천안시동남구,봉명동,봉명동제2투,1772,1123,425,601,85,4,0,1115,8,649,38.11659192825112,53.90134529147982,7.623318385650224,0.35874439461883406,0.0
52,충청남도,천안시동남구,봉명동,봉명동제3투,1800,1103,353,648,86,8,1,1096,7,697,32.20802919708029,59.12408759124088,7.846715328467154,0.7299270072992701,0.09124087591240876
53,충청남도,천안시동남구,봉명동,봉명동제4투,1377,736,221,462,42,6,0,731,5,641,30.23255813953488,63.20109439124487,5.745554035567715,0.8207934336525308,0.0
54,충청남도,천안시동남구,봉명동,봉명동제5투,2232,1512,582,755,146,14,4,1501,11,720,38.77415056628914,50.299800133244496,9.726848767488342,0.9327115256495668,0.2664890073284477
55,충청남도,천안시동남구,봉명동,봉명동제6투,1850,1227,585,506,109,15,3,1218,9,623,48.029556650246306,41.54351395730706,8.949096880131362,1.2315270935960592,0.24630541871921183
56,충청남도,천안시동남구,일봉동,관내사전투표,2425,2425,1496,771,123,18,4,2412,13,0,62.02321724709784,31.965174129353237,5.099502487562189,0.7462686567164178,0.16583747927031509
57,충청남도,천안시동남구,일봉동,일봉동제1투,2147,1198,351,765,63,11,1,1191,7,949,29.47103274559194,64.23173803526448,5.289672544080604,0.9235936188077246,0.08396305625524769
58,충청남도,천안시동남구,일봉동,일봉동제2투,2661,1780,748,894,100,27,3,1772,8,881,42.21218961625282,50.45146726862303,5.643340857787811,1.5237020316027088,0.16930022573363432
59,충청남도,천안시동남구,일봉동,일봉동제3투,2335,1550,607,746,170,15,2,1540,10,785,39.41558441558441,48.44155844155844,11.03896103896104,0.974025974025974,0.12987012987012986
60,충청남도,천안시동남구,일봉동,일봉동제4투,2676,1984,854,943,148,28,1,1974,10,692,43.262411347517734,47.7710233029382,7.497467071935157,1.4184397163120568,0.050658561296859174
61,충청남도,천안시동남구,일봉동,일봉동제5투,3572,2622,1305,1079,199,26,1,2610,12,950,50.0,41.34099616858238,7.624521072796934,0.996168582375479,0.03831417624521073
62,충청남도,천안시동남구,신방동,관내사전투표,7259,7259,5181,1436,558,46,3,7224,35,0,71.71926910299004,19.878183831672203,7.724252491694353,0.636766334440753,0.04152823920265781
63,충청남도,천안시동남구,신방동,신방동제1투,1992,1471,569,759,113,17,2,1460,11,521,38.97260273972603,51.98630136986301,7.739726027397261,1.1643835616438356,0.136986301369863
64,충청남도,천안시동남구,신방동,신방동제2투,2418,1758,861,716,142,32,1,1752,6,660,49.14383561643836,40.8675799086758,8.105022831050228,1.82648401826484,0.05707762557077625
65,충청남도,천안시동남구,신방동,신방동제3투,2800,1988,932,851,173,20,2,1978,10,812,47.118301314459046,43.02325581395349,8.746208291203237,1.0111223458038423,0.10111223458038424
66,충청남도,천안시동남구,신방동,신방동제4투,2440,1884,958,707,166,32,5,1868,16,556,51.2847965738758,37.847965738758035,8.886509635974305,1.7130620985010707,0.26766595289079226
67,충청남도,천안시동남구,신방동,신방동제5투,3554,1883,743,936,167,20,2,1868,15,1671,39.775160599571734,50.107066381156315,8.940042826552462,1.070663811563169,0.10706638115631692
68,충청남도,천안시동남구,신방동,신방동제6투,1183,715,295,351,54,8,0,708,7,468,41.66666666666667,49.57627118644068,7.627118644067797,1.1299435028248588,0.0
69,충청남도,천안시동남구,신방동,신방동제7투,2688,2080,959,894,170,35,3,2061,19,608,46.5308102862688,43.37700145560407,8.248423095584666,1.6982047549733137,0.1455604075691412
70,충청남도,천안시동남구,신방동,신방동제8투,4853,3160,1493,1286,326,33,7,3145,15,1693,47.472178060413356,40.890302066772655,10.365659777424483,1.0492845786963434,0.22257551669316375
71,충청남도,천안시동남구,신방동,신방동제9투,3990,2556,1247,1043,218,28,1,2537,19,1434,49.152542372881356,41.1115490737091,8.592826172644855,1.103665746945211,0.039416633819471816
72,충청남도,천안시동남구,청룡동,관내사전투표,8240,8240,5434,1895,764,79,5,8177,63,0,66.45468998410175,23.174758468876117,9.343279931515227,0.9661244955362602,0.06114711997064938
73,충청남도,천안시동남구,청룡동,청룡동제1투,2910,2054,756,1119,146,21,3,2045,9,856,36.9682151589242,54.71882640586797,7.139364303178485,1.0268948655256724,0.1466992665036675
74,충청남도,천안시동남구,청룡동,청룡동제2투,2474,1570,537,876,135,10,1,1559,11,904,34.44515715202053,56.18986529826812,8.659397049390636,0.6414368184733804,0.06414368184733803
75,충청남도,천안시동남구,청룡동,청룡동제3투,4148,3072,1390,1372,252,30,2,3046,26,1076,45.63361785948785,45.04267892317794,8.273145108338804,0.984898227183191,0.06565988181221273
76,충청남도,천안시동남구,청룡동,청룡동제4투,3393,2404,1031,1164,172,23,0,2390,14,989,43.13807531380753,48.70292887029289,7.1966527196652725,0.9623430962343096,0.0
77,충청남도,천안시동남구,청룡동,청룡동제5투,2972,1940,707,1076,122,22,3,1930,10,1032,36.63212435233161,55.751295336787564,6.321243523316062,1.1398963730569949,0.15544041450777202
78,충청남도,천안시동남구,청룡동,청룡동제6투,1696,1130,436,554,115,11,2,1118,12,566,38.998211091234346,49.55277280858677,10.286225402504472,0.9838998211091234,0.17889087656529518
79,충청남도,천안시동남구,청룡동,청룡동제7투,4874,3305,1604,1312,330,34,4,3284,21,1569,48.84287454323995,39.95127892813642,10.04872107186358,1.0353227771010962,0.12180267965895249
80,충청남도,천안시동남구,청룡동,청룡동제8투,1599,1113,560,442,94,11,2,1109,4,486,50.49594229035167,39.85572587917042,8.476104598737603,0.9918845807033363,0.18034265103697023
81,충청남도,천안시동남구,청룡동,청룡동제9투,3357,2059,821,981,213,25,3,2043,16,1298,40.18600097895252,48.01762114537445,10.425844346549193,1.2236906510034264,0.14684287812041116
82,충청남도,천안시동남구,청룡동,청룡동제10투,3754,2853,1417,1111,273,36,3,2840,13,901,49.894366197183096,39.11971830985915,9.612676056338028,1.267605633802817,0.10563380281690139
83,충청남도,천안시동남구,청룡동,청룡동제11투,1920,1363,651,560,123,16,1,1351,12,557,48.18652849740933,41.45077720207254,9.104367135455218,1.1843079200592153,0.07401924500370095
84,충청남도,천안시동남구,신안동,관내사전투표,6142,6142,3718,1620,687,66,0,6091,51,0,61.04087998686587,26.596617960925954,11.278936135281564,1.083565916926613,0.0
85,충청남도,천안시동남구,신안동,신안동제1투,2041,1195,372,657,134,22,1,1186,9,846,31.365935919055648,55.396290050590224,11.298482293423271,1.854974704890388,0.08431703204047217
86,충청남도,천안시동남구,신안동,신안동제2투,2655,1944,761,935,211,25,0,1932,12,711,39.38923395445135,48.395445134575574,10.921325051759833,1.2939958592132506,0.0
87,충청남도,천안시동남구,신안동,신안동제3투,2100,1143,343,691,87,12,1,1134,9,957,30.246913580246915,60.9347442680776,7.671957671957672,1.0582010582010581,0.08818342151675485
88,충청남도,천안시동남구,신안동,신안동제4투,2172,1622,587,900,123,5,0,1615,7,550,36.34674922600619,55.72755417956656,7.61609907120743,0.30959752321981426,0.0
89,충청남도,천안시동남구,신안동,신안동제5투,2603,1902,747,973,149,17,2,1888,14,701,39.565677966101696,51.53601694915254,7.891949152542373,0.9004237288135594,0.1059322033898305
90,충청남도,천안시동남구,신안동,신안동제6투,2940,1945,724,964,215,21,3,1927,18,995,37.571354436948624,50.02594706798131,11.157239231966788,1.0897768552153606,0.15568240788790866
91,충청남도,천안시동남구,신안동,신안동제7투,3332,2376,1041,1044,237,29,5,2356,20,956,44.18505942275042,44.312393887945674,10.05942275042445,1.230899830220713,0.21222410865874364
92,충청남도,천안시동남구,신안동,신안동제8투,3188,2151,753,1092,247,31,3,2126,25,1037,35.41862652869238,51.36406396989652,11.618062088428974,1.458137347130762,0.14111006585136407
93,충청남도,천안시동남구,신안동,신안동제9투,2522,1867,691,997,149,19,2,1858,9,655,37.19052744886975,53.659849300322925,8.019375672766415,1.022604951560818,0.1076426264800861
94,충청남도,천안시동남구,잘못 투입·구분된 투표지,,0,0,0,0,0,0,0,0,0,0,0.0,0.0,0.0,0.0,0.0
0,전북특별자치도,전주시완산구,거소·선상투표,,866,820,563,99,103,5,6,776,44,46,72.55154639175258,12.757731958762886,13.27319587628866,0.6443298969072164,0.7731958762886598
1,전북특별자치도,전주시완산구,관외사전투표,,36627,36613,29536,2784,3666,321,42,36349,264,14,81.2567058240942,7.659082780819279,10.085559437673663,0.8831054499436023,0.11554650746925638
2,전북특별자치도,전주시완산구,재외투표,,1264,1094,882,95,101,13,0,1091,3,170,80.84326306141155,8.707607699358388,9.25756186984418,1.1915673693858846,0.0
3,전북특별자치도,전주시완산구,중앙동,관내사전투표,4035,4035,3518,311,167,25,3,4024,11,0,87.42544731610337,7.7286282306163026,4.150099403578529,0.621272365805169,0.07455268389662027
4,전북특별자치도,전주시완산구,중앙동,중앙동제1투,965,577,420,109,40,4,1,574,3,388,73.17073170731707,18.989547038327526,6.968641114982578,0.6968641114982579,0.17421602787456447
5,전북특별자치도,전주시완산구,중앙동,중앙동제2투,1285,802,452,264,65,10,3,794,8,483,56.92695214105793,33.249370277078086,8.18639798488665,1.2594458438287155,0.3778337531486146
6,전북특별자치도,전주시완산구,중앙동,중앙동제3투,1668,1083,753,212,98,11,2,1076,7,585,69.9814126394052,19.702602230483272,9.107806691449815,1.0223048327137547,0.18587360594795538
7,전북특별자치도,전주시완산구,풍남동,관내사전투표,2391,2391,2030,187,136,19,7,2379,12,0,85.32997057587221,7.860445565363598,5.7166876839007985,0.7986548970155528,0.2942412778478352
8,전북특별자치도,전주시완산구,풍남동,풍남동제1투,778,453,305,123,18,6,0,452,1,325,67.47787610619469,27.212389380530972,3.982300884955752,1.3274336283185841,0.0
9,전북특별자치도,전주시완산구,풍남동,풍남동제2투,903,548,410,115,19,1,0,545,3,355,75.22935779816514,21.100917431192663,3.486238532110092,0.1834862385321101,0.0
10,전북특별자치도,전주시완산구,노송동,관내사전투표,2822,2822,2522,178,90,15,5,2810,12,0,89.7508896797153,6.334519572953737,3.202846975088968,0.5338078291814947,0.1779359430604982
11,전북특별자치도,전주시완산구,노송동,노송동제1투,969,597,421,135,33,6,0,595,2,372,70.75630252100841,22.689075630252102,5.546218487394958,1.0084033613445378,0.0
12,전북특별자치도,전주시완산구,노송동,노송동제2투,366,192,134,47,8,1,0,190,2,174,70.52631578947368,24.736842105263158,4.2105263157894735,0.5263157894736842,0.0
13,전북특별자치도,전주시완산구,노송동,노송동제3투,1339,914,701,127,66,11,2,907,7,425,77.28776185226019,14.002205071664827,7.2767364939360535,1.2127894156560088,0.2205071664829107
14,전북특별자치도,전주시완산구,노송동,노송동제4투,986,600,475,91,23,5,2,596,4,386,79.69798657718121,15.268456375838927,3.859060402684564,0.8389261744966443,0.33557046979865773
15,전북특별자치도,전주시완산구,노송동,노송동제5투,826,472,360,80,24,3,3,470,2,354,76.59574468085107,17.02127659574468,5.106382978723404,0.6382978723404255,0.6382978723404255
16,전북특별자치도,전주시완산구,완산동,관내사전투표,1989,1989,1756,115,93,14,2,1980,9,0,88.68686868686869,5.808080808080808,4.696969696969696,0.7070707070707071,0.10101010101010101
17,전북특별자치도,전주시완산구,완산동,완산동제1투,1155,766,619,111,24,5,3,762,4,389,81.23359580052494,14.566929133858267,3.149606299212598,0.6561679790026247,0.39370078740157477
18,전북특별자치도,전주시완산구,완산동,완산동제2투,1119,663,449,159,44,5,2,659,4,456,68.13353566009106,24.12746585735964,6.676783004552352,0.7587253414264037,0.30349013657056145
19,전북특별자치도,전주시완산구,동서학동,관내사전투표,2493,2493,2174,164,113,29,4,2484,9,0,87.52012882447666,6.602254428341385,4.549114331723027,1.1674718196457328,0.1610305958132045
20,전북특별자치도,전주시완산구,동서학동,동서학동제1투,1064,665,470,134,51,8,2,665,0,399,70.67669172932331,20.150375939849624,7.669172932330827,1.2030075187969926,0.30075187969924816
21,전북특별자치도,전주시완산구,동서학동,동서학동제2투,497,273,211,37,19,4,0,271,2,224,77.85977859778598,13.653136531365314,7.011070110701106,1.4760147601476015,0.0
22,전북특별자치도,전주시완산구,동서학동,동서학동제3투,912,568,445,99,16,6,1,567,1,344,78.48324514991182,17.46031746031746,2.821869488536155,1.0582010582010581,0.1763668430335097
23,전북특별자치도,전주시완산구,서서학동,관내사전투표,3440,3440,3087,219,94,21,3,3424,16,0,90.15771028037383,6.396028037383178,2.7453271028037385,0.6133177570093458,0.08761682242990654
24,전북특별자치도,전주시완산구,서서학동,서서학동제1투,918,481,328,107,26,11,0,472,9,437,69.49152542372882,22.66949152542373,5.508474576271186,2.330508474576271,0.0
25,전북특별자치도,전주시완산구,서서학동,서서학동제2투,1257,757,581,109,40,12,1,743,14,500,78.19650067294751,14.670255720053834,5.383580080753701,1.6150740242261103,0.13458950201884254
26,전북특별자치도,전주시완산구,서서학동,서서학동제3투,1035,594,434,117,37,4,0,592,2,441,73.3108108108108,19.763513513513516,6.25,0.6756756756756757,0.0
27,전북특별자치도,전주시완산구,중화산1동,관내사전투표,5120,5119,4486,318,251,33,4,5092,27,1,88.09897879025922,6.24509033778476,4.92930086410055,0.648075412411626,0.07855459544383347
28,전북특별자치도,전주시완산구,중화산1동,중화산1동제1투,1985,1108,732,271,86,14,1,1104,4,877,66.30434782608695,24.547101449275363,7.789855072463768,1.2681159420289856,0.09057971014492754
29,전북특별자치도,전주시완산구,중화산1동,중화산1동제2투,1895,1190,801,281,88,13,1,1184,6,705,67.65202702702703,23.73310810810811,7.4324324324324325,1.097972972972973,0.08445945945945946
30,전북특별자치도,전주시완산구,중화산1동,중화산1동제3투,1651,1125,784,256,69,7,3,1119,6,526,70.06255585344057,22.87756925826631,6.166219839142091,0.6255585344057194,0.2680965147453083
31,전북특별자치도,전주시완산구,중화산2동,관내사전투표,5027,5027,4331,329,291,47,6,5004,23,0,86.55075939248601,6.574740207833734,5.815347721822542,0.9392486011191047,0.1199040767386091
32,전북특별자치도,전주시완산구,중화산2동,중화산2동제1투,1955,1381,907,311,132,15,3,1368,13,574,66.30116959064327,22.73391812865497,9.649122807017543,1.0964912280701753,0.21929824561403508
33,전북특별자치도,전주시완산구,중화산2동,중화산2동제2투,2327,1117,805,201,94,9,1,1110,7,1210,72.52252252252252,18.10810810810811,8.468468468468467,0.8108108108108109,0.09009009009009009
34,전북특별자치도,전주시완산구,중화산2동,중화산2동제3투,2223,1370,989,246,107,14,3,1359,11,853,72.77409860191317,18.101545253863137,7.873436350257543,1.030169242089772,0.22075055187637968
35,전북특별자치도,전주시완산구,중화산2동,중화산2동제4투,1523,978,721,182,62,7,1,973,5,545,74.10071942446042,18.705035971223023,6.3720452209660845,0.7194244604316548,0.10277492291880781
36,전북특별자치도,전주시완산구,평화1동,관내사전투표,5102,5102,4571,319,153,31,5,5079,23,0,89.99803110848592,6.2807639299074625,3.0124040165386887,0.610356369364048,0.09844457570387871
37,전북특별자치도,전주시완산구,평화1동,평화1동제1투,1558,849,618,174,40,15,1,848,1,709,72.87735849056604,20.5188679245283,4.716981132075472,1.7688679245283019,0.1179245283018868
38,전북특별자치도,전주시완산구,평화1동,평화1동제2투,1568,763,542,165,40,8,2,757,6,805,71.59841479524438,21.79656538969617,5.284015852047556,1.0568031704095113,0.26420079260237783
39,전북특별자치도,전주시완산구,평화1동,평화1동제3투,1780,1148,845,205,82,6,3,1141,7,632,74.0578439964943,17.96669588080631,7.186678352322525,0.5258545135845749,0.26292725679228746
40,전북특별자치도,전주시완산구,평화2동,관내사전투표,10407,10407,9345,554,407,58,9,10373,34,0,90.08965583726983,5.34078858575147,3.923647932131495,0.5591439313602622,0.08676371348693723
41,전북특별자치도,전주시완산구,평화2동,평화2동제1투,1413,846,584,189,55,11,2,841,5,567,69.44114149821641,22.473246135552913,6.539833531510107,1.3079667063020213,0.23781212841854932
42,전북특별자치도,전주시완산구,평화2동,평화2동제2투,2114,1374,1014,258,84,9,2,1367,7,740,74.17702999268471,18.873445501097294,6.144842721287491,0.6583760058522311,0.1463057790782736
43,전북특별자치도,전주시완산구,평화2동,평화2동제3투,1323,801,624,127,32,9,0,792,9,522,78.78787878787878,16.035353535353536,4.040404040404041,1.1363636363636365,0.0
44,전북특별자치도,전주시완산구,평화2동,평화2동제4투,2309,1756,1386,233,98,25,4,1746,10,553,79.38144329896907,13.344788087056129,5.612829324169531,1.43184421534937,0.22909507445589922
45,전북특별자치도,전주시완산구,평화2동,평화2동제5투,780,537,452,56,22,6,0,536,1,243,84.32835820895522,10.44776119402985,4.104477611940299,1.1194029850746268,0.0
46,전북특별자치도,전주시완산구,평화2동,평화2동제6투,2194,1631,1261,248,98,14,1,1622,9,563,77.74352651048089,15.289765721331689,6.041923551171394,0.8631319358816275,0.06165228113440197
47,전북특별자치도,전주시완산구,평화2동,평화2동제7투,1604,1143,868,194,60,18,0,1140,3,461,76.14035087719299,17.017543859649123,5.263157894736842,1.5789473684210527,0.0
48,전북특별자치도,전주시완산구,평화2동,평화2동제8투,2612,1887,1516,253,85,20,1,1875,12,725,80.85333333333334,13.493333333333332,4.533333333333333,1.0666666666666667,0.05333333333333334
49,전북특별자치도,전주시완산구,평화2동,평화2동제9투,2620,2013,1593,270,112,23,4,2002,11,607,79.57042957042957,13.486513486513488,5.594405594405594,1.1488511488511488,0.1998001998001998
50,전북특별자치도,전주시완산구,평화2동,평화2동제10투,1591,1259,998,154,80,17,1,1250,9,332,79.84,12.32,6.4,1.3599999999999999,0.08
51,전북특별자치도,전주시완산구,서신동,관내사전투표,9684,9679,8578,546,444,64,5,9637,42,5,89.01110304036526,5.665663588253606,4.607242917920515,0.664107087267822,0.05188336619279858
52,전북특별자치도,전주시완산구,서신동,서신동제1투,1283,839,590,169,66,9,0,834,5,444,70.74340527577938,20.26378896882494,7.913669064748201,1.079136690647482,0.0
53,전북특별자치도,전주시완산구,서신동,서신동제2투,1361,752,536,127,75,4,1,743,9,609,72.1399730820996,17.092866756393,10.094212651413189,0.5383580080753702,0.13458950201884254
54,전북특별자치도,전주시완산구,서신동,서신동제3투,910,626,421,139,53,8,0,621,5,284,67.7938808373591,22.383252818035427,8.53462157809984,1.288244766505636,0.0
55,전북특별자치도,전주시완산구,서신동,서신동제4투,2648,1990,1451,355,146,24,3,1979,11,658,73.31985851440122,17.938352703385547,7.377463365336029,1.2127337038908539,0.15159171298635674
56,전북특별자치도,전주시완산구,서신동,서신동제5투,1522,960,710,151,69,20,2,952,8,562,74.57983193277312,15.861344537815125,7.247899159663866,2.100840336134454,0.21008403361344538
57,전북특별자치도,전주시완산구,서신동,서신동제6투,1124,844,656,122,39,14,2,833,11,280,78.75150060024009,14.645858343337334,4.68187274909964,1.680672268907563,0.24009603841536614
58,전북특별자치도,전주시완산구,서신동,서신동제7투,1319,973,769,118,70,6,0,963,10,346,79.85462097611631,12.2533748701973,7.268951194184839,0.6230529595015576,0.0
59,전북특별자치도,전주시완산구,서신동,서신동제8투,2096,1600,1187,264,116,16,3,1586,14,496,74.84237074401008,16.64564943253468,7.3139974779319035,1.008827238335435,0.18915510718789408
60,전북특별자치도,전주시완산구,서신동,서신동제9투,1991,1581,1228,208,125,13,1,1575,6,410,77.96825396825396,13.206349206349207,7.936507936507936,0.8253968253968255,0.06349206349206349
61,전북특별자치도,전주시완산구,서신동,서신동제10투,2967,1901,1385,286,205,16,2,1894,7,1066,73.12565997888068,15.100316789862726,10.823653643083421,0.8447729672650475,0.10559662090813093
62,전북특별자치도,전주시완산구,삼천1동,관내사전투표,3671,3671,3256,252,124,17,4,3653,18,0,89.13222009307418,6.898439638653161,3.3944702983848893,0.46537092800437996,0.10949904188338351
63,전북특별자치도,전주시완산구,삼천1동,삼천1동제1투,997,537,372,117,33,7,1,530,7,460,70.18867924528301,22.07547169811321,6.226415094339623,1.3207547169811322,0.18867924528301888
64,전북특별자치도,전주시완산구,삼천1동,삼천1동제2투,2174,1497,1121,279,86,8,0,1494,3,677,75.0334672021419,18.67469879518072,5.756358768406962,0.535475234270415,0.0
65,전북특별자치도,전주시완산구,삼천1동,삼천1동제3투,1301,790,561,149,67,6,1,784,6,511,71.5561224489796,19.005102040816325,8.545918367346939,0.7653061224489796,0.12755102040816327
66,전북특별자치도,전주시완산구,삼천2동,관내사전투표,4503,4503,4055,259,149,19,4,4486,17,0,90.39233169861792,5.77351761034329,3.321444493981275,0.42353990191707536,0.08916629514043692
67,전북특별자치도,전주시완산구,삼천2동,삼천2동제1투,1213,659,473,122,45,9,0,649,10,554,72.88135593220339,18.798151001540834,6.933744221879815,1.386748844375963,0.0
68,전북특별자치도,전주시완산구,삼천2동,삼천2동제2투,937,552,422,82,33,12,0,549,3,385,76.86703096539162,14.93624772313297,6.0109289617486334,2.185792349726776,0.0
69,전북특별자치도,전주시완산구,삼천2동,삼천2동제3투,1782,1287,947,247,74,18,0,1286,1,495,73.63919129082426,19.206842923794714,5.7542768273716955,1.3996889580093312,0.0
70,전북특별자치도,전주시완산구,삼천2동,삼천2동제4투,1395,814,583,163,53,8,1,808,6,581,72.15346534653465,20.173267326732674,6.5594059405940595,0.9900990099009901,0.12376237623762376
71,전북특별자치도,전주시완산구,삼천3동,관내사전투표,7061,7061,6332,360,279,45,5,7021,40,0,90.1865831078194,5.127474718701039,3.973792906993306,0.6409343398376299,0.07121492664862555
72,전북특별자치도,전주시완산구,삼천3동,삼천3동제1투,1301,858,628,157,56,10,1,852,6,443,73.70892018779342,18.427230046948356,6.572769953051644,1.1737089201877933,0.11737089201877934
73,전북특별자치도,전주시완산구,삼천3동,삼천3동제2투,730,419,326,72,15,5,0,418,1,311,77.99043062200957,17.22488038277512,3.588516746411483,1.1961722488038278,0.0
74,전북특별자치도,전주시완산구,삼천3동,삼천3동제3투,1529,1056,805,169,67,12,1,1054,2,473,76.37571157495256,16.03415559772296,6.35673624288425,1.1385199240986716,0.09487666034155598
75,전북특별자치도,전주시완산구,삼천3동,삼천3동제4투,1614,1200,947,143,88,16,1,1195,5,414,79.2468619246862,11.96652719665272,7.364016736401674,1.3389121338912133,0.08368200836820083
76,전북특별자치도,전주시완산구,삼천3동,삼천3동제5투,1843,1223,938,218,44,13,3,1216,7,620,77.13815789473685,17.927631578947366,3.618421052631579,1.069078947368421,0.24671052631578946
77,전북특별자치도,전주시완산구,삼천3동,삼천3동제6투,1568,1135,862,164,88,14,1,1129,6,433,76.35075287865367,14.526129317980512,7.7945084145261285,1.2400354295837024,0.08857395925597875
78,전북특별자치도,전주시완산구,효자1동,관내사전투표,4814,4814,4261,350,146,28,4,4789,25,0,88.97473376487784,7.308415117978702,3.048653163499687,0.5846732094382961,0.08352474420547087
79,전북특별자치도,전주시완산구,효자1동,효자1동제1투,1508,925,651,198,54,16,2,921,4,583,70.68403908794788,21.49837133550489,5.863192182410423,1.737242128121607,0.21715526601520088
80,전북특별자치도,전주시완산구,효자1동,효자1동제2투,1265,694,499,145,36,9,3,692,2,571,72.10982658959537,20.953757225433524,5.202312138728324,1.300578034682081,0.4335260115606936
81,전북특별자치도,전주시완산구,효자1동,효자1동제3투,2361,1692,1259,305,93,21,3,1681,11,669,74.89589530041641,18.14396192742415,5.532421177870315,1.2492563950029745,0.1784651992861392
82,전북특별자치도,전주시완산구,효자2동,관내사전투표,3837,3837,3357,242,183,25,6,3813,24,0,88.04091266719118,6.346708628376605,4.799370574350905,0.6556517178075006,0.15735641227380015
83,전북특별자치도,전주시완산구,효자2동,효자2동제1투,1675,1142,813,249,68,4,1,1135,7,533,71.62995594713657,21.938325991189426,5.991189427312775,0.3524229074889868,0.0881057268722467
84,전북특별자치도,전주시완산구,효자2동,효자2동제2투,970,628,457,118,40,8,0,623,5,342,73.35473515248796,18.940609951845907,6.420545746388442,1.2841091492776886,0.0
85,전북특별자치도,전주시완산구,효자2동,효자2동제3투,1383,792,511,191,73,9,2,786,6,591,65.01272264631042,24.30025445292621,9.287531806615776,1.1450381679389312,0.2544529262086514
86,전북특별자치도,전주시완산구,효자3동,관내사전투표,5732,5732,5049,361,252,40,11,5713,19,0,88.3773849116051,6.318921757395414,4.410992473306494,0.7001575354454752,0.1925433222475057
87,전북특별자치도,전주시완산구,효자3동,효자3동제1투,1133,724,464,188,58,6,0,716,8,409,64.80446927374301,26.256983240223462,8.100558659217876,0.8379888268156425,0.0
88,전북특별자치도,전주시완산구,효자3동,효자3동제2투,1702,1176,868,213,72,10,4,1167,9,526,74.37874892887746,18.251928020565554,6.169665809768637,0.8568980291345331,0.34275921165381323
89,전북특별자치도,전주시완산구,효자3동,효자3동제3투,1556,1057,783,185,65,15,1,1049,8,499,74.64251668255481,17.63584366062917,6.196377502383222,1.4299332697807436,0.09532888465204957
90,전북특별자치도,전주시완산구,효자3동,효자3동제4투,1392,995,761,152,63,14,1,991,4,397,76.79112008072654,15.338042381432896,6.357214934409687,1.4127144298688195,0.10090817356205853
91,전북특별자치도,전주시완산구,효자4동,관내사전투표,7712,7712,6790,412,404,68,9,7683,29,0,88.37693609267212,5.362488611219575,5.25836261876871,0.8850709358323572,0.11714174150722373
92,전북특별자치도,전주시완산구,효자4동,효자4동제1투,1294,846,543,220,67,11,0,841,5,448,64.56599286563615,26.159334126040427,7.966706302021404,1.3079667063020213,0.0
93,전북특별자치도,전주시완산구,효자4동,효자4동제2투,2548,1869,1254,393,191,24,2,1864,5,679,67.27467811158799,21.083690987124466,10.246781115879829,1.2875536480686696,0.1072961373390558
94,전북특별자치도,전주시완산구,효자4동,효자4동제3투,1518,1051,798,179,62,8,0,1047,4,467,76.21776504297995,17.096466093600764,5.921680993314231,0.7640878701050621,0.0
95,전북특별자치도,전주시완산구,효자4동,효자4동제4투,1489,1040,768,184,67,15,2,1036,4,449,74.13127413127413,17.760617760617762,6.467181467181467,1.4478764478764479,0.19305019305019305
96,전북특별자치도,전주시완산구,효자4동,효자4동제5투,2096,1399,983,236,155,13,5,1392,7,697,70.61781609195403,16.954022988505745,11.135057471264368,0.9339080459770116,0.35919540229885055
97,전북특별자치도,전주시완산구,효자4동,효자4동제6투,634,313,214,62,26,3,2,307,6,321,69.70684039087948,20.195439739413683,8.469055374592834,0.9771986970684038,0.6514657980456027
98,전북특별자치도,전주시완산구,효자4동,효자4동제7투,2559,1716,1293,254,135,16,1,1699,17,843,76.1035903472631,14.949970570924073,7.9458505002942905,0.9417304296645085,0.05885815185403178
99,전북특별자치도,전주시완산구,효자4동,효자4동제8투,1918,1516,1177,199,121,11,3,1511,5,402,77.89543348775645,13.17008603573792,8.007941760423561,0.727994705493051,0.1985440105890139
100,전북특별자치도,전주시완산구,효자4동,효자4동제9투,2632,2027,1533,312,155,18,0,2018,9,605,75.96630327056492,15.460852329038651,7.680872150644202,0.8919722497522299,0.0
101,전북특별자치도,전주시완산구,효자5동,관내사전투표,8896,8896,7449,582,714,87,8,8840,56,0,84.26470588235294,6.58371040723982,8.076923076923077,0.9841628959276018,0.09049773755656108
102,전북특별자치도,전주시완산구,효자5동,효자5동제1투,2666,1592,1066,339,154,16,5,1580,12,1074,67.46835443037975,21.455696202531644,9.746835443037975,1.0126582278481013,0.31645569620253167
103,전북특별자치도,전주시완산구,효자5동,효자5동제2투,2741,1550,988,318,207,20,1,1534,16,1191,64.40677966101694,20.73011734028683,13.494132985658409,1.303780964797914,0.0651890482398957
104,전북특별자치도,전주시완산구,효자5동,효자5동제3투,1685,807,530,181,77,12,0,800,7,878,66.25,22.625,9.625,1.5,0.0
105,전북특별자치도,전주시완산구,효자5동,효자5동제4투,2869,1640,1116,306,186,19,2,1629,11,1229,68.50828729281768,18.784530386740332,11.41804788213628,1.1663597298956414,0.12277470841006752
106,전북특별자치도,전주시완산구,효자5동,효자5동제5투,2069,1507,1037,300,139,16,2,1494,13,562,69.41097724230254,20.080321285140563,9.30388219544846,1.07095046854083,0.13386880856760375
107,전북특별자치도,전주시완산구,효자5동,효자5동제6투,2651,2061,1620,264,128,37,3,2052,9,590,78.94736842105263,12.865497076023392,6.237816764132553,1.8031189083820662,0.14619883040935672
108,전북특별자치도,전주시완산구,효자5동,효자5동제7투,2691,1853,1370,315,144,18,0,1847,6,838,74.17433676231727,17.05468327016784,7.796426637791012,0.9745533297238765,0.0
109,전북특별자치도,전주시완산구,잘못 투입·구분된 투표지,,0,17,15,0,1,1,0,17,0,-17,88.23529411764706,0.0,5.88235294117647,5.88235294117647,0.0
0,전북특별자치도,전주시덕진구,거소·선상투표,,539,508,356,62,68,5,3,494,14,31,72.06477732793523,12.550607287449392,13.765182186234817,1.0121457489878543,0.6072874493927125
1,전북특별자치도,전주시덕진구,관외사전투표,,37393,37383,30320,2734,3646,358,41,37099,284,10,81.72727027682687,7.369470875225748,9.82775816059732,0.964985579126122,0.11051510822394134
2,전북특별자치도,전주시덕진구,재외투표,,1055,898,708,92,84,7,0,891,7,157,79.46127946127946,10.32547699214366,9.427609427609427,0.7856341189674524,0.0
3,전북특별자치도,전주시덕진구,진북동,관내사전투표,5080,5080,4363,435,209,45,4,5056,24,0,86.29351265822784,8.603639240506329,4.13370253164557,0.8900316455696203,0.07911392405063292
4,전북특별자치도,전주시덕진구,진북동,진북동제1투,1214,652,508,109,21,8,0,646,6,562,78.63777089783281,16.873065015479877,3.2507739938080498,1.238390092879257,0.0
5,전북특별자치도,전주시덕진구,진북동,진북동제2투,1798,1058,736,232,71,13,2,1054,4,740,69.8292220113852,22.011385199240987,6.7362428842504745,1.2333965844402277,0.18975332068311196
6,전북특별자치도,전주시덕진구,진북동,진북동제3투,1175,813,627,140,38,5,1,811,2,362,77.31196054254006,17.26263871763255,4.68557336621455,0.6165228113440198,0.12330456226880394
7,전북특별자치도,전주시덕진구,진북동,진북동제4투,1262,846,573,206,56,6,0,841,5,416,68.13317479191439,24.494649227110582,6.658739595719382,0.713436385255648,0.0
8,전북특별자치도,전주시덕진구,인후1동,관내사전투표,5995,5995,5209,469,250,33,4,5965,30,0,87.32606873428333,7.862531433361274,4.191114836546522,0.5532271584241408,0.06705783738474434
9,전북특별자치도,전주시덕진구,인후1동,인후1동제1투,1716,953,666,194,71,8,4,943,10,763,70.62566277836692,20.572640509013787,7.529162248144221,0.8483563096500532,0.4241781548250266
10,전북특별자치도,전주시덕진구,인후1동,인후1동제2투,1481,969,726,160,52,20,2,960,9,512,75.625,16.666666666666664,5.416666666666667,2.083333333333333,0.20833333333333334
11,전북특별자치도,전주시덕진구,인후1동,인후1동제3투,1680,1171,860,212,75,16,1,1164,7,509,73.8831615120275,18.213058419243985,6.443298969072164,1.3745704467353952,0.0859106529209622
12,전북특별자치도,전주시덕진구,인후1동,인후1동제4투,1846,1322,911,263,108,23,4,1309,13,524,69.59511077158136,20.091673032849503,8.25057295645531,1.757066462948816,0.30557677616501144
13,전북특별자치도,전주시덕진구,인후2동,관내사전투표,3113,3113,2701,229,138,27,3,3098,15,0,87.18528082633958,7.391865719819238,4.454486765655261,0.8715300193673339,0.09683666881859264
14,전북특별자치도,전주시덕진구,인후2동,인후2동제1투,1210,786,589,145,39,7,0,780,6,424,75.51282051282051,18.58974358974359,5.0,0.8974358974358974,0.0
15,전북특별자치도,전주시덕진구,인후2동,인후2동제2투,818,415,299,86,24,4,2,415,0,403,72.04819277108435,20.722891566265062,5.783132530120482,0.9638554216867471,0.48192771084337355
16,전북특별자치도,전주시덕진구,인후2동,인후2동제3투,1327,773,583,129,50,6,0,768,5,554,75.91145833333334,16.796875,6.510416666666667,0.78125,0.0
17,전북특별자치도,전주시덕진구,인후2동,인후2동제4투,1551,1071,775,199,87,7,0,1068,3,480,72.56554307116106,18.632958801498127,8.146067415730338,0.6554307116104869,0.0
18,전북특별자치도,전주시덕진구,인후3동,관내사전투표,6915,6915,6233,341,264,44,3,6885,30,0,90.53013798111837,4.95279593318809,3.8344226579520697,0.6390704429920117,0.04357298474945533
19,전북특별자치도,전주시덕진구,인후3동,인후3동제1투,1869,874,605,170,73,13,0,861,13,995,70.267131242741,19.744483159117305,8.478513356562138,1.5098722415795587,0.0
20,전북특별자치도,전주시덕진구,인후3동,인후3동제2투,1623,976,725,165,68,15,0,973,3,647,74.51181911613565,16.95786228160329,6.98869475847893,1.5416238437821173,0.0
21,전북특별자치도,전주시덕진구,인후3동,인후3동제3투,1827,1157,874,176,80,12,3,1145,12,670,76.33187772925764,15.37117903930131,6.986899563318777,1.0480349344978166,0.26200873362445415
22,전북특별자치도,전주시덕진구,인후3동,인후3동제4투,1705,1240,952,204,65,12,1,1234,6,465,77.14748784440843,16.53160453808752,5.26742301458671,0.9724473257698543,0.08103727714748785
23,전북특별자치도,전주시덕진구,인후3동,인후3동제5투,2083,1472,1141,198,108,13,0,1460,12,611,78.15068493150686,13.561643835616438,7.397260273972603,0.8904109589041096,0.0
24,전북특별자치도,전주시덕진구,인후3동,인후3동제6투,2011,1384,1119,157,81,18,1,1376,8,627,81.32267441860465,11.409883720930232,5.886627906976744,1.308139534883721,0.07267441860465117
25,전북특별자치도,전주시덕진구,인후3동,인후3동제7투,1704,777,534,181,51,7,2,775,2,927,68.90322580645162,23.35483870967742,6.580645161290323,0.903225806451613,0.25806451612903225
26,전북특별자치도,전주시덕진구,덕진동,관내사전투표,6643,6643,4929,570,1000,87,3,6589,54,0,74.8064956746092,8.650781605706479,15.176809834572772,1.3203824556078314,0.045530429503718314
27,전북특별자치도,전주시덕진구,덕진동,덕진동제1투,1849,1075,590,295,157,9,2,1053,22,774,56.0303893637227,28.01519468186135,14.909781576448244,0.8547008547008548,0.1899335232668566
28,전북특별자치도,전주시덕진구,덕진동,덕진동제2투,1559,997,695,201,80,11,1,988,9,562,70.34412955465586,20.344129554655872,8.097165991902834,1.1133603238866396,0.10121457489878542
29,전북특별자치도,전주시덕진구,덕진동,덕진동제3투,1868,1196,868,212,97,10,2,1189,7,672,73.00252312867957,17.830109335576115,8.15811606391926,0.8410428931875525,0.16820857863751051
30,전북특별자치도,전주시덕진구,덕진동,덕진동제4투,2221,1447,1081,221,110,25,0,1437,10,774,75.22616562282532,15.379262352122478,7.6548364648573415,1.7397355601948505,0.0
31,전북특별자치도,전주시덕진구,덕진동,덕진동제5투,2510,2013,1605,239,130,21,0,1995,18,497,80.45112781954887,11.979949874686717,6.516290726817042,1.0526315789473684,0.0
32,전북특별자치도,전주시덕진구,금암동,관내사전투표,4066,4066,3566,273,170,25,4,4038,28,0,88.31104507181773,6.760772659732541,4.210004952947004,0.6191183754333829,0.09905894006934125
33,전북특별자치도,전주시덕진구,금암동,금암동제1투,1957,1182,728,251,174,19,1,1173,9,775,62.063086104006814,21.398124467178175,14.83375959079284,1.619778346121057,0.08525149190110827
34,전북특별자치도,전주시덕진구,금암동,금암동제2투,2280,1437,805,353,241,20,2,1421,16,843,56.65024630541872,24.841660802251937,16.959887403237158,1.4074595355383532,0.14074595355383532
35,전북특별자치도,전주시덕진구,금암동,금암동제3투,1106,596,433,114,36,10,1,594,2,510,72.89562289562289,19.19191919191919,6.0606060606060606,1.6835016835016834,0.16835016835016833
36,전북특별자치도,전주시덕진구,금암동,금암동제4투,1546,1009,703,214,76,15,0,1008,1,537,69.7420634920635,21.23015873015873,7.5396825396825395,1.488095238095238,0.0
37,전북특별자치도,전주시덕진구,금암동,금암동제5투,1228,692,416,183,79,9,3,690,2,536,60.28985507246377,26.521739130434785,11.44927536231884,1.3043478260869565,0.43478260869565216
38,전북특별자치도,전주시덕진구,팔복동,관내사전투표,3883,3883,3446,217,174,24,2,3863,20,0,89.20528086979031,5.6173958063681075,4.504271291742169,0.6212787988609888,0.05177323323841575
39,전북특별자치도,전주시덕진구,팔복동,팔복동제1투,1077,560,394,119,38,7,0,558,2,517,70.60931899641577,21.32616487455197,6.810035842293908,1.2544802867383513,0.0
40,전북특별자치도,전주시덕진구,팔복동,팔복동제2투,1614,1021,824,133,47,9,3,1016,5,593,81.10236220472441,13.090551181102361,4.625984251968504,0.8858267716535433,0.2952755905511811
41,전북특별자치도,전주시덕진구,팔복동,팔복동제3투,776,458,288,100,65,3,0,456,2,318,63.1578947368421,21.929824561403507,14.25438596491228,0.6578947368421052,0.0
42,전북특별자치도,전주시덕진구,우아1동,관내사전투표,4035,4035,3523,264,200,32,3,4022,13,0,87.59323719542516,6.5638985579313776,4.972650422675286,0.7956240676280457,0.07458975634012929
43,전북특별자치도,전주시덕진구,우아1동,우아1동제1투,1426,827,562,201,51,8,1,823,4,599,68.28675577156743,24.4228432563791,6.1968408262454435,0.9720534629404617,0.12150668286755771
44,전북특별자치도,전주시덕진구,우아1동,우아1동제2투,2023,1421,1053,241,105,14,2,1415,6,602,74.41696113074205,17.031802120141343,7.420494699646643,0.9893992932862191,0.1413427561837456
45,전북특별자치도,전주시덕진구,우아1동,우아1동제3투,1253,635,422,132,70,6,1,631,4,618,66.87797147385103,20.91917591125198,11.09350237717908,0.9508716323296356,0.15847860538827258
46,전북특별자치도,전주시덕진구,우아2동,관내사전투표,5650,5650,5073,322,190,44,3,5632,18,0,90.07457386363636,5.717329545454546,3.3735795454545454,0.78125,0.05326704545454545
47,전북특별자치도,전주시덕진구,우아2동,우아2동제1투,1355,941,715,159,44,12,2,932,9,414,76.71673819742489,17.06008583690987,4.721030042918455,1.2875536480686696,0.2145922746781116
48,전북특별자치도,전주시덕진구,우아2동,우아2동제2투,1986,962,700,177,64,9,1,951,11,1024,73.60672975814931,18.61198738170347,6.729758149316509,0.9463722397476341,0.10515247108307045
49,전북특별자치도,전주시덕진구,우아2동,우아2동제3투,404,283,231,37,10,1,3,282,1,121,81.91489361702128,13.120567375886525,3.546099290780142,0.3546099290780142,1.0638297872340425
50,전북특별자치도,전주시덕진구,우아2동,우아2동제4투,2464,1252,943,221,74,6,1,1245,7,1212,75.7429718875502,17.751004016064257,5.943775100401607,0.48192771084337355,0.08032128514056225
51,전북특별자치도,전주시덕진구,호성동,관내사전투표,6059,6059,5450,304,246,36,5,6041,18,0,90.21685151464989,5.032279423936434,4.0721734812117205,0.5959278265187883,0.08276775368316504
52,전북특별자치도,전주시덕진구,호성동,호성동제1투,588,376,296,56,18,1,1,372,4,212,79.56989247311827,15.053763440860216,4.838709677419355,0.2688172043010753,0.2688172043010753
53,전북특별자치도,전주시덕진구,호성동,호성동제2투,2688,1924,1478,301,112,20,2,1913,11,764,77.26084683742812,15.734448510193413,5.854678515420805,1.0454783063251438,0.10454783063251437
54,전북특별자치도,전주시덕진구,호성동,호성동제3투,2441,1706,1361,239,81,16,1,1698,8,735,80.15312131919906,14.075382803297998,4.770318021201414,0.9422850412249705,0.058892815076560655
55,전북특별자치도,전주시덕진구,호성동,호성동제4투,1952,1425,993,314,101,9,3,1420,5,527,69.92957746478872,22.112676056338028,7.112676056338028,0.6338028169014085,0.21126760563380279
56,전북특별자치도,전주시덕진구,송천1동,관내사전투표,9394,9394,8165,507,593,83,7,9355,39,0,87.27952966328166,5.419561731694281,6.338856226616782,0.8872260823089256,0.07482629609834314
57,전북특별자치도,전주시덕진구,송천1동,송천1동제1투,1813,1262,923,223,88,18,3,1255,7,551,73.54581673306772,17.768924302788843,7.011952191235061,1.4342629482071714,0.2390438247011952
58,전북특별자치도,전주시덕진구,송천1동,송천1동제2투,1776,1252,966,188,75,12,2,1243,9,524,77.71520514883346,15.12469831053902,6.033789219629927,0.9654062751407884,0.16090104585679807
59,전북특별자치도,전주시덕진구,송천1동,송천1동제3투,1949,1335,1000,219,93,11,2,1325,10,614,75.47169811320755,16.528301886792455,7.018867924528302,0.8301886792452831,0.1509433962264151
60,전북특별자치도,전주시덕진구,송천1동,송천1동제4투,2020,1518,1150,242,96,15,1,1504,14,502,76.4627659574468,16.090425531914892,6.382978723404255,0.9973404255319149,0.06648936170212766
61,전북특별자치도,전주시덕진구,송천1동,송천1동제5투,2072,1693,1329,201,131,19,3,1683,10,379,78.96613190730838,11.942959001782532,7.78371954842543,1.1289364230540702,0.17825311942959002
62,전북특별자치도,전주시덕진구,송천1동,송천1동제6투,2404,1880,1435,266,143,23,0,1867,13,524,76.86127477236208,14.24745581146224,7.659346545259775,1.2319228709159078,0.0
63,전북특별자치도,전주시덕진구,송천1동,송천1동제7투,2176,1603,1232,236,113,13,3,1597,6,573,77.14464621164684,14.777708202880401,7.075767063243582,0.8140262993112084,0.18785222291797118
64,전북특별자치도,전주시덕진구,송천1동,송천1동제8투,2396,1961,1529,249,144,20,5,1947,14,435,78.53107344632768,12.788906009244993,7.395993836671804,1.027221366204417,0.25680534155110424
65,전북특별자치도,전주시덕진구,송천1동,송천1동제9투,3021,2294,1684,356,213,24,4,2281,13,727,73.82726874177992,15.607189829022358,9.33800964489259,1.052170100832968,0.17536168347216133
66,전북특별자치도,전주시덕진구,송천1동,송천1동제10투,2341,1767,1339,273,130,21,0,1763,4,574,75.95008508224616,15.484968803176406,7.37379466817924,1.191151446398185,0.0
67,전북특별자치도,전주시덕진구,송천1동,송천1동제11투,2079,1486,1062,280,119,14,3,1478,8,593,71.85385656292287,18.944519621109606,8.051420838971584,0.9472259810554804,0.20297699594046006
68,전북특별자치도,전주시덕진구,송천1동,송천1동제12투,2612,2073,1576,289,179,21,1,2066,7,539,76.28267182962246,13.98838334946757,8.66408518877057,1.016456921587609,0.0484027105517909
69,전북특별자치도,전주시덕진구,송천2동,관내사전투표,11540,11540,10295,604,511,76,10,11496,44,0,89.55288796102992,5.254001391788448,4.445024356297843,0.6610995128740431,0.08698677800974253
70,전북특별자치도,전주시덕진구,송천2동,송천2동제1투,1442,914,697,133,70,10,0,910,4,528,76.5934065934066,14.615384615384617,7.6923076923076925,1.098901098901099,0.0
71,전북특별자치도,전주시덕진구,송천2동,송천2동제2투,1544,1171,913,173,65,12,2,1165,6,373,78.36909871244634,14.84978540772532,5.579399141630901,1.0300429184549356,0.17167381974248927
72,전북특별자치도,전주시덕진구,송천2동,송천2동제3투,1231,834,601,169,47,9,1,827,7,397,72.67230955259976,20.435308343409915,5.683192261185006,1.0882708585247884,0.12091898428053204
73,전북특별자치도,전주시덕진구,송천2동,송천2동제4투,1415,972,728,177,52,10,0,967,5,443,75.28438469493278,18.304033092037226,5.377456049638056,1.0341261633919339,0.0
74,전북특별자치도,전주시덕진구,송천2동,송천2동제5투,2380,1777,1311,312,119,20,2,1764,13,603,74.31972789115646,17.687074829931973,6.746031746031746,1.1337868480725624,0.11337868480725624
75,전북특별자치도,전주시덕진구,송천2동,송천2동제6투,1172,802,628,106,45,15,1,795,7,370,78.9937106918239,13.333333333333334,5.660377358490567,1.8867924528301887,0.12578616352201258
76,전북특별자치도,전주시덕진구,송천2동,송천2동제7투,1789,1204,853,232,86,21,0,1192,12,585,71.56040268456377,19.463087248322147,7.2147651006711415,1.761744966442953,0.0
77,전북특별자치도,전주시덕진구,조촌동,관내사전투표,4939,4939,4423,257,199,34,8,4921,18,0,89.88010566957936,5.222515748831539,4.043893517577728,0.6909164803901646,0.1625685836212152
78,전북특별자치도,전주시덕진구,조촌동,조촌동제1투,1735,1071,783,186,80,9,1,1059,12,664,73.93767705382436,17.56373937677054,7.554296506137866,0.84985835694051,0.09442870632672333
79,전북특별자치도,전주시덕진구,조촌동,조촌동제2투,2379,1526,1154,245,98,19,1,1517,9,853,76.07119314436387,16.150296638101516,6.460118655240607,1.2524719841793013,0.06591957811470006
80,전북특별자치도,전주시덕진구,조촌동,조촌동제3투,753,458,368,61,21,5,0,455,3,295,80.87912087912088,13.406593406593407,4.615384615384616,1.098901098901099,0.0
81,전북특별자치도,전주시덕진구,여의동,관내사전투표,5242,5242,4648,312,215,38,4,5217,25,0,89.09334866781676,5.980448533640023,4.12114241901476,0.7283879624305156,0.07667241709794902
82,전북특별자치도,전주시덕진구,여의동,여의동제1투,1592,946,646,199,79,14,1,939,7,646,68.79659211927583,21.19275825346113,8.413205537806178,1.4909478168264112,0.10649627263045794
83,전북특별자치도,전주시덕진구,여의동,여의동제2투,1469,972,721,163,69,11,1,965,7,497,74.71502590673576,16.89119170984456,7.1502590673575135,1.1398963730569949,0.10362694300518134
84,전북특별자치도,전주시덕진구,여의동,여의동제3투,2010,1318,1018,189,84,14,3,1308,10,692,77.82874617737004,14.449541284403669,6.422018348623854,1.0703363914373087,0.22935779816513763
85,전북특별자치도,전주시덕진구,여의동,여의동제4투,901,688,532,99,39,13,0,683,5,213,77.89165446559298,14.494875549048317,5.710102489019034,1.903367496339678,0.0
86,전북특별자치도,전주시덕진구,여의동,여의동제5투,808,641,469,105,53,9,1,637,4,167,73.62637362637363,16.483516483516482,8.320251177394034,1.4128728414442702,0.15698587127158556
87,전북특별자치도,전주시덕진구,혁신동,관내사전투표,7739,7739,6620,520,493,80,2,7715,24,0,85.80686973428386,6.740116655865197,6.390149060272197,1.0369410239792611,0.025923525599481533
88,전북특별자치도,전주시덕진구,혁신동,혁신동제1투,2730,2029,1396,413,169,28,7,2013,16,701,69.34923000496771,20.516641828117237,8.395429706905116,1.3909587680079483,0.34773969200198707
89,전북특별자치도,전주시덕진구,혁신동,혁신동제2투,1892,1302,937,233,110,14,1,1295,7,590,72.35521235521234,17.99227799227799,8.494208494208493,1.0810810810810811,0.07722007722007722
90,전북특별자치도,전주시덕진구,혁신동,혁신동제3투,1783,1440,1091,220,91,29,0,1431,9,343,76.24039133473096,15.373864430468204,6.359189378057302,2.026554856743536,0.0
91,전북특별자치도,전주시덕진구,혁신동,혁신동제4투,2385,1864,1337,326,175,12,1,1851,13,521,72.2312263641275,17.612101566720693,9.45434900054025,0.6482982171799028,0.05402485143165856
92,전북특별자치도,전주시덕진구,혁신동,혁신동제5투,2542,2045,1561,283,165,24,2,2035,10,497,76.70761670761671,13.906633906633905,8.108108108108109,1.1793611793611793,0.09828009828009827
93,전북특별자치도,전주시덕진구,혁신동,혁신동제6투,1771,1383,1047,208,99,21,1,1376,7,388,76.09011627906976,15.11627906976744,7.194767441860465,1.5261627906976742,0.07267441860465117
94,전북특별자치도,전주시덕진구,잘못 투입·구분된 투표지,,0,0,0,0,0,0,0,0,0,0,0.0,0.0,0.0,0.0,0.0
0,전북특별자치도,군산시,거소·선상투표,,501,470,321,56,67,3,3,450,20,31,71.33333333333334,12.444444444444445,14.888888888888888,0.6666666666666667,0.6666666666666667
1,전북특별자치도,군산시,관외사전투표,,16582,16580,12517,1833,1912,142,22,16426,154,2,76.20236210885182,11.159137952027272,11.640082795568002,0.8644831364909291,0.13393400706197492
2,전북특별자치도,군산시,재외투표,,809,659,527,72,47,11,0,657,2,150,80.2130898021309,10.95890410958904,7.15372907153729,1.67427701674277,0.0
3,전북특별자치도,군산시,옥구읍,관내사전투표,1726,1726,1537,116,52,10,2,1717,9,0,89.51659871869539,6.75596971461852,3.0285381479324402,0.5824111822947,0.11648223645894001
4,전북특별자치도,군산시,옥구읍,옥구읍투표소,1111,570,418,121,22,3,1,565,5,541,73.98230088495575,21.415929203539825,3.893805309734513,0.5309734513274336,0.17699115044247787
5,전북특별자치도,군산시,옥산면,관내사전투표,2321,2321,2074,148,83,10,0,2315,6,0,89.58963282937366,6.393088552915767,3.5853131749460045,0.4319654427645789,0.0
6,전북특별자치도,군산시,옥산면,옥산면투표소,1576,954,701,187,48,13,1,950,4,622,73.78947368421052,19.68421052631579,5.052631578947368,1.368421052631579,0.10526315789473684
7,전북특별자치도,군산시,회현면,관내사전투표,1344,1344,1218,81,23,10,3,1335,9,0,91.23595505617978,6.067415730337078,1.7228464419475655,0.7490636704119851,0.22471910112359553
8,전북특별자치도,군산시,회현면,회현면투표소,971,521,385,114,11,5,0,515,6,450,74.75728155339806,22.135922330097088,2.1359223300970873,0.9708737864077669,0.0
9,전북특별자치도,군산시,임피면,관내사전투표,1484,1484,1340,79,39,7,3,1468,16,0,91.28065395095368,5.381471389645776,2.656675749318801,0.4768392370572207,0.20435967302452315
10,전북특별자치도,군산시,임피면,임피면투표소,828,417,306,97,9,2,1,415,2,411,73.73493975903614,23.373493975903614,2.1686746987951806,0.48192771084337355,0.24096385542168677
11,전북특별자치도,군산시,서수면,관내사전투표,1077,1077,961,70,33,8,3,1075,2,0,89.3953488372093,6.511627906976744,3.0697674418604652,0.7441860465116279,0.27906976744186046
12,전북특별자치도,군산시,서수면,서수면투표소,956,526,361,132,27,2,1,523,3,430,69.02485659655831,25.239005736137663,5.162523900573614,0.3824091778202677,0.19120458891013384
13,전북특별자치도,군산시,대야면,관내사전투표,2571,2571,2251,202,91,8,4,2556,15,0,88.06729264475743,7.902973395931142,3.560250391236307,0.3129890453834116,0.1564945226917058
14,전북특별자치도,군산시,대야면,대야면투표소,1625,786,577,170,26,6,0,779,7,839,74.06931964056483,21.822849807445444,3.3376123234916557,0.7702182284980745,0.0
15,전북특별자치도,군산시,개정면,관내사전투표,1128,1128,1005,93,22,4,0,1124,4,0,89.41281138790036,8.274021352313166,1.9572953736654803,0.3558718861209964,0.0
16,전북특별자치도,군산시,개정면,개정면투표소,1080,619,453,130,29,1,3,616,3,461,73.53896103896103,21.1038961038961,4.707792207792208,0.16233766233766234,0.487012987012987
17,전북특별자치도,군산시,성산면,관내사전투표,1719,1719,1506,143,52,9,2,1712,7,0,87.96728971962617,8.352803738317757,3.0373831775700935,0.5257009345794392,0.11682242990654204
18,전북특별자치도,군산시,성산면,성산면투표소,982,589,428,126,29,3,1,587,2,393,72.91311754684838,21.465076660988075,4.940374787052811,0.5110732538330494,0.17035775127768313
19,전북특별자치도,군산시,나포면,관내사전투표,1066,1066,946,70,26,8,0,1050,16,0,90.0952380952381,6.666666666666667,2.4761904761904763,0.7619047619047619,0.0
20,전북특별자치도,군산시,나포면,나포면투표소,777,405,301,84,12,3,1,401,4,372,75.06234413965088,20.947630922693268,2.9925187032418954,0.7481296758104738,0.24937655860349126
21,전북특별자치도,군산시,옥도면,관내사전투표,356,356,320,26,9,0,0,355,1,0,90.14084507042254,7.323943661971831,2.535211267605634,0.0,0.0
22,전북특별자치도,군산시,옥도면,옥도면제1투,204,137,128,8,1,0,0,137,0,67,93.43065693430657,5.839416058394161,0.7299270072992701,0.0,0.0
23,전북특별자치도,군산시,옥도면,옥도면제2투,477,327,279,38,6,1,0,324,3,150,86.11111111111111,11.728395061728394,1.8518518518518516,0.30864197530864196,0.0
24,전북특별자치도,군산시,옥도면,옥도면제3투,242,152,143,5,3,0,1,152,0,90,94.07894736842105,3.289473684210526,1.9736842105263157,0.0,0.6578947368421052
25,전북특별자치도,군산시,옥도면,옥도면제4투,67,39,33,2,2,0,1,38,1,28,86.8421052631579,5.263157894736842,5.263157894736842,0.0,2.631578947368421
26,전북특별자치도,군산시,옥도면,옥도면제5투,126,88,73,13,0,1,1,88,0,38,82.95454545454545,14.772727272727273,0.0,1.1363636363636365,1.1363636363636365
27,전북특별자치도,군산시,옥도면,옥도면제6투,45,30,26,3,1,0,0,30,0,15,86.66666666666667,10.0,3.3333333333333335,0.0,0.0
28,전북특별자치도,군산시,옥도면,옥도면제7투,85,51,46,5,0,0,0,51,0,34,90.19607843137256,9.803921568627452,0.0,0.0,0.0
29,전북특별자치도,군산시,옥도면,옥도면제8투,27,20,12,6,2,0,0,20,0,7,60.0,30.0,10.0,0.0,0.0
30,전북특별자치도,군산시,옥도면,옥도면제9투,152,83,70,13,0,0,0,83,0,69,84.33734939759037,15.66265060240964,0.0,0.0,0.0
31,전북특별자치도,군산시,옥서면,관내사전투표,1926,1926,1668,141,91,13,3,1916,10,0,87.05636743215031,7.359081419624217,4.749478079331942,0.6784968684759917,0.15657620041753653
32,전북특별자치도,군산시,옥서면,옥서면투표소,950,490,350,97,33,5,0,485,5,460,72.16494845360825,20.0,6.804123711340206,1.0309278350515463,0.0
33,전북특별자치도,군산시,해신동,관내사전투표,1642,1642,1462,110,50,13,1,1636,6,0,89.3643031784841,6.723716381418093,3.056234718826406,0.7946210268948656,0.061124694376528114
34,전북특별자치도,군산시,해신동,해신동투표소,839,451,313,110,20,5,1,449,2,388,69.71046770601336,24.4988864142539,4.4543429844097995,1.1135857461024499,0.22271714922048996
35,전북특별자치도,군산시,월명동,관내사전투표,2460,2460,2148,209,77,15,3,2452,8,0,87.60195758564437,8.523654159869494,3.1402936378466557,0.6117455138662317,0.12234910277324632
36,전북특별자치도,군산시,월명동,월명동제1투,949,491,300,157,27,3,0,487,4,458,61.601642710472284,32.238193018480494,5.544147843942506,0.6160164271047228,0.0
37,전북특별자치도,군산시,월명동,월명동제2투,1062,656,465,157,26,2,1,651,5,406,71.42857142857143,24.11674347158218,3.9938556067588324,0.30721966205837176,0.15360983102918588
38,전북특별자치도,군산시,삼학동,관내사전투표,3735,3735,3281,310,97,20,4,3712,23,0,88.38900862068965,8.351293103448276,2.613146551724138,0.5387931034482759,0.10775862068965517
39,전북특별자치도,군산시,삼학동,삼학동투표소,2072,1119,787,268,45,10,1,1111,8,953,70.83708370837084,24.122412241224122,4.05040504050405,0.9000900090009001,0.09000900090009001
40,전북특별자치도,군산시,신풍동,관내사전투표,2327,2327,2040,184,78,11,1,2314,13,0,88.1590319792567,7.951598962834917,3.3707865168539324,0.47536732929991354,0.043215211754537596
41,전북특별자치도,군산시,신풍동,신풍동제1투,916,488,323,140,20,3,0,486,2,428,66.46090534979425,28.80658436213992,4.11522633744856,0.6172839506172839,0.0
42,전북특별자치도,군산시,신풍동,신풍동제2투,619,318,224,80,12,1,1,318,0,301,70.44025157232704,25.157232704402517,3.7735849056603774,0.3144654088050315,0.3144654088050315
43,전북특별자치도,군산시,신풍동,신풍동제3투,1294,920,696,173,38,4,1,912,8,374,76.31578947368422,18.969298245614034,4.166666666666666,0.43859649122807015,0.10964912280701754
44,전북특별자치도,군산시,중앙동,관내사전투표,2525,2525,2222,191,75,20,5,2513,12,0,88.42021488261042,7.600477516912058,2.9844807003581377,0.7958615200955035,0.19896538002387587
45,전북특별자치도,군산시,중앙동,중앙동투표소,1722,930,653,210,53,7,0,923,7,792,70.74756229685806,22.75189599133261,5.742145178764897,0.7583965330444203,0.0
46,전북특별자치도,군산시,흥남동,관내사전투표,4645,4645,4119,335,145,26,5,4630,15,0,88.96328293736501,7.235421166306695,3.131749460043196,0.5615550755939525,0.10799136069114472
47,전북특별자치도,군산시,흥남동,흥남동제1투,1411,749,531,158,56,2,0,747,2,662,71.08433734939759,21.151271753681392,7.49665327978581,0.2677376171352075,0.0
48,전북특별자치도,군산시,흥남동,흥남동제2투,1785,1088,826,199,49,6,0,1080,8,697,76.48148148148148,18.425925925925927,4.537037037037037,0.5555555555555556,0.0
49,전북특별자치도,군산시,흥남동,흥남동제3투,756,496,348,118,24,4,1,495,1,260,70.3030303030303,23.83838383838384,4.848484848484849,0.8080808080808081,0.20202020202020202
50,전북특별자치도,군산시,흥남동,흥남동제4투,992,626,449,134,31,8,0,622,4,366,72.18649517684888,21.54340836012862,4.983922829581994,1.2861736334405145,0.0
51,전북특별자치도,군산시,조촌동,관내사전투표,8845,8845,7752,546,434,60,5,8797,48,0,88.12095032397409,6.206661361827895,4.933500056837558,0.6820506991019666,0.05683755825849721
52,전북특별자치도,군산시,조촌동,조촌동제1투,1569,742,496,151,75,11,0,733,9,827,67.66712141882674,20.600272851296044,10.231923601637108,1.5006821282401093,0.0
53,전북특별자치도,군산시,조촌동,조촌동제2투,2497,1501,1085,289,104,14,2,1494,7,996,72.62382864792504,19.34404283801874,6.961178045515395,0.9370816599732262,0.13386880856760375
54,전북특별자치도,군산시,조촌동,조촌동제3투,1076,624,449,145,19,4,1,618,6,452,72.65372168284789,23.462783171521036,3.074433656957929,0.6472491909385114,0.16181229773462785
55,전북특별자치도,군산시,조촌동,조촌동제4투,2467,1752,1308,305,107,21,2,1743,9,715,75.04302925989673,17.498565691336776,6.138841078600115,1.2048192771084338,0.11474469305794606
56,전북특별자치도,군산시,조촌동,조촌동제5투,2953,2182,1595,398,161,15,2,2171,11,771,73.46844771994473,18.332565637954858,7.415937356057116,0.6909258406264395,0.09212344541685859
57,전북특별자치도,군산시,경암동,관내사전투표,3334,3334,2943,234,121,23,3,3324,10,0,88.53790613718412,7.039711191335741,3.6401925391095067,0.6919374247894103,0.09025270758122744
58,전북특별자치도,군산시,경암동,경암동제1투,865,443,307,109,21,3,1,441,2,422,69.61451247165533,24.71655328798186,4.761904761904762,0.6802721088435374,0.22675736961451248
59,전북특별자치도,군산시,경암동,경암동제2투,1523,962,729,185,36,8,0,958,4,561,76.09603340292276,19.31106471816284,3.7578288100208765,0.8350730688935281,0.0
60,전북특별자치도,군산시,경암동,경암동제3투,800,532,394,115,13,8,2,532,0,268,74.06015037593986,21.616541353383457,2.443609022556391,1.5037593984962405,0.37593984962406013
61,전북특별자치도,군산시,구암동,관내사전투표,3817,3817,3333,266,171,24,0,3794,23,0,87.84923563521349,7.011070110701106,4.5071164997364255,0.632577754348972,0.0
62,전북특별자치도,군산시,구암동,구암동제1투,1732,1053,733,242,65,7,1,1048,5,679,69.94274809160305,23.091603053435115,6.202290076335878,0.6679389312977099,0.09541984732824427
63,전북특별자치도,군산시,구암동,구암동제2투,3195,2239,1565,430,205,22,3,2225,14,956,70.33707865168539,19.325842696629213,9.213483146067416,0.9887640449438202,0.1348314606741573
64,전북특별자치도,군산시,개정동,관내사전투표,2017,2017,1791,134,70,13,1,2009,8,0,89.14883026381284,6.669985067197611,3.484320557491289,0.6470881035340966,0.049776007964161276
65,전북특별자치도,군산시,개정동,개정동투표소,882,527,358,137,22,4,0,521,6,355,68.71401151631477,26.29558541266795,4.222648752399232,0.7677543186180422,0.0
66,전북특별자치도,군산시,수송동,관내사전투표,10727,10727,9351,709,549,78,2,10689,38,0,87.48245860230142,6.632987183085415,5.136121246140893,0.7297221442604547,0.01871082421180653
67,전북특별자치도,군산시,수송동,수송동제1투,1894,1082,709,275,90,6,0,1080,2,812,65.64814814814814,25.462962962962965,8.333333333333332,0.5555555555555556,0.0
68,전북특별자치도,군산시,수송동,수송동제2투,1529,1025,795,161,58,5,0,1019,6,504,78.01766437684003,15.799803729146223,5.691854759568204,0.49067713444553485,0.0
69,전북특별자치도,군산시,수송동,수송동제3투,1731,1179,900,207,51,11,2,1171,8,552,76.85738684884714,17.67719897523484,4.355251921434671,0.9393680614859093,0.1707941929974381
70,전북특별자치도,군산시,수송동,수송동제4투,1521,911,684,169,51,3,0,907,4,610,75.41345093715546,18.632855567805954,5.622932745314222,0.33076074972436603,0.0
71,전북특별자치도,군산시,수송동,수송동제5투,3115,1947,1330,397,176,29,3,1935,12,1168,68.73385012919897,20.516795865633075,9.095607235142118,1.4987080103359174,0.15503875968992248
72,전북특별자치도,군산시,수송동,수송동제6투,2646,1871,1435,288,115,23,2,1863,8,775,77.02630166398282,15.458937198067632,6.172839506172839,1.2345679012345678,0.10735373054213634
73,전북특별자치도,군산시,수송동,수송동제7투,2307,1688,1197,341,117,21,0,1676,12,619,71.4200477326969,20.346062052505967,6.980906921241051,1.2529832935560858,0.0
74,전북특별자치도,군산시,수송동,수송동제8투,2269,1616,1216,294,85,15,3,1613,3,653,75.38747675139493,18.22690638561686,5.269683818970862,0.9299442033477991,0.18598884066955984
75,전북특별자치도,군산시,수송동,수송동제9투,2585,1912,1512,271,103,17,1,1904,8,673,79.41176470588235,14.233193277310924,5.409663865546219,0.8928571428571428,0.052521008403361345
76,전북특별자치도,군산시,수송동,수송동제10투,930,621,462,118,32,7,0,619,2,309,74.63651050080774,19.063004846526656,5.169628432956381,1.1308562197092082,0.0
77,전북특별자치도,군산시,수송동,수송동제11투,1798,1359,1086,185,71,9,0,1351,8,439,80.38490007401926,13.693560325684679,5.255366395262769,0.6661732050333087,0.0
78,전북특별자치도,군산시,나운1동,관내사전투표,5246,5246,4649,385,152,31,2,5219,27,0,89.07836750335314,7.376892124928148,2.912435332439165,0.5939835217474612,0.03832151753209427
79,전북특별자치도,군산시,나운1동,나운1동제1투,1432,782,499,220,49,8,1,777,5,650,64.22136422136421,28.314028314028317,6.306306306306306,1.0296010296010296,0.1287001287001287
80,전북특별자치도,군산시,나운1동,나운1동제2투,2082,1235,890,251,69,15,1,1226,9,847,72.59380097879283,20.473083197389887,5.628058727569331,1.2234910277324633,0.08156606851549755
81,전북특별자치도,군산시,나운1동,나운1동제3투,1084,667,505,114,37,5,0,661,6,417,76.39939485627836,17.246596066565807,5.597579425113464,0.7564296520423601,0.0
82,전북특별자치도,군산시,나운1동,나운1동제4투,1285,773,525,178,50,13,2,768,5,512,68.359375,23.177083333333336,6.510416666666667,1.6927083333333333,0.26041666666666663
83,전북특별자치도,군산시,나운2동,관내사전투표,8591,8589,7627,565,320,42,5,8559,30,2,89.11087743895315,6.601238462437201,3.7387545273980605,0.49071153172099546,0.058418039490594695
84,전북특별자치도,군산시,나운2동,나운2동제1투,1829,1101,780,242,69,6,0,1097,4,728,71.10300820419326,22.060164083865086,6.289881494986327,0.5469462169553327,0.0
85,전북특별자치도,군산시,나운2동,나운2동제2투,1087,698,565,98,13,5,3,684,14,389,82.60233918128655,14.327485380116958,1.9005847953216373,0.7309941520467835,0.43859649122807015
86,전북특별자치도,군산시,나운2동,나운2동제3투,1542,1120,851,194,62,6,0,1113,7,422,76.46001796945193,17.4303683737646,5.570530098831986,0.5390835579514826,0.0
87,전북특별자치도,군산시,나운2동,나운2동제4투,2088,1483,1139,241,77,17,3,1477,6,605,77.11577522004063,16.316858496953284,5.213270142180095,1.1509817197020988,0.2031144211238998
88,전북특별자치도,군산시,나운2동,나운2동제5투,2696,1772,1296,345,96,15,4,1756,16,924,73.80410022779044,19.646924829157175,5.466970387243736,0.8542141230068337,0.22779043280182232
89,전북특별자치도,군산시,나운3동,관내사전투표,6103,6103,5264,398,368,42,8,6080,23,0,86.57894736842105,6.546052631578947,6.052631578947368,0.6907894736842105,0.13157894736842105
90,전북특별자치도,군산시,나운3동,나운3동제1투,3098,2071,1533,377,129,18,2,2059,12,1027,74.4536182612919,18.30985915492958,6.26517727051967,0.8742107819329772,0.09713453132588634
91,전북특별자치도,군산시,나운3동,나운3동제2투,3158,2009,1557,314,104,19,2,1996,13,1149,78.0060120240481,15.731462925851702,5.210420841683367,0.9519038076152305,0.1002004008016032
92,전북특별자치도,군산시,나운3동,나운3동제3투,1252,830,570,198,47,10,0,825,5,422,69.0909090909091,24.0,5.696969696969697,1.2121212121212122,0.0
93,전북특별자치도,군산시,나운3동,나운3동제4투,1595,705,488,131,71,7,3,700,5,890,69.71428571428572,18.714285714285715,10.142857142857142,1.0,0.4285714285714286
94,전북특별자치도,군산시,나운3동,나운3동제5투,1288,824,632,142,41,7,0,822,2,464,76.88564476885644,17.27493917274939,4.987834549878346,0.851581508515815,0.0
95,전북특별자치도,군산시,나운3동,나운3동제6투,1085,711,518,119,58,9,2,706,5,374,73.37110481586402,16.855524079320112,8.21529745042493,1.2747875354107647,0.28328611898017
96,전북특별자치도,군산시,나운3동,나운3동제7투,1904,1234,787,333,95,8,2,1225,9,670,64.24489795918367,27.183673469387752,7.755102040816326,0.653061224489796,0.163265306122449
97,전북특별자치도,군산시,소룡동,관내사전투표,6173,6172,5519,385,204,30,5,6143,29,1,89.84209669542568,6.267296109392804,3.320853003418525,0.48836073579684197,0.08139345596614032
98,전북특별자치도,군산시,소룡동,소룡동제1투,1350,629,457,134,26,8,4,629,0,721,72.65500794912559,21.303656597774246,4.133545310015898,1.2718600953895072,0.6359300476947536
99,전북특별자치도,군산시,소룡동,소룡동제2투,934,576,437,114,17,3,1,572,4,358,76.3986013986014,19.93006993006993,2.972027972027972,0.5244755244755245,0.17482517482517482
100,전북특별자치도,군산시,소룡동,소룡동제3투,1562,767,573,148,33,5,3,762,5,795,75.19685039370079,19.42257217847769,4.330708661417323,0.6561679790026247,0.39370078740157477
101,전북특별자치도,군산시,소룡동,소룡동제4투,2485,1367,1039,239,73,7,3,1361,6,1118,76.34092578986039,17.56061719324026,5.363703159441587,0.5143277002204262,0.2204261572373255
102,전북특별자치도,군산시,소룡동,소룡동제5투,1572,852,616,178,55,2,0,851,1,720,72.38542890716803,20.9165687426557,6.462984723854288,0.23501762632197415,0.0
103,전북특별자치도,군산시,미성동,관내사전투표,4604,4604,4118,259,178,25,4,4584,20,0,89.83420593368237,5.650087260034904,3.883071553228621,0.5453752181500873,0.08726003490401396
104,전북특별자치도,군산시,미성동,미성동제1투,1001,477,378,77,20,1,0,476,1,524,79.41176470588235,16.176470588235293,4.201680672268908,0.21008403361344538,0.0
105,전북특별자치도,군산시,미성동,미성동제2투,1279,711,521,131,45,6,1,704,7,568,74.00568181818183,18.607954545454543,6.392045454545454,0.8522727272727272,0.14204545454545456
106,전북특별자치도,군산시,미성동,미성동제3투,1903,813,593,159,47,6,2,807,6,1090,73.4820322180917,19.702602230483272,5.8240396530359355,0.7434944237918215,0.24783147459727387
107,전북특별자치도,군산시,미성동,미성동제4투,976,628,473,105,35,7,0,620,8,348,76.29032258064517,16.93548387096774,5.64516129032258,1.129032258064516,0.0
108,전북특별자치도,군산시,잘못 투입·구분된 투표지,,0,2,2,0,0,0,0,2,0,-2,100.0,0.0,0.0,0.0,0.0
0,전북특별자치도,익산시,거소·선상투표,,528,501,349,64,67,2,5,487,14,27,71.66324435318275,13.141683778234087,13.75770020533881,0.41067761806981523,1.0266940451745379
1,전북특별자치도,익산시,관외사전투표,,19126,19125,14601,1865,2287,160,25,18938,187,1,77.09895448304995,9.847924807265814,12.076248811912556,0.8448621818565847,0.13200971591509134
2,전북특별자치도,익산시,재외투표,,816,666,543,58,57,4,1,663,3,150,81.90045248868778,8.74811463046757,8.597285067873303,0.603318250377074,0.1508295625942685
3,전북특별자치도,익산시,함열읍,관내사전투표,3433,3433,3025,265,108,19,4,3421,12,0,88.42443729903538,7.746273019584916,3.1569716457176265,0.5553931598947676,0.1169248757673195
4,전북특별자치도,익산시,함열읍,함열읍제1투,1378,711,512,161,21,4,3,701,10,667,73.03851640513552,22.96718972895863,2.9957203994293864,0.5706134094151213,0.42796005706134094
5,전북특별자치도,익산시,함열읍,함열읍제2투,1060,631,468,133,22,3,1,627,4,429,74.64114832535886,21.21212121212121,3.508771929824561,0.4784688995215311,0.1594896331738437
6,전북특별자치도,익산시,오산면,관내사전투표,1994,1994,1783,132,50,15,3,1983,11,0,89.91427130610187,6.656580937972769,2.5214321734745337,0.7564296520423601,0.15128593040847202
7,전북특별자치도,익산시,오산면,오산면제1투,899,502,395,79,14,10,0,498,4,397,79.31726907630522,15.863453815261044,2.8112449799196786,2.0080321285140563,0.0
8,전북특별자치도,익산시,오산면,오산면제2투,1632,1100,873,159,47,10,2,1091,9,532,80.01833180568286,14.57378551787351,4.307974335472044,0.916590284142988,0.18331805682859761
9,전북특별자치도,익산시,오산면,오산면제3투,527,308,224,65,11,3,0,303,5,219,73.92739273927393,21.45214521452145,3.6303630363036308,0.9900990099009901,0.0
10,전북특별자치도,익산시,황등면,관내사전투표,3014,3014,2719,169,86,16,4,2994,20,0,90.81496325985304,5.6446225784903135,2.8724114896459585,0.5344021376085505,0.13360053440213762
11,전북특별자치도,익산시,황등면,황등면제1투,921,465,335,108,12,4,3,462,3,456,72.51082251082252,23.376623376623375,2.5974025974025974,0.8658008658008658,0.6493506493506493
12,전북특별자치도,익산시,황등면,황등면제2투,1564,961,726,176,45,10,0,957,4,603,75.86206896551724,18.39080459770115,4.702194357366771,1.044932079414838,0.0
13,전북특별자치도,익산시,황등면,황등면제3투,451,291,226,52,9,2,0,289,2,160,78.20069204152249,17.99307958477509,3.1141868512110724,0.6920415224913495,0.0
14,전북특별자치도,익산시,함라면,관내사전투표,988,988,883,70,23,5,0,981,7,0,90.01019367991844,7.135575942915392,2.344546381243629,0.509683995922528,0.0
15,전북특별자치도,익산시,함라면,함라면투표소,760,411,300,92,8,4,1,405,6,349,74.07407407407408,22.71604938271605,1.9753086419753085,0.9876543209876543,0.24691358024691357
16,전북특별자치도,익산시,웅포면,관내사전투표,674,674,607,44,19,1,0,671,3,0,90.46199701937407,6.557377049180328,2.8315946348733236,0.14903129657228018,0.0
17,전북특별자치도,익산시,웅포면,웅포면투표소,550,300,218,65,12,3,1,299,1,250,72.90969899665552,21.73913043478261,4.013377926421405,1.0033444816053512,0.33444816053511706
18,전북특별자치도,익산시,성당면,관내사전투표,722,722,647,55,15,2,1,720,2,0,89.86111111111111,7.638888888888889,2.083333333333333,0.2777777777777778,0.1388888888888889
19,전북특별자치도,익산시,성당면,성당면투표소,739,390,286,85,10,5,1,387,3,349,73.90180878552972,21.963824289405682,2.5839793281653747,1.2919896640826873,0.2583979328165375
20,전북특별자치도,익산시,용안면,관내사전투표,1073,1072,924,98,23,5,2,1052,20,1,87.83269961977186,9.315589353612168,2.1863117870722433,0.4752851711026616,0.19011406844106463
21,전북특별자치도,익산시,용안면,용안면투표소,912,451,300,125,17,2,1,445,6,461,67.41573033707866,28.08988764044944,3.8202247191011236,0.44943820224719105,0.22471910112359553
22,전북특별자치도,익산시,낭산면,관내사전투표,1139,1139,1000,81,42,8,0,1131,8,0,88.41732979664015,7.161803713527852,3.7135278514588856,0.707338638373121,0.0
23,전북특별자치도,익산시,낭산면,낭산면투표소,1173,676,498,141,24,6,0,669,7,497,74.43946188340807,21.076233183856502,3.587443946188341,0.8968609865470852,0.0
24,전북특별자치도,익산시,망성면,관내사전투표,1006,1006,843,124,23,8,1,999,7,0,84.38438438438438,12.412412412412413,2.3023023023023024,0.8008008008008007,0.10010010010010009
25,전북특별자치도,익산시,망성면,망성면투표소,1323,739,501,203,23,3,0,730,9,584,68.63013698630137,27.808219178082194,3.1506849315068495,0.410958904109589,0.0
26,전북특별자치도,익산시,여산면,관내사전투표,1419,1419,1231,109,55,8,3,1406,13,0,87.55334281650072,7.7524893314367,3.911806543385491,0.5689900426742532,0.21337126600284498
27,전북특별자치도,익산시,여산면,여산면투표소,1195,665,447,169,41,4,0,661,4,530,67.62481089258698,25.56732223903177,6.202723146747353,0.6051437216338881,0.0
28,전북특별자치도,익산시,금마면,관내사전투표,2788,2788,2387,237,115,18,5,2762,26,0,86.42288196958725,8.580738595220854,4.163649529326575,0.6517016654598118,0.18102824040550325
29,전북특별자치도,익산시,금마면,금마면제1투,1326,742,485,209,37,7,1,739,3,584,65.62922868741543,28.28146143437077,5.006765899864682,0.9472259810554804,0.13531799729364005
30,전북특별자치도,익산시,금마면,금마면제2투,734,435,311,100,18,2,0,431,4,299,72.15777262180974,23.201856148491878,4.176334106728538,0.46403712296983757,0.0
31,전북특별자치도,익산시,왕궁면,관내사전투표,1825,1825,1596,133,66,10,5,1810,15,0,88.17679558011051,7.348066298342541,3.6464088397790055,0.5524861878453038,0.2762430939226519
32,전북특별자치도,익산시,왕궁면,왕궁면제1투,1265,729,523,152,36,8,2,721,8,536,72.5381414701803,21.081830790568652,4.993065187239944,1.1095700416088765,0.27739251040221913
33,전북특별자치도,익산시,왕궁면,왕궁면제2투,517,278,210,48,13,3,1,275,3,239,76.36363636363637,17.454545454545457,4.7272727272727275,1.090909090909091,0.36363636363636365
34,전북특별자치도,익산시,왕궁면,왕궁면제3투,406,343,265,67,8,0,1,341,2,63,77.71260997067448,19.64809384164223,2.346041055718475,0.0,0.2932551319648094
35,전북특별자치도,익산시,춘포면,관내사전투표,1236,1236,1113,63,29,10,1,1216,20,0,91.5296052631579,5.180921052631579,2.384868421052632,0.8223684210526315,0.08223684210526315
36,전북특별자치도,익산시,춘포면,춘포면제1투,555,289,234,41,11,2,0,288,1,266,81.25,14.23611111111111,3.8194444444444446,0.6944444444444444,0.0
37,전북특별자치도,익산시,춘포면,춘포면제2투,692,481,420,42,11,4,2,479,2,211,87.68267223382045,8.768267223382047,2.2964509394572024,0.8350730688935281,0.41753653444676403
38,전북특별자치도,익산시,춘포면,춘포면제3투,825,561,442,87,26,3,0,558,3,264,79.21146953405018,15.591397849462366,4.659498207885305,0.5376344086021506,0.0
39,전북특별자치도,익산시,삼기면,관내사전투표,1564,1564,1379,89,45,15,3,1531,33,0,90.07184846505551,5.81319399085565,2.939255388634879,0.9797517962116263,0.1959503592423253
40,전북특별자치도,익산시,삼기면,삼기면투표소,960,513,382,91,32,6,1,512,1,447,74.609375,17.7734375,6.25,1.171875,0.1953125
41,전북특별자치도,익산시,용동면,관내사전투표,599,599,505,64,23,3,1,596,3,0,84.73154362416108,10.738255033557047,3.859060402684564,0.5033557046979865,0.16778523489932887
42,전북특별자치도,익산시,용동면,용동면투표소,627,348,260,75,10,3,0,348,0,279,74.71264367816092,21.551724137931032,2.8735632183908044,0.8620689655172413,0.0
43,전북특별자치도,익산시,중앙동,관내사전투표,2178,2178,1893,184,67,20,3,2167,11,0,87.35579141670512,8.4910013844024,3.091832025842178,0.9229349330872173,0.1384402399630826
44,전북특별자치도,익산시,중앙동,중앙동제1투,804,420,281,93,36,4,2,416,4,384,67.54807692307693,22.355769230769234,8.653846153846153,0.9615384615384616,0.4807692307692308
45,전북특별자치도,익산시,중앙동,중앙동제2투,582,305,198,77,21,2,1,299,6,277,66.22073578595318,25.75250836120401,7.023411371237458,0.6688963210702341,0.33444816053511706
46,전북특별자치도,익산시,평화동,관내사전투표,1936,1936,1719,135,62,9,1,1926,10,0,89.25233644859813,7.009345794392523,3.2191069574247146,0.46728971962616817,0.05192107995846314
47,전북특별자치도,익산시,평화동,평화동제1투,1086,646,467,135,41,1,0,644,2,440,72.51552795031056,20.96273291925466,6.366459627329192,0.15527950310559005,0.0
48,전북특별자치도,익산시,평화동,평화동제2투,727,422,339,64,15,0,1,419,3,305,80.90692124105013,15.274463007159905,3.579952267303103,0.0,0.23866348448687352
49,전북특별자치도,익산시,인화동,관내사전투표,2897,2897,2617,177,80,12,2,2888,9,0,90.6163434903047,6.1288088642659275,2.7700831024930745,0.41551246537396125,0.06925207756232687
50,전북특별자치도,익산시,인화동,인화동제1투,1196,581,390,138,38,5,1,572,9,615,68.18181818181817,24.125874125874127,6.643356643356643,0.8741258741258742,0.17482517482517482
51,전북특별자치도,익산시,인화동,인화동제2투,1258,674,492,144,24,8,1,669,5,584,73.54260089686099,21.524663677130047,3.587443946188341,1.195814648729447,0.14947683109118087
52,전북특별자치도,익산시,동산동,관내사전투표,7042,7041,6425,340,211,38,7,7021,20,1,91.51118074348383,4.842615012106537,3.0052699045719984,0.5412334425295542,0.09970089730807577
53,전북특별자치도,익산시,동산동,동산동제1투,1239,702,536,126,35,3,1,701,1,537,76.46219686162625,17.97432239657632,4.9928673323823105,0.42796005706134094,0.14265335235378032
54,전북특별자치도,익산시,동산동,동산동제2투,866,491,379,80,26,6,0,491,0,375,77.18940936863544,16.293279022403258,5.295315682281059,1.2219959266802443,0.0
55,전북특별자치도,익산시,동산동,동산동제3투,1711,957,712,166,61,6,4,949,8,754,75.0263435194942,17.49209694415174,6.42781875658588,0.6322444678609063,0.42149631190727077
56,전북특별자치도,익산시,동산동,동산동제4투,1683,992,762,156,58,6,3,985,7,691,77.36040609137056,15.83756345177665,5.888324873096447,0.6091370558375634,0.3045685279187817
57,전북특별자치도,익산시,동산동,동산동제5투,2636,1593,1263,238,64,12,3,1580,13,1043,79.9367088607595,15.063291139240507,4.050632911392405,0.7594936708860759,0.18987341772151897
58,전북특별자치도,익산시,마동,관내사전투표,5778,5778,5150,321,241,30,7,5749,29,0,89.58079666028874,5.583579753000522,4.192033397112541,0.5218298834579926,0.1217603061401983
59,전북특별자치도,익산시,마동,마동제1투,596,289,198,67,17,1,1,284,5,307,69.71830985915493,23.591549295774648,5.985915492957746,0.35211267605633806,0.35211267605633806
60,전북특별자치도,익산시,마동,마동제2투,3490,2401,1829,352,177,32,2,2392,9,1089,76.46321070234113,14.715719063545151,7.399665551839465,1.3377926421404682,0.08361204013377926
61,전북특별자치도,익산시,마동,마동제3투,2715,1711,1250,315,125,13,2,1705,6,1004,73.31378299120234,18.475073313782993,7.331378299120235,0.7624633431085044,0.11730205278592376
62,전북특별자치도,익산시,남중동,관내사전투표,4447,4447,3890,355,150,27,5,4427,20,0,87.86988931556358,8.018974474813643,3.38829907386492,0.6098938332956856,0.112943302462164
63,전북특별자치도,익산시,남중동,남중동제1투,1047,518,348,140,26,2,0,516,2,529,67.44186046511628,27.131782945736433,5.038759689922481,0.3875968992248062,0.0
64,전북특별자치도,익산시,남중동,남중동제2투,1225,743,501,180,50,10,0,741,2,482,67.61133603238866,24.291497975708502,6.747638326585695,1.349527665317139,0.0
65,전북특별자치도,익산시,남중동,남중동제3투,1411,809,589,149,54,11,1,804,5,602,73.2587064676617,18.53233830845771,6.7164179104477615,1.3681592039800996,0.12437810945273632
66,전북특별자치도,익산시,남중동,남중동제4투,1166,714,522,166,23,1,0,712,2,452,73.31460674157303,23.314606741573034,3.2303370786516856,0.1404494382022472,0.0
67,전북특별자치도,익산시,모현동,관내사전투표,10826,10826,9629,659,430,57,5,10780,46,0,89.32282003710576,6.11317254174397,3.9888682745825603,0.5287569573283859,0.0463821892393321
68,전북특별자치도,익산시,모현동,모현동제1투,1374,734,547,134,37,8,3,729,5,640,75.03429355281207,18.381344307270233,5.075445816186557,1.0973936899862824,0.411522633744856
69,전북특별자치도,익산시,모현동,모현동제2투,1202,740,517,159,50,8,0,734,6,462,70.43596730245231,21.662125340599456,6.811989100817439,1.08991825613079,0.0
70,전북특별자치도,익산시,모현동,모현동제3투,1601,1044,779,189,60,8,4,1040,4,557,74.90384615384616,18.173076923076923,5.769230769230769,0.7692307692307693,0.38461538461538464
71,전북특별자치도,익산시,모현동,모현동제4투,1157,673,451,170,37,12,0,670,3,484,67.31343283582089,25.37313432835821,5.522388059701493,1.791044776119403,0.0
72,전북특별자치도,익산시,모현동,모현동제5투,1551,1003,727,194,62,15,0,998,5,548,72.84569138276554,19.438877755511022,6.212424849699398,1.503006012024048,0.0
73,전북특별자치도,익산시,모현동,모현동제6투,1931,1408,1105,201,80,16,1,1403,5,523,78.75980042765502,14.326443335709193,5.702066999287242,1.1404133998574484,0.07127583749109052
74,전북특별자치도,익산시,모현동,모현동제7투,1548,960,755,151,39,8,1,954,6,588,79.14046121593292,15.828092243186584,4.088050314465408,0.8385744234800839,0.10482180293501049
75,전북특별자치도,익산시,모현동,모현동제8투,1621,1251,968,185,74,14,2,1243,8,370,77.87610619469027,14.883346741753822,5.953338696701529,1.1263073209975865,0.16090104585679807
76,전북특별자치도,익산시,모현동,모현동제9투,1360,969,712,169,67,15,0,963,6,391,73.93561786085151,17.549325025960542,6.95742471443406,1.557632398753894,0.0
77,전북특별자치도,익산시,모현동,모현동제10투,1559,1211,987,150,56,14,0,1207,4,348,81.77299088649545,12.427506213753107,4.63960231980116,1.15990057995029,0.0
78,전북특별자치도,익산시,송학동,관내사전투표,5041,5041,4487,310,195,30,2,5024,17,0,89.31130573248409,6.170382165605096,3.881369426751592,0.5971337579617835,0.039808917197452234
79,전북특별자치도,익산시,송학동,송학동제1투,686,383,284,65,27,5,1,382,1,303,74.3455497382199,17.015706806282722,7.068062827225131,1.3089005235602094,0.2617801047120419
80,전북특별자치도,익산시,송학동,송학동제2투,921,620,459,122,33,2,0,616,4,301,74.51298701298701,19.805194805194805,5.357142857142857,0.3246753246753247,0.0
81,전북특별자치도,익산시,송학동,송학동제3투,2570,1627,1245,217,142,13,1,1618,9,943,76.946847960445,13.411619283065512,8.776266996291717,0.8034610630407911,0.061804697156983925
82,전북특별자치도,익산시,신동,관내사전투표,6217,6217,4870,557,649,51,12,6139,78,0,79.32888092523213,9.073138947711353,10.571754357387196,0.8307541944942173,0.19547157517510994
83,전북특별자치도,익산시,신동,신동제1투,1782,953,516,286,129,7,2,940,13,829,54.8936170212766,30.425531914893618,13.72340425531915,0.7446808510638299,0.2127659574468085
84,전북특별자치도,익산시,신동,신동제2투,1788,850,506,235,96,4,0,841,9,938,60.166468489892985,27.94292508917955,11.414982164090368,0.47562425683709864,0.0
85,전북특별자치도,익산시,신동,신동제3투,1825,1266,899,254,93,15,0,1261,5,559,71.29262490087233,20.14274385408406,7.375099127676448,1.189532117367169,0.0
86,전북특별자치도,익산시,신동,신동제4투,1229,604,443,118,35,0,0,596,8,625,74.32885906040269,19.798657718120804,5.87248322147651,0.0,0.0
87,전북특별자치도,익산시,영등1동,관내사전투표,7064,7064,6287,439,274,43,2,7045,19,0,89.24059616749467,6.231369765791341,3.889283179559971,0.6103619588360539,0.028388928317956
88,전북특별자치도,익산시,영등1동,영등1동제1투,1250,706,461,175,54,12,0,702,4,544,65.66951566951566,24.92877492877493,7.6923076923076925,1.7094017094017095,0.0
89,전북특별자치도,익산시,영등1동,영등1동제2투,2475,1489,1091,304,68,15,1,1479,10,986,73.76605814739689,20.554428668018932,4.597701149425287,1.0141987829614605,0.0676132521974307
90,전북특별자치도,익산시,영등1동,영등1동제3투,2214,1369,987,252,105,9,2,1355,14,845,72.84132841328413,18.59778597785978,7.7490774907749085,0.6642066420664207,0.14760147601476015
91,전북특별자치도,익산시,영등1동,영등1동제4투,2229,1459,1068,274,89,16,0,1447,12,770,73.80787836903939,18.935729094678646,6.150656530753283,1.10573600552868,0.0
92,전북특별자치도,익산시,영등2동,관내사전투표,6732,6732,5862,397,365,51,6,6681,51,0,87.7413560844185,5.9422242179314475,5.463254003891633,0.7633587786259541,0.08980691513246519
93,전북특별자치도,익산시,영등2동,영등2동제1투,1703,1113,826,175,90,13,2,1106,7,590,74.68354430379746,15.822784810126583,8.1374321880651,1.1754068716094033,0.18083182640144665
94,전북특별자치도,익산시,영등2동,영등2동제2투,1257,805,531,178,76,15,1,801,4,452,66.29213483146067,22.22222222222222,9.488139825218477,1.8726591760299627,0.12484394506866417
95,전북특별자치도,익산시,영등2동,영등2동제3투,1722,1098,802,180,95,11,2,1090,8,624,73.57798165137615,16.51376146788991,8.715596330275229,1.0091743119266057,0.1834862385321101
96,전북특별자치도,익산시,어양동,관내사전투표,7887,7887,6992,463,334,54,8,7851,36,0,89.05871863456885,5.897337918736467,4.254235129282894,0.6878104700038212,0.10189784740797352
97,전북특별자치도,익산시,어양동,어양동제1투,3108,1700,1274,284,110,18,1,1687,13,1408,75.51867219917013,16.834617664493184,6.520450503852994,1.066982809721399,0.05927682276229994
98,전북특별자치도,익산시,어양동,어양동제2투,1509,907,608,232,61,4,0,905,2,602,67.18232044198895,25.635359116022098,6.740331491712707,0.44198895027624313,0.0
99,전북특별자치도,익산시,어양동,어양동제3투,1631,1035,720,225,72,12,1,1030,5,596,69.90291262135922,21.844660194174757,6.990291262135923,1.1650485436893203,0.0970873786407767
100,전북특별자치도,익산시,어양동,어양동제4투,1472,1011,813,127,57,9,0,1006,5,461,80.81510934393638,12.624254473161034,5.666003976143141,0.8946322067594433,0.0
101,전북특별자치도,익산시,어양동,어양동제5투,1328,896,676,143,61,9,1,890,6,432,75.95505617977528,16.06741573033708,6.853932584269663,1.0112359550561798,0.11235955056179776
102,전북특별자치도,익산시,팔봉동,관내사전투표,3232,3232,2811,198,113,25,5,3152,80,0,89.18147208121827,6.281725888324872,3.5850253807106602,0.7931472081218274,0.15862944162436549
103,전북특별자치도,익산시,팔봉동,팔봉동제1투,1903,1088,787,234,48,6,5,1080,8,815,72.87037037037038,21.666666666666668,4.444444444444445,0.5555555555555556,0.4629629629629629
104,전북특별자치도,익산시,팔봉동,팔봉동제2투,580,344,268,62,13,1,0,344,0,236,77.90697674418605,18.023255813953487,3.77906976744186,0.29069767441860467,0.0
105,전북특별자치도,익산시,삼성동,관내사전투표,8278,8278,7427,458,317,43,6,8251,27,0,90.01333171736759,5.5508423221427705,3.84195855047873,0.5211489516422252,0.07271845836868258
106,전북특별자치도,익산시,삼성동,삼성동제1투,1662,1027,756,173,84,9,0,1022,5,635,73.97260273972603,16.927592954990214,8.21917808219178,0.8806262230919765,0.0
107,전북특별자치도,익산시,삼성동,삼성동제2투,1232,694,539,111,29,8,0,687,7,538,78.4570596797671,16.157205240174672,4.2212518195050945,1.1644832605531297,0.0
108,전북특별자치도,익산시,삼성동,삼성동제3투,1728,987,665,237,69,8,0,979,8,741,67.926455566905,24.20837589376915,7.048008171603677,0.8171603677221655,0.0
109,전북특별자치도,익산시,삼성동,삼성동제4투,1943,1329,1037,206,67,14,2,1326,3,614,78.2051282051282,15.535444947209653,5.052790346907994,1.0558069381598794,0.1508295625942685
110,전북특별자치도,익산시,삼성동,삼성동제5투,1928,1267,975,195,75,8,3,1256,11,661,77.62738853503186,15.525477707006369,5.971337579617835,0.6369426751592357,0.23885350318471338
111,전북특별자치도,익산시,삼성동,삼성동제6투,1615,1063,819,161,71,10,1,1062,1,552,77.11864406779661,15.160075329566855,6.685499058380414,0.9416195856873822,0.09416195856873823
112,전북특별자치도,익산시,삼성동,삼성동제7투,626,397,334,44,10,3,2,393,4,229,84.98727735368958,11.195928753180661,2.5445292620865136,0.7633587786259541,0.5089058524173028
113,전북특별자치도,익산시,삼성동,삼성동제8투,1940,1332,977,231,105,7,2,1322,10,608,73.90317700453858,17.473524962178516,7.94251134644478,0.529500756429652,0.15128593040847202
114,전북특별자치도,익산시,잘못 투입·구분된 투표지,,0,3,1,0,1,0,0,2,1,-3,50.0,0.0,50.0,0.0,0.0
0,전북특별자치도,정읍시,거소·선상투표,,572,539,381,60,42,7,3,493,46,33,77.28194726166329,12.170385395537526,8.519269776876268,1.4198782961460445,0.6085192697768762
1,전북특별자치도,정읍시,관외사전투표,,8124,8123,6371,754,828,60,16,8029,94,1,79.34985676921161,9.390957778054553,10.312616764229668,0.747291069871715,0.19927761863245733
2,전북특별자치도,정읍시,재외투표,,327,265,220,22,17,5,0,264,1,62,83.33333333333334,8.333333333333332,6.4393939393939394,1.893939393939394,0.0
3,전북특별자치도,정읍시,신태인읍,관내사전투표,2413,2413,2203,120,63,10,2,2398,15,0,91.86822351959967,5.004170141784821,2.627189324437031,0.4170141784820684,0.08340283569641367
4,전북특별자치도,정읍시,신태인읍,신태인읍제1투,812,436,342,71,17,3,1,434,2,376,78.80184331797236,16.359447004608295,3.9170506912442393,0.6912442396313364,0.2304147465437788
5,전북특별자치도,정읍시,신태인읍,신태인읍제2투,670,359,284,60,3,3,2,352,7,311,80.68181818181817,17.045454545454543,0.8522727272727272,0.8522727272727272,0.5681818181818182
6,전북특별자치도,정읍시,신태인읍,신태인읍제3투,534,314,263,41,3,1,2,310,4,220,84.83870967741936,13.225806451612904,0.967741935483871,0.3225806451612903,0.6451612903225806
7,전북특별자치도,정읍시,북면,관내사전투표,2677,2677,2452,125,71,16,4,2668,9,0,91.904047976012,4.685157421289355,2.6611694152923535,0.5997001499250375,0.14992503748125938
8,전북특별자치도,정읍시,북면,북면제1투,677,357,259,82,13,1,0,355,2,320,72.95774647887325,23.098591549295776,3.6619718309859155,0.28169014084507044,0.0
9,전북특별자치도,정읍시,북면,북면제2투,664,350,283,51,5,3,1,343,7,314,82.5072886297376,14.868804664723031,1.4577259475218658,0.8746355685131195,0.2915451895043732
10,전북특별자치도,정읍시,입암면,관내사전투표,1265,1265,1153,68,30,4,2,1257,8,0,91.72633253778838,5.409705648369132,2.386634844868735,0.31821797931583135,0.15910898965791567
11,전북특별자치도,정읍시,입암면,입암면제1투,495,272,212,53,5,2,0,272,0,223,77.94117647058823,19.485294117647058,1.8382352941176472,0.7352941176470588,0.0
12,전북특별자치도,정읍시,입암면,입암면제2투,525,323,261,53,4,0,1,319,4,202,81.81818181818183,16.614420062695924,1.2539184952978055,0.0,0.3134796238244514
13,전북특별자치도,정읍시,소성면,관내사전투표,987,987,890,62,27,4,2,985,2,0,90.35532994923858,6.2944162436548226,2.7411167512690358,0.40609137055837563,0.20304568527918782
14,전북특별자치도,정읍시,소성면,소성면투표소,647,304,227,58,9,4,3,301,3,343,75.41528239202658,19.269102990033225,2.990033222591362,1.3289036544850499,0.9966777408637874
15,전북특별자치도,정읍시,고부면,관내사전투표,1218,1218,1106,70,24,11,2,1213,5,0,91.17889530090683,5.7708161582852435,1.9785655399835118,0.9068425391591096,0.16488046166529266
16,전북특별자치도,정읍시,고부면,고부면투표소,969,476,379,76,11,4,1,471,5,493,80.46709129511677,16.13588110403397,2.335456475583864,0.8492569002123143,0.21231422505307856
17,전북특별자치도,정읍시,영원면,관내사전투표,795,795,707,53,18,7,1,786,9,0,89.94910941475827,6.743002544529262,2.2900763358778624,0.8905852417302799,0.1272264631043257
18,전북특별자치도,정읍시,영원면,영원면투표소,553,273,199,53,10,8,0,270,3,280,73.70370370370371,19.62962962962963,3.7037037037037033,2.9629629629629632,0.0
19,전북특별자치도,정읍시,덕천면,관내사전투표,860,860,785,37,23,8,0,853,7,0,92.02813599062134,4.337631887456038,2.6963657678780772,0.9378663540445485,0.0
20,전북특별자치도,정읍시,덕천면,덕천면제1투,325,179,148,19,5,6,0,178,1,146,83.14606741573034,10.674157303370785,2.8089887640449436,3.3707865168539324,0.0
21,전북특별자치도,정읍시,덕천면,덕천면제2투,308,185,147,25,10,1,1,184,1,123,79.8913043478261,13.586956521739129,5.434782608695652,0.5434782608695652,0.5434782608695652
22,전북특별자치도,정읍시,이평면,관내사전투표,908,908,839,44,15,3,1,902,6,0,93.01552106430155,4.878048780487805,1.662971175166297,0.3325942350332594,0.11086474501108648
23,전북특별자치도,정읍시,이평면,이평면투표소,648,317,245,51,14,2,3,315,2,331,77.77777777777779,16.19047619047619,4.444444444444445,0.6349206349206349,0.9523809523809524
24,전북특별자치도,정읍시,정우면,관내사전투표,898,898,806,51,22,6,4,889,9,0,90.6636670416198,5.736782902137233,2.4746906636670416,0.6749156355455568,0.44994375703037126
25,전북특별자치도,정읍시,정우면,정우면투표소,859,434,329,81,13,4,2,429,5,425,76.68997668997669,18.88111888111888,3.0303030303030303,0.9324009324009324,0.4662004662004662
26,전북특별자치도,정읍시,태인면,관내사전투표,1466,1466,1334,84,26,5,9,1458,8,0,91.49519890260632,5.761316872427984,1.7832647462277091,0.3429355281207133,0.6172839506172839
27,전북특별자치도,정읍시,태인면,태인면제1투,686,385,299,65,15,1,1,381,4,301,78.4776902887139,17.060367454068242,3.937007874015748,0.26246719160104987,0.26246719160104987
28,전북특별자치도,정읍시,태인면,태인면제2투,511,279,238,34,6,0,0,278,1,232,85.61151079136691,12.23021582733813,2.158273381294964,0.0,0.0
29,전북특별자치도,정읍시,감곡면,관내사전투표,925,925,824,62,29,3,0,918,7,0,89.76034858387798,6.753812636165578,3.159041394335512,0.32679738562091504,0.0
30,전북특별자치도,정읍시,감곡면,감곡면투표소,969,475,360,91,16,2,2,471,4,494,76.43312101910828,19.32059447983015,3.397027600849257,0.42462845010615713,0.42462845010615713
31,전북특별자치도,정읍시,옹동면,관내사전투표,617,617,573,34,5,2,1,615,2,0,93.17073170731707,5.528455284552845,0.8130081300813009,0.3252032520325203,0.16260162601626016
32,전북특별자치도,정읍시,옹동면,옹동면투표소,541,290,218,56,10,3,2,289,1,251,75.4325259515571,19.377162629757784,3.4602076124567476,1.0380622837370241,0.6920415224913495
33,전북특별자치도,정읍시,칠보면,관내사전투표,982,982,901,46,22,4,0,973,9,0,92.60020554984584,4.72764645426516,2.2610483042137717,0.41109969167523125,0.0
34,전북특별자치도,정읍시,칠보면,칠보면제1투,574,304,234,58,7,3,2,304,0,270,76.97368421052632,19.078947368421055,2.302631578947368,0.9868421052631579,0.6578947368421052
35,전북특별자치도,정읍시,칠보면,칠보면제2투,258,175,149,21,2,2,0,174,1,83,85.63218390804597,12.068965517241379,1.1494252873563218,1.1494252873563218,0.0
36,전북특별자치도,정읍시,산내면,관내사전투표,563,563,500,39,15,3,3,560,3,0,89.28571428571429,6.964285714285714,2.6785714285714284,0.5357142857142857,0.5357142857142857
37,전북특별자치도,정읍시,산내면,산내면투표소,385,197,148,41,5,0,2,196,1,188,75.51020408163265,20.918367346938776,2.5510204081632653,0.0,1.0204081632653061
38,전북특별자치도,정읍시,산외면,관내사전투표,882,882,784,72,16,1,4,877,5,0,89.39566704675028,8.209806157354619,1.8244013683010263,0.11402508551881414,0.45610034207525657
39,전북특별자치도,정읍시,산외면,산외면투표소,687,361,279,64,8,2,2,355,6,326,78.59154929577464,18.028169014084508,2.2535211267605635,0.5633802816901409,0.5633802816901409
40,전북특별자치도,정읍시,수성동,관내사전투표,6459,6459,5864,273,231,50,1,6419,40,0,91.35379342576725,4.252998909487459,3.598691384950927,0.7789375292101574,0.015578750584203147
41,전북특별자치도,정읍시,수성동,수성동제1투,765,439,335,80,20,4,0,439,0,326,76.30979498861048,18.223234624145785,4.555808656036446,0.9111617312072893,0.0
42,전북특별자치도,정읍시,수성동,수성동제2투,1068,740,596,100,34,5,3,738,2,328,80.75880758807588,13.550135501355012,4.607046070460704,0.6775067750677507,0.40650406504065045
43,전북특별자치도,정읍시,수성동,수성동제3투,771,439,349,70,15,1,2,437,2,332,79.86270022883295,16.018306636155607,3.4324942791762014,0.2288329519450801,0.4576659038901602
44,전북특별자치도,정읍시,수성동,수성동제4투,1773,953,719,160,54,14,1,948,5,820,75.84388185654008,16.877637130801688,5.69620253164557,1.4767932489451476,0.10548523206751054
45,전북특별자치도,정읍시,수성동,수성동제5투,2175,1190,900,186,84,11,2,1183,7,985,76.0777683854607,15.722738799661876,7.100591715976331,0.9298393913778529,0.16906170752324598
46,전북특별자치도,정읍시,장명동,관내사전투표,1389,1389,1242,91,38,8,2,1381,8,0,89.93482983345402,6.589427950760318,2.7516292541636496,0.5792903692976104,0.1448225923244026
47,전북특별자치도,정읍시,장명동,장명동투표소,1040,588,442,104,29,8,0,583,5,452,75.8147512864494,17.83876500857633,4.974271012006861,1.3722126929674099,0.0
48,전북특별자치도,정읍시,내장상동,관내사전투표,7138,7138,6463,348,252,37,5,7105,33,0,90.96410978184377,4.8979591836734695,3.5467980295566504,0.5207600281491906,0.07037297677691766
49,전북특별자치도,정읍시,내장상동,내장상동제1투,2204,1438,1154,180,74,18,2,1428,10,766,80.812324929972,12.605042016806722,5.182072829131653,1.2605042016806722,0.1400560224089636
50,전북특별자치도,정읍시,내장상동,내장상동제2투,1150,748,553,144,34,9,0,740,8,402,74.72972972972973,19.45945945945946,4.594594594594595,1.2162162162162162,0.0
51,전북특별자치도,정읍시,내장상동,내장상동제3투,940,612,500,76,29,6,0,611,1,328,81.83306055646482,12.438625204582651,4.746317512274959,0.9819967266775778,0.0
52,전북특별자치도,정읍시,내장상동,내장상동제4투,1019,569,437,96,27,5,0,565,4,450,77.34513274336283,16.991150442477874,4.778761061946903,0.8849557522123894,0.0
53,전북특별자치도,정읍시,내장상동,내장상동제5투,804,509,403,82,12,6,2,505,4,295,79.8019801980198,16.237623762376238,2.376237623762376,1.188118811881188,0.39603960396039606
54,전북특별자치도,정읍시,내장상동,내장상동제6투,1410,847,646,133,52,10,2,843,4,563,76.63107947805456,15.776986951364174,6.168446026097272,1.1862396204033214,0.2372479240806643
55,전북특별자치도,정읍시,시기동,관내사전투표,1881,1881,1688,120,50,14,3,1875,6,0,90.02666666666667,6.4,2.666666666666667,0.7466666666666667,0.16
56,전북특별자치도,정읍시,시기동,시기동제1투,651,391,282,87,16,3,0,388,3,260,72.68041237113401,22.422680412371136,4.123711340206185,0.7731958762886598,0.0
57,전북특별자치도,정읍시,시기동,시기동제2투,514,336,283,37,13,2,0,335,1,178,84.4776119402985,11.044776119402986,3.880597014925373,0.5970149253731344,0.0
58,전북특별자치도,정읍시,초산동,관내사전투표,2723,2723,2477,133,80,17,2,2709,14,0,91.4359542266519,4.909560723514212,2.9531192321889996,0.6275378368401624,0.07382798080472498
59,전북특별자치도,정읍시,초산동,초산동제1투,779,459,377,50,19,10,0,456,3,320,82.67543859649122,10.964912280701753,4.166666666666666,2.1929824561403506,0.0
60,전북특별자치도,정읍시,초산동,초산동제2투,1087,633,478,98,43,9,0,628,5,454,76.11464968152866,15.605095541401273,6.8471337579617835,1.4331210191082804,0.0
61,전북특별자치도,정읍시,초산동,초산동제3투,1429,956,739,134,65,9,1,948,8,473,77.9535864978903,14.135021097046414,6.856540084388185,0.949367088607595,0.10548523206751054
62,전북특별자치도,정읍시,연지동,관내사전투표,3551,3551,3152,211,142,25,6,3536,15,0,89.14027149321268,5.967194570135747,4.015837104072398,0.7070135746606335,0.16968325791855204
63,전북특별자치도,정읍시,연지동,연지동제1투,998,510,368,105,30,3,0,506,4,488,72.72727272727273,20.75098814229249,5.928853754940711,0.592885375494071,0.0
64,전북특별자치도,정읍시,연지동,연지동제2투,1170,762,584,118,44,8,0,754,8,408,77.45358090185677,15.649867374005305,5.835543766578249,1.0610079575596816,0.0
65,전북특별자치도,정읍시,농소동,관내사전투표,1253,1253,1112,81,48,9,0,1250,3,0,88.96,6.4799999999999995,3.84,0.72,0.0
66,전북특별자치도,정읍시,농소동,농소동제1투,550,275,215,44,11,2,1,273,2,275,78.75457875457876,16.117216117216117,4.029304029304029,0.7326007326007326,0.3663003663003663
67,전북특별자치도,정읍시,농소동,농소동제2투,891,526,434,68,21,2,0,525,1,365,82.66666666666667,12.95238095238095,4.0,0.38095238095238093,0.0
68,전북특별자치도,정읍시,상교동,관내사전투표,1581,1581,1432,75,42,7,6,1562,19,0,91.67733674775928,4.801536491677337,2.6888604353393086,0.44814340588988477,0.3841229193341869
69,전북특별자치도,정읍시,상교동,상교동제1투,916,447,331,78,29,3,0,441,6,469,75.05668934240363,17.687074829931973,6.575963718820861,0.6802721088435374,0.0
70,전북특별자치도,정읍시,상교동,상교동제2투,546,280,210,55,11,2,1,279,1,266,75.26881720430107,19.71326164874552,3.942652329749104,0.7168458781362007,0.35842293906810035
71,전북특별자치도,정읍시,잘못 투입·구분된 투표지,,0,0,0,0,0,0,0,0,0,0,0.0,0.0,0.0,0.0,0.0
0,전북특별자치도,남원시,거소·선상투표,,194,187,135,27,14,1,0,177,10,7,76.27118644067797,15.254237288135593,7.909604519774012,0.5649717514124294,0.0
1,전북특별자치도,남원시,관외사전투표,,5788,5786,4479,579,606,58,10,5732,54,2,78.14026517794836,10.101186322400558,10.572226099092813,1.0118632240055827,0.17445917655268667
2,전북특별자치도,남원시,재외투표,,222,182,150,20,9,2,0,181,1,40,82.87292817679558,11.049723756906078,4.972375690607735,1.1049723756906076,0.0
3,전북특별자치도,남원시,운봉읍,관내사전투표,1888,1888,1716,90,50,10,5,1871,17,0,91.7156600748263,4.810261892036345,2.672367717797969,0.5344735435595939,0.26723677177979693
4,전북특별자치도,남원시,운봉읍,운봉읍제1투,602,315,227,63,12,3,1,306,9,287,74.18300653594771,20.588235294117645,3.9215686274509802,0.9803921568627451,0.32679738562091504
5,전북특별자치도,남원시,운봉읍,운봉읍제2투,640,325,223,80,9,7,1,320,5,315,69.6875,25.0,2.8125,2.1875,0.3125
6,전북특별자치도,남원시,주천면,관내사전투표,1073,1073,963,59,26,6,2,1056,17,0,91.19318181818183,5.587121212121212,2.462121212121212,0.5681818181818182,0.1893939393939394
7,전북특별자치도,남원시,주천면,주천면투표소,811,455,342,88,13,5,2,450,5,356,76.0,19.555555555555557,2.888888888888889,1.1111111111111112,0.4444444444444444
8,전북특별자치도,남원시,수지면,관내사전투표,457,457,408,19,15,3,2,447,10,0,91.2751677852349,4.250559284116331,3.3557046979865772,0.6711409395973155,0.44742729306487694
9,전북특별자치도,남원시,수지면,수지면투표소,412,230,175,43,7,1,1,227,3,182,77.09251101321586,18.94273127753304,3.0837004405286343,0.4405286343612335,0.4405286343612335
10,전북특별자치도,남원시,송동면,관내사전투표,824,824,756,30,21,6,5,818,6,0,92.42053789731052,3.6674816625916873,2.567237163814181,0.7334963325183375,0.6112469437652812
11,전북특별자치도,남원시,송동면,송동면투표소,631,346,285,46,11,1,1,344,2,285,82.84883720930233,13.372093023255813,3.1976744186046515,0.29069767441860467,0.29069767441860467
12,전북특별자치도,남원시,주생면,관내사전투표,828,828,764,40,13,3,2,822,6,0,92.94403892944038,4.866180048661801,1.5815085158150852,0.36496350364963503,0.24330900243309003
13,전북특별자치도,남원시,주생면,주생면투표소,604,338,252,62,18,3,0,335,3,266,75.22388059701493,18.507462686567163,5.3731343283582085,0.8955223880597015,0.0
14,전북특별자치도,남원시,금지면,관내사전투표,1048,1048,945,60,20,10,2,1037,11,0,91.12825458052073,5.785920925747348,1.9286403085824495,0.9643201542912248,0.19286403085824494
15,전북특별자치도,남원시,금지면,금지면투표소,792,467,370,70,13,4,2,459,8,325,80.61002178649237,15.250544662309368,2.832244008714597,0.8714596949891068,0.4357298474945534
16,전북특별자치도,남원시,대강면,관내사전투표,707,707,635,42,15,6,2,700,7,0,90.71428571428571,6.0,2.142857142857143,0.8571428571428572,0.2857142857142857
17,전북특별자치도,남원시,대강면,대강면투표소,518,262,197,52,4,5,2,260,2,256,75.76923076923077,20.0,1.5384615384615385,1.9230769230769231,0.7692307692307693
18,전북특별자치도,남원시,대산면,관내사전투표,727,727,624,50,22,8,2,706,21,0,88.38526912181302,7.0821529745042495,3.1161473087818696,1.13314447592068,0.28328611898017
19,전북특별자치도,남원시,대산면,대산면투표소,542,284,221,51,9,1,0,282,2,258,78.36879432624113,18.085106382978726,3.1914893617021276,0.3546099290780142,0.0
20,전북특별자치도,남원시,사매면,관내사전투표,629,629,581,27,12,3,1,624,5,0,93.10897435897436,4.326923076923077,1.9230769230769231,0.4807692307692308,0.16025641025641024
21,전북특별자치도,남원시,사매면,사매면투표소,540,269,219,32,11,2,2,266,3,271,82.33082706766918,12.030075187969924,4.135338345864661,0.7518796992481203,0.7518796992481203
22,전북특별자치도,남원시,덕과면,관내사전투표,389,389,360,19,6,1,0,386,3,0,93.26424870466322,4.922279792746114,1.5544041450777202,0.2590673575129534,0.0
23,전북특별자치도,남원시,덕과면,덕과면투표소,324,181,143,30,4,3,0,180,1,143,79.44444444444444,16.666666666666664,2.2222222222222223,1.6666666666666667,0.0
24,전북특별자치도,남원시,보절면,관내사전투표,637,637,580,37,11,2,6,636,1,0,91.19496855345912,5.817610062893082,1.729559748427673,0.3144654088050315,0.9433962264150944
25,전북특별자치도,남원시,보절면,보절면투표소,521,303,235,45,12,2,3,297,6,218,79.12457912457911,15.151515151515152,4.040404040404041,0.6734006734006733,1.0101010101010102
26,전북특별자치도,남원시,산동면,관내사전투표,833,833,746,47,15,11,2,821,12,0,90.86479902557856,5.724725943970768,1.8270401948842874,1.3398294762484775,0.24360535931790497
27,전북특별자치도,남원시,산동면,산동면투표소,501,293,235,48,5,3,1,292,1,208,80.47945205479452,16.43835616438356,1.7123287671232876,1.0273972602739725,0.3424657534246575
28,전북특별자치도,남원시,이백면,관내사전투표,975,975,884,52,17,6,2,961,14,0,91.98751300728408,5.411030176899064,1.768990634755463,0.6243496357960457,0.20811654526534862
29,전북특별자치도,남원시,이백면,이백면투표소,698,390,307,60,16,2,1,386,4,308,79.53367875647669,15.544041450777202,4.145077720207254,0.5181347150259068,0.2590673575129534
30,전북특별자치도,남원시,인월면,관내사전투표,1364,1364,1203,103,34,12,5,1357,7,0,88.65143699336772,7.59027266028003,2.5055268975681653,0.8843036109064112,0.36845983787767134
31,전북특별자치도,남원시,인월면,인월면투표소,1018,582,433,116,24,5,1,579,3,436,74.78411053540587,20.03454231433506,4.145077720207254,0.8635578583765112,0.17271157167530224
32,전북특별자치도,남원시,아영면,관내사전투표,929,929,850,45,17,9,0,921,8,0,92.29098805646036,4.88599348534202,1.8458197611292075,0.9771986970684038,0.0
33,전북특별자치도,남원시,아영면,아영면투표소,633,345,272,59,8,3,1,343,2,288,79.30029154518951,17.20116618075802,2.3323615160349855,0.8746355685131195,0.2915451895043732
34,전북특별자치도,남원시,산내면,관내사전투표,936,936,816,54,22,37,0,929,7,0,87.83638320775027,5.81270182992465,2.3681377825618943,3.982777179763186,0.0
35,전북특별자치도,남원시,산내면,산내면투표소,662,374,275,78,8,10,0,371,3,288,74.12398921832884,21.024258760107816,2.15633423180593,2.6954177897574128,0.0
36,전북특별자치도,남원시,동충동,관내사전투표,1805,1805,1583,132,55,17,2,1789,16,0,88.48518725544997,7.378423700391281,3.0743432084963667,0.9502515371716043,0.11179429849077697
37,전북특별자치도,남원시,동충동,동충동투표소,1030,554,423,103,20,4,0,550,4,476,76.9090909090909,18.72727272727273,3.6363636363636362,0.7272727272727273,0.0
38,전북특별자치도,남원시,죽항동,관내사전투표,1667,1667,1482,109,55,8,6,1660,7,0,89.27710843373494,6.566265060240964,3.313253012048193,0.48192771084337355,0.3614457831325301
39,전북특별자치도,남원시,죽항동,죽항동투표소,989,469,324,117,21,4,0,466,3,520,69.52789699570815,25.10729613733906,4.506437768240343,0.8583690987124464,0.0
40,전북특별자치도,남원시,노암동,관내사전투표,2505,2505,2259,147,74,8,3,2491,14,0,90.686471296668,5.9012444801284625,2.9706945002007226,0.3211561621838619,0.12043356081894822
41,전북특별자치도,남원시,노암동,노암동제1투,477,257,199,46,9,3,0,257,0,220,77.431906614786,17.898832684824903,3.501945525291829,1.1673151750972763,0.0
42,전북특별자치도,남원시,노암동,노암동제2투,1467,856,660,130,43,11,2,846,10,611,78.01418439716312,15.36643026004728,5.08274231678487,1.3002364066193852,0.2364066193853428
43,전북특별자치도,남원시,금동,관내사전투표,2971,2971,2696,162,88,14,2,2962,9,0,91.01958136394327,5.469277515192437,2.9709655638082375,0.4726536124240378,0.0675219446320054
44,전북특별자치도,남원시,금동,금동제1투,730,447,331,92,14,4,0,441,6,283,75.05668934240363,20.861678004535147,3.1746031746031744,0.9070294784580499,0.0
45,전북특별자치도,남원시,금동,금동제2투,1412,863,691,130,29,7,3,860,3,549,80.34883720930233,15.11627906976744,3.372093023255814,0.813953488372093,0.3488372093023256
46,전북특별자치도,남원시,왕정동,관내사전투표,2419,2419,2205,129,62,9,2,2407,12,0,91.60781055255505,5.359368508516826,2.5758205234732032,0.3739094308267553,0.08309098462816784
47,전북특별자치도,남원시,왕정동,왕정동제1투,970,564,423,101,26,6,1,557,7,406,75.94254937163375,18.13285457809695,4.66786355475763,1.0771992818671454,0.17953321364452424
48,전북특별자치도,남원시,왕정동,왕정동제2투,803,426,325,77,18,3,1,424,2,377,76.65094339622641,18.160377358490564,4.245283018867925,0.7075471698113208,0.2358490566037736
49,전북특별자치도,남원시,향교동,관내사전투표,3298,3298,2945,191,119,20,3,3278,20,0,89.84136668700428,5.826723611958511,3.63026235509457,0.6101281269066504,0.09151921903599756
50,전북특별자치도,남원시,향교동,향교동제1투,1368,707,536,133,32,2,1,704,3,661,76.13636363636364,18.892045454545457,4.545454545454546,0.2840909090909091,0.14204545454545456
51,전북특별자치도,남원시,향교동,향교동제2투,451,266,212,41,6,4,0,263,3,185,80.6083650190114,15.5893536121673,2.2813688212927756,1.520912547528517,0.0
52,전북특별자치도,남원시,향교동,향교동제3투,508,240,171,52,10,4,1,238,2,268,71.84873949579831,21.84873949579832,4.201680672268908,1.680672268907563,0.42016806722689076
53,전북특별자치도,남원시,도통동,관내사전투표,6276,6276,5674,322,210,43,4,6253,23,0,90.74044458659843,5.149528226451303,3.3583879737725892,0.6876699184391492,0.0639692947385255
54,전북특별자치도,남원시,도통동,도통동제1투,1058,653,456,144,45,5,0,650,3,405,70.15384615384616,22.153846153846153,6.923076923076923,0.7692307692307693,0.0
55,전북특별자치도,남원시,도통동,도통동제2투,894,492,351,100,28,6,1,486,6,402,72.22222222222221,20.5761316872428,5.761316872427984,1.2345679012345678,0.205761316872428
56,전북특별자치도,남원시,도통동,도통동제3투,1670,949,752,136,48,7,0,943,6,721,79.74549310710498,14.422057264050903,5.090137857900318,0.7423117709437964,0.0
57,전북특별자치도,남원시,도통동,도통동제4투,1192,683,509,108,52,4,1,674,9,509,75.5192878338279,16.023738872403563,7.71513353115727,0.5934718100890208,0.1483679525222552
58,전북특별자치도,남원시,잘못 투입·구분된 투표지,,0,0,0,0,0,0,0,0,0,0,0.0,0.0,0.0,0.0,0.0
0,전북특별자치도,김제시,거소·선상투표,,389,362,278,33,19,3,5,338,24,27,82.24852071005917,9.763313609467456,5.621301775147929,0.8875739644970414,1.4792899408284024
1,전북특별자치도,김제시,관외사전투표,,9141,9140,7409,851,745,60,14,9079,61,1,81.6059037338914,9.373278995484084,8.205749531886772,0.6608657341116864,0.15420200462606012
2,전북특별자치도,김제시,재외투표,,286,227,182,22,17,5,0,226,1,59,80.53097345132744,9.734513274336283,7.52212389380531,2.2123893805309733,0.0
3,전북특별자치도,김제시,만경읍,관내사전투표,1354,1354,1187,107,34,8,3,1339,15,0,88.64824495892456,7.991038088125467,2.539208364451083,0.597460791635549,0.22404779686333084
4,전북특별자치도,김제시,만경읍,만경읍투표소,917,518,381,109,16,4,3,513,5,399,74.26900584795322,21.24756335282651,3.1189083820662766,0.7797270955165692,0.5847953216374269
5,전북특별자치도,김제시,죽산면,관내사전투표,1026,1026,947,46,18,5,2,1018,8,0,93.02554027504911,4.518664047151278,1.768172888015717,0.4911591355599214,0.19646365422396855
6,전북특별자치도,김제시,죽산면,죽산면투표소,852,452,339,88,15,6,0,448,4,400,75.66964285714286,19.642857142857142,3.3482142857142856,1.3392857142857142,0.0
7,전북특별자치도,김제시,백산면,관내사전투표,1629,1629,1475,85,53,3,2,1618,11,0,91.1619283065513,5.253399258343634,3.2756489493201486,0.1854140914709518,0.12360939431396785
8,전북특별자치도,김제시,백산면,백산면투표소,1230,644,490,115,31,3,0,639,5,586,76.68231611893583,17.996870109546165,4.851330203442879,0.4694835680751174,0.0
9,전북특별자치도,김제시,용지면,관내사전투표,1424,1424,1279,95,28,11,4,1417,7,0,90.26111503175723,6.704304869442485,1.9760056457304165,0.776287932251235,0.2822865208186309
10,전북특별자치도,김제시,용지면,용지면투표소,1140,577,409,129,23,8,2,571,6,563,71.62872154115587,22.59194395796848,4.028021015761821,1.4010507880910683,0.3502626970227671
11,전북특별자치도,김제시,백구면,관내사전투표,1463,1463,1340,80,25,10,1,1456,7,0,92.03296703296702,5.4945054945054945,1.7170329670329672,0.6868131868131868,0.06868131868131869
12,전북특별자치도,김제시,백구면,백구면제1투,745,426,337,69,17,1,1,425,1,319,79.29411764705883,16.235294117647058,4.0,0.2352941176470588,0.2352941176470588
13,전북특별자치도,김제시,백구면,백구면제2투,614,341,267,63,8,2,1,341,0,273,78.2991202346041,18.475073313782993,2.346041055718475,0.5865102639296188,0.2932551319648094
14,전북특별자치도,김제시,부량면,관내사전투표,635,635,576,31,19,4,2,632,3,0,91.13924050632912,4.90506329113924,3.0063291139240507,0.6329113924050633,0.31645569620253167
15,전북특별자치도,김제시,부량면,부량면투표소,472,245,183,45,12,1,0,241,4,227,75.93360995850622,18.672199170124482,4.979253112033195,0.4149377593360996,0.0
16,전북특별자치도,김제시,공덕면,관내사전투표,1089,1089,998,58,24,5,2,1087,2,0,91.81232750689972,5.335786568537258,2.2079116835326587,0.45998160073597055,0.18399264029438822
17,전북특별자치도,김제시,공덕면,공덕면투표소,834,489,373,85,25,1,3,487,2,345,76.59137577002053,17.453798767967147,5.133470225872689,0.20533880903490762,0.6160164271047228
18,전북특별자치도,김제시,청하면,관내사전투표,811,811,720,57,23,4,3,807,4,0,89.21933085501858,7.063197026022305,2.8500619578686495,0.49566294919454773,0.37174721189591076
19,전북특별자치도,김제시,청하면,청하면투표소,515,292,215,55,12,4,1,287,5,223,74.91289198606272,19.16376306620209,4.181184668989547,1.3937282229965158,0.34843205574912894
20,전북특별자치도,김제시,성덕면,관내사전투표,753,753,676,49,14,6,0,745,8,0,90.73825503355705,6.577181208053691,1.8791946308724832,0.8053691275167786,0.0
21,전북특별자치도,김제시,성덕면,성덕면투표소,534,276,202,66,3,3,1,275,1,258,73.45454545454545,24.0,1.090909090909091,1.090909090909091,0.36363636363636365
22,전북특별자치도,김제시,진봉면,관내사전투표,901,901,813,50,25,4,2,894,7,0,90.93959731543623,5.592841163310962,2.796420581655481,0.44742729306487694,0.22371364653243847
23,전북특별자치도,김제시,진봉면,진봉면제1투,575,261,200,49,3,3,1,256,5,314,78.125,19.140625,1.171875,1.171875,0.390625
24,전북특별자치도,김제시,진봉면,진봉면제2투,272,173,148,18,4,0,1,171,2,99,86.54970760233918,10.526315789473683,2.3391812865497075,0.0,0.5847953216374269
25,전북특별자치도,김제시,금구면,관내사전투표,1972,1972,1786,113,46,13,3,1961,11,0,91.07598164201937,5.76236613972463,2.3457419683834777,0.6629270780214177,0.1529831718510964
26,전북특별자치도,김제시,금구면,금구면제1투,953,527,377,119,22,5,0,523,4,426,72.08413001912047,22.753346080305928,4.2065009560229445,0.9560229445506693,0.0
27,전북특별자치도,김제시,금구면,금구면제2투,482,249,192,40,8,4,2,246,3,233,78.04878048780488,16.260162601626014,3.2520325203252036,1.6260162601626018,0.8130081300813009
28,전북특별자치도,김제시,금구면,금구면제3투,393,237,186,31,10,4,2,233,4,156,79.82832618025752,13.304721030042918,4.291845493562231,1.7167381974248928,0.8583690987124464
29,전북특별자치도,김제시,봉남면,관내사전투표,899,899,814,57,15,7,4,897,2,0,90.74693422519509,6.354515050167224,1.6722408026755853,0.7803790412486065,0.4459308807134894
30,전북특별자치도,김제시,봉남면,봉남면투표소,835,461,357,78,16,4,2,457,4,374,78.11816192560175,17.067833698030636,3.50109409190372,0.87527352297593,0.437636761487965
31,전북특별자치도,김제시,황산면,관내사전투표,1028,1028,927,59,21,5,2,1014,14,0,91.42011834319527,5.818540433925049,2.0710059171597637,0.4930966469428008,0.19723865877712032
32,전북특별자치도,김제시,황산면,황산면투표소,720,402,320,59,14,4,0,397,5,318,80.60453400503779,14.86146095717884,3.5264483627204033,1.0075566750629723,0.0
33,전북특별자치도,김제시,금산면,관내사전투표,2017,2017,1864,98,32,9,6,2009,8,0,92.78247884519661,4.878048780487805,1.5928322548531608,0.44798407167745147,0.2986560477849677
34,전북특별자치도,김제시,금산면,금산면투표소,1509,788,598,158,17,5,1,779,9,721,76.76508344030809,20.282413350449293,2.1822849807445444,0.6418485237483954,0.12836970474967907
35,전북특별자치도,김제시,광활면,관내사전투표,601,601,551,23,17,3,1,595,6,0,92.60504201680672,3.865546218487395,2.857142857142857,0.5042016806722689,0.16806722689075632
36,전북특별자치도,김제시,광활면,광활면투표소,479,276,233,32,8,1,0,274,2,203,85.03649635036497,11.678832116788321,2.9197080291970803,0.36496350364963503,0.0
37,전북특별자치도,김제시,요촌동,관내사전투표,4076,4076,3663,234,138,13,4,4052,24,0,90.39980256663375,5.774925962487661,3.405725567620928,0.32082922013820336,0.09871668311944717
38,전북특별자치도,김제시,요촌동,요촌동제1투,1713,955,671,193,78,4,2,948,7,758,70.78059071729957,20.35864978902954,8.227848101265822,0.42194092827004215,0.21097046413502107
39,전북특별자치도,김제시,요촌동,요촌동제2투,1964,1110,791,240,55,11,1,1098,12,854,72.04007285974498,21.85792349726776,5.009107468123862,1.0018214936247722,0.09107468123861566
40,전북특별자치도,김제시,요촌동,요촌동제3투,425,267,196,64,6,0,1,267,0,158,73.40823970037454,23.970037453183522,2.247191011235955,0.0,0.37453183520599254
41,전북특별자치도,김제시,신풍동,관내사전투표,4238,4238,3807,257,123,27,8,4222,16,0,90.17053529133112,6.0871624822359065,2.9133112269066794,0.63950734249171,0.18948365703458078
42,전북특별자치도,김제시,신풍동,신풍동제1투,1715,968,684,210,53,13,1,961,7,747,71.17585848074923,21.852237252861602,5.515088449531738,1.352757544224766,0.10405827263267431
43,전북특별자치도,김제시,신풍동,신풍동제2투,1000,514,382,95,25,5,0,507,7,486,75.34516765285996,18.73767258382643,4.930966469428008,0.9861932938856016,0.0
44,전북특별자치도,김제시,신풍동,신풍동제3투,1215,728,535,129,49,7,0,720,8,487,74.30555555555556,17.916666666666668,6.805555555555555,0.9722222222222222,0.0
45,전북특별자치도,김제시,신풍동,신풍동제4투,661,377,308,57,10,0,0,375,2,284,82.13333333333334,15.2,2.666666666666667,0.0,0.0
46,전북특별자치도,김제시,검산동,관내사전투표,4880,4880,4392,251,185,29,4,4861,19,0,90.351779469245,5.163546595350751,3.805801275457725,0.5965850648014812,0.08228759514503188
47,전북특별자치도,김제시,검산동,검산동제1투,2445,1400,1026,243,98,14,3,1384,16,1045,74.13294797687861,17.557803468208093,7.08092485549133,1.0115606936416186,0.2167630057803468
48,전북특별자치도,김제시,검산동,검산동제2투,873,574,490,60,16,2,1,569,5,299,86.11599297012302,10.54481546572935,2.8119507908611596,0.35149384885764495,0.17574692442882248
49,전북특별자치도,김제시,검산동,검산동제3투,1078,683,513,122,37,8,1,681,2,395,75.33039647577093,17.91483113069016,5.4331864904552125,1.1747430249632893,0.14684287812041116
50,전북특별자치도,김제시,교월동,관내사전투표,3108,3108,2787,195,93,16,4,3095,13,0,90.04846526655896,6.30048465266559,3.0048465266558964,0.5169628432956381,0.12924071082390953
51,전북특별자치도,김제시,교월동,교월동제1투,1284,668,508,123,26,5,1,663,5,616,76.6214177978884,18.552036199095024,3.9215686274509802,0.7541478129713424,0.1508295625942685
52,전북특별자치도,김제시,교월동,교월동제2투,1039,613,489,90,23,5,3,610,3,426,80.16393442622952,14.754098360655737,3.7704918032786887,0.819672131147541,0.49180327868852464
53,전북특별자치도,김제시,잘못 투입·구분된 투표지,,0,0,0,0,0,0,0,0,0,0,0.0,0.0,0.0,0.0,0.0
0,전북특별자치도,완주군,거소·선상투표,,264,253,192,31,16,5,1,245,8,11,78.36734693877551,12.653061224489795,6.530612244897959,2.0408163265306123,0.40816326530612246
1,전북특별자치도,완주군,관외사전투표,,14374,14369,11754,1186,1179,138,8,14265,104,5,82.39747634069401,8.314055380301436,8.264984227129338,0.967402733964248,0.056081317910970915
2,전북특별자치도,완주군,재외투표,,322,270,214,35,15,5,0,269,1,52,79.5539033457249,13.011152416356877,5.5762081784386615,1.858736059479554,0.0
3,전북특별자치도,완주군,삼례읍,관내사전투표,6394,6394,5645,402,254,43,3,6347,47,0,88.9396565306444,6.333700961083977,4.001890657003308,0.6774854261855995,0.047266425082716244
4,전북특별자치도,완주군,삼례읍,삼례읍제1투,1678,906,653,173,56,14,1,897,9,772,72.79821627647715,19.286510590858416,6.243032329988852,1.560758082497213,0.11148272017837235
5,전북특별자치도,완주군,삼례읍,삼례읍제2투,1934,1110,857,189,46,9,3,1104,6,824,77.62681159420289,17.119565217391305,4.166666666666666,0.8152173913043478,0.2717391304347826
6,전북특별자치도,완주군,삼례읍,삼례읍제3투,1421,860,672,119,45,12,0,848,12,561,79.24528301886792,14.033018867924529,5.306603773584905,1.4150943396226416,0.0
7,전북특별자치도,완주군,삼례읍,삼례읍제4투,3868,2858,2068,461,274,35,4,2842,16,1010,72.76565798733287,16.22097114707952,9.64109781843772,1.2315270935960592,0.14074595355383532
8,전북특별자치도,완주군,봉동읍,관내사전투표,8194,8194,7289,475,326,61,6,8157,37,0,89.35883290425402,5.823219320828736,3.9965673654529854,0.7478239548853746,0.0735564545788893
9,전북특별자치도,완주군,봉동읍,봉동읍제1투,1460,736,545,131,39,15,2,732,4,724,74.4535519125683,17.89617486338798,5.327868852459016,2.0491803278688523,0.273224043715847
10,전북특별자치도,완주군,봉동읍,봉동읍제2투,2971,1794,1367,286,102,18,10,1783,11,1177,76.66853617498597,16.040381379697138,5.720695457094784,1.0095344924284912,0.5608524957936063
11,전북특별자치도,완주군,봉동읍,봉동읍제3투,3100,2154,1609,349,153,24,6,2141,13,946,75.15179822512845,16.300794021485288,7.146193367585241,1.120971508640822,0.2802428771602055
12,전북특별자치도,완주군,봉동읍,봉동읍제4투,2550,1789,1369,258,132,18,2,1779,10,761,76.95334457560428,14.502529510961216,7.419898819561552,1.0118043844856661,0.11242270938729623
13,전북특별자치도,완주군,용진읍,관내사전투표,3102,3102,2778,156,120,31,5,3090,12,0,89.90291262135922,5.048543689320388,3.8834951456310676,1.0032362459546926,0.16181229773462785
14,전북특별자치도,완주군,용진읍,용진읍제1투,412,247,196,36,12,2,0,246,1,165,79.67479674796748,14.634146341463413,4.878048780487805,0.8130081300813009,0.0
15,전북특별자치도,완주군,용진읍,용진읍제2투,610,382,302,68,8,1,0,379,3,228,79.68337730870712,17.941952506596305,2.1108179419525066,0.2638522427440633,0.0
16,전북특별자치도,완주군,용진읍,용진읍제3투,1891,1264,935,208,93,20,0,1256,8,627,74.44267515923568,16.560509554140125,7.404458598726114,1.5923566878980893,0.0
17,전북특별자치도,완주군,용진읍,용진읍제4투,1124,664,503,116,38,4,0,661,3,460,76.09682299546142,17.549167927382754,5.748865355521937,0.6051437216338881,0.0
18,전북특별자치도,완주군,상관면,관내사전투표,1594,1594,1449,93,35,6,1,1584,10,0,91.47727272727273,5.871212121212121,2.20959595959596,0.3787878787878788,0.06313131313131314
19,전북특별자치도,완주군,상관면,상관면제1투,1069,562,416,119,15,10,1,561,1,507,74.15329768270945,21.21212121212121,2.6737967914438503,1.7825311942959003,0.17825311942959002
20,전북특별자치도,완주군,상관면,상관면제2투,334,182,129,41,6,2,1,179,3,152,72.06703910614524,22.905027932960895,3.35195530726257,1.1173184357541899,0.5586592178770949
21,전북특별자치도,완주군,이서면,관내사전투표,3528,3527,3173,180,119,28,5,3505,22,1,90.527817403709,5.1355206847360915,3.3951497860199713,0.7988587731811698,0.14265335235378032
22,전북특별자치도,완주군,이서면,이서면제1투,1564,910,662,172,55,13,0,902,8,654,73.39246119733924,19.06873614190687,6.097560975609756,1.441241685144124,0.0
23,전북특별자치도,완주군,이서면,이서면제2투,1832,1233,917,218,73,17,1,1226,7,599,74.79608482871126,17.781402936378466,5.954323001631321,1.3866231647634584,0.08156606851549755
24,전북특별자치도,완주군,이서면,이서면제3투,2573,1935,1411,333,152,24,3,1923,12,638,73.3749349973999,17.31669266770671,7.904316172646905,1.24804992199688,0.15600624024961
25,전북특별자치도,완주군,소양면,관내사전투표,2357,2357,2107,133,56,24,6,2326,31,0,90.58469475494411,5.717970765262253,2.407566638005159,1.0318142734307825,0.2579535683576956
26,전북특별자치도,완주군,소양면,소양면제1투,942,568,411,122,21,6,3,563,5,374,73.00177619893428,21.6696269982238,3.7300177619893424,1.0657193605683837,0.5328596802841918
27,전북특별자치도,완주군,소양면,소양면제2투,677,354,257,72,15,5,1,350,4,323,73.42857142857143,20.57142857142857,4.285714285714286,1.4285714285714286,0.2857142857142857
28,전북특별자치도,완주군,소양면,소양면제3투,486,293,215,67,8,0,0,290,3,193,74.13793103448276,23.103448275862068,2.7586206896551726,0.0,0.0
29,전북특별자치도,완주군,구이면,관내사전투표,2087,2087,1894,128,42,12,1,2077,10,0,91.18921521425133,6.162734713529129,2.0221473278767452,0.5777563793933558,0.04814636494944632
30,전북특별자치도,완주군,구이면,구이면제1투,877,569,366,159,33,7,0,565,4,308,64.7787610619469,28.14159292035398,5.84070796460177,1.238938053097345,0.0
31,전북특별자치도,완주군,구이면,구이면제2투,671,429,348,67,8,3,1,427,2,242,81.49882903981265,15.690866510538642,1.873536299765808,0.702576112412178,0.234192037470726
32,전북특별자치도,완주군,구이면,구이면제3투,573,362,276,71,8,3,0,358,4,211,77.09497206703911,19.832402234636874,2.2346368715083798,0.8379888268156425,0.0
33,전북특별자치도,완주군,고산면,관내사전투표,2509,2509,2225,144,60,30,13,2472,37,0,90.00809061488673,5.825242718446602,2.4271844660194173,1.2135922330097086,0.5258899676375405
34,전북특별자치도,완주군,고산면,고산면제1투,944,498,380,81,16,10,1,488,10,446,77.8688524590164,16.598360655737704,3.278688524590164,2.0491803278688523,0.20491803278688525
35,전북특별자치도,완주군,고산면,고산면제2투,456,297,242,38,8,3,1,292,5,159,82.87671232876713,13.013698630136986,2.73972602739726,1.0273972602739725,0.3424657534246575
36,전북특별자치도,완주군,비봉면,관내사전투표,905,905,792,67,27,8,1,895,10,0,88.49162011173183,7.486033519553073,3.016759776536313,0.8938547486033519,0.11173184357541899
37,전북특별자치도,완주군,비봉면,비봉면투표소,608,345,283,47,9,5,1,345,0,263,82.02898550724638,13.623188405797102,2.608695652173913,1.4492753623188406,0.2898550724637681
38,전북특별자치도,완주군,운주면,관내사전투표,760,760,613,107,23,8,2,753,7,0,81.40770252324037,14.209827357237717,3.054448871181939,1.0624169986719787,0.2656042496679947
39,전북특별자치도,완주군,운주면,운주면투표소,672,395,244,130,16,1,2,393,2,277,62.086513994910945,33.078880407124686,4.071246819338422,0.2544529262086514,0.5089058524173028
40,전북특별자치도,완주군,화산면,관내사전투표,878,878,782,58,28,4,2,874,4,0,89.47368421052632,6.636155606407322,3.203661327231121,0.4576659038901602,0.2288329519450801
41,전북특별자치도,완주군,화산면,화산면투표소,898,501,356,118,15,4,3,496,5,397,71.7741935483871,23.790322580645164,3.024193548387097,0.8064516129032258,0.6048387096774194
42,전북특별자치도,완주군,동상면,관내사전투표,325,325,285,27,10,2,0,324,1,0,87.96296296296296,8.333333333333332,3.0864197530864197,0.6172839506172839,0.0
43,전북특별자치도,완주군,동상면,동상면투표소,269,119,86,26,3,2,0,117,2,150,73.50427350427351,22.22222222222222,2.564102564102564,1.7094017094017095,0.0
44,전북특별자치도,완주군,경천면,관내사전투표,579,579,506,48,10,6,3,573,6,0,88.30715532286213,8.37696335078534,1.7452006980802792,1.0471204188481675,0.5235602094240838
45,전북특별자치도,완주군,경천면,경천면투표소,311,174,114,47,4,3,1,169,5,137,67.45562130177515,27.810650887573964,2.366863905325444,1.7751479289940828,0.591715976331361
46,전북특별자치도,완주군,잘못 투입·구분된 투표지,,0,2,2,0,0,0,0,2,0,-2,100.0,0.0,0.0,0.0,0.0
0,전북특별자치도,진안군,거소·선상투표,,84,76,62,7,3,0,0,72,4,8,86.11111111111111,9.722222222222223,4.166666666666666,0.0,0.0
1,전북특별자치도,진안군,관외사전투표,,3686,3685,2992,339,298,36,4,3669,16,1,81.5481057508858,9.239574816026165,8.122104115562824,0.9811937857726901,0.10902153175252113
2,전북특별자치도,진안군,재외투표,,105,83,70,7,5,1,0,83,0,22,84.33734939759037,8.433734939759036,6.024096385542169,1.2048192771084338,0.0
3,전북특별자치도,진안군,진안읍,관내사전투표,4125,4124,3638,286,131,33,9,4097,27,1,88.79668049792531,6.980717598242617,3.1974615572370024,0.8054674151818403,0.2196729314132292
4,전북특별자치도,진안군,진안읍,진안읍제1투,911,511,353,119,29,5,3,509,2,400,69.3516699410609,23.37917485265226,5.697445972495088,0.9823182711198428,0.5893909626719057
5,전북특별자치도,진안군,진안읍,진안읍제2투,1223,726,532,148,35,6,1,722,4,497,73.68421052631578,20.498614958448755,4.847645429362881,0.8310249307479225,0.13850415512465375
6,전북특별자치도,진안군,진안읍,진안읍제3투,1210,647,483,129,27,1,2,642,5,563,75.23364485981308,20.093457943925234,4.205607476635514,0.1557632398753894,0.3115264797507788
7,전북특별자치도,진안군,용담면,관내사전투표,417,417,350,52,8,0,4,414,3,0,84.54106280193237,12.560386473429952,1.932367149758454,0.0,0.966183574879227
8,전북특별자치도,진안군,용담면,용담면투표소,280,167,100,62,2,1,0,165,2,113,60.60606060606061,37.57575757575757,1.2121212121212122,0.6060606060606061,0.0
9,전북특별자치도,진안군,안천면,관내사전투표,488,488,413,43,22,2,1,481,7,0,85.86278586278586,8.93970893970894,4.5738045738045745,0.4158004158004158,0.2079002079002079
10,전북특별자치도,진안군,안천면,안천면투표소,364,217,138,69,7,0,0,214,3,147,64.48598130841121,32.242990654205606,3.2710280373831773,0.0,0.0
11,전북특별자치도,진안군,동향면,관내사전투표,648,648,587,37,12,6,2,644,4,0,91.14906832298136,5.745341614906832,1.8633540372670807,0.9316770186335404,0.3105590062111801
12,전북특별자치도,진안군,동향면,동향면투표소,383,228,177,40,5,1,2,225,3,155,78.66666666666666,17.77777777777778,2.2222222222222223,0.4444444444444444,0.8888888888888888
13,전북특별자치도,진안군,상전면,관내사전투표,341,341,311,19,6,2,2,340,1,0,91.47058823529412,5.588235294117648,1.7647058823529411,0.5882352941176471,0.5882352941176471
14,전북특별자치도,진안군,상전면,상전면투표소,234,138,102,31,3,1,0,137,1,96,74.45255474452554,22.62773722627737,2.18978102189781,0.7299270072992701,0.0
15,전북특별자치도,진안군,백운면,관내사전투표,828,828,738,44,22,9,1,814,14,0,90.66339066339066,5.405405405405405,2.7027027027027026,1.1056511056511056,0.12285012285012285
16,전북특별자치도,진안군,백운면,백운면투표소,570,316,235,63,11,4,1,314,2,254,74.84076433121018,20.063694267515924,3.5031847133757963,1.2738853503184715,0.3184713375796179
17,전북특별자치도,진안군,성수면,관내사전투표,632,632,568,37,15,7,2,629,3,0,90.30206677265501,5.88235294117647,2.384737678855326,1.1128775834658187,0.3179650238473768
18,전북특별자치도,진안군,성수면,성수면투표소,574,331,257,65,4,3,0,329,2,243,78.11550151975683,19.756838905775076,1.21580547112462,0.911854103343465,0.0
19,전북특별자치도,진안군,마령면,관내사전투표,687,687,619,50,9,5,1,684,3,0,90.49707602339181,7.309941520467836,1.3157894736842104,0.7309941520467835,0.14619883040935672
20,전북특별자치도,진안군,마령면,마령면투표소,595,336,257,67,10,1,0,335,1,259,76.71641791044776,20.0,2.9850746268656714,0.2985074626865672,0.0
21,전북특별자치도,진안군,부귀면,관내사전투표,1057,1057,949,73,25,4,1,1052,5,0,90.20912547528516,6.939163498098859,2.376425855513308,0.38022813688212925,0.09505703422053231
22,전북특별자치도,진안군,부귀면,부귀면투표소,849,478,351,103,15,4,1,474,4,371,74.0506329113924,21.729957805907173,3.1645569620253164,0.8438818565400843,0.21097046413502107
23,전북특별자치도,진안군,정천면,관내사전투표,438,438,402,25,4,5,2,438,0,0,91.78082191780823,5.707762557077626,0.91324200913242,1.141552511415525,0.45662100456621
24,전북특별자치도,진안군,정천면,정천면투표소,336,205,165,31,3,1,1,201,4,131,82.08955223880598,15.422885572139302,1.4925373134328357,0.4975124378109453,0.4975124378109453
25,전북특별자치도,진안군,주천면,관내사전투표,688,688,572,80,21,7,3,683,5,0,83.74816983894583,11.71303074670571,3.074670571010249,1.0248901903367496,0.43923865300146414
26,전북특별자치도,진안군,주천면,주천면투표소,483,278,180,81,10,1,2,274,4,205,65.69343065693431,29.56204379562044,3.64963503649635,0.36496350364963503,0.7299270072992701
27,전북특별자치도,진안군,잘못 투입·구분된 투표지,,0,0,0,0,0,0,0,0,0,0,0.0,0.0,0.0,0.0,0.0
0,전북특별자치도,무주군,거소·선상투표,,111,104,74,9,13,1,3,100,4,7,74.0,9.0,13.0,1.0,3.0
1,전북특별자치도,무주군,관외사전투표,,2263,2262,1625,396,196,20,4,2241,21,1,72.51227130745202,17.670682730923694,8.746095493083445,0.892458723784025,0.178491744756805
2,전북특별자치도,무주군,재외투표,,109,89,74,9,5,1,0,89,0,20,83.14606741573034,10.112359550561797,5.617977528089887,1.1235955056179776,0.0
3,전북특별자치도,무주군,무주읍,관내사전투표,4300,4300,3606,412,202,37,12,4269,31,0,84.46943078004216,9.650972124619349,4.7317873038182245,0.8667135160459125,0.28109627547434995
4,전북특별자치도,무주군,무주읍,무주읍제1투,1937,1168,770,323,59,8,2,1162,6,769,66.26506024096386,27.796901893287433,5.077452667814113,0.6884681583476765,0.17211703958691912
5,전북특별자치도,무주군,무주읍,무주읍제2투,1152,629,409,185,26,7,1,628,1,523,65.12738853503186,29.458598726114648,4.140127388535031,1.1146496815286624,0.15923566878980894
6,전북특별자치도,무주군,무풍면,관내사전투표,882,882,704,140,31,4,1,880,2,0,80.0,15.909090909090908,3.5227272727272725,0.45454545454545453,0.11363636363636363
7,전북특별자치도,무주군,무풍면,무풍면투표소,863,512,314,165,23,3,1,506,6,351,62.055335968379445,32.608695652173914,4.545454545454546,0.592885375494071,0.1976284584980237
8,전북특별자치도,무주군,설천면,관내사전투표,1411,1411,1148,178,62,10,3,1401,10,0,81.94147037830122,12.70521056388294,4.425410421127766,0.7137758743754461,0.21413276231263384
9,전북특별자치도,무주군,설천면,설천면제1투,837,462,271,165,18,4,1,459,3,375,59.04139433551199,35.947712418300654,3.9215686274509802,0.8714596949891068,0.2178649237472767
10,전북특별자치도,무주군,설천면,설천면제2투,656,462,335,108,11,2,1,457,5,194,73.30415754923413,23.63238512035011,2.4070021881838075,0.437636761487965,0.2188183807439825
11,전북특별자치도,무주군,적상면,관내사전투표,1005,1005,855,101,24,7,2,989,16,0,86.45096056622852,10.212335692618806,2.4266936299292214,0.7077856420626896,0.20222446916076847
12,전북특별자치도,무주군,적상면,적상면투표소,1042,651,419,202,14,3,4,642,9,391,65.26479750778816,31.464174454828658,2.1806853582554515,0.46728971962616817,0.6230529595015576
13,전북특별자치도,무주군,안성면,관내사전투표,1902,1902,1675,156,41,19,4,1895,7,0,88.39050131926122,8.232189973614776,2.163588390501319,1.0026385224274408,0.21108179419525064
14,전북특별자치도,무주군,안성면,안성면투표소,1384,702,479,170,35,5,4,693,9,682,69.11976911976912,24.53102453102453,5.05050505050505,0.7215007215007215,0.5772005772005772
15,전북특별자치도,무주군,부남면,관내사전투표,569,569,468,67,19,3,4,561,8,0,83.42245989304813,11.942959001782532,3.3868092691622103,0.53475935828877,0.7130124777183601
16,전북특별자치도,무주군,부남면,부남면투표소,476,273,169,90,6,1,0,266,7,203,63.53383458646616,33.83458646616541,2.2556390977443606,0.37593984962406013,0.0
17,전북특별자치도,무주군,잘못 투입·구분된 투표지,,0,0,0,0,0,0,0,0,0,0,0.0,0.0,0.0,0.0,0.0
0,전북특별자치도,장수군,거소·선상투표,,55,51,43,1,7,0,0,51,0,4,84.31372549019608,1.9607843137254901,13.725490196078432,0.0,0.0
1,전북특별자치도,장수군,관외사전투표,,2250,2249,1781,248,166,30,4,2229,20,1,79.90130103185284,11.126065500224316,7.447285778375953,1.3458950201884252,0.1794526693584567
2,전북특별자치도,장수군,재외투표,,91,68,55,7,4,1,0,67,1,23,82.08955223880598,10.44776119402985,5.970149253731343,1.4925373134328357,0.0
3,전북특별자치도,장수군,장수읍,관내사전투표,2972,2972,2602,192,116,28,7,2945,27,0,88.35314091680814,6.519524617996604,3.9388794567062817,0.9507640067911713,0.23769100169779284
4,전북특별자치도,장수군,장수읍,장수읍제1투,1693,1009,771,177,44,10,1,1003,6,684,76.86939182452642,17.647058823529413,4.3868394815553335,0.9970089730807578,0.09970089730807577
5,전북특별자치도,장수군,장수읍,장수읍제2투,686,453,342,90,9,4,2,447,6,233,76.51006711409396,20.13422818791946,2.013422818791946,0.8948545861297539,0.44742729306487694
6,전북특별자치도,장수군,산서면,관내사전투표,917,917,827,61,12,10,1,911,6,0,90.77936333699232,6.695938529088913,1.3172338090010975,1.0976948408342482,0.10976948408342481
7,전북특별자치도,장수군,산서면,산서면투표소,579,319,256,44,11,5,0,316,3,260,81.0126582278481,13.924050632911392,3.481012658227848,1.5822784810126582,0.0
8,전북특별자치도,장수군,번암면,관내사전투표,970,970,866,75,15,2,5,963,7,0,89.92731048805815,7.78816199376947,1.557632398753894,0.20768431983385255,0.5192107995846313
9,전북특별자치도,장수군,번암면,번암면투표소,758,427,326,87,8,2,2,425,2,331,76.70588235294117,20.47058823529412,1.8823529411764703,0.4705882352941176,0.4705882352941176
10,전북특별자치도,장수군,장계면,관내사전투표,2002,2002,1766,155,59,10,4,1994,8,0,88.56569709127382,7.773319959879639,2.958876629889669,0.5015045135406219,0.20060180541624875
11,전북특별자치도,장수군,장계면,장계면투표소,1290,710,536,135,27,6,2,706,4,580,75.92067988668555,19.121813031161473,3.824362606232295,0.84985835694051,0.28328611898017
12,전북특별자치도,장수군,천천면,관내사전투표,856,856,755,71,13,9,3,851,5,0,88.71915393654524,8.343125734430082,1.527614571092832,1.0575793184488838,0.35252643948296125
13,전북특별자치도,장수군,천천면,천천면투표소,742,397,271,109,10,3,2,395,2,345,68.60759493670886,27.59493670886076,2.5316455696202533,0.7594936708860759,0.5063291139240507
14,전북특별자치도,장수군,계남면,관내사전투표,870,870,796,50,12,7,0,865,5,0,92.02312138728324,5.780346820809249,1.3872832369942196,0.8092485549132947,0.0
15,전북특별자치도,장수군,계남면,계남면투표소,657,366,277,68,15,1,2,363,3,291,76.30853994490359,18.732782369146005,4.132231404958678,0.27548209366391185,0.5509641873278237
16,전북특별자치도,장수군,계북면,관내사전투표,702,702,614,50,25,7,1,697,5,0,88.09182209469154,7.173601147776183,3.5868005738880915,1.0043041606886656,0.1434720229555237
17,전북특별자치도,장수군,계북면,계북면투표소,498,267,201,41,14,3,2,261,6,231,77.01149425287356,15.708812260536398,5.363984674329502,1.1494252873563218,0.7662835249042145
18,전북특별자치도,장수군,잘못 투입·구분된 투표지,,0,0,0,0,0,0,0,0,0,0,0.0,0.0,0.0,0.0,0.0
0,전북특별자치도,임실군,거소·선상투표,,86,83,68,8,3,2,0,81,2,3,83.9506172839506,9.876543209876543,3.7037037037037033,2.4691358024691357,0.0
1,전북특별자치도,임실군,관외사전투표,,3844,3841,3201,342,240,29,4,3816,25,3,83.88364779874213,8.962264150943396,6.289308176100629,0.759958071278826,0.10482180293501049
2,전북특별자치도,임실군,재외투표,,96,78,63,9,6,0,0,78,0,18,80.76923076923077,11.538461538461538,7.6923076923076925,0.0,0.0
3,전북특별자치도,임실군,임실읍,관내사전투표,3037,3037,2654,215,117,26,5,3017,20,0,87.96818031156778,7.126284388465363,3.8780245276764997,0.8617832283725556,0.16572754391779915
4,전북특별자치도,임실군,임실읍,임실읍제1투,1280,753,538,162,39,3,3,745,8,527,72.21476510067114,21.74496644295302,5.23489932885906,0.4026845637583893,0.4026845637583893
5,전북특별자치도,임실군,임실읍,임실읍제2투,1003,584,427,114,32,6,0,579,5,419,73.74784110535406,19.689119170984455,5.526770293609672,1.0362694300518136,0.0
6,전북특별자치도,임실군,청웅면,관내사전투표,573,573,519,36,6,5,2,568,5,0,91.37323943661971,6.338028169014084,1.056338028169014,0.8802816901408451,0.35211267605633806
7,전북특별자치도,임실군,청웅면,청웅면투표소,414,221,172,36,5,7,0,220,1,193,78.18181818181819,16.363636363636363,2.272727272727273,3.1818181818181817,0.0
8,전북특별자치도,임실군,운암면,관내사전투표,265,265,238,18,6,1,0,263,2,0,90.49429657794677,6.844106463878327,2.2813688212927756,0.38022813688212925,0.0
9,전북특별자치도,임실군,운암면,운암면제1투,161,96,72,19,1,1,0,93,3,65,77.41935483870968,20.43010752688172,1.0752688172043012,1.0752688172043012,0.0
10,전북특별자치도,임실군,운암면,운암면제2투,172,132,123,8,0,0,1,132,0,40,93.18181818181817,6.0606060606060606,0.0,0.0,0.7575757575757576
11,전북특별자치도,임실군,운암면,운암면제3투,317,216,153,44,12,4,0,213,3,101,71.83098591549296,20.657276995305164,5.633802816901409,1.8779342723004695,0.0
12,전북특별자치도,임실군,신평면,관내사전투표,460,460,413,29,7,4,3,456,4,0,90.5701754385965,6.359649122807018,1.5350877192982455,0.8771929824561403,0.6578947368421052
13,전북특별자치도,임실군,신평면,신평면투표소,478,266,205,49,3,1,0,258,8,212,79.45736434108527,18.992248062015506,1.1627906976744187,0.3875968992248062,0.0
14,전북특별자치도,임실군,성수면,관내사전투표,573,573,511,37,13,4,5,570,3,0,89.64912280701755,6.491228070175438,2.280701754385965,0.7017543859649122,0.8771929824561403
15,전북특별자치도,임실군,성수면,성수면투표소,581,343,274,51,11,2,1,339,4,238,80.8259587020649,15.04424778761062,3.2448377581120944,0.5899705014749262,0.2949852507374631
16,전북특별자치도,임실군,오수면,관내사전투표,1690,1690,1557,81,24,11,3,1676,14,0,92.89976133651552,4.832935560859188,1.431980906921241,0.6563245823389021,0.17899761336515513
17,전북특별자치도,임실군,오수면,오수면투표소,1145,612,479,108,20,2,1,610,2,533,78.52459016393442,17.704918032786885,3.278688524590164,0.32786885245901637,0.16393442622950818
18,전북특별자치도,임실군,신덕면,관내사전투표,397,397,364,20,7,3,1,395,2,0,92.15189873417722,5.063291139240507,1.7721518987341773,0.7594936708860759,0.25316455696202533
19,전북특별자치도,임실군,신덕면,신덕면투표소,425,222,184,30,6,1,1,222,0,203,82.88288288288288,13.513513513513514,2.7027027027027026,0.45045045045045046,0.45045045045045046
20,전북특별자치도,임실군,삼계면,관내사전투표,485,485,438,25,13,3,2,481,4,0,91.06029106029106,5.197505197505198,2.7027027027027026,0.6237006237006237,0.4158004158004158
21,전북특별자치도,임실군,삼계면,삼계면투표소,512,269,214,38,7,3,3,265,4,243,80.75471698113208,14.339622641509434,2.6415094339622645,1.1320754716981132,1.1320754716981132
22,전북특별자치도,임실군,관촌면,관내사전투표,1653,1653,1489,101,42,9,2,1643,10,0,90.626902008521,6.1472915398660986,2.556299452221546,0.5477784540474742,0.12172854534388314
23,전북특별자치도,임실군,관촌면,관촌면투표소,989,537,408,96,23,4,1,532,5,452,76.69172932330827,18.045112781954884,4.323308270676692,0.7518796992481203,0.18796992481203006
24,전북특별자치도,임실군,강진면,관내사전투표,705,705,640,43,15,1,2,701,4,0,91.2981455064194,6.134094151212553,2.1398002853067046,0.14265335235378032,0.28530670470756064
25,전북특별자치도,임실군,강진면,강진면투표소,475,251,194,36,14,3,1,248,3,224,78.2258064516129,14.516129032258066,5.64516129032258,1.2096774193548387,0.4032258064516129
26,전북특별자치도,임실군,덕치면,관내사전투표,386,386,354,25,1,0,1,381,5,0,92.91338582677166,6.561679790026247,0.26246719160104987,0.0,0.26246719160104987
27,전북특별자치도,임실군,덕치면,덕치면투표소,358,192,155,22,8,1,2,188,4,166,82.4468085106383,11.702127659574469,4.25531914893617,0.5319148936170213,1.0638297872340425
28,전북특별자치도,임실군,지사면,관내사전투표,426,426,399,16,4,2,0,421,5,0,94.77434679334917,3.800475059382423,0.9501187648456058,0.4750593824228029,0.0
29,전북특별자치도,임실군,지사면,지사면투표소,356,207,172,31,1,0,2,206,1,149,83.49514563106796,15.048543689320388,0.48543689320388345,0.0,0.9708737864077669
30,전북특별자치도,임실군,잘못 투입·구분된 투표지,,0,0,0,0,0,0,0,0,0,0,0.0,0.0,0.0,0.0,0.0
0,전북특별자치도,순창군,거소·선상투표,,125,122,89,16,6,1,0,112,10,3,79.46428571428571,14.285714285714285,5.357142857142857,0.8928571428571428,0.0
1,전북특별자치도,순창군,관외사전투표,,3634,3634,3001,318,267,19,2,3607,27,0,83.19933462711394,8.816190740227334,7.402273357360688,0.5267535347934572,0.05544774050457444
2,전북특별자치도,순창군,재외투표,,129,106,85,12,5,4,0,106,0,23,80.18867924528303,11.320754716981133,4.716981132075472,3.7735849056603774,0.0
3,전북특별자치도,순창군,순창읍,관내사전투표,4388,4388,3929,266,132,36,4,4367,21,0,89.97023128005496,6.091138081062515,3.022670025188917,0.8243645523242501,0.09159606136936112
4,전북특별자치도,순창군,순창읍,순창읍제1투,763,430,325,76,22,3,1,427,3,333,76.11241217798595,17.798594847775178,5.152224824355972,0.702576112412178,0.234192037470726
5,전북특별자치도,순창군,순창읍,순창읍제2투,1165,659,488,137,26,3,0,654,5,506,74.61773700305811,20.948012232415902,3.9755351681957185,0.45871559633027525,0.0
6,전북특별자치도,순창군,순창읍,순창읍제3투,923,543,414,97,20,5,1,537,6,380,77.09497206703911,18.063314711359403,3.7243947858473,0.931098696461825,0.186219739292365
7,전북특별자치도,순창군,인계면,관내사전투표,867,867,779,52,20,5,2,858,9,0,90.79254079254079,6.0606060606060606,2.331002331002331,0.5827505827505828,0.2331002331002331
8,전북특별자치도,순창군,인계면,인계면투표소,352,198,150,36,4,0,3,193,5,154,77.720207253886,18.65284974093264,2.072538860103627,0.0,1.5544041450777202
9,전북특별자치도,순창군,동계면,관내사전투표,953,953,843,66,25,6,4,944,9,0,89.30084745762711,6.991525423728813,2.6483050847457625,0.6355932203389831,0.423728813559322
10,전북특별자치도,순창군,동계면,동계면투표소,501,270,207,45,9,5,0,266,4,231,77.81954887218046,16.917293233082706,3.3834586466165413,1.8796992481203008,0.0
11,전북특별자치도,순창군,적성면,관내사전투표,692,692,604,45,24,6,2,681,11,0,88.69309838472834,6.607929515418502,3.524229074889868,0.881057268722467,0.2936857562408223
12,전북특별자치도,순창군,적성면,적성면투표소,275,137,97,29,5,1,1,133,4,138,72.93233082706767,21.804511278195488,3.7593984962406015,0.7518796992481203,0.7518796992481203
13,전북특별자치도,순창군,유등면,관내사전투표,644,644,587,32,11,7,0,637,7,0,92.15070643642072,5.023547880690738,1.726844583987441,1.098901098901099,0.0
14,전북특별자치도,순창군,유등면,유등면투표소,259,138,112,24,1,0,0,137,1,121,81.75182481751825,17.51824817518248,0.7299270072992701,0.0,0.0
15,전북특별자치도,순창군,풍산면,관내사전투표,699,699,622,38,20,8,2,690,9,0,90.14492753623189,5.507246376811594,2.898550724637681,1.1594202898550725,0.2898550724637681
16,전북특별자치도,순창군,풍산면,풍산면투표소,455,225,164,43,9,5,2,223,2,230,73.54260089686099,19.282511210762333,4.0358744394618835,2.242152466367713,0.8968609865470852
17,전북특별자치도,순창군,금과면,관내사전투표,914,914,814,64,17,11,2,908,6,0,89.64757709251101,7.048458149779736,1.8722466960352422,1.2114537444933922,0.22026431718061676
18,전북특별자치도,순창군,금과면,금과면투표소,442,214,167,29,8,2,2,208,6,228,80.28846153846155,13.942307692307693,3.8461538461538463,0.9615384615384616,0.9615384615384616
19,전북특별자치도,순창군,팔덕면,관내사전투표,926,926,832,59,22,5,1,919,7,0,90.53318824809575,6.420021762785637,2.3939064200217626,0.544069640914037,0.1088139281828074
20,전북특별자치도,순창군,팔덕면,팔덕면투표소,322,163,126,23,10,2,0,161,2,159,78.26086956521739,14.285714285714285,6.211180124223603,1.2422360248447204,0.0
21,전북특별자치도,순창군,복흥면,관내사전투표,1017,1017,939,63,8,2,2,1014,3,0,92.60355029585799,6.21301775147929,0.7889546351084813,0.19723865877712032,0.19723865877712032
22,전북특별자치도,순창군,복흥면,복흥면제1투,334,161,134,19,7,1,0,161,0,173,83.22981366459628,11.801242236024844,4.3478260869565215,0.6211180124223602,0.0
23,전북특별자치도,순창군,복흥면,복흥면제2투,221,147,119,20,5,1,0,145,2,74,82.06896551724138,13.793103448275861,3.4482758620689653,0.6896551724137931,0.0
24,전북특별자치도,순창군,쌍치면,관내사전투표,946,946,842,72,17,3,0,934,12,0,90.14989293361884,7.708779443254818,1.8201284796573876,0.32119914346895073,0.0
25,전북특별자치도,순창군,쌍치면,쌍치면투표소,521,313,230,62,13,5,2,312,1,208,73.71794871794873,19.871794871794872,4.166666666666666,1.6025641025641024,0.641025641025641
26,전북특별자치도,순창군,구림면,관내사전투표,1092,1092,986,64,23,10,2,1085,7,0,90.87557603686636,5.8986175115207375,2.1198156682027647,0.9216589861751152,0.18433179723502305
27,전북특별자치도,순창군,구림면,구림면제1투,402,198,140,47,9,1,0,197,1,204,71.06598984771574,23.85786802030457,4.568527918781726,0.5076142131979695,0.0
28,전북특별자치도,순창군,구림면,구림면제2투,223,134,97,30,5,0,0,132,2,89,73.48484848484848,22.727272727272727,3.787878787878788,0.0,0.0
29,전북특별자치도,순창군,잘못 투입·구분된 투표지,,0,0,0,0,0,0,0,0,0,0,0.0,0.0,0.0,0.0,0.0
0,전북특별자치도,고창군,거소·선상투표,,236,221,180,20,9,3,2,214,7,15,84.11214953271028,9.345794392523365,4.205607476635514,1.4018691588785046,0.9345794392523363
1,전북특별자치도,고창군,관외사전투표,,4570,4570,3682,428,368,40,7,4525,45,0,81.37016574585635,9.458563535911601,8.132596685082873,0.8839779005524863,0.15469613259668508
2,전북특별자치도,고창군,재외투표,,179,153,126,15,12,0,0,153,0,26,82.35294117647058,9.803921568627452,7.8431372549019605,0.0,0.0
3,전북특별자치도,고창군,고창읍,관내사전투표,7129,7128,6311,479,255,45,2,7092,36,1,88.98759165256627,6.754089114495206,3.5956006768189512,0.6345177664974619,0.028200789622109423
4,전북특별자치도,고창군,고창읍,고창읍제1투,787,447,327,91,22,2,0,442,5,340,73.98190045248869,20.588235294117645,4.97737556561086,0.4524886877828055,0.0
5,전북특별자치도,고창군,고창읍,고창읍제2투,960,598,469,89,31,3,1,593,5,362,79.0893760539629,15.008431703204048,5.227655986509275,0.5059021922428331,0.16863406408094433
6,전북특별자치도,고창군,고창읍,고창읍제3투,976,605,486,92,22,1,0,601,4,371,80.86522462562395,15.307820299500833,3.6605657237936775,0.16638935108153077,0.0
7,전북특별자치도,고창군,고창읍,고창읍제4투,738,428,334,66,14,10,0,424,4,310,78.77358490566037,15.566037735849056,3.30188679245283,2.358490566037736,0.0
8,전북특별자치도,고창군,고창읍,고창읍제5투,974,593,304,262,18,2,1,587,6,381,51.78875638841567,44.63373083475298,3.0664395229982966,0.34071550255536626,0.17035775127768313
9,전북특별자치도,고창군,고창읍,고창읍제6투,983,653,540,76,25,4,1,646,7,330,83.59133126934985,11.76470588235294,3.8699690402476783,0.6191950464396285,0.15479876160990713
10,전북특별자치도,고창군,고창읍,고창읍제7투,1658,1074,882,132,35,14,3,1066,8,584,82.73921200750469,12.382739212007504,3.283302063789869,1.3133208255159476,0.28142589118198874
11,전북특별자치도,고창군,고수면,관내사전투표,1576,1576,1423,81,51,6,7,1568,8,0,90.75255102040816,5.165816326530613,3.2525510204081636,0.3826530612244898,0.4464285714285714
12,전북특별자치도,고창군,고수면,고수면투표소,831,445,356,74,8,2,1,441,4,386,80.72562358276643,16.780045351473923,1.8140589569160999,0.45351473922902497,0.22675736961451248
13,전북특별자치도,고창군,아산면,관내사전투표,1524,1524,1383,83,38,11,1,1516,8,0,91.2269129287599,5.474934036939314,2.5065963060686016,0.7255936675461742,0.06596306068601583
14,전북특별자치도,고창군,아산면,아산면제1투,538,286,210,61,8,3,1,283,3,252,74.20494699646643,21.554770318021202,2.8268551236749118,1.0600706713780919,0.35335689045936397
15,전북특별자치도,고창군,아산면,아산면제2투,316,203,149,38,7,4,2,200,3,113,74.5,19.0,3.5000000000000004,2.0,1.0
16,전북특별자치도,고창군,무장면,관내사전투표,1328,1328,1190,88,22,8,8,1316,12,0,90.42553191489363,6.68693009118541,1.6717325227963524,0.60790273556231,0.60790273556231
17,전북특별자치도,고창군,무장면,무장면투표소,892,490,386,70,18,7,3,484,6,402,79.75206611570248,14.46280991735537,3.71900826446281,1.4462809917355373,0.6198347107438017
18,전북특별자치도,고창군,공음면,관내사전투표,1162,1162,1052,70,21,3,3,1149,13,0,91.55787641427328,6.092254134029591,1.8276762402088773,0.26109660574412535,0.26109660574412535
19,전북특별자치도,고창군,공음면,공음면투표소,754,370,277,62,19,4,1,363,7,384,76.30853994490359,17.079889807162534,5.234159779614325,1.1019283746556474,0.27548209366391185
20,전북특별자치도,고창군,상하면,관내사전투표,1213,1213,1105,59,21,9,5,1199,14,0,92.16013344453712,4.920767306088407,1.7514595496246872,0.7506255212677231,0.4170141784820684
21,전북특별자치도,고창군,상하면,상하면투표소,619,344,279,41,13,3,3,339,5,275,82.30088495575221,12.094395280235988,3.8348082595870205,0.8849557522123894,0.8849557522123894
22,전북특별자치도,고창군,해리면,관내사전투표,1337,1337,1211,74,26,4,11,1326,11,0,91.32730015082956,5.580693815987934,1.9607843137254901,0.301659125188537,0.8295625942684767
23,전북특별자치도,고창군,해리면,해리면제1투,479,231,178,43,9,1,0,231,0,248,77.05627705627705,18.614718614718615,3.896103896103896,0.4329004329004329,0.0
24,전북특별자치도,고창군,해리면,해리면제2투,350,198,158,33,7,0,0,198,0,152,79.7979797979798,16.666666666666664,3.535353535353535,0.0,0.0
25,전북특별자치도,고창군,성송면,관내사전투표,805,805,741,39,16,6,1,803,2,0,92.27895392278954,4.85678704856787,1.9925280199252802,0.7471980074719801,0.12453300124533001
26,전북특별자치도,고창군,성송면,성송면투표소,573,308,239,55,9,2,0,305,3,265,78.36065573770492,18.0327868852459,2.9508196721311477,0.6557377049180327,0.0
27,전북특별자치도,고창군,대산면,관내사전투표,1458,1458,1337,62,27,8,5,1439,19,0,92.91174426685198,4.308547602501737,1.8763029881862403,0.5559416261292565,0.34746351633078526
28,전북특별자치도,고창군,대산면,대산면제1투,595,314,265,35,10,0,2,312,2,281,84.93589743589743,11.217948717948719,3.205128205128205,0.0,0.641025641025641
29,전북특별자치도,고창군,대산면,대산면제2투,478,293,256,25,6,1,2,290,3,185,88.27586206896552,8.620689655172415,2.0689655172413794,0.3448275862068966,0.6896551724137931
30,전북특별자치도,고창군,심원면,관내사전투표,1078,1078,997,55,15,3,4,1074,4,0,92.83054003724395,5.121042830540038,1.3966480446927374,0.27932960893854747,0.37243947858473
31,전북특별자치도,고창군,심원면,심원면투표소,863,481,379,74,25,0,0,478,3,382,79.2887029288703,15.481171548117153,5.230125523012552,0.0,0.0
32,전북특별자치도,고창군,흥덕면,관내사전투표,1487,1487,1332,100,32,10,5,1479,8,0,90.06085192697769,6.761325219743069,2.1636240703177823,0.676132521974307,0.3380662609871535
33,전북특별자치도,고창군,흥덕면,흥덕면투표소,1046,573,471,76,14,3,2,566,7,473,83.21554770318022,13.427561837455832,2.4734982332155475,0.5300353356890459,0.35335689045936397
34,전북특별자치도,고창군,성내면,관내사전투표,822,822,733,62,15,1,4,815,7,0,89.93865030674847,7.6073619631901845,1.8404907975460123,0.1226993865030675,0.49079754601227
35,전북특별자치도,고창군,성내면,성내면투표소,601,300,216,69,8,2,2,297,3,301,72.72727272727273,23.232323232323232,2.6936026936026933,0.6734006734006733,0.6734006734006733
36,전북특별자치도,고창군,신림면,관내사전투표,1041,1041,966,46,20,3,0,1035,6,0,93.33333333333333,4.444444444444445,1.932367149758454,0.2898550724637681,0.0
37,전북특별자치도,고창군,신림면,신림면투표소,641,327,268,43,9,3,1,324,3,314,82.71604938271605,13.271604938271606,2.7777777777777777,0.9259259259259258,0.30864197530864196
38,전북특별자치도,고창군,부안면,관내사전투표,1218,1218,1093,79,21,9,10,1212,6,0,90.18151815181518,6.518151815181518,1.7326732673267329,0.7425742574257426,0.825082508250825
39,전북특별자치도,고창군,부안면,부안면제1투,481,257,194,40,15,3,1,253,4,224,76.6798418972332,15.810276679841898,5.928853754940711,1.185770750988142,0.3952569169960474
40,전북특별자치도,고창군,부안면,부안면제2투,427,247,206,28,3,3,4,244,3,180,84.42622950819673,11.475409836065573,1.2295081967213115,1.2295081967213115,1.639344262295082
41,전북특별자치도,고창군,잘못 투입·구분된 투표지,,0,1,1,0,0,0,0,1,0,-1,100.0,0.0,0.0,0.0,0.0
0,전북특별자치도,부안군,거소·선상투표,,171,164,125,18,13,0,2,158,6,7,79.11392405063292,11.39240506329114,8.227848101265822,0.0,1.2658227848101267
1,전북특별자치도,부안군,관외사전투표,,4791,4790,3853,498,365,36,5,4757,33,1,80.99642631910868,10.468782846331722,7.672903090182888,0.7567794828673533,0.10510826150935462
2,전북특별자치도,부안군,재외투표,,144,119,99,10,9,1,0,119,0,25,83.19327731092437,8.403361344537815,7.563025210084033,0.8403361344537815,0.0
3,전북특별자치도,부안군,부안읍,관내사전투표,7056,7056,6267,492,232,28,5,7024,32,0,89.22266514806378,7.004555808656036,3.3029612756264237,0.3986332574031891,0.07118451025056947
4,전북특별자치도,부안군,부안읍,부안읍제1투,921,464,343,102,15,1,2,463,1,457,74.08207343412528,22.03023758099352,3.2397408207343417,0.21598272138228944,0.4319654427645789
5,전북특별자치도,부안군,부안읍,부안읍제2투,1141,649,481,134,26,5,0,646,3,492,74.45820433436533,20.743034055727556,4.024767801857585,0.7739938080495357,0.0
6,전북특별자치도,부안군,부안읍,부안읍제3투,833,388,277,93,12,4,1,387,1,445,71.57622739018088,24.031007751937985,3.10077519379845,1.03359173126615,0.2583979328165375
7,전북특별자치도,부안군,부안읍,부안읍제4투,1813,1088,854,166,54,10,0,1084,4,725,78.78228782287823,15.313653136531366,4.981549815498155,0.9225092250922509,0.0
8,전북특별자치도,부안군,부안읍,부안읍제5투,1499,817,633,128,46,6,2,815,2,682,77.66871165644172,15.70552147239264,5.644171779141105,0.7361963190184049,0.245398773006135
9,전북특별자치도,부안군,부안읍,부안읍제6투,475,280,221,40,12,4,1,278,2,195,79.49640287769785,14.388489208633093,4.316546762589928,1.4388489208633095,0.3597122302158274
10,전북특별자치도,부안군,주산면,관내사전투표,901,901,806,65,13,6,1,891,10,0,90.46015712682379,7.295173961840629,1.4590347923681257,0.6734006734006733,0.11223344556677892
11,전북특별자치도,부안군,주산면,주산면투표소,644,332,261,59,7,3,0,330,2,312,79.0909090909091,17.87878787878788,2.1212121212121215,0.9090909090909091,0.0
12,전북특별자치도,부안군,동진면,관내사전투표,985,985,875,80,19,5,0,979,6,0,89.37691521961185,8.171603677221654,1.940755873340143,0.5107252298263534,0.0
13,전북특별자치도,부안군,동진면,동진면투표소,915,460,361,71,17,2,4,455,5,455,79.34065934065934,15.604395604395604,3.7362637362637363,0.43956043956043955,0.8791208791208791
14,전북특별자치도,부안군,행안면,관내사전투표,2461,2461,2234,125,57,20,5,2441,20,0,91.51986890618599,5.12085210979107,2.3351085620647276,0.8193363375665711,0.20483408439164277
15,전북특별자치도,부안군,행안면,행안면투표소,795,422,324,91,5,1,1,422,0,373,76.77725118483413,21.563981042654028,1.1848341232227488,0.23696682464454977,0.23696682464454977
16,전북특별자치도,부안군,계화면,관내사전투표,1055,1055,977,46,19,1,3,1046,9,0,93.40344168260039,4.397705544933078,1.8164435946462716,0.09560229445506692,0.28680688336520077
17,전북특별자치도,부안군,계화면,계화면제1투,773,418,341,52,15,3,2,413,5,355,82.56658595641646,12.590799031477,3.631961259079903,0.7263922518159807,0.48426150121065376
18,전북특별자치도,부안군,계화면,계화면제2투,351,244,220,19,4,0,0,243,1,107,90.53497942386831,7.818930041152264,1.646090534979424,0.0,0.0
19,전북특별자치도,부안군,계화면,계화면제3투,260,184,163,17,0,0,2,182,2,76,89.56043956043956,9.340659340659341,0.0,0.0,1.098901098901099
20,전북특별자치도,부안군,보안면,관내사전투표,944,944,830,81,25,3,2,941,3,0,88.20403825717322,8.607863974495219,2.6567481402763016,0.3188097768331562,0.21253985122210414
21,전북특별자치도,부안군,보안면,보안면투표소,796,411,321,69,12,6,0,408,3,385,78.67647058823529,16.911764705882355,2.941176470588235,1.4705882352941175,0.0
22,전북특별자치도,부안군,변산면,관내사전투표,1512,1512,1347,102,48,5,3,1505,7,0,89.5016611295681,6.777408637873754,3.189368770764119,0.33222591362126247,0.19933554817275745
23,전북특별자치도,부안군,변산면,변산면제1투,654,333,247,74,8,3,1,333,0,321,74.17417417417418,22.22222222222222,2.4024024024024024,0.9009009009009009,0.3003003003003003
24,전북특별자치도,부안군,변산면,변산면제2투,1156,774,641,101,24,3,3,772,2,382,83.03108808290155,13.082901554404144,3.1088082901554404,0.38860103626943004,0.38860103626943004
25,전북특별자치도,부안군,진서면,관내사전투표,1040,1040,953,58,16,8,4,1039,1,0,91.72281039461019,5.582290664100096,1.539942252165544,0.769971126082772,0.384985563041386
26,전북특별자치도,부안군,진서면,진서면투표소,789,413,305,91,10,3,1,410,3,376,74.39024390243902,22.195121951219512,2.4390243902439024,0.7317073170731708,0.24390243902439024
27,전북특별자치도,부안군,백산면,관내사전투표,1181,1181,1042,97,23,8,4,1174,7,0,88.75638841567292,8.262350936967632,1.9591141396933562,0.6814310051107325,0.34071550255536626
28,전북특별자치도,부안군,백산면,백산면투표소,837,427,318,88,13,1,2,422,5,410,75.35545023696683,20.85308056872038,3.080568720379147,0.23696682464454977,0.47393364928909953
29,전북특별자치도,부안군,상서면,관내사전투표,875,875,780,59,29,3,1,872,3,0,89.44954128440367,6.76605504587156,3.325688073394496,0.34403669724770647,0.11467889908256881
30,전북특별자치도,부안군,상서면,상서면투표소,683,318,248,55,10,1,1,315,3,365,78.73015873015873,17.46031746031746,3.1746031746031744,0.31746031746031744,0.31746031746031744
31,전북특별자치도,부안군,하서면,관내사전투표,1160,1160,1049,73,24,7,2,1155,5,0,90.82251082251082,6.320346320346321,2.0779220779220777,0.6060606060606061,0.17316017316017315
32,전북특별자치도,부안군,하서면,하서면투표소,878,452,364,69,9,5,2,449,3,426,81.06904231625836,15.367483296213807,2.0044543429844097,1.1135857461024499,0.4454342984409799
33,전북특별자치도,부안군,줄포면,관내사전투표,1219,1219,1105,80,21,3,2,1211,8,0,91.24690338563171,6.6061106523534265,1.7341040462427744,0.2477291494632535,0.16515276630883566
34,전북특별자치도,부안군,줄포면,줄포면투표소,900,474,375,80,12,5,0,472,2,426,79.44915254237289,16.94915254237288,2.5423728813559325,1.059322033898305,0.0
35,전북특별자치도,부안군,위도면,관내사전투표,421,421,378,21,11,3,2,415,6,0,91.08433734939759,5.0602409638554215,2.6506024096385543,0.7228915662650602,0.48192771084337355
36,전북특별자치도,부안군,위도면,위도면제1투,258,128,96,27,4,0,0,127,1,130,75.59055118110236,21.25984251968504,3.149606299212598,0.0,0.0
37,전북특별자치도,부안군,위도면,위도면제2투,100,73,69,4,0,0,0,73,0,27,94.52054794520548,5.47945205479452,0.0,0.0,0.0
38,전북특별자치도,부안군,잘못 투입·구분된 투표지,,0,0,0,0,0,0,0,0,0,0,0.0,0.0,0.0,0.0,0.0
0,전라남도,목포시,거소·선상투표,,755,715,530,64,91,6,2,693,22,40,76.47907647907648,9.235209235209235,13.131313131313133,0.8658008658008658,0.2886002886002886
1,전라남도,목포시,관외사전투표,,17833,17823,14387,1317,1772,160,28,17664,159,10,81.44814311594203,7.455842391304348,10.031702898550725,0.9057971014492754,0.1585144927536232
2,전라남도,목포시,재외투표,,502,403,328,42,24,8,0,402,1,99,81.59203980099502,10.44776119402985,5.970149253731343,1.9900497512437811,0.0
3,전라남도,목포시,용당1동,관내사전투표,3984,3984,3687,182,83,13,6,3971,13,0,92.84814908083607,4.583228405943087,2.09015361369932,0.32737345756736336,0.15109544195416771
4,전라남도,목포시,용당1동,용당1동제1투,1085,610,469,103,23,10,2,607,3,475,77.26523887973642,16.96869851729819,3.789126853377265,1.6474464579901154,0.3294892915980231
5,전라남도,목포시,용당1동,용당1동제2투,809,368,297,52,12,6,0,367,1,441,80.92643051771117,14.168937329700274,3.2697547683923704,1.6348773841961852,0.0
6,전라남도,목포시,용당1동,용당1동제3투,1003,594,481,74,30,4,0,589,5,409,81.66383701188455,12.563667232597622,5.093378607809847,0.6791171477079796,0.0
7,전라남도,목포시,용당1동,용당1동제4투,980,530,417,86,19,6,1,529,1,450,78.82797731568998,16.257088846880908,3.5916824196597354,1.1342155009451798,0.1890359168241966
8,전라남도,목포시,용당2동,관내사전투표,2505,2505,2304,120,53,15,2,2494,11,0,92.38171611868484,4.811547714514836,2.125100240577386,0.6014434643143545,0.08019246190858059
9,전라남도,목포시,용당2동,용당2동제1투,1055,503,400,71,17,6,4,498,5,552,80.32128514056225,14.257028112449799,3.413654618473896,1.2048192771084338,0.8032128514056224
10,전라남도,목포시,용당2동,용당2동제2투,732,387,313,51,20,1,0,385,2,345,81.2987012987013,13.246753246753245,5.194805194805195,0.2597402597402597,0.0
11,전라남도,목포시,연동,관내사전투표,1695,1695,1607,50,22,6,4,1689,6,0,95.14505624629959,2.960331557134399,1.3025458851391356,0.3552397868561279,0.2368265245707519
12,전라남도,목포시,연동,연동제1투,691,312,235,62,11,3,0,311,1,379,75.56270096463022,19.935691318327976,3.536977491961415,0.964630225080386,0.0
13,전라남도,목포시,연동,연동제2투,932,505,433,51,14,1,2,501,4,427,86.42714570858283,10.179640718562874,2.7944111776447107,0.19960079840319359,0.39920159680638717
14,전라남도,목포시,산정동,관내사전투표,3098,3098,2851,139,79,21,1,3091,7,0,92.23552248463281,4.496926560983501,2.5558071821417014,0.6793917825946296,0.03235198964736331
15,전라남도,목포시,산정동,산정동제1투,1548,802,589,152,42,10,1,794,8,746,74.18136020151134,19.143576826196472,5.289672544080604,1.2594458438287155,0.12594458438287154
16,전라남도,목포시,산정동,산정동제2투,1669,1096,888,149,42,11,1,1091,5,573,81.39321723189734,13.657195233730523,3.84967919340055,1.008249312557287,0.09165902841429881
17,전라남도,목포시,연산동,관내사전투표,3026,3026,2766,114,93,18,4,2995,31,0,92.35392320534224,3.8063439065108513,3.1051752921535893,0.6010016694490818,0.1335559265442404
18,전라남도,목포시,연산동,연산동제1투,1443,977,831,77,53,8,0,969,8,466,85.75851393188854,7.946336429308566,5.469556243550051,0.8255933952528379,0.0
19,전라남도,목포시,연산동,연산동제2투,1724,988,754,160,53,11,5,983,5,736,76.70396744659207,16.276703967446593,5.391658189216684,1.119023397761953,0.508646998982706
20,전라남도,목포시,원산동,관내사전투표,3901,3901,3600,151,112,24,1,3888,13,0,92.5925925925926,3.8837448559670777,2.880658436213992,0.6172839506172839,0.0257201646090535
21,전라남도,목포시,원산동,원산동제1투,724,368,307,33,22,2,1,365,3,356,84.10958904109589,9.04109589041096,6.027397260273973,0.547945205479452,0.273972602739726
22,전라남도,목포시,원산동,원산동제2투,1151,651,507,96,34,12,1,650,1,500,78.0,14.76923076923077,5.230769230769231,1.8461538461538463,0.15384615384615385
23,전라남도,목포시,원산동,원산동제3투,1431,794,650,98,27,9,1,785,9,637,82.80254777070064,12.48407643312102,3.4394904458598727,1.1464968152866242,0.12738853503184713
24,전라남도,목포시,원산동,원산동제4투,1158,732,608,85,28,10,0,731,1,426,83.17373461012312,11.627906976744185,3.830369357045144,1.3679890560875512,0.0
25,전라남도,목포시,대성동,관내사전투표,2399,2399,2215,92,73,8,0,2388,11,0,92.75544388609715,3.8525963149078724,3.0569514237855944,0.33500837520938026,0.0
26,전라남도,목포시,대성동,대성동투표소,1610,888,686,141,49,6,3,885,3,722,77.51412429378531,15.932203389830507,5.536723163841808,0.6779661016949152,0.3389830508474576
27,전라남도,목포시,목원동,관내사전투표,2884,2884,2608,161,84,21,1,2875,9,0,90.71304347826087,5.6000000000000005,2.9217391304347826,0.7304347826086957,0.034782608695652174
28,전라남도,목포시,목원동,목원동제1투,848,478,398,63,9,5,0,475,3,370,83.78947368421052,13.263157894736842,1.8947368421052633,1.0526315789473684,0.0
29,전라남도,목포시,목원동,목원동제2투,791,384,275,78,23,4,2,382,2,407,71.98952879581152,20.418848167539267,6.020942408376963,1.0471204188481675,0.5235602094240838
30,전라남도,목포시,목원동,목원동제3투,877,384,275,91,11,3,0,380,4,493,72.36842105263158,23.94736842105263,2.8947368421052633,0.7894736842105263,0.0
31,전라남도,목포시,동명동,관내사전투표,2108,2108,1966,86,33,15,5,2105,3,0,93.39667458432304,4.085510688836105,1.5676959619952493,0.7125890736342043,0.23752969121140144
32,전라남도,목포시,동명동,동명동제1투,827,391,315,58,13,2,1,389,2,436,80.97686375321337,14.910025706940875,3.3419023136246784,0.5141388174807198,0.2570694087403599
33,전라남도,목포시,동명동,동명동제2투,738,340,277,51,11,1,0,340,0,398,81.47058823529412,15.0,3.2352941176470593,0.29411764705882354,0.0
34,전라남도,목포시,삼학동,관내사전투표,3252,3252,3047,113,73,10,1,3244,8,0,93.9272503082614,3.4833538840937117,2.2503082614056718,0.3082614056720099,0.030826140567200986
35,전라남도,목포시,삼학동,삼학동제1투,1087,605,488,78,31,2,2,601,4,482,81.19800332778702,12.9783693843594,5.158069883527454,0.33277870216306155,0.33277870216306155
36,전라남도,목포시,삼학동,삼학동제2투,874,489,397,64,19,7,0,487,2,385,81.51950718685832,13.141683778234087,3.9014373716632447,1.4373716632443532,0.0
37,전라남도,목포시,만호동,관내사전투표,1347,1347,1236,59,29,8,1,1333,14,0,92.7231807951988,4.426106526631658,2.175543885971493,0.6001500375093773,0.07501875468867217
38,전라남도,목포시,만호동,만호동투표소,869,323,248,58,8,5,0,319,4,546,77.74294670846395,18.181818181818183,2.507836990595611,1.5673981191222568,0.0
39,전라남도,목포시,유달동,관내사전투표,2025,2025,1862,86,46,19,1,2014,11,0,92.45283018867924,4.270109235352533,2.284011916583913,0.9433962264150944,0.04965243296921549
40,전라남도,목포시,유달동,유달동제1투,487,215,171,35,7,0,0,213,2,272,80.28169014084507,16.431924882629108,3.286384976525822,0.0,0.0
41,전라남도,목포시,유달동,유달동제2투,503,236,185,31,9,4,1,230,6,267,80.43478260869566,13.478260869565217,3.91304347826087,1.7391304347826086,0.43478260869565216
42,전라남도,목포시,유달동,유달동제3투,330,176,138,28,9,1,0,176,0,154,78.4090909090909,15.909090909090908,5.113636363636364,0.5681818181818182,0.0
43,전라남도,목포시,유달동,유달동제4투,93,70,58,9,2,0,0,69,1,23,84.05797101449275,13.043478260869565,2.898550724637681,0.0,0.0
44,전라남도,목포시,유달동,유달동제5투,93,53,53,0,0,0,0,53,0,40,100.0,0.0,0.0,0.0,0.0
45,전라남도,목포시,죽교동,관내사전투표,1557,1557,1413,61,58,12,2,1546,11,0,91.39715394566623,3.945666235446313,3.751617076326003,0.7761966364812419,0.129366106080207
46,전라남도,목포시,죽교동,죽교동제1투,429,204,158,39,6,0,0,203,1,225,77.83251231527095,19.21182266009852,2.955665024630542,0.0,0.0
47,전라남도,목포시,죽교동,죽교동제2투,672,319,245,59,11,0,1,316,3,353,77.53164556962025,18.670886075949365,3.481012658227848,0.0,0.31645569620253167
48,전라남도,목포시,북항동,관내사전투표,4416,4416,4087,153,130,27,3,4400,16,0,92.88636363636364,3.4772727272727275,2.9545454545454546,0.6136363636363636,0.06818181818181819
49,전라남도,목포시,북항동,북항동제1투,1592,900,683,145,54,10,0,892,8,692,76.5695067264574,16.255605381165918,6.053811659192825,1.1210762331838564,0.0
50,전라남도,목포시,북항동,북항동제2투,787,383,296,59,17,8,0,380,3,404,77.89473684210526,15.526315789473685,4.473684210526316,2.1052631578947367,0.0
51,전라남도,목포시,북항동,북항동제3투,701,389,310,56,14,6,1,387,2,312,80.10335917312662,14.470284237726098,3.6175710594315245,1.550387596899225,0.2583979328165375
52,전라남도,목포시,용해동,관내사전투표,5516,5516,5079,206,157,40,7,5489,27,0,92.53051557660777,3.75296046638732,2.8602659865184914,0.7287301876480233,0.12752778283840407
53,전라남도,목포시,용해동,용해동제1투,1244,641,486,101,38,8,2,635,6,603,76.53543307086615,15.905511811023624,5.984251968503937,1.2598425196850394,0.31496062992125984
54,전라남도,목포시,용해동,용해동제2투,1366,819,674,91,36,11,1,813,6,547,82.90282902829028,11.193111931119311,4.428044280442804,1.3530135301353015,0.12300123001230012
55,전라남도,목포시,용해동,용해동제3투,1521,831,653,110,45,15,2,825,6,690,79.15151515151516,13.333333333333334,5.454545454545454,1.8181818181818181,0.24242424242424243
56,전라남도,목포시,용해동,용해동제4투,1541,1012,870,86,46,6,0,1008,4,529,86.30952380952381,8.531746031746032,4.563492063492063,0.5952380952380952,0.0
57,전라남도,목포시,이로동,관내사전투표,3245,3245,2956,157,99,21,1,3234,11,0,91.4038342609771,4.854669140383426,3.061224489795918,0.6493506493506493,0.030921459492888066
58,전라남도,목포시,이로동,이로동제1투,851,507,406,75,18,5,0,504,3,344,80.55555555555556,14.880952380952381,3.571428571428571,0.992063492063492,0.0
59,전라남도,목포시,이로동,이로동제2투,1349,811,639,121,41,6,1,808,3,538,79.08415841584159,14.975247524752474,5.074257425742575,0.7425742574257426,0.12376237623762376
60,전라남도,목포시,이로동,이로동제3투,1466,1009,814,125,50,13,1,1003,6,457,81.15653040877368,12.462612163509473,4.985044865403789,1.296111665004985,0.09970089730807577
61,전라남도,목포시,상동,관내사전투표,4903,4903,4496,238,120,23,3,4880,23,0,92.1311475409836,4.877049180327869,2.459016393442623,0.4713114754098361,0.06147540983606558
62,전라남도,목포시,상동,상동제1투,1070,542,419,87,26,4,3,539,3,528,77.73654916512059,16.14100185528757,4.823747680890538,0.7421150278293136,0.5565862708719851
63,전라남도,목포시,상동,상동제2투,855,331,250,51,18,6,1,326,5,524,76.68711656441718,15.644171779141105,5.521472392638037,1.8404907975460123,0.3067484662576687
64,전라남도,목포시,상동,상동제3투,1561,1177,982,121,55,12,0,1170,7,384,83.93162393162393,10.34188034188034,4.700854700854701,1.0256410256410255,0.0
65,전라남도,목포시,상동,상동제4투,2618,1825,1521,192,82,22,2,1819,6,793,83.61737218251787,10.555250137438152,4.507971412864211,1.2094557449147882,0.10995052226498077
66,전라남도,목포시,상동,상동제5투,2055,1343,1097,162,68,10,1,1338,5,712,81.98804185351271,12.10762331838565,5.082212257100149,0.7473841554559043,0.07473841554559044
67,전라남도,목포시,하당동,관내사전투표,5304,5304,4824,222,201,38,2,5287,17,0,91.24267070172121,4.1989786268205025,3.8017779459050502,0.7187440892755816,0.03782863627766219
68,전라남도,목포시,하당동,하당동제1투,1427,557,418,94,35,6,1,554,3,870,75.45126353790613,16.967509025270758,6.31768953068592,1.083032490974729,0.18050541516245489
69,전라남도,목포시,하당동,하당동제2투,2276,1102,799,175,103,13,3,1093,9,1174,73.10155535224153,16.010978956999086,9.423604757548034,1.1893870082342177,0.2744739249771272
70,전라남도,목포시,하당동,하당동제3투,2160,1557,1264,179,95,11,3,1552,5,603,81.44329896907216,11.533505154639176,6.121134020618556,0.7087628865979382,0.19329896907216496
71,전라남도,목포시,신흥동,관내사전투표,4698,4698,4298,211,137,35,2,4683,15,0,91.77877428998505,4.505658765748452,2.92547512278454,0.7473841554559043,0.04270766602605167
72,전라남도,목포시,신흥동,신흥동제1투,1809,1021,792,157,62,7,0,1018,3,788,77.79960707269156,15.422396856581532,6.090373280943026,0.68762278978389,0.0
73,전라남도,목포시,신흥동,신흥동제2투,1214,762,624,102,29,3,0,758,4,452,82.32189973614776,13.456464379947231,3.825857519788918,0.395778364116095,0.0
74,전라남도,목포시,신흥동,신흥동제3투,1559,1059,861,129,48,13,1,1052,7,500,81.84410646387833,12.262357414448669,4.562737642585551,1.2357414448669202,0.09505703422053231
75,전라남도,목포시,신흥동,신흥동제4투,2146,1280,988,206,59,14,1,1268,12,866,77.91798107255521,16.246056782334385,4.652996845425868,1.1041009463722398,0.07886435331230283
76,전라남도,목포시,삼향동,관내사전투표,3056,3056,2795,126,95,24,3,3043,13,0,91.8501478803812,4.140650673677293,3.1219191587249426,0.7886953664147224,0.0985869208018403
77,전라남도,목포시,삼향동,삼향동제1투,795,437,366,49,16,4,0,435,2,358,84.13793103448276,11.264367816091953,3.67816091954023,0.9195402298850575,0.0
78,전라남도,목포시,삼향동,삼향동제2투,817,444,352,69,18,2,2,443,1,373,79.45823927765237,15.575620767494355,4.063205417607223,0.4514672686230248,0.4514672686230248
79,전라남도,목포시,옥암동,관내사전투표,5183,5183,4722,232,174,31,4,5163,20,0,91.45845438698431,4.493511524307573,3.37013364323068,0.600426108851443,0.07747433662599264
80,전라남도,목포시,옥암동,옥암동제1투,2054,1360,1078,193,61,13,1,1346,14,694,80.0891530460624,14.338781575037146,4.531946508172362,0.9658246656760773,0.07429420505200594
81,전라남도,목포시,옥암동,옥암동제2투,1477,923,742,109,51,11,2,915,8,554,81.09289617486338,11.912568306010929,5.573770491803279,1.2021857923497268,0.2185792349726776
82,전라남도,목포시,부흥동,관내사전투표,4540,4540,4115,206,166,37,2,4526,14,0,90.91913389306231,4.551480335837383,3.6676977463543965,0.8174988952717631,0.04418912947414936
83,전라남도,목포시,부흥동,부흥동제1투,1042,527,385,91,39,4,0,519,8,515,74.18111753371869,17.533718689788053,7.514450867052023,0.7707129094412332,0.0
84,전라남도,목포시,부흥동,부흥동제2투,583,340,262,52,16,3,1,334,6,243,78.44311377245509,15.568862275449103,4.790419161676647,0.8982035928143712,0.29940119760479045
85,전라남도,목포시,부흥동,부흥동제3투,1300,827,673,103,40,8,0,824,3,473,81.6747572815534,12.5,4.854368932038835,0.9708737864077669,0.0
86,전라남도,목포시,부주동,관내사전투표,6095,6095,5502,303,214,45,5,6069,26,0,90.65743944636678,4.992585269401879,3.526116328884495,0.7414730598121602,0.08238589553468446
87,전라남도,목포시,부주동,부주동제1투,1173,796,619,102,55,15,0,791,5,377,78.25537294563844,12.895069532237674,6.95322376738306,1.8963337547408345,0.0
88,전라남도,목포시,부주동,부주동제2투,1521,798,594,133,47,15,0,789,9,723,75.2851711026616,16.856780735107733,5.9569074778200255,1.9011406844106464,0.0
89,전라남도,목포시,부주동,부주동제3투,2277,1380,1063,196,95,15,2,1371,9,897,77.5346462436178,14.296134208606857,6.929248723559446,1.0940919037199124,0.14587892049598833
90,전라남도,목포시,부주동,부주동제4투,930,604,406,149,40,6,0,601,3,326,67.55407653910149,24.792013311148086,6.655574043261231,0.9983361064891847,0.0
91,전라남도,목포시,부주동,부주동제5투,1444,1052,800,182,61,6,1,1050,2,392,76.19047619047619,17.333333333333336,5.809523809523809,0.5714285714285714,0.09523809523809523
92,전라남도,목포시,잘못 투입·구분된 투표지,,0,0,0,0,0,0,0,0,0,0,0.0,0.0,0.0,0.0,0.0
0,전라남도,여수시,거소·선상투표,,644,607,442,53,73,3,5,576,31,37,76.73611111111111,9.20138888888889,12.67361111111111,0.5208333333333333,0.8680555555555556
1,전라남도,여수시,관외사전투표,,16423,16420,12268,1626,2205,134,21,16254,166,3,75.47680570936384,10.003691399040235,13.565891472868216,0.8244124523194291,0.12919896640826875
2,전라남도,여수시,재외투표,,782,605,496,52,49,5,0,602,3,177,82.39202657807309,8.637873754152823,8.13953488372093,0.8305647840531563,0.0
3,전라남도,여수시,돌산읍,관내사전투표,2104,2104,1931,107,37,12,1,2088,16,0,92.48084291187739,5.124521072796935,1.7720306513409962,0.5747126436781609,0.047892720306513405
4,전라남도,여수시,돌산읍,돌산읍제1투,848,411,338,56,10,1,1,406,5,437,83.2512315270936,13.793103448275861,2.4630541871921183,0.24630541871921183,0.24630541871921183
5,전라남도,여수시,돌산읍,돌산읍제2투,1017,686,602,69,5,2,5,683,3,331,88.14055636896046,10.102489019033674,0.7320644216691069,0.29282576866764276,0.7320644216691069
6,전라남도,여수시,돌산읍,돌산읍제3투,706,454,396,39,9,6,2,452,2,252,87.61061946902655,8.628318584070795,1.991150442477876,1.3274336283185841,0.4424778761061947
7,전라남도,여수시,돌산읍,돌산읍제4투,746,464,405,50,5,2,0,462,2,282,87.66233766233766,10.822510822510822,1.0822510822510822,0.4329004329004329,0.0
8,전라남도,여수시,돌산읍,돌산읍제5투,2677,1741,1449,219,57,6,0,1731,10,936,83.70883882149047,12.65164644714038,3.2928942807625647,0.34662045060658575,0.0
9,전라남도,여수시,소라면,관내사전투표,6596,6596,5993,287,226,44,8,6558,38,0,91.38456846599573,4.376334248246416,3.446172613601708,0.6709362610551998,0.12198841110094541
10,전라남도,여수시,소라면,소라면제1투,703,389,299,66,15,3,1,384,5,314,77.86458333333334,17.1875,3.90625,0.78125,0.26041666666666663
11,전라남도,여수시,소라면,소라면제2투,636,375,327,34,10,2,0,373,2,261,87.66756032171583,9.115281501340483,2.680965147453083,0.5361930294906166,0.0
12,전라남도,여수시,소라면,소라면제3투,594,322,276,31,10,2,0,319,3,272,86.52037617554859,9.717868338557993,3.1347962382445136,0.6269592476489028,0.0
13,전라남도,여수시,소라면,소라면제4투,506,295,245,41,7,0,0,293,2,211,83.61774744027304,13.993174061433447,2.3890784982935154,0.0,0.0
14,전라남도,여수시,소라면,소라면제5투,2809,1813,1462,222,99,16,3,1802,11,996,81.13207547169812,12.319644839067703,5.493895671476138,0.8879023307436182,0.1664816870144284
15,전라남도,여수시,소라면,소라면제6투,3316,2537,2049,287,158,27,1,2522,15,779,81.24504361617764,11.379857256145916,6.26486915146709,1.070578905630452,0.03965107057890563
16,전라남도,여수시,율촌면,관내사전투표,2550,2550,2362,108,55,8,6,2539,11,0,93.02875147695944,4.253643166601024,2.1662071681764474,0.31508467900748327,0.23631350925561243
17,전라남도,여수시,율촌면,율촌면제1투,1325,679,548,92,27,8,1,676,3,646,81.06508875739645,13.609467455621301,3.9940828402366866,1.183431952662722,0.14792899408284024
18,전라남도,여수시,율촌면,율촌면제2투,463,285,213,59,6,1,2,281,4,178,75.80071174377224,20.99644128113879,2.135231316725979,0.3558718861209964,0.7117437722419928
19,전라남도,여수시,율촌면,율촌면제3투,505,310,259,37,8,3,1,308,2,195,84.0909090909091,12.012987012987013,2.5974025974025974,0.974025974025974,0.3246753246753247
20,전라남도,여수시,율촌면,율촌면제4투,130,102,91,10,0,0,1,102,0,28,89.2156862745098,9.803921568627452,0.0,0.0,0.9803921568627451
21,전라남도,여수시,화양면,관내사전투표,2961,2961,2721,131,74,11,5,2942,19,0,92.48810333106731,4.452753229095853,2.515295717199184,0.37389530931339227,0.1699524133242692
22,전라남도,여수시,화양면,화양면제1투,1175,600,469,89,24,5,2,589,11,575,79.62648556876061,15.110356536502549,4.074702886247878,0.8488964346349746,0.3395585738539898
23,전라남도,여수시,화양면,화양면제2투,619,351,283,53,4,2,3,345,6,268,82.02898550724638,15.36231884057971,1.1594202898550725,0.5797101449275363,0.8695652173913043
24,전라남도,여수시,화양면,화양면제3투,616,317,269,35,10,2,0,316,1,299,85.12658227848101,11.075949367088606,3.1645569620253164,0.6329113924050633,0.0
25,전라남도,여수시,남면,관내사전투표,720,720,649,40,20,4,1,714,6,0,90.89635854341736,5.602240896358544,2.801120448179272,0.5602240896358543,0.1400560224089636
26,전라남도,여수시,남면,남면제1투,340,121,87,30,2,0,0,119,2,219,73.10924369747899,25.210084033613445,1.680672268907563,0.0,0.0
27,전라남도,여수시,남면,남면제2투,94,69,63,2,2,0,0,67,2,25,94.02985074626866,2.9850746268656714,2.9850746268656714,0.0,0.0
28,전라남도,여수시,남면,남면제3투,125,87,81,4,0,1,0,86,1,38,94.18604651162791,4.651162790697675,0.0,1.1627906976744187,0.0
29,전라남도,여수시,남면,남면제4투,70,58,53,1,1,1,1,57,1,12,92.98245614035088,1.7543859649122806,1.7543859649122806,1.7543859649122806,1.7543859649122806
30,전라남도,여수시,남면,남면제5투,191,136,120,11,3,0,1,135,1,55,88.88888888888889,8.148148148148149,2.2222222222222223,0.0,0.7407407407407408
31,전라남도,여수시,남면,남면제6투,281,218,192,19,3,0,1,215,3,63,89.30232558139535,8.837209302325581,1.3953488372093024,0.0,0.46511627906976744
32,전라남도,여수시,화정면,관내사전투표,371,371,333,18,14,1,0,366,5,0,90.98360655737704,4.918032786885246,3.825136612021858,0.273224043715847,0.0
33,전라남도,여수시,화정면,화정면제1투,68,44,37,4,1,0,0,42,2,24,88.09523809523809,9.523809523809524,2.380952380952381,0.0,0.0
34,전라남도,여수시,화정면,화정면제2투,381,292,271,13,2,0,4,290,2,89,93.44827586206897,4.482758620689655,0.6896551724137931,0.0,1.3793103448275863
35,전라남도,여수시,화정면,화정면제3투,98,51,47,4,0,0,0,51,0,47,92.15686274509804,7.8431372549019605,0.0,0.0,0.0
36,전라남도,여수시,화정면,화정면제4투,40,35,33,0,1,0,0,34,1,5,97.05882352941177,0.0,2.941176470588235,0.0,0.0
37,전라남도,여수시,화정면,화정면제5투,174,146,133,5,1,0,2,141,5,28,94.32624113475178,3.546099290780142,0.7092198581560284,0.0,1.4184397163120568
38,전라남도,여수시,화정면,화정면제6투,41,32,28,2,0,0,2,32,0,9,87.5,6.25,0.0,0.0,6.25
39,전라남도,여수시,화정면,화정면제7투,72,60,51,7,1,0,0,59,1,12,86.4406779661017,11.864406779661017,1.694915254237288,0.0,0.0
40,전라남도,여수시,화정면,화정면제8투,129,95,91,4,0,0,0,95,0,34,95.78947368421052,4.2105263157894735,0.0,0.0,0.0
41,전라남도,여수시,화정면,화정면제9투,46,38,37,0,0,0,0,37,1,8,100.0,0.0,0.0,0.0,0.0
42,전라남도,여수시,화정면,화정면제10투,26,20,19,1,0,0,0,20,0,6,95.0,5.0,0.0,0.0,0.0
43,전라남도,여수시,화정면,화정면제11투,28,25,25,0,0,0,0,25,0,3,100.0,0.0,0.0,0.0,0.0
44,전라남도,여수시,삼산면,관내사전투표,488,488,428,40,15,2,0,485,3,0,88.24742268041237,8.24742268041237,3.0927835051546393,0.4123711340206186,0.0
45,전라남도,여수시,삼산면,삼산면제1투,202,91,66,20,3,2,0,91,0,111,72.52747252747253,21.978021978021978,3.296703296703297,2.197802197802198,0.0
46,전라남도,여수시,삼산면,삼산면제2투,253,190,159,24,2,1,2,188,2,63,84.57446808510637,12.76595744680851,1.0638297872340425,0.5319148936170213,1.0638297872340425
47,전라남도,여수시,삼산면,삼산면제3투,223,172,153,15,2,1,1,172,0,51,88.95348837209302,8.720930232558139,1.1627906976744187,0.5813953488372093,0.5813953488372093
48,전라남도,여수시,삼산면,삼산면제4투,143,111,89,18,2,0,2,111,0,32,80.18018018018019,16.216216216216218,1.8018018018018018,0.0,1.8018018018018018
49,전라남도,여수시,동문동,관내사전투표,2110,2110,1919,113,57,9,3,2101,9,0,91.33745835316516,5.378391242265588,2.7129938124702524,0.42836744407425037,0.14278914802475012
50,전라남도,여수시,동문동,동문동제1투,799,472,366,85,15,2,2,470,2,327,77.87234042553192,18.085106382978726,3.1914893617021276,0.425531914893617,0.425531914893617
51,전라남도,여수시,동문동,동문동제2투,415,216,166,42,3,3,0,214,2,199,77.57009345794393,19.626168224299064,1.4018691588785046,1.4018691588785046,0.0
52,전라남도,여수시,동문동,동문동제3투,363,221,180,34,5,2,0,221,0,142,81.44796380090497,15.384615384615385,2.262443438914027,0.904977375565611,0.0
53,전라남도,여수시,한려동,관내사전투표,1926,1926,1733,96,80,7,0,1916,10,0,90.44885177453027,5.010438413361169,4.175365344467641,0.36534446764091855,0.0
54,전라남도,여수시,한려동,한려동제1투,461,273,206,47,14,2,0,269,4,188,76.57992565055763,17.472118959107807,5.204460966542751,0.7434944237918215,0.0
55,전라남도,여수시,한려동,한려동제2투,604,318,240,58,14,3,0,315,3,286,76.19047619047619,18.412698412698415,4.444444444444445,0.9523809523809524,0.0
56,전라남도,여수시,중앙동,관내사전투표,2849,2849,2623,142,60,9,4,2838,11,0,92.42424242424242,5.003523608174771,2.1141649048625792,0.3171247357293869,0.14094432699083861
57,전라남도,여수시,중앙동,중앙동제1투,739,399,310,58,21,6,0,395,4,340,78.48101265822784,14.683544303797468,5.3164556962025316,1.5189873417721518,0.0
58,전라남도,여수시,중앙동,중앙동제2투,713,365,288,60,13,3,1,365,0,348,78.9041095890411,16.43835616438356,3.5616438356164384,0.821917808219178,0.273972602739726
59,전라남도,여수시,충무동,관내사전투표,1196,1196,1092,52,35,8,2,1189,7,0,91.84188393608073,4.373423044575273,2.943650126156434,0.6728343145500421,0.16820857863751051
60,전라남도,여수시,충무동,충무동제1투,595,281,235,36,9,1,0,281,0,314,83.62989323843416,12.811387900355871,3.202846975088968,0.3558718861209964,0.0
61,전라남도,여수시,충무동,충무동제2투,860,496,431,43,18,2,0,494,2,364,87.24696356275304,8.704453441295547,3.643724696356275,0.4048582995951417,0.0
62,전라남도,여수시,광림동,관내사전투표,3252,3252,2982,152,87,15,2,3238,14,0,92.09388511426808,4.694255713403336,2.686843730697962,0.46324891908585547,0.06176652254478073
63,전라남도,여수시,광림동,광림동제1투,819,417,341,61,9,2,2,415,2,402,82.16867469879519,14.698795180722893,2.1686746987951806,0.48192771084337355,0.48192771084337355
64,전라남도,여수시,광림동,광림동제2투,574,347,288,51,5,1,0,345,2,227,83.47826086956522,14.782608695652174,1.4492753623188406,0.2898550724637681,0.0
65,전라남도,여수시,광림동,광림동제3투,1125,728,591,97,28,9,1,726,2,397,81.40495867768594,13.360881542699724,3.8567493112947657,1.2396694214876034,0.13774104683195593
66,전라남도,여수시,서강동,관내사전투표,2309,2309,2109,113,65,8,2,2297,12,0,91.81541140618198,4.919460165433174,2.8297779712668696,0.348280365694384,0.087070091423596
67,전라남도,여수시,서강동,서강동제1투,723,365,294,53,15,1,1,364,1,358,80.76923076923077,14.560439560439562,4.1208791208791204,0.27472527472527475,0.27472527472527475
68,전라남도,여수시,서강동,서강동제2투,871,533,413,82,30,5,0,530,3,338,77.9245283018868,15.471698113207546,5.660377358490567,0.9433962264150944,0.0
69,전라남도,여수시,대교동,관내사전투표,2672,2672,2479,114,57,11,2,2663,9,0,93.0904994367255,4.280886218550507,2.1404431092752536,0.41306796845662785,0.07510326699211416
70,전라남도,여수시,대교동,대교동제1투,1431,726,595,101,25,2,0,723,3,705,82.29598893499308,13.96957123098202,3.4578146611341634,0.2766251728907331,0.0
71,전라남도,여수시,대교동,대교동제2투,620,397,349,27,10,5,1,392,5,223,89.03061224489795,6.887755102040815,2.5510204081632653,1.2755102040816326,0.25510204081632654
72,전라남도,여수시,국동,관내사전투표,5197,5197,4770,238,139,26,5,5178,19,0,92.12050984936269,4.596369254538432,2.6844341444573194,0.5021243723445346,0.09656237929702588
73,전라남도,여수시,국동,국동제1투,648,331,242,62,20,5,1,330,1,317,73.33333333333333,18.787878787878785,6.0606060606060606,1.5151515151515151,0.30303030303030304
74,전라남도,여수시,국동,국동제2투,823,400,326,60,11,2,0,399,1,423,81.70426065162907,15.037593984962406,2.756892230576441,0.5012531328320802,0.0
75,전라남도,여수시,국동,국동제3투,1460,910,755,106,36,8,1,906,4,550,83.33333333333334,11.699779249448124,3.9735099337748347,0.8830022075055187,0.11037527593818984
76,전라남도,여수시,국동,국동제4투,1227,809,681,79,34,7,4,805,4,418,84.59627329192546,9.813664596273291,4.22360248447205,0.8695652173913043,0.4968944099378882
77,전라남도,여수시,월호동,관내사전투표,3232,3232,2946,161,89,24,1,3221,11,0,91.46227879540515,4.9984476870537105,2.76311704439615,0.7451102142191867,0.03104625892579944
78,전라남도,여수시,월호동,월호동제1투,1295,751,568,143,36,1,0,748,3,544,75.93582887700535,19.11764705882353,4.81283422459893,0.1336898395721925,0.0
79,전라남도,여수시,월호동,월호동제2투,1024,682,534,106,34,4,0,678,4,342,78.76106194690266,15.634218289085547,5.014749262536873,0.5899705014749262,0.0
80,전라남도,여수시,월호동,월호동제3투,327,247,213,24,7,0,0,244,3,80,87.29508196721312,9.836065573770492,2.8688524590163933,0.0,0.0
81,전라남도,여수시,월호동,월호동제4투,49,38,37,1,0,0,0,38,0,11,97.36842105263158,2.631578947368421,0.0,0.0,0.0
82,전라남도,여수시,여서동,관내사전투표,5998,5997,5466,274,206,30,6,5982,15,1,91.37412236710131,4.580407890337679,3.44366432631227,0.5015045135406219,0.10030090270812438
83,전라남도,여수시,여서동,여서동제1투,1225,622,468,109,36,6,2,621,1,603,75.36231884057972,17.55233494363929,5.797101449275362,0.966183574879227,0.322061191626409
84,전라남도,여수시,여서동,여서동제2투,1207,846,665,130,38,6,2,841,5,361,79.07253269916765,15.457788347205708,4.5184304399524375,0.713436385255648,0.23781212841854932
85,전라남도,여수시,여서동,여서동제3투,1280,927,745,142,36,3,0,926,1,353,80.45356371490281,15.334773218142548,3.8876889848812093,0.32397408207343414,0.0
86,전라남도,여수시,여서동,여서동제4투,1142,776,655,83,21,10,2,771,5,366,84.95460440985732,10.765239948119326,2.7237354085603114,1.297016861219196,0.25940337224383914
87,전라남도,여수시,여서동,여서동제5투,1397,1103,901,131,52,16,0,1100,3,294,81.9090909090909,11.90909090909091,4.7272727272727275,1.4545454545454546,0.0
88,전라남도,여수시,여서동,여서동제6투,1028,639,524,80,24,5,2,635,4,389,82.51968503937009,12.598425196850393,3.779527559055118,0.7874015748031495,0.31496062992125984
89,전라남도,여수시,문수동,관내사전투표,6730,6730,6129,295,247,35,1,6707,23,0,91.38213806470851,4.398389742060534,3.6827195467422094,0.5218428507529447,0.01490979573579842
90,전라남도,여수시,문수동,문수동제1투,641,492,423,49,14,5,0,491,1,149,86.15071283095723,9.979633401221996,2.8513238289205702,1.0183299389002036,0.0
91,전라남도,여수시,문수동,문수동제2투,1228,816,683,95,30,3,1,812,4,412,84.11330049261085,11.69950738916256,3.6945812807881775,0.3694581280788177,0.12315270935960591
92,전라남도,여수시,문수동,문수동제3투,1797,1009,750,173,67,13,0,1003,6,788,74.77567298105683,17.24825523429711,6.679960119641076,1.296111665004985,0.0
93,전라남도,여수시,문수동,문수동제4투,1512,1149,962,121,51,9,0,1143,6,363,84.16447944007,10.586176727909011,4.4619422572178475,0.7874015748031495,0.0
94,전라남도,여수시,문수동,문수동제5투,1256,811,667,111,22,2,2,804,7,445,82.96019900497512,13.805970149253731,2.736318407960199,0.24875621890547264,0.24875621890547264
95,전라남도,여수시,문수동,문수동제6투,1745,1127,883,165,68,7,0,1123,4,618,78.6286731967943,14.692787177203916,6.055209260908281,0.6233303650934996,0.0
96,전라남도,여수시,미평동,관내사전투표,5762,5761,5097,300,273,44,9,5723,38,1,89.06168093657173,5.242005940940066,4.77022540625546,0.7688275380045431,0.15726017822820199
97,전라남도,여수시,미평동,미평동제1투,1416,854,568,195,67,14,1,845,9,562,67.2189349112426,23.076923076923077,7.928994082840236,1.6568047337278107,0.1183431952662722
98,전라남도,여수시,미평동,미평동제2투,1345,820,642,133,34,3,1,813,7,525,78.96678966789668,16.359163591635916,4.182041820418204,0.36900369003690037,0.12300123001230012
99,전라남도,여수시,미평동,미평동제3투,935,545,426,83,28,4,0,541,4,390,78.74306839186691,15.341959334565619,5.175600739371535,0.7393715341959335,0.0
100,전라남도,여수시,미평동,미평동제4투,888,624,456,121,39,7,0,623,1,264,73.19422150882825,19.42215088282504,6.260032102728733,1.1235955056179776,0.0
101,전라남도,여수시,둔덕동,관내사전투표,4014,4014,3671,147,144,34,1,3997,17,0,91.84388291218414,3.677758318739054,3.6027020265198897,0.8506379784838629,0.02501876407305479
102,전라남도,여수시,둔덕동,둔덕동제1투,836,459,328,94,28,6,0,456,3,377,71.9298245614035,20.614035087719298,6.140350877192982,1.3157894736842104,0.0
103,전라남도,여수시,둔덕동,둔덕동제2투,1488,931,710,160,48,9,0,927,4,557,76.59115426105717,17.25997842502697,5.177993527508091,0.9708737864077669,0.0
104,전라남도,여수시,둔덕동,둔덕동제3투,1208,823,656,108,51,6,0,821,2,385,79.90255785627284,13.15468940316687,6.211936662606577,0.730816077953715,0.0
105,전라남도,여수시,만덕동,관내사전투표,3714,3714,3342,174,160,18,5,3699,15,0,90.34874290348743,4.703974047039741,4.325493376588267,0.48661800486618007,0.13517166801838335
106,전라남도,여수시,만덕동,만덕동제1투,1595,1070,872,134,47,11,1,1065,5,525,81.87793427230046,12.582159624413144,4.413145539906103,1.0328638497652582,0.09389671361502347
107,전라남도,여수시,만덕동,만덕동제2투,1733,1152,805,231,91,19,0,1146,6,581,70.24432809773124,20.157068062827225,7.940663176265271,1.6579406631762654,0.0
108,전라남도,여수시,만덕동,만덕동제3투,544,349,299,31,11,3,2,346,3,195,86.41618497109826,8.959537572254336,3.1791907514450863,0.8670520231213872,0.5780346820809248
109,전라남도,여수시,쌍봉동,관내사전투표,11797,11797,10418,667,592,65,10,11752,45,0,88.64874063989107,5.675629680054459,5.037440435670524,0.5530973451327433,0.08509189925119127
110,전라남도,여수시,쌍봉동,쌍봉동제1투,1027,562,371,121,59,6,1,558,4,465,66.48745519713262,21.68458781362007,10.57347670250896,1.0752688172043012,0.17921146953405018
111,전라남도,여수시,쌍봉동,쌍봉동제2투,2040,1248,904,242,90,6,1,1243,5,792,72.72727272727273,19.469026548672566,7.240547063555914,0.4827031375703942,0.08045052292839903
112,전라남도,여수시,쌍봉동,쌍봉동제3투,1680,1168,852,219,68,14,1,1154,14,512,73.83015597920277,18.977469670710573,5.892547660311958,1.2131715771230502,0.08665511265164644
113,전라남도,여수시,쌍봉동,쌍봉동제4투,1392,1054,766,193,82,7,3,1051,3,338,72.88296860133207,18.363463368220742,7.802093244529019,0.6660323501427212,0.285442435775452
114,전라남도,여수시,쌍봉동,쌍봉동제5투,1842,1376,1049,210,95,12,2,1368,8,466,76.68128654970761,15.350877192982457,6.944444444444445,0.8771929824561403,0.14619883040935672
115,전라남도,여수시,쌍봉동,쌍봉동제6투,1353,950,744,146,50,6,0,946,4,403,78.64693446088795,15.433403805496829,5.2854122621564485,0.6342494714587738,0.0
116,전라남도,여수시,쌍봉동,쌍봉동제7투,2072,1534,1209,214,90,17,0,1530,4,538,79.01960784313725,13.986928104575163,5.88235294117647,1.1111111111111112,0.0
117,전라남도,여수시,쌍봉동,쌍봉동제8투,2001,1530,1183,222,102,13,0,1520,10,471,77.82894736842105,14.605263157894738,6.7105263157894735,0.855263157894737,0.0
118,전라남도,여수시,시전동,관내사전투표,9429,9429,8527,423,388,56,10,9404,25,0,90.67418119948958,4.49808592088473,4.125903870693322,0.5954912803062526,0.10633772862611655
119,전라남도,여수시,시전동,시전동제1투,1210,820,640,112,60,6,0,818,2,390,78.239608801956,13.691931540342297,7.334963325183375,0.7334963325183375,0.0
120,전라남도,여수시,시전동,시전동제2투,1930,1454,1204,159,74,7,1,1445,9,476,83.32179930795847,11.003460207612457,5.1211072664359865,0.4844290657439446,0.06920415224913494
121,전라남도,여수시,시전동,시전동제3투,1715,1067,804,162,85,4,0,1055,12,648,76.2085308056872,15.355450236966824,8.056872037914692,0.37914691943127965,0.0
122,전라남도,여수시,시전동,시전동제4투,873,473,334,87,42,2,1,466,7,400,71.67381974248927,18.669527896995707,9.012875536480687,0.4291845493562232,0.2145922746781116
123,전라남도,여수시,시전동,시전동제5투,1270,806,573,177,45,6,0,801,5,464,71.53558052434457,22.09737827715356,5.617977528089887,0.7490636704119851,0.0
124,전라남도,여수시,시전동,시전동제6투,2280,1675,1345,187,116,14,1,1663,12,605,80.87793144918821,11.244738424533974,6.975345760673482,0.841852074564041,0.06013229104028864
125,전라남도,여수시,시전동,시전동제7투,1946,1455,1050,264,120,14,0,1448,7,491,72.51381215469614,18.23204419889503,8.287292817679557,0.9668508287292817,0.0
126,전라남도,여수시,시전동,시전동제8투,2651,2065,1598,290,148,15,0,2051,14,586,77.91321306679669,14.139444173573867,7.215992198927353,0.7313505607020965,0.0
127,전라남도,여수시,시전동,시전동제9투,3014,2169,1694,276,162,19,2,2153,16,845,78.6809103576405,12.819321876451465,7.524384579656293,0.8824895494658616,0.09289363678588017
128,전라남도,여수시,여천동,관내사전투표,8050,8049,7211,366,391,39,6,8013,36,1,89.99126419568202,4.567577686259828,4.879570697616374,0.4867090977162112,0.07487832272557095
129,전라남도,여수시,여천동,여천동제1투,968,594,451,93,39,6,0,589,5,374,76.5704584040747,15.789473684210526,6.621392190152801,1.0186757215619695,0.0
130,전라남도,여수시,여천동,여천동제2투,1701,1120,834,162,96,17,0,1109,11,581,75.20288548241659,14.607754733994591,8.656447249774573,1.532912533814247,0.0
131,전라남도,여수시,여천동,여천동제3투,2102,1171,872,175,101,11,3,1162,9,931,75.04302925989673,15.060240963855422,8.691910499139414,0.9466437177280551,0.25817555938037867
132,전라남도,여수시,여천동,여천동제4투,2405,1518,1202,190,95,22,1,1510,8,887,79.60264900662251,12.582781456953644,6.291390728476822,1.456953642384106,0.06622516556291391
133,전라남도,여수시,여천동,여천동제5투,1744,1161,954,146,45,8,3,1156,5,583,82.52595155709342,12.629757785467127,3.8927335640138407,0.6920415224913495,0.25951557093425603
134,전라남도,여수시,주삼동,관내사전투표,3628,3626,3294,125,170,16,5,3610,16,2,91.24653739612188,3.4626038781163437,4.7091412742382275,0.443213296398892,0.13850415512465375
135,전라남도,여수시,주삼동,주삼동제1투,525,257,184,55,14,2,0,255,2,268,72.15686274509804,21.568627450980394,5.490196078431373,0.7843137254901961,0.0
136,전라남도,여수시,주삼동,주삼동제2투,2291,1471,1171,178,85,23,1,1458,13,820,80.31550068587106,12.208504801097392,5.829903978052126,1.577503429355281,0.06858710562414265
137,전라남도,여수시,삼일동,관내사전투표,1705,1705,1543,65,77,9,0,1694,11,0,91.086186540732,3.837072018890201,4.545454545454546,0.5312868949232585,0.0
138,전라남도,여수시,삼일동,삼일동투표소,681,359,266,69,18,2,0,355,4,322,74.92957746478874,19.43661971830986,5.070422535211268,0.5633802816901409,0.0
139,전라남도,여수시,묘도동,관내사전투표,652,652,596,27,23,2,2,650,2,0,91.6923076923077,4.153846153846154,3.5384615384615383,0.3076923076923077,0.3076923076923077
140,전라남도,여수시,묘도동,묘도동투표소,348,176,158,13,2,1,1,175,1,172,90.28571428571428,7.428571428571429,1.1428571428571428,0.5714285714285714,0.5714285714285714
141,전라남도,여수시,잘못 투입·구분된 투표지,,0,4,4,0,0,0,0,4,0,-4,100.0,0.0,0.0,0.0,0.0
0,전라남도,순천시,거소·선상투표,,645,606,438,63,63,7,5,576,30,39,76.04166666666666,10.9375,10.9375,1.215277777777778,0.8680555555555556
1,전라남도,순천시,관외사전투표,,24094,24091,19022,1922,2750,187,32,23913,178,3,79.54669008489105,8.037469159034835,11.500020909128926,0.7820014218207669,0.1338184251244093
2,전라남도,순천시,재외투표,,821,656,527,69,50,7,0,653,3,165,80.70444104134764,10.566615620214396,7.656967840735068,1.0719754977029097,0.0
3,전라남도,순천시,승주읍,관내사전투표,1331,1331,1212,75,22,9,1,1319,12,0,91.88779378316907,5.686125852918878,1.6679302501895377,0.6823351023502654,0.0758150113722517
4,전라남도,순천시,승주읍,승주읍투표소,983,557,451,79,21,3,1,555,2,426,81.26126126126127,14.234234234234233,3.783783783783784,0.5405405405405406,0.18018018018018017
5,전라남도,순천시,주암면,관내사전투표,1267,1267,1149,62,32,6,6,1255,12,0,91.55378486055777,4.940239043824701,2.549800796812749,0.4780876494023904,0.4780876494023904
6,전라남도,순천시,주암면,주암면제1투,636,446,376,50,10,1,1,438,8,190,85.84474885844749,11.415525114155251,2.28310502283105,0.228310502283105,0.228310502283105
7,전라남도,순천시,주암면,주암면제2투,609,310,255,45,5,2,0,307,3,299,83.06188925081433,14.65798045602606,1.6286644951140066,0.6514657980456027,0.0
8,전라남도,순천시,송광면,관내사전투표,659,659,610,25,12,7,1,655,4,0,93.12977099236642,3.816793893129771,1.8320610687022902,1.0687022900763359,0.15267175572519084
9,전라남도,순천시,송광면,송광면투표소,463,248,205,34,3,3,2,247,1,215,82.99595141700405,13.765182186234817,1.214574898785425,1.214574898785425,0.8097165991902834
10,전라남도,순천시,외서면,관내사전투표,457,457,414,23,9,7,1,454,3,0,91.18942731277532,5.066079295154185,1.9823788546255507,1.5418502202643172,0.22026431718061676
11,전라남도,순천시,외서면,외서면투표소,258,126,106,14,5,0,0,125,1,132,84.8,11.200000000000001,4.0,0.0,0.0
12,전라남도,순천시,낙안면,관내사전투표,1560,1560,1427,78,30,3,5,1543,17,0,92.48217757615036,5.055087491898899,1.9442644199611145,0.19442644199611148,0.32404406999351915
13,전라남도,순천시,낙안면,낙안면제1투,578,279,219,49,6,1,0,275,4,299,79.63636363636364,17.81818181818182,2.181818181818182,0.36363636363636365,0.0
14,전라남도,순천시,낙안면,낙안면제2투,365,220,179,31,7,1,0,218,2,145,82.11009174311926,14.220183486238533,3.211009174311927,0.45871559633027525,0.0
15,전라남도,순천시,별량면,관내사전투표,2411,2411,2206,120,55,17,3,2401,10,0,91.8783840066639,4.997917534360683,2.2907122032486464,0.7080383173677633,0.12494793835901709
16,전라남도,순천시,별량면,별량면제1투,750,388,319,55,5,3,0,382,6,362,83.50785340314137,14.397905759162304,1.3089005235602094,0.7853403141361256,0.0
17,전라남도,순천시,별량면,별량면제2투,735,345,275,53,9,1,3,341,4,390,80.64516129032258,15.542521994134898,2.6392961876832843,0.2932551319648094,0.8797653958944283
18,전라남도,순천시,별량면,별량면제3투,577,356,296,41,12,3,1,353,3,221,83.85269121813032,11.614730878186968,3.39943342776204,0.84985835694051,0.28328611898017
19,전라남도,순천시,상사면,관내사전투표,1365,1365,1258,53,38,6,4,1359,6,0,92.56806475349522,3.899926416482708,2.79617365710081,0.44150110375275936,0.29433406916850624
20,전라남도,순천시,상사면,상사면투표소,1030,571,451,84,17,10,1,563,8,459,80.10657193605684,14.92007104795737,3.019538188277087,1.7761989342806392,0.17761989342806395
21,전라남도,순천시,해룡면,관내사전투표,10851,10851,9656,509,577,65,3,10810,41,0,89.32469935245143,4.708603145235893,5.337650323774283,0.6012950971322849,0.02775208140610546
22,전라남도,순천시,해룡면,해룡면제1투,1537,1008,851,104,38,8,1,1002,6,529,84.93013972055888,10.379241516966067,3.792415169660679,0.7984031936127743,0.09980039920159679
23,전라남도,순천시,해룡면,해룡면제2투,578,403,365,22,6,2,1,396,7,175,92.17171717171718,5.555555555555555,1.5151515151515151,0.5050505050505051,0.25252525252525254
24,전라남도,순천시,해룡면,해룡면제3투,1906,1282,994,179,84,16,2,1275,7,624,77.9607843137255,14.03921568627451,6.588235294117648,1.2549019607843137,0.1568627450980392
25,전라남도,순천시,해룡면,해룡면제4투,1706,1253,977,179,80,5,2,1243,10,453,78.60016090104585,14.400643604183427,6.436041834271923,0.4022526146419952,0.16090104585679807
26,전라남도,순천시,해룡면,해룡면제5투,2019,1434,1130,170,112,15,1,1428,6,585,79.13165266106442,11.904761904761903,7.8431372549019605,1.050420168067227,0.0700280112044818
27,전라남도,순천시,해룡면,해룡면제6투,2401,1710,1377,196,110,17,1,1701,9,691,80.95238095238095,11.522633744855968,6.466784244562023,0.9994121105232217,0.058788947677836566
28,전라남도,순천시,해룡면,해룡면제7투,1471,1121,897,128,81,8,0,1114,7,350,80.52064631956912,11.490125673249551,7.271095152603231,0.718132854578097,0.0
29,전라남도,순천시,해룡면,해룡면제8투,2327,1774,1371,257,121,18,2,1769,5,553,77.50141322781232,14.527981910684002,6.840022611644997,1.0175240248728095,0.11305822498586772
30,전라남도,순천시,해룡면,해룡면제9투,2335,1637,1243,246,122,16,10,1637,0,698,75.93158216249236,15.027489309712887,7.452657299938912,0.9773976786805132,0.6108735491753208
31,전라남도,순천시,해룡면,해룡면제10투,1852,1434,1094,197,122,15,3,1431,3,418,76.45003494060097,13.76659678546471,8.525506638714187,1.0482180293501049,0.20964360587002098
32,전라남도,순천시,해룡면,해룡면제11투,2730,2082,1487,361,193,27,2,2070,12,648,71.83574879227052,17.439613526570046,9.323671497584542,1.3043478260869565,0.0966183574879227
33,전라남도,순천시,서면,관내사전투표,3916,3915,3518,200,135,35,2,3890,25,1,90.43701799485862,5.141388174807198,3.470437017994859,0.8997429305912596,0.051413881748071974
34,전라남도,순천시,서면,서면제1투,443,290,231,43,8,3,2,287,3,153,80.48780487804879,14.982578397212542,2.7874564459930316,1.0452961672473868,0.6968641114982579
35,전라남도,순천시,서면,서면제2투,606,377,284,75,13,4,1,377,0,229,75.3315649867374,19.893899204244033,3.4482758620689653,1.0610079575596816,0.2652519893899204
36,전라남도,순천시,서면,서면제3투,2434,1819,1461,210,117,17,3,1808,11,615,80.8075221238938,11.61504424778761,6.471238938053098,0.9402654867256638,0.16592920353982302
37,전라남도,순천시,서면,서면제4투,2609,1841,1458,260,84,23,1,1826,15,768,79.84665936473165,14.238773274917854,4.600219058050383,1.2595837897042717,0.054764512595837894
38,전라남도,순천시,서면,서면제5투,566,377,319,45,6,2,1,373,4,189,85.52278820375335,12.064343163538874,1.6085790884718498,0.5361930294906166,0.2680965147453083
39,전라남도,순천시,황전면,관내사전투표,1464,1464,1348,63,25,12,4,1452,12,0,92.8374655647383,4.338842975206612,1.721763085399449,0.8264462809917356,0.27548209366391185
40,전라남도,순천시,황전면,황전면제1투,465,250,190,48,8,2,0,248,2,215,76.61290322580645,19.35483870967742,3.225806451612903,0.8064516129032258,0.0
41,전라남도,순천시,황전면,황전면제2투,534,315,267,40,5,1,2,315,0,219,84.76190476190476,12.698412698412698,1.5873015873015872,0.31746031746031744,0.6349206349206349
42,전라남도,순천시,월등면,관내사전투표,773,773,735,23,11,1,0,770,3,0,95.45454545454545,2.987012987012987,1.4285714285714286,0.12987012987012986,0.0
43,전라남도,순천시,월등면,월등면투표소,526,299,252,41,3,1,0,297,2,227,84.84848484848484,13.804713804713806,1.0101010101010102,0.33670033670033667,0.0
44,전라남도,순천시,향동,관내사전투표,1959,1958,1735,130,66,19,1,1951,7,1,88.92875448487955,6.663249615581752,3.3828805740645826,0.9738595592004101,0.05125576627370579
45,전라남도,순천시,향동,향동투표소,1158,630,477,120,24,2,0,623,7,528,76.56500802568218,19.26163723916533,3.8523274478330656,0.32102728731942215,0.0
46,전라남도,순천시,매곡동,관내사전투표,3267,3267,2814,217,197,18,5,3251,16,0,86.5579821593356,6.67486927099354,6.059673946478006,0.5536757920639803,0.15379883112888343
47,전라남도,순천시,매곡동,매곡동제1투,714,411,272,105,23,7,0,407,4,303,66.83046683046683,25.7985257985258,5.651105651105651,1.71990171990172,0.0
48,전라남도,순천시,매곡동,매곡동제2투,1533,972,661,194,91,16,2,964,8,561,68.56846473029046,20.12448132780083,9.439834024896266,1.6597510373443984,0.2074688796680498
49,전라남도,순천시,삼산동,관내사전투표,9442,9442,8393,478,461,59,7,9398,44,0,89.3062353692275,5.08618855075548,4.905298999787188,0.6277931474781869,0.07448393275164929
50,전라남도,순천시,삼산동,삼산동제1투,836,481,276,117,75,8,1,477,4,355,57.861635220125784,24.528301886792452,15.723270440251572,1.6771488469601679,0.20964360587002098
51,전라남도,순천시,삼산동,삼산동제2투,1384,1001,745,160,80,5,2,992,9,383,75.1008064516129,16.129032258064516,8.064516129032258,0.5040322580645161,0.20161290322580644
52,전라남도,순천시,삼산동,삼산동제3투,1453,901,684,135,64,12,1,896,5,552,76.33928571428571,15.066964285714285,7.142857142857142,1.3392857142857142,0.11160714285714285
53,전라남도,순천시,삼산동,삼산동제4투,2291,1540,1186,248,76,16,3,1529,11,751,77.5670372792675,16.219751471550033,4.970568999345978,1.0464355788096795,0.1962066710268149
54,전라남도,순천시,삼산동,삼산동제5투,2103,1597,1271,193,110,14,0,1588,9,506,80.03778337531486,12.153652392947103,6.926952141057935,0.8816120906801008,0.0
55,전라남도,순천시,삼산동,삼산동제6투,2575,1797,1391,280,103,12,1,1787,10,778,77.8399552322328,15.668718522663683,5.763850027979855,0.6715165081141579,0.05595970900951316
56,전라남도,순천시,삼산동,삼산동제7투,1383,1087,867,153,57,4,1,1082,5,296,80.12939001848429,14.140480591497228,5.268022181146026,0.36968576709796674,0.09242144177449169
57,전라남도,순천시,조곡동,관내사전투표,2572,2572,2327,127,92,10,2,2558,14,0,90.96950742767788,4.964816262705239,3.596559812353401,0.3909304143862392,0.07818608287724785
58,전라남도,순천시,조곡동,조곡동제1투,1882,1369,1038,231,75,13,1,1358,11,513,76.4359351988218,17.010309278350515,5.522827687776141,0.9572901325478645,0.07363770250368189
59,전라남도,순천시,조곡동,조곡동제2투,363,192,136,43,9,1,1,190,2,171,71.57894736842105,22.63157894736842,4.736842105263158,0.5263157894736842,0.5263157894736842
60,전라남도,순천시,조곡동,조곡동제3투,645,346,237,80,22,6,0,345,1,299,68.69565217391305,23.18840579710145,6.3768115942028984,1.7391304347826086,0.0
61,전라남도,순천시,덕연동,관내사전투표,10309,10309,9415,425,371,50,8,10269,40,0,91.68370824812543,4.138669782841562,3.6128152692569873,0.48690232739312495,0.07790437238289999
62,전라남도,순천시,덕연동,덕연동제1투,1637,1124,864,185,58,10,1,1118,6,513,77.28085867620752,16.547406082289804,5.18783542039356,0.8944543828264758,0.08944543828264759
63,전라남도,순천시,덕연동,덕연동제2투,1683,1024,784,163,58,11,1,1017,7,659,77.08947885939035,16.027531956735498,5.703048180924287,1.0816125860373649,0.09832841691248771
64,전라남도,순천시,덕연동,덕연동제3투,1615,1253,1018,158,58,12,1,1247,6,362,81.63592622293504,12.670408981555733,4.651162790697675,0.9623095429029671,0.08019246190858059
65,전라남도,순천시,덕연동,덕연동제4투,1452,1016,791,152,63,7,0,1013,3,436,78.08489634748273,15.004935834155972,6.219151036525173,0.6910167818361304,0.0
66,전라남도,순천시,덕연동,덕연동제5투,1519,1149,940,132,64,8,2,1146,3,370,82.02443280977313,11.518324607329843,5.5846422338568935,0.6980802792321117,0.17452006980802792
67,전라남도,순천시,덕연동,덕연동제6투,1528,1137,922,132,63,13,0,1130,7,391,81.59292035398231,11.68141592920354,5.575221238938053,1.1504424778761062,0.0
68,전라남도,순천시,덕연동,덕연동제7투,1214,831,665,105,48,5,1,824,7,383,80.70388349514563,12.742718446601941,5.825242718446602,0.6067961165048543,0.12135922330097086
69,전라남도,순천시,덕연동,덕연동제8투,1985,1443,1173,161,81,16,1,1432,11,542,81.91340782122904,11.243016759776536,5.656424581005587,1.1173184357541899,0.06983240223463687
70,전라남도,순천시,덕연동,덕연동제9투,1906,1435,1175,151,82,18,1,1427,8,471,82.34057463209531,10.581639803784162,5.746320953048353,1.261387526278907,0.0700770847932726
71,전라남도,순천시,덕연동,덕연동제10투,1732,1273,1026,160,70,10,1,1267,6,459,80.97868981846882,12.628255722178375,5.524861878453039,0.7892659826361484,0.07892659826361484
72,전라남도,순천시,덕연동,덕연동제11투,2167,1595,1296,186,90,12,4,1588,7,572,81.61209068010076,11.712846347607053,5.6675062972292185,0.7556675062972292,0.2518891687657431
73,전라남도,순천시,풍덕동,관내사전투표,4508,4508,4125,228,119,20,2,4494,14,0,91.7890520694259,5.07343124165554,2.64797507788162,0.4450378282153983,0.04450378282153983
74,전라남도,순천시,풍덕동,풍덕동제1투,638,334,254,59,16,1,0,330,4,304,76.96969696969697,17.87878787878788,4.848484848484849,0.30303030303030304,0.0
75,전라남도,순천시,풍덕동,풍덕동제2투,1061,695,568,94,29,3,1,695,0,366,81.72661870503597,13.525179856115107,4.172661870503598,0.4316546762589928,0.14388489208633093
76,전라남도,순천시,풍덕동,풍덕동제3투,1486,1030,802,157,58,5,2,1024,6,456,78.3203125,15.33203125,5.6640625,0.48828125,0.1953125
77,전라남도,순천시,남제동,관내사전투표,3215,3215,2917,158,108,14,3,3200,15,0,91.15625,4.9375,3.375,0.43750000000000006,0.09375
78,전라남도,순천시,남제동,남제동제1투,620,332,263,50,14,4,0,331,1,288,79.45619335347432,15.105740181268882,4.229607250755287,1.2084592145015105,0.0
79,전라남도,순천시,남제동,남제동제2투,810,464,372,73,14,1,0,460,4,346,80.8695652173913,15.869565217391305,3.0434782608695654,0.21739130434782608,0.0
80,전라남도,순천시,남제동,남제동제3투,1571,845,664,117,49,8,2,840,5,726,79.04761904761905,13.928571428571429,5.833333333333333,0.9523809523809524,0.2380952380952381
81,전라남도,순천시,저전동,관내사전투표,1817,1817,1653,89,49,7,2,1800,17,0,91.83333333333333,4.944444444444445,2.722222222222222,0.3888888888888889,0.1111111111111111
82,전라남도,순천시,저전동,저전동투표소,886,521,384,92,29,12,0,517,4,365,74.27466150870407,17.79497098646035,5.609284332688588,2.321083172147002,0.0
83,전라남도,순천시,장천동,관내사전투표,1536,1536,1372,96,53,6,3,1530,6,0,89.6732026143791,6.2745098039215685,3.4640522875816995,0.39215686274509803,0.19607843137254902
84,전라남도,순천시,장천동,장천동투표소,750,361,268,67,24,1,0,360,1,389,74.44444444444444,18.61111111111111,6.666666666666667,0.2777777777777778,0.0
85,전라남도,순천시,중앙동,관내사전투표,2637,2637,2352,143,103,26,2,2626,11,0,89.56587966488956,5.445544554455446,3.9223153084539226,0.9900990099009901,0.07616146230007616
86,전라남도,순천시,중앙동,중앙동투표소,972,506,359,99,31,9,1,499,7,466,71.9438877755511,19.839679358717436,6.212424849699398,1.8036072144288577,0.2004008016032064
87,전라남도,순천시,도사동,관내사전투표,5648,5647,5194,234,170,28,3,5629,18,1,92.27216201812045,4.157043879907621,3.020074613608101,0.4974240540060401,0.053295434357790016
88,전라남도,순천시,도사동,도사동제1투,1527,864,666,145,42,4,1,858,6,663,77.62237762237763,16.8997668997669,4.895104895104895,0.4662004662004662,0.11655011655011654
89,전라남도,순천시,도사동,도사동제2투,829,502,401,59,34,5,2,501,1,327,80.03992015968065,11.776447105788424,6.786427145708583,0.998003992015968,0.39920159680638717
90,전라남도,순천시,도사동,도사동제3투,601,385,311,58,10,1,4,384,1,216,80.98958333333334,15.104166666666666,2.604166666666667,0.26041666666666663,1.0416666666666665
91,전라남도,순천시,도사동,도사동제4투,1760,1342,1077,167,81,12,0,1337,5,418,80.55347793567688,12.490650710546,6.05833956619297,0.8975317875841435,0.0
92,전라남도,순천시,도사동,도사동제5투,1835,1368,1078,171,102,10,2,1363,5,467,79.09024211298606,12.545854732208364,7.4834922964049895,0.7336757153338225,0.1467351430667645
93,전라남도,순천시,왕조1동,관내사전투표,11197,11196,9979,560,538,77,5,11159,37,1,89.42557576843804,5.018370821758222,4.821220539474863,0.6900259879917555,0.044806882337126985
94,전라남도,순천시,왕조1동,왕조1동제1투,1528,1093,814,186,78,9,1,1088,5,435,74.81617647058823,17.09558823529412,7.169117647058823,0.8272058823529412,0.09191176470588235
95,전라남도,순천시,왕조1동,왕조1동제2투,1132,608,435,105,51,9,3,603,5,524,72.13930348258707,17.412935323383085,8.45771144278607,1.4925373134328357,0.4975124378109453
96,전라남도,순천시,왕조1동,왕조1동제3투,2118,1257,909,205,120,14,3,1251,6,861,72.66187050359713,16.38689048760991,9.59232613908873,1.1191047162270185,0.2398081534772182
97,전라남도,순천시,왕조1동,왕조1동제4투,1532,1087,826,167,77,9,0,1079,8,445,76.55236329935126,15.477293790546803,7.136237256719184,0.8341056533827619,0.0
98,전라남도,순천시,왕조1동,왕조1동제5투,950,672,521,101,39,5,1,667,5,278,78.11094452773614,15.142428785607196,5.847076461769116,0.7496251874062968,0.14992503748125938
99,전라남도,순천시,왕조1동,왕조1동제6투,914,577,482,59,24,4,1,570,7,337,84.56140350877193,10.350877192982457,4.2105263157894735,0.7017543859649122,0.17543859649122806
100,전라남도,순천시,왕조1동,왕조1동제7투,2053,1161,820,200,120,14,0,1154,7,892,71.05719237435008,17.33102253032929,10.398613518197573,1.2131715771230502,0.0
101,전라남도,순천시,왕조1동,왕조1동제8투,1432,978,758,160,55,2,1,976,2,454,77.6639344262295,16.39344262295082,5.635245901639344,0.20491803278688525,0.10245901639344263
102,전라남도,순천시,왕조1동,왕조1동제9투,2394,1846,1457,242,120,12,2,1833,13,548,79.48717948717949,13.202400436442991,6.546644844517186,0.6546644844517185,0.10911074740861974
103,전라남도,순천시,왕조1동,왕조1동제10투,1611,1173,843,236,78,5,1,1163,10,438,72.48495270851247,20.292347377472055,6.706792777300086,0.4299226139294927,0.08598452278589853
104,전라남도,순천시,왕조1동,왕조1동제11투,1459,1143,833,206,90,12,0,1141,2,316,73.00613496932516,18.054338299737072,7.887817703768624,1.0517090271691498,0.0
105,전라남도,순천시,왕조1동,왕조1동제12투,2124,1784,1327,241,186,19,1,1774,10,340,74.80270574971814,13.58511837655017,10.4847801578354,1.0710259301014655,0.05636978579481398
106,전라남도,순천시,왕조2동,관내사전투표,11105,11104,10027,446,504,85,8,11070,34,1,90.57813911472448,4.0289069557362245,4.5528455284552845,0.7678410117434508,0.07226738934056008
107,전라남도,순천시,왕조2동,왕조2동제1투,1328,950,754,120,63,8,1,946,4,378,79.70401691331924,12.684989429175475,6.659619450317125,0.8456659619450317,0.10570824524312897
108,전라남도,순천시,왕조2동,왕조2동제2투,1131,679,491,125,49,6,0,671,8,452,73.17436661698957,18.628912071535023,7.302533532041728,0.8941877794336811,0.0
109,전라남도,순천시,왕조2동,왕조2동제3투,2118,1442,1135,195,88,11,1,1430,12,676,79.37062937062937,13.636363636363635,6.153846153846154,0.7692307692307693,0.06993006993006994
110,전라남도,순천시,왕조2동,왕조2동제4투,1538,989,698,176,92,17,0,983,6,549,71.00712105798576,17.90437436419125,9.35910478128179,1.7293997965412005,0.0
111,전라남도,순천시,잘못 투입·구분된 투표지,,0,4,3,0,1,0,0,4,0,-4,75.0,0.0,25.0,0.0,0.0
0,전라남도,나주시,거소·선상투표,,508,466,340,52,34,3,2,431,35,42,78.88631090487239,12.064965197215777,7.888631090487238,0.6960556844547563,0.46403712296983757
1,전라남도,나주시,관외사전투표,,13722,13722,11431,916,1151,123,7,13628,94,0,83.8787789844438,6.721455826240094,8.445846786028763,0.9025535661872616,0.05136483710008805
2,전라남도,나주시,재외투표,,393,310,233,45,28,2,1,309,1,83,75.40453074433657,14.563106796116504,9.06148867313916,0.6472491909385114,0.3236245954692557
3,전라남도,나주시,남평읍,관내사전투표,4369,4369,4054,162,103,25,5,4349,20,0,93.216831455507,3.7249942515520806,2.3683605426534835,0.5748447919061853,0.11496895838123705
4,전라남도,나주시,남평읍,남평읍제1투,1163,650,562,56,21,7,0,646,4,513,86.9969040247678,8.6687306501548,3.2507739938080498,1.08359133126935,0.0
5,전라남도,나주시,남평읍,남평읍제2투,2572,1612,1287,214,85,21,1,1608,4,960,80.03731343283582,13.308457711442786,5.286069651741294,1.3059701492537312,0.06218905472636816
6,전라남도,나주시,남평읍,남평읍제3투,331,232,206,18,6,0,0,230,2,99,89.56521739130436,7.82608695652174,2.608695652173913,0.0,0.0
7,전라남도,나주시,세지면,관내사전투표,1287,1287,1212,40,18,4,6,1280,7,0,94.6875,3.125,1.40625,0.3125,0.46875
8,전라남도,나주시,세지면,세지면투표소,791,373,299,57,12,2,1,371,2,418,80.59299191374663,15.363881401617252,3.234501347708895,0.5390835579514826,0.2695417789757413
9,전라남도,나주시,왕곡면,관내사전투표,1449,1449,1337,60,36,6,1,1440,9,0,92.84722222222223,4.166666666666666,2.5,0.4166666666666667,0.06944444444444445
10,전라남도,나주시,왕곡면,왕곡면제1투,360,186,141,32,6,2,4,185,1,174,76.21621621621621,17.2972972972973,3.2432432432432434,1.0810810810810811,2.1621621621621623
11,전라남도,나주시,왕곡면,왕곡면제2투,472,281,239,32,7,1,1,280,1,191,85.35714285714285,11.428571428571429,2.5,0.35714285714285715,0.35714285714285715
12,전라남도,나주시,반남면,관내사전투표,642,642,605,22,7,3,1,638,4,0,94.82758620689656,3.4482758620689653,1.09717868338558,0.4702194357366771,0.1567398119122257
13,전라남도,나주시,반남면,반남면투표소,436,254,206,35,7,2,1,251,3,182,82.07171314741036,13.94422310756972,2.788844621513944,0.796812749003984,0.398406374501992
14,전라남도,나주시,공산면,관내사전투표,1089,1089,1018,33,24,4,3,1082,7,0,94.08502772643253,3.0499075785582255,2.2181146025878005,0.36968576709796674,0.27726432532347506
15,전라남도,나주시,공산면,공산면투표소,667,365,308,40,11,5,0,364,1,302,84.61538461538461,10.989010989010989,3.021978021978022,1.3736263736263736,0.0
16,전라남도,나주시,동강면,관내사전투표,1097,1097,1025,41,17,5,3,1091,6,0,93.95050412465628,3.758020164986251,1.5582034830430798,0.458295142071494,0.27497708524289644
17,전라남도,나주시,동강면,동강면투표소,705,363,288,56,9,6,2,361,2,342,79.77839335180056,15.512465373961218,2.4930747922437675,1.662049861495845,0.554016620498615
18,전라남도,나주시,다시면,관내사전투표,1946,1946,1811,85,29,7,5,1937,9,0,93.49509550851832,4.388229220443986,1.497160557563242,0.3613835828600929,0.2581311306143521
19,전라남도,나주시,다시면,다시면투표소,960,498,367,102,18,3,3,493,5,462,74.4421906693712,20.689655172413794,3.6511156186612577,0.6085192697768762,0.6085192697768762
20,전라남도,나주시,문평면,관내사전투표,704,704,657,29,9,4,1,700,4,0,93.85714285714286,4.142857142857142,1.2857142857142856,0.5714285714285714,0.14285714285714285
21,전라남도,나주시,문평면,문평면투표소,540,280,228,38,8,3,1,278,2,260,82.01438848920863,13.66906474820144,2.877697841726619,1.079136690647482,0.3597122302158274
22,전라남도,나주시,노안면,관내사전투표,1669,1669,1559,56,30,7,4,1656,13,0,94.14251207729468,3.3816425120772946,1.8115942028985508,0.4227053140096618,0.24154589371980675
23,전라남도,나주시,노안면,노안면제1투,335,181,145,26,5,1,1,178,3,154,81.46067415730337,14.606741573033707,2.8089887640449436,0.5617977528089888,0.5617977528089888
24,전라남도,나주시,노안면,노안면제2투,532,342,298,35,4,1,1,339,3,190,87.90560471976401,10.32448377581121,1.1799410029498525,0.2949852507374631,0.2949852507374631
25,전라남도,나주시,노안면,노안면제3투,742,400,346,33,8,5,0,392,8,342,88.26530612244898,8.418367346938775,2.0408163265306123,1.2755102040816326,0.0
26,전라남도,나주시,금천면,관내사전투표,2332,2332,2136,90,82,9,5,2322,10,0,91.98966408268734,3.875968992248062,3.5314384151593456,0.3875968992248062,0.2153316106804479
27,전라남도,나주시,금천면,금천면제1투,1465,850,622,163,51,7,2,845,5,615,73.6094674556213,19.289940828402365,6.035502958579881,0.8284023668639053,0.2366863905325444
28,전라남도,나주시,금천면,금천면제2투,375,230,198,21,9,0,0,228,2,145,86.8421052631579,9.210526315789473,3.9473684210526314,0.0,0.0
29,전라남도,나주시,금천면,금천면제3투,453,234,194,28,7,2,0,231,3,219,83.98268398268398,12.121212121212121,3.0303030303030303,0.8658008658008658,0.0
30,전라남도,나주시,산포면,관내사전투표,1793,1793,1627,84,63,11,2,1787,6,0,91.0464465584779,4.700615556799105,3.5254616675993287,0.6155567991046447,0.11191941801902631
31,전라남도,나주시,산포면,산포면제1투,700,391,339,37,8,3,0,387,4,309,87.59689922480621,9.560723514211885,2.0671834625323,0.7751937984496124,0.0
32,전라남도,나주시,산포면,산포면제2투,121,87,69,13,2,0,1,85,2,34,81.17647058823529,15.294117647058824,2.3529411764705883,0.0,1.1764705882352942
33,전라남도,나주시,산포면,산포면제3투,371,252,230,15,4,1,0,250,2,119,92.0,6.0,1.6,0.4,0.0
34,전라남도,나주시,다도면,관내사전투표,876,876,731,68,26,8,10,843,33,0,86.71411625148279,8.066429418742587,3.084223013048636,0.9489916963226572,1.1862396204033214
35,전라남도,나주시,다도면,다도면투표소,528,249,206,34,6,1,0,247,2,279,83.40080971659918,13.765182186234817,2.42914979757085,0.4048582995951417,0.0
36,전라남도,나주시,봉황면,관내사전투표,1597,1597,1491,52,29,10,2,1584,13,0,94.12878787878788,3.2828282828282833,1.8308080808080809,0.6313131313131313,0.12626262626262627
37,전라남도,나주시,봉황면,봉황면제1투,886,492,413,46,22,3,3,487,5,394,84.80492813141683,9.44558521560575,4.517453798767967,0.6160164271047228,0.6160164271047228
38,전라남도,나주시,봉황면,봉황면제2투,395,206,189,11,2,2,0,204,2,189,92.64705882352942,5.392156862745098,0.9803921568627451,0.9803921568627451,0.0
39,전라남도,나주시,송월동,관내사전투표,3862,3862,3466,189,160,26,4,3845,17,0,90.14304291287387,4.915474642392717,4.161248374512354,0.6762028608582574,0.10403120936280884
40,전라남도,나주시,송월동,송월동제1투,1993,1274,940,185,125,17,1,1268,6,719,74.13249211356468,14.589905362776026,9.858044164037855,1.3406940063091484,0.07886435331230283
41,전라남도,나주시,송월동,송월동제2투,886,484,355,94,27,3,0,479,5,402,74.11273486430062,19.624217118997915,5.6367432150313155,0.6263048016701461,0.0
42,전라남도,나주시,송월동,송월동제3투,1020,675,528,102,31,5,2,668,7,345,79.04191616766467,15.269461077844312,4.640718562874251,0.7485029940119761,0.29940119760479045
43,전라남도,나주시,영강동,관내사전투표,1538,1538,1359,79,46,12,8,1504,34,0,90.3590425531915,5.252659574468085,3.0585106382978724,0.7978723404255319,0.5319148936170213
44,전라남도,나주시,영강동,영강동투표소,852,441,328,76,30,2,1,437,4,411,75.05720823798627,17.391304347826086,6.864988558352403,0.4576659038901602,0.2288329519450801
45,전라남도,나주시,금남동,관내사전투표,1698,1698,1562,85,31,8,1,1687,11,0,92.5903971547125,5.038529934795495,1.8375815056312983,0.4742145820983995,0.05927682276229994
46,전라남도,나주시,금남동,금남동제1투,670,385,298,69,14,1,0,382,3,285,78.01047120418848,18.06282722513089,3.664921465968586,0.2617801047120419,0.0
47,전라남도,나주시,금남동,금남동제2투,402,218,168,36,6,1,2,213,5,184,78.87323943661971,16.901408450704224,2.8169014084507045,0.4694835680751174,0.9389671361502347
48,전라남도,나주시,금남동,금남동제3투,553,280,217,41,17,1,1,277,3,273,78.33935018050542,14.801444043321299,6.137184115523466,0.36101083032490977,0.36101083032490977
49,전라남도,나주시,성북동,관내사전투표,3528,3528,3157,186,135,34,3,3515,13,0,89.81507823613086,5.291607396870555,3.8406827880512093,0.9672830725462305,0.08534850640113799
50,전라남도,나주시,성북동,성북동제1투,499,244,186,45,9,2,0,242,2,255,76.85950413223141,18.59504132231405,3.71900826446281,0.8264462809917356,0.0
51,전라남도,나주시,성북동,성북동제2투,724,408,300,73,29,3,0,405,3,316,74.07407407407408,18.02469135802469,7.160493827160494,0.7407407407407408,0.0
52,전라남도,나주시,성북동,성북동제3투,1856,1315,1039,185,66,17,2,1309,6,541,79.37356760886173,14.132925897631779,5.042016806722689,1.2987012987012987,0.15278838808250572
53,전라남도,나주시,영산동,관내사전투표,1344,1344,1248,60,23,5,0,1336,8,0,93.41317365269461,4.491017964071856,1.721556886227545,0.37425149700598803,0.0
54,전라남도,나주시,영산동,영산동제1투,389,193,155,26,8,1,1,191,2,196,81.15183246073299,13.612565445026178,4.18848167539267,0.5235602094240838,0.5235602094240838
55,전라남도,나주시,영산동,영산동제2투,631,309,261,34,6,4,0,305,4,322,85.57377049180329,11.147540983606557,1.9672131147540985,1.3114754098360655,0.0
56,전라남도,나주시,이창동,관내사전투표,2113,2113,1939,82,67,13,3,2104,9,0,92.15779467680608,3.897338403041825,3.1844106463878328,0.6178707224334601,0.14258555133079848
57,전라남도,나주시,이창동,이창동투표소,1142,558,451,74,25,6,1,557,1,584,80.96947935368043,13.285457809694792,4.488330341113106,1.0771992818671454,0.17953321364452424
58,전라남도,나주시,빛가람동,관내사전투표,10123,10123,8547,628,772,111,9,10067,56,0,84.90116221317176,6.2382040329790405,7.66862024436277,1.1026124962749577,0.08940101321148307
59,전라남도,나주시,빛가람동,빛가람동제1투,2145,1450,951,302,166,21,1,1441,9,695,65.99583622484386,20.95766828591256,11.519777931991673,1.457321304649549,0.06939625260235947
60,전라남도,나주시,빛가람동,빛가람동제2투,2831,2176,1651,297,189,27,1,2165,11,655,76.25866050808314,13.718244803695152,8.729792147806005,1.2471131639722863,0.046189376443418015
61,전라남도,나주시,빛가람동,빛가람동제3투,1598,1043,720,221,88,9,0,1038,5,555,69.36416184971098,21.290944123314066,8.477842003853564,0.8670520231213872,0.0
62,전라남도,나주시,빛가람동,빛가람동제4투,2536,1818,1397,261,136,15,1,1810,8,718,77.18232044198895,14.419889502762432,7.513812154696133,0.8287292817679558,0.05524861878453039
63,전라남도,나주시,빛가람동,빛가람동제5투,1594,1112,838,191,64,13,1,1107,5,482,75.70009033423668,17.253839205058718,5.781391147244806,1.1743450767841013,0.09033423667570009
64,전라남도,나주시,빛가람동,빛가람동제6투,2073,1396,1076,208,97,10,0,1391,5,677,77.35442127965493,14.953271028037381,6.9734004313443565,0.7189072609633357,0.0
65,전라남도,나주시,잘못 투입·구분된 투표지,,0,0,0,0,0,0,0,0,0,0,0.0,0.0,0.0,0.0,0.0
0,전라남도,광양시,거소·선상투표,,399,375,266,49,44,3,4,366,9,24,72.6775956284153,13.387978142076504,12.021857923497267,0.819672131147541,1.092896174863388
1,전라남도,광양시,관외사전투표,,13356,13352,9884,1510,1692,125,23,13234,118,4,74.68641378268097,11.410004533776636,12.785250113344414,0.9445367991536949,0.1737947710442799
2,전라남도,광양시,재외투표,,450,372,302,40,26,2,0,370,2,78,81.62162162162161,10.81081081081081,7.027027027027027,0.5405405405405406,0.0
3,전라남도,광양시,광양읍,관내사전투표,13501,13501,12145,740,483,83,10,13461,40,0,90.22360894435776,5.497362751652924,3.58814352574103,0.6165960924151251,0.07428868583314761
4,전라남도,광양시,광양읍,광양읍제1투,1512,1013,795,159,46,9,1,1010,3,499,78.71287128712872,15.742574257425742,4.554455445544554,0.891089108910891,0.09900990099009901
5,전라남도,광양시,광양읍,광양읍제2투,1320,728,543,144,27,6,2,722,6,592,75.20775623268699,19.94459833795014,3.739612188365651,0.8310249307479225,0.2770083102493075
6,전라남도,광양시,광양읍,광양읍제3투,382,267,216,35,12,3,0,266,1,115,81.203007518797,13.157894736842104,4.511278195488721,1.1278195488721803,0.0
7,전라남도,광양시,광양읍,광양읍제4투,1677,1030,812,164,46,3,0,1025,5,647,79.21951219512195,16.0,4.48780487804878,0.2926829268292683,0.0
8,전라남도,광양시,광양읍,광양읍제5투,311,212,178,23,7,2,0,210,2,99,84.76190476190476,10.952380952380953,3.3333333333333335,0.9523809523809524,0.0
9,전라남도,광양시,광양읍,광양읍제6투,364,256,217,25,11,1,2,256,0,108,84.765625,9.765625,4.296875,0.390625,0.78125
10,전라남도,광양시,광양읍,광양읍제7투,1199,806,634,102,58,4,2,800,6,393,79.25,12.75,7.249999999999999,0.5,0.25
11,전라남도,광양시,광양읍,광양읍제8투,1615,829,601,167,51,5,0,824,5,786,72.93689320388349,20.266990291262136,6.189320388349515,0.6067961165048543,0.0
12,전라남도,광양시,광양읍,광양읍제9투,2290,1446,1181,173,69,12,0,1435,11,844,82.29965156794425,12.055749128919862,4.808362369337979,0.8362369337979094,0.0
13,전라남도,광양시,광양읍,광양읍제10투,816,607,491,66,40,4,1,602,5,209,81.56146179401993,10.96345514950166,6.64451827242525,0.6644518272425249,0.16611295681063123
14,전라남도,광양시,광양읍,광양읍제11투,1118,708,553,91,52,6,2,704,4,410,78.55113636363636,12.926136363636365,7.386363636363637,0.8522727272727272,0.2840909090909091
15,전라남도,광양시,광양읍,광양읍제12투,1782,1180,902,207,60,8,1,1178,2,602,76.5704584040747,17.572156196943972,5.093378607809847,0.6791171477079796,0.08488964346349745
16,전라남도,광양시,광양읍,광양읍제13투,3097,2175,1747,241,154,19,4,2165,10,922,80.69284064665126,11.131639722863742,7.113163972286374,0.8775981524249422,0.18475750577367206
17,전라남도,광양시,광양읍,광양읍제14투,2051,1575,1297,157,94,20,1,1569,6,476,82.66411727214786,10.006373486297004,5.991077119184194,1.2746972594008923,0.06373486297004462
18,전라남도,광양시,광양읍,광양읍제15투,1082,812,648,106,42,11,0,807,5,270,80.29739776951673,13.135068153655514,5.204460966542751,1.3630731102850062,0.0
19,전라남도,광양시,봉강면,관내사전투표,1446,1446,1305,64,48,10,2,1429,17,0,91.32260321903429,4.478656403079076,3.358992302309307,0.6997900629811057,0.13995801259622112
20,전라남도,광양시,봉강면,봉강면제1투,303,208,169,28,8,3,0,208,0,95,81.25,13.461538461538462,3.8461538461538463,1.4423076923076923,0.0
21,전라남도,광양시,봉강면,봉강면제2투,443,269,214,45,6,3,1,269,0,174,79.5539033457249,16.728624535315987,2.2304832713754648,1.1152416356877324,0.37174721189591076
22,전라남도,광양시,옥룡면,관내사전투표,1945,1945,1797,88,35,9,4,1933,12,0,92.96430419037766,4.552509053285049,1.8106570098292811,0.46559751681324363,0.20693222969477496
23,전라남도,광양시,옥룡면,옥룡면투표소,967,577,426,123,22,3,2,576,1,390,73.95833333333334,21.354166666666664,3.8194444444444446,0.5208333333333333,0.3472222222222222
24,전라남도,광양시,옥곡면,관내사전투표,1753,1754,1590,99,40,12,0,1741,13,-1,91.32682366456059,5.686387133831131,2.2975301550832854,0.6892590465249857,0.0
25,전라남도,광양시,옥곡면,옥곡면투표소,1552,839,587,198,45,5,1,836,3,713,70.21531100478468,23.684210526315788,5.382775119617225,0.5980861244019139,0.11961722488038277
26,전라남도,광양시,진상면,관내사전투표,1416,1416,1267,99,37,5,3,1411,5,0,89.79447200566973,7.016300496102056,2.6222537207654146,0.3543586109142452,0.21261516654854712
27,전라남도,광양시,진상면,진상면투표소,862,461,366,79,3,8,1,457,4,401,80.0875273522976,17.286652078774615,0.6564551422319475,1.75054704595186,0.2188183807439825
28,전라남도,광양시,진월면,관내사전투표,1122,1122,1022,63,21,4,3,1113,9,0,91.82389937106919,5.660377358490567,1.8867924528301887,0.3593890386343217,0.2695417789757413
29,전라남도,광양시,진월면,진월면제1투,437,222,172,43,5,1,0,221,1,215,77.82805429864254,19.457013574660635,2.262443438914027,0.4524886877828055,0.0
30,전라남도,광양시,진월면,진월면제2투,270,178,149,23,2,0,0,174,4,92,85.63218390804597,13.218390804597702,1.1494252873563218,0.0,0.0
31,전라남도,광양시,진월면,진월면제3투,350,246,199,37,4,1,3,244,2,104,81.55737704918032,15.163934426229508,1.639344262295082,0.4098360655737705,1.2295081967213115
32,전라남도,광양시,다압면,관내사전투표,730,730,618,77,21,7,3,726,4,0,85.12396694214877,10.606060606060606,2.8925619834710745,0.9641873278236914,0.4132231404958678
33,전라남도,광양시,다압면,다압면투표소,527,284,210,63,7,2,0,282,2,243,74.46808510638297,22.340425531914892,2.4822695035460995,0.7092198581560284,0.0
34,전라남도,광양시,골약동,관내사전투표,4948,4948,4164,341,393,21,2,4921,27,0,84.61694777484252,6.929485876854298,7.986181670392196,0.42674253200568996,0.0406421459053038
35,전라남도,광양시,골약동,골약동제1투,1706,1143,760,238,121,16,1,1136,7,563,66.90140845070422,20.950704225352112,10.651408450704224,1.4084507042253522,0.08802816901408451
36,전라남도,광양시,골약동,골약동제2투,2096,1510,943,351,188,20,0,1502,8,586,62.782956058588546,23.368841544607193,12.51664447403462,1.3315579227696404,0.0
37,전라남도,광양시,중마동,관내사전투표,15531,15531,13448,1076,830,101,11,15466,65,0,86.95202379412905,6.957196430880641,5.366610629768524,0.6530453898874952,0.07112375533428165
38,전라남도,광양시,중마동,중마동제1투,2219,1263,859,299,90,10,1,1259,4,956,68.22875297855441,23.74900714853058,7.148530579825259,0.7942811755361397,0.07942811755361398
39,전라남도,광양시,중마동,중마동제2투,2623,1647,1240,290,99,10,0,1639,8,976,75.65588773642466,17.69371568029286,6.0402684563758395,0.6101281269066504,0.0
40,전라남도,광양시,중마동,중마동제3투,2350,1397,997,290,89,17,0,1393,4,953,71.5721464465183,20.8183776022972,6.389088298636038,1.2203876525484567,0.0
41,전라남도,광양시,중마동,중마동제4투,2615,1713,1219,321,143,20,0,1703,10,902,71.57956547269524,18.849089841456255,8.396946564885496,1.1743981209630063,0.0
42,전라남도,광양시,중마동,중마동제5투,3411,2188,1648,351,149,24,3,2175,13,1223,75.77011494252874,16.137931034482758,6.850574712643678,1.103448275862069,0.13793103448275862
43,전라남도,광양시,중마동,중마동제6투,3176,1849,1369,322,125,16,1,1833,16,1327,74.68630660120022,17.56683033278778,6.819421713038734,0.872885979268958,0.05455537370430987
44,전라남도,광양시,중마동,중마동제7투,2485,1634,1150,307,144,18,1,1620,14,851,70.98765432098766,18.950617283950617,8.88888888888889,1.1111111111111112,0.06172839506172839
45,전라남도,광양시,중마동,중마동제8투,2128,1546,1175,259,83,20,2,1539,7,582,76.34827810266407,16.82910981156595,5.39311241065627,1.299545159194282,0.1299545159194282
46,전라남도,광양시,중마동,중마동제9투,3186,2188,1412,493,241,25,4,2175,13,998,64.91954022988506,22.666666666666664,11.080459770114942,1.1494252873563218,0.1839080459770115
47,전라남도,광양시,광영동,관내사전투표,5046,5046,4351,428,214,25,7,5025,21,0,86.58706467661692,8.517412935323383,4.258706467661692,0.4975124378109453,0.13930348258706468
48,전라남도,광양시,광영동,광영동제1투,1480,762,537,175,43,5,1,761,1,718,70.56504599211564,22.996057818659658,5.650459921156373,0.657030223390276,0.1314060446780552
49,전라남도,광양시,광영동,광영동제2투,999,590,439,117,28,3,1,588,2,409,74.65986394557824,19.897959183673468,4.761904761904762,0.5102040816326531,0.17006802721088435
50,전라남도,광양시,광영동,광영동제3투,1963,1120,785,250,72,5,0,1112,8,843,70.59352517985612,22.48201438848921,6.474820143884892,0.44964028776978415,0.0
51,전라남도,광양시,태인동,관내사전투표,1778,1778,1562,113,92,6,2,1775,3,0,88.0,6.366197183098592,5.183098591549296,0.3380281690140845,0.11267605633802817
52,전라남도,광양시,태인동,태인동투표소,453,228,182,35,7,4,0,228,0,225,79.82456140350878,15.350877192982457,3.070175438596491,1.7543859649122806,0.0
53,전라남도,광양시,금호동,관내사전투표,4803,4803,3639,656,456,27,3,4781,22,0,76.11378372725372,13.720978874712403,9.537753608031792,0.5647354110018824,0.06274837900020916
54,전라남도,광양시,금호동,금호동제1투,852,573,309,190,62,10,0,571,2,279,54.115586690017516,33.274956217162874,10.85814360770578,1.7513134851138354,0.0
55,전라남도,광양시,금호동,금호동제2투,646,431,222,168,32,7,1,430,1,215,51.627906976744185,39.06976744186046,7.441860465116279,1.627906976744186,0.23255813953488372
56,전라남도,광양시,금호동,금호동제3투,750,530,222,197,104,4,0,527,3,220,42.125237191650854,37.381404174573056,19.734345351043643,0.7590132827324478,0.0
57,전라남도,광양시,금호동,금호동제4투,713,486,244,176,51,9,0,480,6,227,50.83333333333333,36.666666666666664,10.625,1.875,0.0
58,전라남도,광양시,금호동,금호동제5투,726,506,279,174,46,3,1,503,3,220,55.46719681908549,34.59244532803181,9.145129224652088,0.5964214711729622,0.19880715705765406
59,전라남도,광양시,잘못 투입·구분된 투표지,,0,0,0,0,0,0,0,0,0,0,0.0,0.0,0.0,0.0,0.0
0,전라남도,담양군,거소·선상투표,,136,128,103,9,14,1,1,128,0,8,80.46875,7.03125,10.9375,0.78125,0.78125
1,전라남도,담양군,관외사전투표,,6460,6459,5462,451,451,52,7,6423,36,1,85.03814416939124,7.02164097773626,7.02164097773626,0.8095905340183716,0.1089833411178577
2,전라남도,담양군,재외투표,,189,147,108,16,21,2,0,147,0,42,73.46938775510205,10.884353741496598,14.285714285714285,1.3605442176870748,0.0
3,전라남도,담양군,담양읍,관내사전투표,5490,5490,5005,280,151,24,9,5469,21,0,91.51581641982081,5.119765953556408,2.761016639239349,0.4388370817334065,0.16456390565002743
4,전라남도,담양군,담양읍,담양읍제1투,971,581,485,63,23,7,2,580,1,390,83.62068965517241,10.86206896551724,3.9655172413793105,1.206896551724138,0.3448275862068966
5,전라남도,담양군,담양읍,담양읍제2투,1321,732,566,116,38,5,4,729,3,589,77.64060356652949,15.912208504801098,5.212620027434842,0.6858710562414266,0.5486968449931412
6,전라남도,담양군,담양읍,담양읍제3투,1542,934,680,180,58,8,4,930,4,608,73.11827956989248,19.35483870967742,6.236559139784946,0.8602150537634409,0.43010752688172044
7,전라남도,담양군,담양읍,담양읍제4투,1303,768,652,82,24,5,3,766,2,535,85.11749347258485,10.704960835509137,3.1331592689295036,0.6527415143603132,0.39164490861618795
8,전라남도,담양군,봉산면,관내사전투표,1135,1135,1056,45,20,8,1,1130,5,0,93.45132743362832,3.982300884955752,1.7699115044247788,0.7079646017699115,0.08849557522123894
9,전라남도,담양군,봉산면,봉산면투표소,819,466,370,69,18,4,3,464,2,353,79.74137931034483,14.870689655172415,3.8793103448275863,0.8620689655172413,0.646551724137931
10,전라남도,담양군,고서면,관내사전투표,1452,1452,1350,59,30,5,1,1445,7,0,93.42560553633218,4.083044982698962,2.0761245674740483,0.34602076124567477,0.06920415224913494
11,전라남도,담양군,고서면,고서면투표소,837,466,374,72,11,3,1,461,5,371,81.12798264642083,15.61822125813449,2.386117136659436,0.6507592190889371,0.21691973969631237
12,전라남도,담양군,가사문학면,관내사전투표,549,549,508,23,12,1,3,547,2,0,92.87020109689213,4.204753199268739,2.1937842778793417,0.18281535648994515,0.5484460694698354
13,전라남도,담양군,가사문학면,가사문학면투표소,281,132,104,24,2,1,1,132,0,149,78.78787878787878,18.181818181818183,1.5151515151515151,0.7575757575757576,0.7575757575757576
14,전라남도,담양군,창평면,관내사전투표,1586,1586,1478,48,35,9,5,1575,11,0,93.84126984126983,3.0476190476190474,2.2222222222222223,0.5714285714285714,0.31746031746031744
15,전라남도,담양군,창평면,창평면투표소,1043,557,449,82,15,6,1,553,4,486,81.19349005424955,14.828209764918626,2.7124773960216997,1.0849909584086799,0.18083182640144665
16,전라남도,담양군,대덕면,관내사전투표,724,724,678,20,13,7,2,720,4,0,94.16666666666667,2.7777777777777777,1.8055555555555554,0.9722222222222222,0.2777777777777778
17,전라남도,담양군,대덕면,대덕면투표소,603,317,251,51,11,1,0,314,3,286,79.93630573248409,16.24203821656051,3.5031847133757963,0.3184713375796179,0.0
18,전라남도,담양군,무정면,관내사전투표,992,992,884,57,37,6,3,987,5,0,89.56433637284701,5.775075987841945,3.7487335359675784,0.60790273556231,0.303951367781155
19,전라남도,담양군,무정면,무정면투표소,867,454,349,75,22,2,1,449,5,413,77.728285077951,16.70378619153675,4.8997772828507795,0.4454342984409799,0.22271714922048996
20,전라남도,담양군,금성면,관내사전투표,1134,1134,1031,46,36,5,4,1122,12,0,91.88948306595366,4.09982174688057,3.2085561497326207,0.4456327985739751,0.35650623885918004
21,전라남도,담양군,금성면,금성면투표소,842,428,341,63,17,2,2,425,3,414,80.23529411764706,14.823529411764705,4.0,0.4705882352941176,0.4705882352941176
22,전라남도,담양군,용면,관내사전투표,828,828,764,39,17,4,2,826,2,0,92.49394673123487,4.721549636803874,2.0581113801452786,0.48426150121065376,0.24213075060532688
23,전라남도,담양군,용면,용면제1투,486,295,247,34,9,3,1,294,1,191,84.01360544217688,11.564625850340136,3.061224489795918,1.0204081632653061,0.3401360544217687
24,전라남도,담양군,용면,용면제2투,161,109,89,13,5,0,1,108,1,52,82.4074074074074,12.037037037037036,4.62962962962963,0.0,0.9259259259259258
25,전라남도,담양군,월산면,관내사전투표,1136,1136,1040,56,18,7,4,1125,11,0,92.44444444444444,4.977777777777778,1.6,0.6222222222222222,0.35555555555555557
26,전라남도,담양군,월산면,월산면투표소,707,375,312,42,13,3,3,373,2,332,83.6461126005362,11.26005361930295,3.485254691689008,0.8042895442359249,0.8042895442359249
27,전라남도,담양군,수북면,관내사전투표,2355,2355,2161,93,67,24,2,2347,8,0,92.07498934810397,3.962505325948019,2.854708138048573,1.0225820195994888,0.08521516829995739
28,전라남도,담양군,수북면,수북면제1투,1176,706,581,85,32,5,1,704,2,470,82.5284090909091,12.073863636363637,4.545454545454546,0.7102272727272727,0.14204545454545456
29,전라남도,담양군,수북면,수북면제2투,318,200,178,15,2,1,3,199,1,118,89.44723618090453,7.537688442211055,1.0050251256281406,0.5025125628140703,1.507537688442211
30,전라남도,담양군,대전면,관내사전투표,1623,1623,1538,42,28,4,2,1614,9,0,95.2912019826518,2.6022304832713754,1.734820322180917,0.24783147459727387,0.12391573729863693
31,전라남도,담양군,대전면,대전면제1투,895,513,408,78,21,4,0,511,2,382,79.84344422700586,15.264187866927593,4.10958904109589,0.7827788649706457,0.0
32,전라남도,담양군,대전면,대전면제2투,424,274,231,28,5,5,1,270,4,150,85.55555555555556,10.37037037037037,1.8518518518518516,1.8518518518518516,0.3703703703703704
33,전라남도,담양군,잘못 투입·구분된 투표지,,0,0,0,0,0,0,0,0,0,0,0.0,0.0,0.0,0.0,0.0
0,전라남도,장성군,거소·선상투표,,93,92,71,11,8,0,0,90,2,1,78.88888888888889,12.222222222222221,8.88888888888889,0.0,0.0
1,전라남도,장성군,관외사전투표,,6493,6493,5367,512,511,57,5,6452,41,0,83.18350898946063,7.935523868567886,7.920024798512089,0.8834469931804092,0.07749535027898327
2,전라남도,장성군,재외투표,,123,94,81,6,5,1,0,93,1,29,87.09677419354838,6.451612903225806,5.376344086021505,1.0752688172043012,0.0
3,전라남도,장성군,장성읍,관내사전투표,5817,5817,5302,273,168,43,6,5792,25,0,91.54005524861878,4.713397790055248,2.9005524861878453,0.7424033149171271,0.10359116022099447
4,전라남도,장성군,장성읍,장성읍제1투,923,488,361,89,24,9,1,484,4,435,74.58677685950413,18.388429752066116,4.958677685950414,1.859504132231405,0.2066115702479339
5,전라남도,장성군,장성읍,장성읍제2투,1270,705,543,117,37,5,0,702,3,565,77.35042735042735,16.666666666666664,5.270655270655271,0.7122507122507122,0.0
6,전라남도,장성군,장성읍,장성읍제3투,1247,675,544,93,29,4,1,671,4,572,81.07302533532041,13.859910581222056,4.321907600596125,0.5961251862891207,0.14903129657228018
7,전라남도,장성군,장성읍,장성읍제4투,1128,693,566,91,23,5,0,685,8,435,82.62773722627738,13.284671532846716,3.3576642335766427,0.7299270072992701,0.0
8,전라남도,장성군,진원면,관내사전투표,1248,1248,1153,59,25,5,0,1242,6,0,92.8341384863124,4.750402576489534,2.0128824476650564,0.40257648953301123,0.0
9,전라남도,장성군,진원면,진원면제1투,680,404,313,68,15,3,0,399,5,276,78.44611528822055,17.042606516290725,3.7593984962406015,0.7518796992481203,0.0
10,전라남도,장성군,진원면,진원면제2투,402,262,224,25,4,5,1,259,3,140,86.48648648648648,9.652509652509652,1.5444015444015444,1.9305019305019304,0.3861003861003861
11,전라남도,장성군,남면,관내사전투표,1520,1520,1411,63,30,5,3,1512,8,0,93.32010582010582,4.166666666666666,1.984126984126984,0.3306878306878307,0.1984126984126984
12,전라남도,장성군,남면,남면투표소,1125,604,477,89,22,8,1,597,7,521,79.89949748743719,14.90787269681742,3.6850921273031827,1.340033500837521,0.16750418760469013
13,전라남도,장성군,동화면,관내사전투표,966,966,870,56,27,5,4,962,4,0,90.43659043659044,5.8212058212058215,2.806652806652807,0.5197505197505198,0.4158004158004158
14,전라남도,장성군,동화면,동화면투표소,641,365,291,55,10,3,2,361,4,276,80.60941828254848,15.23545706371191,2.7700831024930745,0.8310249307479225,0.554016620498615
15,전라남도,장성군,삼서면,관내사전투표,1496,1496,1280,106,86,6,4,1482,14,0,86.3697705802969,7.152496626180836,5.802968960863698,0.4048582995951417,0.2699055330634278
16,전라남도,장성군,삼서면,삼서면투표소,869,469,382,69,14,0,1,466,3,400,81.97424892703863,14.806866952789699,3.004291845493562,0.0,0.2145922746781116
17,전라남도,장성군,삼계면,관내사전투표,2006,2006,1785,128,69,13,2,1997,9,0,89.38407611417125,6.4096144216324475,3.4551827741612415,0.6509764646970456,0.10015022533800699
18,전라남도,장성군,삼계면,삼계면투표소,1588,832,531,220,68,6,1,826,6,756,64.28571428571429,26.634382566585955,8.232445520581114,0.7263922518159807,0.12106537530266344
19,전라남도,장성군,황룡면,관내사전투표,1724,1724,1605,72,31,7,2,1717,7,0,93.47699475829936,4.19336051252184,1.80547466511357,0.4076878276062901,0.11648223645894001
20,전라남도,장성군,황룡면,황룡면투표소,1260,673,545,97,18,9,0,669,4,587,81.46487294469357,14.499252615844544,2.690582959641256,1.345291479820628,0.0
21,전라남도,장성군,서삼면,관내사전투표,610,610,551,35,19,1,1,607,3,0,90.77429983525536,5.766062602965404,3.130148270181219,0.16474464579901155,0.16474464579901155
22,전라남도,장성군,서삼면,서삼면투표소,445,244,180,44,14,3,1,242,2,201,74.3801652892562,18.181818181818183,5.785123966942149,1.2396694214876034,0.4132231404958678
23,전라남도,장성군,북일면,관내사전투표,647,647,611,20,8,4,3,646,1,0,94.58204334365325,3.0959752321981426,1.238390092879257,0.6191950464396285,0.46439628482972134
24,전라남도,장성군,북일면,북일면투표소,412,215,185,25,1,2,1,214,1,197,86.44859813084112,11.682242990654206,0.46728971962616817,0.9345794392523363,0.46728971962616817
25,전라남도,장성군,북이면,관내사전투표,1317,1317,1201,81,20,3,4,1309,8,0,91.7494270435447,6.187929717341483,1.5278838808250574,0.2291825821237586,0.30557677616501144
26,전라남도,장성군,북이면,북이면투표소,808,390,311,64,11,0,1,387,3,418,80.36175710594316,16.5374677002584,2.842377260981912,0.0,0.2583979328165375
27,전라남도,장성군,북하면,관내사전투표,895,895,821,38,18,7,3,887,8,0,92.55918827508455,4.284103720405862,2.029312288613303,0.7891770011273956,0.3382187147688839
28,전라남도,장성군,북하면,북하면투표소,575,299,212,72,11,1,0,296,3,276,71.62162162162163,24.324324324324326,3.7162162162162162,0.33783783783783783,0.0
29,전라남도,장성군,잘못 투입·구분된 투표지,,0,0,0,0,0,0,0,0,0,0,0.0,0.0,0.0,0.0,0.0
0,전라남도,곡성군,거소·선상투표,,75,74,54,10,6,0,1,71,3,1,76.05633802816901,14.084507042253522,8.450704225352112,0.0,1.4084507042253522
1,전라남도,곡성군,관외사전투표,,3706,3705,3068,317,247,39,9,3680,25,1,83.36956521739131,8.61413043478261,6.711956521739131,1.059782608695652,0.24456521739130438
2,전라남도,곡성군,재외투표,,109,73,51,15,7,0,0,73,0,36,69.86301369863014,20.54794520547945,9.58904109589041,0.0,0.0
3,전라남도,곡성군,곡성읍,관내사전투표,3596,3596,3186,191,117,29,7,3530,66,0,90.25495750708215,5.410764872521247,3.314447592067989,0.821529745042493,0.19830028328611898
4,전라남도,곡성군,곡성읍,곡성읍제1투,1190,718,555,119,28,7,4,713,5,472,77.84011220196354,16.690042075736326,3.9270687237026647,0.9817671809256662,0.5610098176718092
5,전라남도,곡성군,곡성읍,곡성읍제2투,830,424,321,73,20,7,1,422,2,406,76.06635071090048,17.298578199052134,4.739336492890995,1.6587677725118484,0.23696682464454977
6,전라남도,곡성군,곡성읍,곡성읍제3투,500,306,264,30,5,3,1,303,3,194,87.12871287128714,9.900990099009901,1.65016501650165,0.9900990099009901,0.33003300330033003
7,전라남도,곡성군,오곡면,관내사전투표,775,775,705,44,13,10,1,773,2,0,91.20310478654594,5.692108667529108,1.6817593790426906,1.29366106080207,0.129366106080207
8,전라남도,곡성군,오곡면,오곡면투표소,572,355,264,79,6,3,2,354,1,217,74.57627118644068,22.316384180790962,1.694915254237288,0.847457627118644,0.5649717514124294
9,전라남도,곡성군,삼기면,관내사전투표,664,664,604,33,10,6,3,656,8,0,92.07317073170732,5.0304878048780495,1.524390243902439,0.9146341463414633,0.45731707317073167
10,전라남도,곡성군,삼기면,삼기면투표소,552,270,217,40,3,3,2,265,5,282,81.88679245283019,15.09433962264151,1.1320754716981132,1.1320754716981132,0.7547169811320755
11,전라남도,곡성군,석곡면,관내사전투표,1320,1320,1200,77,18,10,1,1306,14,0,91.88361408882083,5.895865237366003,1.3782542113323124,0.7656967840735069,0.0765696784073507
12,전라남도,곡성군,석곡면,석곡면투표소,651,329,244,68,11,3,0,326,3,322,74.84662576687117,20.858895705521473,3.374233128834356,0.9202453987730062,0.0
13,전라남도,곡성군,목사동면,관내사전투표,519,519,458,35,14,4,2,513,6,0,89.27875243664717,6.82261208576998,2.729044834307992,0.7797270955165692,0.3898635477582846
14,전라남도,곡성군,목사동면,목사동면투표소,383,161,115,34,7,2,1,159,2,222,72.32704402515722,21.38364779874214,4.40251572327044,1.257861635220126,0.628930817610063
15,전라남도,곡성군,죽곡면,관내사전투표,776,776,697,52,11,4,2,766,10,0,90.99216710182768,6.7885117493472595,1.4360313315926894,0.5221932114882507,0.26109660574412535
16,전라남도,곡성군,죽곡면,죽곡면투표소,573,286,193,77,8,4,0,282,4,287,68.43971631205675,27.30496453900709,2.8368794326241136,1.4184397163120568,0.0
17,전라남도,곡성군,고달면,관내사전투표,433,433,396,17,10,4,2,429,4,0,92.3076923076923,3.9627039627039626,2.331002331002331,0.9324009324009324,0.4662004662004662
18,전라남도,곡성군,고달면,고달면투표소,416,255,209,34,9,2,0,254,1,161,82.28346456692913,13.385826771653544,3.543307086614173,0.7874015748031495,0.0
19,전라남도,곡성군,옥과면,관내사전투표,1990,1990,1801,93,67,13,5,1979,11,0,91.0055583628095,4.699343102577059,3.3855482566953006,0.6568974229408793,0.25265285497726125
20,전라남도,곡성군,옥과면,옥과면제1투,872,463,358,72,25,4,0,459,4,409,77.99564270152506,15.686274509803921,5.446623093681917,0.8714596949891068,0.0
21,전라남도,곡성군,옥과면,옥과면제2투,429,255,201,44,7,3,0,255,0,174,78.82352941176471,17.254901960784313,2.7450980392156863,1.1764705882352942,0.0
22,전라남도,곡성군,입면,관내사전투표,982,982,889,60,18,6,3,976,6,0,91.0860655737705,6.147540983606557,1.8442622950819672,0.6147540983606558,0.3073770491803279
23,전라남도,곡성군,입면,입면투표소,628,305,234,41,20,7,0,302,3,323,77.48344370860927,13.57615894039735,6.622516556291391,2.3178807947019866,0.0
24,전라남도,곡성군,겸면,관내사전투표,672,672,611,35,11,7,4,668,4,0,91.46706586826348,5.239520958083832,1.6467065868263475,1.0479041916167664,0.5988023952095809
25,전라남도,곡성군,겸면,겸면투표소,480,225,153,48,10,7,2,220,5,255,69.54545454545455,21.818181818181817,4.545454545454546,3.1818181818181817,0.9090909090909091
26,전라남도,곡성군,오산면,관내사전투표,523,523,475,30,10,4,2,521,2,0,91.17082533589252,5.758157389635317,1.9193857965451053,0.7677543186180422,0.3838771593090211
27,전라남도,곡성군,오산면,오산면투표소,426,206,154,38,6,4,1,203,3,220,75.86206896551724,18.7192118226601,2.955665024630542,1.9704433497536946,0.49261083743842365
28,전라남도,곡성군,잘못 투입·구분된 투표지,,0,0,0,0,0,0,0,0,0,0,0.0,0.0,0.0,0.0,0.0
0,전라남도,구례군,거소·선상투표,,65,57,48,4,4,0,0,56,1,8,85.71428571428571,7.142857142857142,7.142857142857142,0.0,0.0
1,전라남도,구례군,관외사전투표,,2701,2699,2169,271,219,26,2,2687,12,2,80.72199478972833,10.085597320431708,8.150353554149609,0.9676218831410495,0.07443245254931151
2,전라남도,구례군,재외투표,,96,70,56,9,3,2,0,70,0,26,80.0,12.857142857142856,4.285714285714286,2.857142857142857,0.0
3,전라남도,구례군,구례읍,관내사전투표,4235,4235,3797,272,122,20,3,4214,21,0,90.10441385856667,6.4546748932131,2.895111532985287,0.47460844803037494,0.07119126720455624
4,전라남도,구례군,구례읍,구례읍제1투,1150,687,540,117,19,6,0,682,5,463,79.17888563049853,17.155425219941346,2.785923753665689,0.8797653958944283,0.0
5,전라남도,구례군,구례읍,구례읍제2투,769,401,305,68,20,5,0,398,3,368,76.63316582914574,17.08542713567839,5.025125628140704,1.256281407035176,0.0
6,전라남도,구례군,구례읍,구례읍제3투,473,296,230,47,12,4,0,293,3,177,78.49829351535837,16.040955631399317,4.09556313993174,1.3651877133105803,0.0
7,전라남도,구례군,구례읍,구례읍제4투,893,549,414,110,17,6,0,547,2,344,75.68555758683729,20.109689213893965,3.1078610603290677,1.0968921389396709,0.0
8,전라남도,구례군,문척면,관내사전투표,832,832,755,50,16,2,3,826,6,0,91.4043583535109,6.053268765133172,1.937046004842615,0.24213075060532688,0.36319612590799033
9,전라남도,구례군,문척면,문척면투표소,396,226,161,50,11,3,0,225,1,170,71.55555555555554,22.22222222222222,4.888888888888889,1.3333333333333335,0.0
10,전라남도,구례군,간전면,관내사전투표,746,746,678,41,14,4,1,738,8,0,91.869918699187,5.555555555555555,1.8970189701897018,0.5420054200542005,0.13550135501355012
11,전라남도,구례군,간전면,간전면투표소,365,223,160,48,8,2,1,219,4,142,73.0593607305936,21.91780821917808,3.65296803652968,0.91324200913242,0.45662100456621
12,전라남도,구례군,토지면,관내사전투표,1160,1160,1042,74,20,5,2,1143,17,0,91.16360454943133,6.474190726159231,1.7497812773403325,0.4374453193350831,0.17497812773403326
13,전라남도,구례군,토지면,토지면투표소,703,414,312,80,15,3,1,411,3,289,75.91240875912408,19.464720194647203,3.64963503649635,0.7299270072992701,0.24330900243309003
14,전라남도,구례군,마산면,관내사전투표,1452,1452,1305,86,29,10,6,1436,16,0,90.87743732590529,5.988857938718663,2.01949860724234,0.6963788300835655,0.4178272980501393
15,전라남도,구례군,마산면,마산면투표소,718,412,283,112,5,7,1,408,4,306,69.36274509803921,27.450980392156865,1.2254901960784315,1.715686274509804,0.24509803921568626
16,전라남도,구례군,광의면,관내사전투표,994,994,914,51,15,5,1,986,8,0,92.69776876267748,5.172413793103448,1.5212981744421907,0.5070993914807302,0.10141987829614604
17,전라남도,구례군,광의면,광의면제1투,458,256,202,41,8,2,1,254,2,202,79.52755905511812,16.141732283464567,3.149606299212598,0.7874015748031495,0.39370078740157477
18,전라남도,구례군,광의면,광의면제2투,286,166,121,33,8,2,0,164,2,120,73.78048780487805,20.121951219512198,4.878048780487805,1.2195121951219512,0.0
19,전라남도,구례군,용방면,관내사전투표,826,826,747,51,16,6,4,824,2,0,90.65533980582524,6.189320388349515,1.9417475728155338,0.7281553398058253,0.48543689320388345
20,전라남도,구례군,용방면,용방면투표소,411,253,178,60,7,3,1,249,4,158,71.4859437751004,24.096385542168676,2.8112449799196786,1.2048192771084338,0.4016064257028112
21,전라남도,구례군,산동면,관내사전투표,1243,1243,1140,66,22,5,4,1237,6,0,92.15844785772029,5.335489086499596,1.7784963621665322,0.40420371867421184,0.32336297493936944
22,전라남도,구례군,산동면,산동면제1투,419,248,189,47,8,2,1,247,1,171,76.51821862348179,19.02834008097166,3.2388663967611335,0.8097165991902834,0.4048582995951417
23,전라남도,구례군,산동면,산동면제2투,372,225,155,64,4,0,0,223,2,147,69.50672645739911,28.699551569506728,1.7937219730941705,0.0,0.0
24,전라남도,구례군,산동면,산동면제3투,212,151,118,27,5,0,0,150,1,61,78.66666666666666,18.0,3.3333333333333335,0.0,0.0
25,전라남도,구례군,잘못 투입·구분된 투표지,,0,0,0,0,0,0,0,0,0,0,0.0,0.0,0.0,0.0,0.0
0,전라남도,고흥군,거소·선상투표,,223,216,161,36,11,4,1,213,3,7,75.5868544600939,16.901408450704224,5.164319248826291,1.8779342723004695,0.4694835680751174
1,전라남도,고흥군,관외사전투표,,5302,5301,4318,531,366,38,7,5260,41,1,82.09125475285171,10.095057034220533,6.9581749049429655,0.7224334600760456,0.13307984790874525
2,전라남도,고흥군,재외투표,,189,133,106,18,7,0,0,131,2,56,80.91603053435115,13.740458015267176,5.343511450381679,0.0,0.0
3,전라남도,고흥군,고흥읍,관내사전투표,5121,5121,4618,253,194,30,2,5097,24,0,90.60231508730627,4.963704139690014,3.8061604865607217,0.5885815185403178,0.039238767902687856
4,전라남도,고흥군,고흥읍,고흥읍제1투,323,243,222,16,2,1,1,242,1,80,91.73553719008265,6.6115702479338845,0.8264462809917356,0.4132231404958678,0.4132231404958678
5,전라남도,고흥군,고흥읍,고흥읍제2투,708,436,350,55,20,6,0,431,5,272,81.20649651972158,12.761020881670534,4.640371229698376,1.3921113689095126,0.0
6,전라남도,고흥군,고흥읍,고흥읍제3투,912,559,437,95,22,2,2,558,1,353,78.31541218637993,17.025089605734767,3.942652329749104,0.35842293906810035,0.35842293906810035
7,전라남도,고흥군,고흥읍,고흥읍제4투,2092,1190,896,233,46,7,3,1185,5,902,75.61181434599156,19.662447257383967,3.8818565400843887,0.5907172995780591,0.25316455696202533
8,전라남도,고흥군,도양읍,관내사전투표,4770,4770,4369,238,108,23,8,4746,24,0,92.05646860514118,5.014749262536873,2.275600505689001,0.48461862621154655,0.1685630004214075
9,전라남도,고흥군,도양읍,도양읍제1투,864,535,428,77,19,3,3,530,5,329,80.75471698113208,14.528301886792452,3.5849056603773586,0.5660377358490566,0.5660377358490566
10,전라남도,고흥군,도양읍,도양읍제2투,1059,536,438,75,12,4,2,531,5,523,82.48587570621469,14.124293785310735,2.2598870056497176,0.7532956685499058,0.3766478342749529
11,전라남도,고흥군,도양읍,도양읍제3투,1446,800,673,97,22,1,1,794,6,646,84.76070528967254,12.21662468513854,2.770780856423174,0.12594458438287154,0.12594458438287154
12,전라남도,고흥군,도양읍,도양읍제4투,353,239,108,118,5,2,2,235,4,114,45.95744680851064,50.212765957446805,2.127659574468085,0.851063829787234,0.851063829787234
13,전라남도,고흥군,풍양면,관내사전투표,1572,1572,1441,67,29,15,7,1559,13,0,92.43104554201412,4.297626683771648,1.860166773572803,0.9621552277100706,0.4490057729313663
14,전라남도,고흥군,풍양면,풍양면제1투,647,384,289,71,12,1,4,377,7,263,76.657824933687,18.83289124668435,3.183023872679045,0.2652519893899204,1.0610079575596816
15,전라남도,고흥군,풍양면,풍양면제2투,445,327,294,19,5,1,4,323,4,118,91.02167182662538,5.88235294117647,1.5479876160990713,0.30959752321981426,1.238390092879257
16,전라남도,고흥군,도덕면,관내사전투표,1191,1191,1095,43,28,5,5,1176,15,0,93.11224489795919,3.6564625850340136,2.380952380952381,0.4251700680272109,0.4251700680272109
17,전라남도,고흥군,도덕면,도덕면제1투,562,342,277,55,6,0,2,340,2,220,81.47058823529412,16.176470588235293,1.7647058823529411,0.0,0.5882352941176471
18,전라남도,고흥군,도덕면,도덕면제2투,483,321,266,40,5,4,1,316,5,162,84.17721518987342,12.658227848101266,1.5822784810126582,1.2658227848101267,0.31645569620253167
19,전라남도,고흥군,금산면,관내사전투표,2066,2066,1936,92,17,2,5,2052,14,0,94.34697855750487,4.483430799220272,0.8284600389863548,0.09746588693957114,0.24366471734892786
20,전라남도,고흥군,금산면,금산면제1투,680,301,245,46,6,1,1,299,2,379,81.93979933110369,15.384615384615385,2.0066889632107023,0.33444816053511706,0.33444816053511706
21,전라남도,고흥군,금산면,금산면제2투,593,344,297,41,2,1,1,342,2,249,86.8421052631579,11.988304093567251,0.5847953216374269,0.29239766081871343,0.29239766081871343
22,전라남도,고흥군,도화면,관내사전투표,2168,2168,1998,102,37,3,6,2146,22,0,93.10344827586206,4.753028890959925,1.7241379310344827,0.13979496738117428,0.27958993476234856
23,전라남도,고흥군,도화면,도화면투표소,1044,510,375,115,8,6,0,504,6,534,74.40476190476191,22.817460317460316,1.5873015873015872,1.1904761904761905,0.0
24,전라남도,고흥군,포두면,관내사전투표,2058,2058,1911,96,31,9,3,2050,8,0,93.21951219512195,4.682926829268292,1.5121951219512195,0.4390243902439025,0.14634146341463414
25,전라남도,고흥군,포두면,포두면제1투,311,226,196,19,6,3,0,224,2,85,87.5,8.482142857142858,2.6785714285714284,1.3392857142857142,0.0
26,전라남도,고흥군,포두면,포두면제2투,270,173,147,20,3,0,0,170,3,97,86.47058823529412,11.76470588235294,1.7647058823529411,0.0,0.0
27,전라남도,고흥군,포두면,포두면제3투,672,339,254,65,9,3,2,333,6,333,76.27627627627628,19.51951951951952,2.7027027027027026,0.9009009009009009,0.6006006006006006
28,전라남도,고흥군,포두면,포두면제4투,538,379,329,37,6,3,2,377,2,159,87.26790450928382,9.814323607427056,1.5915119363395225,0.7957559681697612,0.5305039787798408
29,전라남도,고흥군,봉래면,관내사전투표,960,960,853,68,22,6,2,951,9,0,89.6950578338591,7.150368033648791,2.3133543638275498,0.6309148264984227,0.2103049421661409
30,전라남도,고흥군,봉래면,봉래면투표소,560,288,219,53,13,0,1,286,2,272,76.57342657342657,18.53146853146853,4.545454545454546,0.0,0.34965034965034963
31,전라남도,고흥군,동일면,관내사전투표,791,791,735,33,11,2,2,783,8,0,93.86973180076629,4.21455938697318,1.40485312899106,0.2554278416347382,0.2554278416347382
32,전라남도,고흥군,동일면,동일면투표소,407,200,130,54,7,4,2,197,3,207,65.98984771573603,27.411167512690355,3.5532994923857872,2.030456852791878,1.015228426395939
33,전라남도,고흥군,점암면,관내사전투표,1275,1275,1144,77,22,11,6,1260,15,0,90.7936507936508,6.111111111111111,1.746031746031746,0.873015873015873,0.4761904761904762
34,전라남도,고흥군,점암면,점암면투표소,767,405,317,70,9,1,4,401,4,362,79.05236907730672,17.45635910224439,2.2443890274314215,0.24937655860349126,0.997506234413965
35,전라남도,고흥군,영남면,관내사전투표,591,591,551,26,7,1,3,588,3,0,93.70748299319727,4.421768707482993,1.1904761904761905,0.17006802721088435,0.5102040816326531
36,전라남도,고흥군,영남면,영남면투표소,374,193,158,27,5,0,0,190,3,181,83.15789473684211,14.210526315789473,2.631578947368421,0.0,0.0
37,전라남도,고흥군,과역면,관내사전투표,1976,1976,1780,130,32,10,7,1959,17,0,90.86268504338948,6.636038795303727,1.6334864726901481,0.5104645227156712,0.35732516590096985
38,전라남도,고흥군,과역면,과역면제1투,600,326,239,73,7,4,0,323,3,274,73.9938080495356,22.60061919504644,2.1671826625387,1.238390092879257,0.0
39,전라남도,고흥군,과역면,과역면제2투,324,168,139,23,2,1,1,166,2,156,83.73493975903614,13.855421686746988,1.2048192771084338,0.6024096385542169,0.6024096385542169
40,전라남도,고흥군,남양면,관내사전투표,875,875,787,51,15,4,2,859,16,0,91.61816065192085,5.9371362048894065,1.7462165308498252,0.46565774155995343,0.23282887077997672
41,전라남도,고흥군,남양면,남양면제1투,390,200,147,42,3,3,0,195,5,190,75.38461538461539,21.53846153846154,1.5384615384615385,1.5384615384615385,0.0
42,전라남도,고흥군,남양면,남양면제2투,389,267,230,23,5,3,2,263,4,122,87.45247148288973,8.745247148288973,1.9011406844106464,1.1406844106463878,0.7604562737642585
43,전라남도,고흥군,동강면,관내사전투표,1570,1570,1417,90,30,20,4,1561,9,0,90.77514413837284,5.7655349135169764,1.9218449711723256,1.2812299807815504,0.25624599615631005
44,전라남도,고흥군,동강면,동강면투표소,984,526,431,80,11,2,0,524,2,458,82.25190839694656,15.267175572519085,2.099236641221374,0.38167938931297707,0.0
45,전라남도,고흥군,대서면,관내사전투표,1070,1070,979,59,14,5,4,1061,9,0,92.27144203581527,5.5607917059377945,1.3195098963242224,0.47125353440150797,0.3770028275212064
46,전라남도,고흥군,대서면,대서면투표소,645,340,265,52,15,3,0,335,5,305,79.1044776119403,15.522388059701491,4.477611940298507,0.8955223880597015,0.0
47,전라남도,고흥군,두원면,관내사전투표,1454,1454,1330,76,19,6,7,1438,16,0,92.48956884561892,5.285118219749652,1.321279554937413,0.4172461752433936,0.48678720445062584
48,전라남도,고흥군,두원면,두원면제1투,482,238,164,63,6,0,2,235,3,244,69.7872340425532,26.80851063829787,2.553191489361702,0.0,0.851063829787234
49,전라남도,고흥군,두원면,두원면제2투,418,254,219,28,5,2,0,254,0,164,86.22047244094489,11.023622047244094,1.968503937007874,0.7874015748031495,0.0
50,전라남도,고흥군,잘못 투입·구분된 투표지,,0,0,0,0,0,0,0,0,0,0,0.0,0.0,0.0,0.0,0.0
0,전라남도,보성군,거소·선상투표,,164,159,115,15,9,4,4,147,12,5,78.2312925170068,10.204081632653061,6.122448979591836,2.7210884353741496,2.7210884353741496
1,전라남도,보성군,관외사전투표,,4432,4430,3697,380,282,33,6,4398,32,2,84.06093678944974,8.640291041382445,6.412005457025921,0.7503410641200546,0.1364256480218281
2,전라남도,보성군,재외투표,,176,124,88,22,6,3,0,119,5,52,73.94957983193278,18.487394957983195,5.042016806722689,2.5210084033613445,0.0
3,전라남도,보성군,보성읍,관내사전투표,3795,3795,3406,227,113,26,3,3775,20,0,90.22516556291392,6.013245033112582,2.9933774834437084,0.6887417218543046,0.07947019867549669
4,전라남도,보성군,보성읍,보성읍제1투,385,213,155,43,10,3,1,212,1,172,73.11320754716981,20.28301886792453,4.716981132075472,1.4150943396226416,0.4716981132075472
5,전라남도,보성군,보성읍,보성읍제2투,723,394,300,72,14,3,2,391,3,329,76.72634271099744,18.414322250639387,3.580562659846547,0.7672634271099744,0.5115089514066496
6,전라남도,보성군,보성읍,보성읍제3투,723,449,348,73,20,3,1,445,4,274,78.20224719101122,16.40449438202247,4.49438202247191,0.6741573033707865,0.22471910112359553
7,전라남도,보성군,보성읍,보성읍제4투,191,116,87,21,5,2,0,115,1,75,75.65217391304347,18.26086956521739,4.3478260869565215,1.7391304347826086,0.0
8,전라남도,보성군,보성읍,보성읍제5투,601,346,263,67,8,5,0,343,3,255,76.67638483965014,19.533527696793,2.3323615160349855,1.4577259475218658,0.0
9,전라남도,보성군,벌교읍,관내사전투표,4032,4032,3703,212,77,21,5,4018,14,0,92.1602787456446,5.276256844201095,1.9163763066202089,0.5226480836236934,0.12444001991040318
10,전라남도,보성군,벌교읍,벌교읍제1투,314,166,125,32,6,3,0,166,0,148,75.30120481927712,19.27710843373494,3.614457831325301,1.8072289156626504,0.0
11,전라남도,보성군,벌교읍,벌교읍제2투,468,261,210,43,6,0,0,259,2,207,81.08108108108108,16.602316602316602,2.3166023166023164,0.0,0.0
12,전라남도,보성군,벌교읍,벌교읍제3투,647,396,325,53,11,1,1,391,5,251,83.12020460358056,13.554987212276215,2.813299232736573,0.2557544757033248,0.2557544757033248
13,전라남도,보성군,벌교읍,벌교읍제4투,501,287,230,39,8,5,2,284,3,214,80.98591549295774,13.732394366197184,2.8169014084507045,1.7605633802816902,0.7042253521126761
14,전라남도,보성군,벌교읍,벌교읍제5투,384,263,216,38,4,2,1,261,2,121,82.75862068965517,14.559386973180077,1.532567049808429,0.7662835249042145,0.38314176245210724
15,전라남도,보성군,벌교읍,벌교읍제6투,392,235,196,30,6,1,0,233,2,157,84.12017167381974,12.875536480686694,2.575107296137339,0.4291845493562232,0.0
16,전라남도,보성군,벌교읍,벌교읍제7투,171,107,88,18,0,0,0,106,1,64,83.01886792452831,16.9811320754717,0.0,0.0,0.0
17,전라남도,보성군,벌교읍,벌교읍제8투,1145,693,533,123,27,4,0,687,6,452,77.58369723435226,17.903930131004365,3.9301310043668125,0.5822416302765648,0.0
18,전라남도,보성군,벌교읍,벌교읍제9투,332,211,185,24,0,1,1,211,0,121,87.67772511848341,11.374407582938389,0.0,0.47393364928909953,0.47393364928909953
19,전라남도,보성군,벌교읍,벌교읍제10투,152,108,106,0,1,0,0,107,1,44,99.06542056074767,0.0,0.9345794392523363,0.0,0.0
20,전라남도,보성군,노동면,관내사전투표,569,569,520,22,10,10,2,564,5,0,92.19858156028369,3.900709219858156,1.773049645390071,1.773049645390071,0.3546099290780142
21,전라남도,보성군,노동면,노동면투표소,300,167,130,25,8,1,1,165,2,133,78.78787878787878,15.151515151515152,4.848484848484849,0.6060606060606061,0.6060606060606061
22,전라남도,보성군,미력면,관내사전투표,630,630,577,31,17,3,0,628,2,0,91.87898089171973,4.936305732484077,2.7070063694267517,0.47770700636942676,0.0
23,전라남도,보성군,미력면,미력면투표소,431,255,208,34,7,3,2,254,1,176,81.88976377952756,13.385826771653544,2.7559055118110236,1.1811023622047243,0.7874015748031495
24,전라남도,보성군,겸백면,관내사전투표,448,448,419,19,5,0,0,443,5,0,94.5823927765237,4.288939051918736,1.1286681715575622,0.0,0.0
25,전라남도,보성군,겸백면,겸백면투표소,369,216,182,27,6,0,0,215,1,153,84.65116279069768,12.558139534883722,2.7906976744186047,0.0,0.0
26,전라남도,보성군,율어면,관내사전투표,523,523,469,33,9,5,3,519,4,0,90.36608863198458,6.358381502890173,1.7341040462427744,0.9633911368015413,0.5780346820809248
27,전라남도,보성군,율어면,율어면투표소,317,185,148,27,4,4,0,183,2,132,80.87431693989072,14.754098360655737,2.185792349726776,2.185792349726776,0.0
28,전라남도,보성군,복내면,관내사전투표,793,793,724,44,14,5,2,789,4,0,91.7617237008872,5.576679340937896,1.7743979721166032,0.6337135614702154,0.25348542458808615
29,전라남도,보성군,복내면,복내면투표소,382,192,141,34,9,3,1,188,4,190,75.0,18.085106382978726,4.787234042553192,1.5957446808510638,0.5319148936170213
30,전라남도,보성군,문덕면,관내사전투표,424,424,396,15,8,0,1,420,4,0,94.28571428571428,3.571428571428571,1.9047619047619049,0.0,0.2380952380952381
31,전라남도,보성군,문덕면,문덕면투표소,213,114,85,21,5,1,0,112,2,99,75.89285714285714,18.75,4.464285714285714,0.8928571428571428,0.0
32,전라남도,보성군,조성면,관내사전투표,1688,1688,1540,89,32,6,9,1676,12,0,91.8854415274463,5.310262529832936,1.9093078758949882,0.35799522673031026,0.5369928400954653
33,전라남도,보성군,조성면,조성면제1투,715,353,282,46,14,2,2,346,7,362,81.5028901734104,13.294797687861271,4.046242774566474,0.5780346820809248,0.5780346820809248
34,전라남도,보성군,조성면,조성면제2투,417,240,209,27,0,0,1,237,3,177,88.18565400843882,11.39240506329114,0.0,0.0,0.42194092827004215
35,전라남도,보성군,득량면,관내사전투표,1546,1546,1383,100,29,11,5,1528,18,0,90.51047120418848,6.544502617801047,1.8979057591623036,0.7198952879581152,0.32722513089005234
36,전라남도,보성군,득량면,득량면제1투,398,189,152,29,4,1,1,187,2,209,81.28342245989305,15.508021390374333,2.13903743315508,0.53475935828877,0.53475935828877
37,전라남도,보성군,득량면,득량면제2투,632,387,316,53,9,5,0,383,4,245,82.50652741514361,13.838120104438643,2.3498694516971277,1.3054830287206265,0.0
38,전라남도,보성군,득량면,득량면제3투,314,183,154,23,4,1,0,182,1,131,84.61538461538461,12.637362637362637,2.197802197802198,0.5494505494505495,0.0
39,전라남도,보성군,회천면,관내사전투표,1194,1194,1093,60,24,6,4,1187,7,0,92.08087615838248,5.054759898904802,2.0219039595619206,0.5054759898904801,0.33698399326032014
40,전라남도,보성군,회천면,회천면제1투,307,144,109,30,3,2,0,144,0,163,75.69444444444444,20.833333333333336,2.083333333333333,1.3888888888888888,0.0
41,전라남도,보성군,회천면,회천면제2투,413,286,250,27,5,4,0,286,0,127,87.41258741258741,9.44055944055944,1.7482517482517483,1.3986013986013985,0.0
42,전라남도,보성군,회천면,회천면제3투,398,265,224,24,6,5,1,260,5,133,86.15384615384616,9.230769230769232,2.307692307692308,1.9230769230769231,0.38461538461538464
43,전라남도,보성군,웅치면,관내사전투표,602,602,562,21,13,0,2,598,4,0,93.9799331103679,3.511705685618729,2.1739130434782608,0.0,0.33444816053511706
44,전라남도,보성군,웅치면,웅치면투표소,321,173,141,22,6,0,1,170,3,148,82.94117647058825,12.941176470588237,3.5294117647058822,0.0,0.5882352941176471
45,전라남도,보성군,잘못 투입·구분된 투표지,,0,0,0,0,0,0,0,0,0,0,0.0,0.0,0.0,0.0,0.0
0,전라남도,화순군,거소·선상투표,,156,144,110,12,12,3,2,139,5,12,79.13669064748201,8.633093525179856,8.633093525179856,2.158273381294964,1.4388489208633095
1,전라남도,화순군,관외사전투표,,8631,8629,7379,513,615,72,5,8584,45,2,85.96225535880708,5.976234855545201,7.164492078285181,0.8387698042870456,0.05824790307548928
2,전라남도,화순군,재외투표,,178,136,112,14,5,2,0,133,3,42,84.21052631578947,10.526315789473683,3.7593984962406015,1.5037593984962405,0.0
3,전라남도,화순군,화순읍,관내사전투표,10793,10791,9901,440,328,66,9,10744,47,2,92.15376023827253,4.095309009679822,3.052866716306776,0.6142963514519731,0.08376768428890544
4,전라남도,화순군,화순읍,화순읍제1투,1921,1342,1088,160,73,8,2,1331,11,579,81.74305033809166,12.021036814425244,5.484598046581517,0.6010518407212623,0.15026296018031557
5,전라남도,화순군,화순읍,화순읍제2투,534,337,286,29,13,3,1,332,5,197,86.14457831325302,8.734939759036145,3.91566265060241,0.9036144578313252,0.30120481927710846
6,전라남도,화순군,화순읍,화순읍제3투,2794,1823,1492,203,95,16,4,1810,13,971,82.43093922651934,11.215469613259668,5.248618784530387,0.8839779005524863,0.22099447513812157
7,전라남도,화순군,화순읍,화순읍제4투,1841,1083,820,165,73,13,2,1073,10,758,76.42124883504195,15.37744641192917,6.803355079217148,1.211556383970177,0.1863932898415657
8,전라남도,화순군,화순읍,화순읍제5투,2164,1278,1008,150,91,17,0,1266,12,886,79.62085308056872,11.848341232227488,7.187993680884676,1.3428120063191153,0.0
9,전라남도,화순군,화순읍,화순읍제6투,1816,1302,1099,113,69,10,2,1293,9,514,84.99613302397525,8.739365815931942,5.336426914153132,0.7733952049497294,0.15467904098994587
10,전라남도,화순군,화순읍,화순읍제7투,2808,2064,1685,242,91,26,3,2047,17,744,82.31558378114313,11.822178798241328,4.44553004396678,1.2701514411333659,0.14655593551538837
11,전라남도,화순군,화순읍,화순읍제8투,411,296,265,21,6,1,1,294,2,115,90.1360544217687,7.142857142857142,2.0408163265306123,0.3401360544217687,0.3401360544217687
12,전라남도,화순군,화순읍,화순읍제9투,1971,1349,1145,141,43,12,3,1344,5,622,85.19345238095238,10.491071428571429,3.199404761904762,0.8928571428571428,0.2232142857142857
13,전라남도,화순군,한천면,관내사전투표,472,472,431,18,14,4,0,467,5,0,92.29122055674517,3.854389721627409,2.9978586723768736,0.8565310492505354,0.0
14,전라남도,화순군,한천면,한천면투표소,392,196,148,43,5,0,0,196,0,196,75.51020408163265,21.93877551020408,2.5510204081632653,0.0,0.0
15,전라남도,화순군,춘양면,관내사전투표,887,887,826,39,12,3,2,882,5,0,93.65079365079364,4.421768707482993,1.3605442176870748,0.3401360544217687,0.22675736961451248
16,전라남도,화순군,춘양면,춘양면투표소,536,235,196,29,7,1,1,234,1,301,83.76068376068376,12.393162393162394,2.9914529914529915,0.4273504273504274,0.4273504273504274
17,전라남도,화순군,청풍면,관내사전투표,437,437,399,19,10,1,3,432,5,0,92.36111111111111,4.398148148148148,2.314814814814815,0.23148148148148145,0.6944444444444444
18,전라남도,화순군,청풍면,청풍면투표소,308,162,139,11,7,1,1,159,3,146,87.42138364779875,6.918238993710692,4.40251572327044,0.628930817610063,0.628930817610063
19,전라남도,화순군,이양면,관내사전투표,849,849,773,33,18,7,1,832,17,0,92.90865384615384,3.9663461538461537,2.1634615384615383,0.8413461538461539,0.1201923076923077
20,전라남도,화순군,이양면,이양면투표소,578,272,236,26,3,2,1,268,4,306,88.05970149253731,9.701492537313433,1.1194029850746268,0.7462686567164178,0.3731343283582089
21,전라남도,화순군,능주면,관내사전투표,1958,1958,1791,84,51,14,3,1943,15,0,92.17704580545548,4.323211528564077,2.624806999485332,0.7205352547606794,0.1544004117344313
22,전라남도,화순군,능주면,능주면투표소,1033,586,475,76,26,4,2,583,3,447,81.47512864493997,13.036020583190394,4.459691252144083,0.6861063464837049,0.34305317324185247
23,전라남도,화순군,도곡면,관내사전투표,1423,1423,1318,67,25,7,1,1418,5,0,92.94781382228491,4.724964739069112,1.7630465444287728,0.4936530324400564,0.07052186177715092
24,전라남도,화순군,도곡면,도곡면투표소,863,477,384,65,15,4,1,469,8,386,81.87633262260128,13.859275053304904,3.1982942430703627,0.8528784648187633,0.21321961620469082
25,전라남도,화순군,도암면,관내사전투표,616,616,564,29,8,5,1,607,9,0,92.9159802306425,4.7775947281713345,1.3179571663920924,0.8237232289950577,0.16474464579901155
26,전라남도,화순군,도암면,도암면투표소,422,210,172,31,4,1,0,208,2,212,82.6923076923077,14.903846153846153,1.9230769230769231,0.4807692307692308,0.0
27,전라남도,화순군,이서면,관내사전투표,404,404,364,26,9,2,0,401,3,0,90.77306733167082,6.483790523690773,2.2443890274314215,0.4987531172069825,0.0
28,전라남도,화순군,이서면,이서면투표소,259,122,106,13,2,1,0,122,0,137,86.88524590163934,10.655737704918032,1.639344262295082,0.819672131147541,0.0
29,전라남도,화순군,백아면,관내사전투표,621,621,575,22,13,4,4,618,3,0,93.042071197411,3.559870550161812,2.103559870550162,0.6472491909385114,0.6472491909385114
30,전라남도,화순군,백아면,백아면투표소,433,217,188,17,5,1,3,214,3,216,87.85046728971963,7.943925233644859,2.336448598130841,0.46728971962616817,1.4018691588785046
31,전라남도,화순군,동복면,관내사전투표,659,659,610,19,21,3,2,655,4,0,93.12977099236642,2.900763358778626,3.2061068702290076,0.45801526717557256,0.3053435114503817
32,전라남도,화순군,동복면,동복면투표소,532,316,261,41,3,5,1,311,5,216,83.92282958199357,13.183279742765272,0.964630225080386,1.607717041800643,0.3215434083601286
33,전라남도,화순군,사평면,관내사전투표,1222,1222,1134,55,18,3,5,1215,7,0,93.33333333333333,4.526748971193416,1.4814814814814816,0.24691358024691357,0.411522633744856
34,전라남도,화순군,사평면,사평면투표소,566,257,215,33,5,2,1,256,1,309,83.984375,12.890625,1.953125,0.78125,0.390625
35,전라남도,화순군,동면,관내사전투표,1832,1832,1685,78,34,8,7,1812,20,0,92.99116997792495,4.304635761589404,1.8763796909492272,0.44150110375275936,0.3863134657836645
36,전라남도,화순군,동면,동면투표소,986,535,430,82,12,2,2,528,7,451,81.43939393939394,15.530303030303031,2.272727272727273,0.3787878787878788,0.3787878787878788
37,전라남도,화순군,잘못 투입·구분된 투표지,,0,2,1,0,1,0,0,2,0,-2,50.0,0.0,50.0,0.0,0.0
0,전라남도,장흥군,거소·선상투표,,181,172,144,14,7,1,0,166,6,9,86.74698795180723,8.433734939759036,4.216867469879518,0.6024096385542169,0.0
1,전라남도,장흥군,관외사전투표,,3378,3378,2772,280,261,34,6,3353,25,0,82.6722338204593,8.350730688935283,7.784073963614674,1.0140172979421413,0.17894422904861318
2,전라남도,장흥군,재외투표,,137,101,82,13,6,0,0,101,0,36,81.1881188118812,12.871287128712872,5.9405940594059405,0.0,0.0
3,전라남도,장흥군,장흥읍,관내사전투표,6049,6049,5493,308,177,32,14,6024,25,0,91.18525896414343,5.112881806108898,2.9382470119521913,0.5312084993359893,0.23240371845949537
4,전라남도,장흥군,장흥읍,장흥읍제1투,936,493,397,72,14,3,1,487,6,443,81.51950718685832,14.784394250513348,2.8747433264887063,0.6160164271047228,0.20533880903490762
5,전라남도,장흥군,장흥읍,장흥읍제2투,340,172,133,29,4,0,3,169,3,168,78.69822485207101,17.159763313609467,2.366863905325444,0.0,1.7751479289940828
6,전라남도,장흥군,장흥읍,장흥읍제3투,1309,790,630,118,31,7,1,787,3,519,80.05082592121983,14.993646759847524,3.9390088945362134,0.8894536213468869,0.12706480304955528
7,전라남도,장흥군,장흥읍,장흥읍제4투,1208,719,560,112,35,8,0,715,4,489,78.32167832167832,15.664335664335665,4.895104895104895,1.118881118881119,0.0
8,전라남도,장흥군,장흥읍,장흥읍제5투,508,290,224,48,12,4,1,289,1,218,77.50865051903114,16.608996539792386,4.1522491349480966,1.384083044982699,0.34602076124567477
9,전라남도,장흥군,장흥읍,장흥읍제6투,313,186,154,22,8,1,1,186,0,127,82.79569892473118,11.827956989247312,4.301075268817205,0.5376344086021506,0.5376344086021506
10,전라남도,장흥군,관산읍,관내사전투표,2273,2273,2135,72,39,9,4,2259,14,0,94.51084550686144,3.187250996015936,1.7264276228419653,0.398406374501992,0.17706949977866313
11,전라남도,장흥군,관산읍,관산읍제1투,541,257,211,30,9,6,1,257,0,284,82.10116731517509,11.673151750972762,3.501945525291829,2.3346303501945527,0.38910505836575876
12,전라남도,장흥군,관산읍,관산읍제2투,407,192,171,19,1,1,0,192,0,215,89.0625,9.895833333333332,0.5208333333333333,0.5208333333333333,0.0
13,전라남도,장흥군,관산읍,관산읍제3투,448,284,249,27,5,2,0,283,1,164,87.98586572438163,9.540636042402827,1.76678445229682,0.7067137809187279,0.0
14,전라남도,장흥군,대덕읍,관내사전투표,1508,1508,1359,82,32,9,12,1494,14,0,90.96385542168674,5.4886211512717535,2.14190093708166,0.6024096385542169,0.8032128514056224
15,전라남도,장흥군,대덕읍,대덕읍제1투,774,392,288,82,10,4,2,386,6,382,74.61139896373057,21.243523316062177,2.5906735751295336,1.0362694300518136,0.5181347150259068
16,전라남도,장흥군,대덕읍,대덕읍제2투,259,186,158,20,5,2,1,186,0,73,84.94623655913979,10.75268817204301,2.6881720430107525,1.0752688172043012,0.5376344086021506
17,전라남도,장흥군,용산면,관내사전투표,1103,1103,1019,45,21,7,3,1095,8,0,93.05936073059361,4.10958904109589,1.9178082191780823,0.6392694063926941,0.273972602739726
18,전라남도,장흥군,용산면,용산면투표소,619,317,243,60,7,4,0,314,3,302,77.38853503184714,19.10828025477707,2.229299363057325,1.2738853503184715,0.0
19,전라남도,장흥군,안양면,관내사전투표,1376,1376,1259,60,24,9,3,1355,21,0,92.91512915129151,4.428044280442804,1.7712177121771218,0.6642066420664207,0.22140221402214022
20,전라남도,장흥군,안양면,안양면제1투,387,182,132,39,6,2,1,180,2,205,73.33333333333333,21.666666666666668,3.3333333333333335,1.1111111111111112,0.5555555555555556
21,전라남도,장흥군,안양면,안양면제2투,418,265,235,19,6,0,0,260,5,153,90.38461538461539,7.307692307692308,2.307692307692308,0.0,0.0
22,전라남도,장흥군,장동면,관내사전투표,553,553,511,26,11,2,0,550,3,0,92.9090909090909,4.7272727272727275,2.0,0.36363636363636365,0.0
23,전라남도,장흥군,장동면,장동면투표소,379,219,139,62,6,6,2,215,4,160,64.65116279069767,28.837209302325583,2.7906976744186047,2.7906976744186047,0.9302325581395349
24,전라남도,장흥군,장평면,관내사전투표,1043,1043,964,44,15,5,5,1033,10,0,93.32042594385285,4.259438528557599,1.452081316553727,0.48402710551790895,0.48402710551790895
25,전라남도,장흥군,장평면,장평면투표소,589,303,240,48,9,2,1,300,3,286,80.0,16.0,3.0,0.6666666666666667,0.33333333333333337
26,전라남도,장흥군,유치면,관내사전투표,486,486,428,37,6,3,3,477,9,0,89.72746331236897,7.756813417190776,1.257861635220126,0.628930817610063,0.628930817610063
27,전라남도,장흥군,유치면,유치면투표소,254,118,78,32,4,2,0,116,2,136,67.24137931034483,27.586206896551722,3.4482758620689653,1.7241379310344827,0.0
28,전라남도,장흥군,부산면,관내사전투표,891,891,823,40,14,8,4,889,2,0,92.57592800899887,4.499437570303712,1.574803149606299,0.8998875140607425,0.44994375703037126
29,전라남도,장흥군,부산면,부산면투표소,426,215,166,36,5,3,2,212,3,211,78.30188679245283,16.9811320754717,2.358490566037736,1.4150943396226416,0.9433962264150944
30,전라남도,장흥군,회진면,관내사전투표,1397,1397,1283,70,22,5,6,1386,11,0,92.56854256854257,5.05050505050505,1.5873015873015872,0.36075036075036077,0.4329004329004329
31,전라남도,장흥군,회진면,회진면투표소,663,343,276,55,7,1,3,342,1,320,80.7017543859649,16.08187134502924,2.046783625730994,0.29239766081871343,0.8771929824561403
32,전라남도,장흥군,잘못 투입·구분된 투표지,,0,0,0,0,0,0,0,0,0,0,0.0,0.0,0.0,0.0,0.0
0,전라남도,강진군,거소·선상투표,,159,149,123,11,5,1,1,141,8,10,87.2340425531915,7.801418439716312,3.546099290780142,0.7092198581560284,0.7092198581560284
1,전라남도,강진군,관외사전투표,,3259,3258,2659,296,233,35,5,3228,30,1,82.3729863692689,9.169764560099132,7.218091697645601,1.084262701363073,0.15489467162329618
2,전라남도,강진군,재외투표,,132,87,64,16,5,2,0,87,0,45,73.5632183908046,18.39080459770115,5.747126436781609,2.2988505747126435,0.0
3,전라남도,강진군,강진읍,관내사전투표,5528,5528,4928,363,161,39,9,5500,28,0,89.60000000000001,6.6000000000000005,2.9272727272727272,0.7090909090909091,0.16363636363636364
4,전라남도,강진군,강진읍,강진읍제1투,641,342,259,64,13,4,1,341,1,299,75.95307917888563,18.7683284457478,3.812316715542522,1.1730205278592376,0.2932551319648094
5,전라남도,강진군,강진읍,강진읍제2투,982,590,460,98,23,7,0,588,2,392,78.2312925170068,16.666666666666664,3.9115646258503403,1.1904761904761905,0.0
6,전라남도,강진군,강진읍,강진읍제3투,729,435,324,92,13,1,2,432,3,294,75.0,21.296296296296298,3.009259259259259,0.23148148148148145,0.4629629629629629
7,전라남도,강진군,강진읍,강진읍제4투,410,244,192,39,8,2,0,241,3,166,79.66804979253112,16.182572614107883,3.319502074688797,0.8298755186721992,0.0
8,전라남도,강진군,강진읍,강진읍제5투,411,245,211,25,4,0,2,242,3,166,87.19008264462809,10.330578512396695,1.6528925619834711,0.0,0.8264462809917356
9,전라남도,강진군,강진읍,강진읍제6투,1257,796,612,122,50,4,3,791,5,461,77.37041719342605,15.423514538558786,6.32111251580278,0.5056890012642226,0.37926675094816686
10,전라남도,강진군,군동면,관내사전투표,1653,1653,1453,113,62,11,0,1639,14,0,88.6516168395363,6.894447834045149,3.7827943868212324,0.6711409395973155,0.0
11,전라남도,강진군,군동면,군동면제1투,333,153,99,41,9,0,0,149,4,180,66.44295302013423,27.516778523489933,6.0402684563758395,0.0,0.0
12,전라남도,강진군,군동면,군동면제2투,734,444,342,74,19,3,1,439,5,290,77.90432801822324,16.856492027334852,4.328018223234624,0.683371298405467,0.22779043280182232
13,전라남도,강진군,군동면,군동면제3투,259,149,127,14,7,1,0,149,0,110,85.23489932885906,9.395973154362416,4.697986577181208,0.6711409395973155,0.0
14,전라남도,강진군,칠량면,관내사전투표,1070,1070,956,75,17,7,6,1061,9,0,90.10367577756834,7.0688030160226205,1.6022620169651274,0.6597549481621112,0.5655042412818096
15,전라남도,강진군,칠량면,칠량면투표소,666,362,285,57,11,1,2,356,6,304,80.0561797752809,16.01123595505618,3.089887640449438,0.2808988764044944,0.5617977528089888
16,전라남도,강진군,대구면,관내사전투표,530,530,463,43,14,5,1,526,4,0,88.02281368821293,8.17490494296578,2.6615969581749046,0.9505703422053232,0.19011406844106463
17,전라남도,강진군,대구면,대구면투표소,301,168,130,29,5,1,0,165,3,133,78.78787878787878,17.575757575757574,3.0303030303030303,0.6060606060606061,0.0
18,전라남도,강진군,마량면,관내사전투표,917,917,838,49,14,3,0,904,13,0,92.69911504424779,5.420353982300885,1.5486725663716814,0.33185840707964603,0.0
19,전라남도,강진군,마량면,마량면투표소,490,265,203,49,11,0,0,263,2,225,77.18631178707224,18.631178707224336,4.182509505703422,0.0,0.0
20,전라남도,강진군,도암면,관내사전투표,1017,1017,893,78,21,5,7,1004,13,0,88.94422310756973,7.768924302788845,2.091633466135458,0.49800796812749004,0.697211155378486
21,전라남도,강진군,도암면,도암면제1투,479,283,210,54,10,3,0,277,6,196,75.81227436823104,19.494584837545126,3.6101083032490973,1.083032490974729,0.0
22,전라남도,강진군,도암면,도암면제2투,286,197,167,18,6,2,1,194,3,89,86.08247422680412,9.278350515463918,3.0927835051546393,1.0309278350515463,0.5154639175257731
23,전라남도,강진군,신전면,관내사전투표,840,840,761,46,13,9,3,832,8,0,91.46634615384616,5.528846153846153,1.5625,1.0817307692307692,0.3605769230769231
24,전라남도,강진군,신전면,신전면제1투,317,178,129,38,7,0,0,174,4,139,74.13793103448276,21.839080459770116,4.022988505747127,0.0,0.0
25,전라남도,강진군,신전면,신전면제2투,234,158,142,12,2,2,0,158,0,76,89.87341772151899,7.59493670886076,1.2658227848101267,1.2658227848101267,0.0
26,전라남도,강진군,성전면,관내사전투표,1362,1362,1226,71,36,10,3,1346,16,0,91.08469539375929,5.274888558692422,2.674591381872214,0.7429420505200593,0.22288261515601782
27,전라남도,강진군,성전면,성전면투표소,808,412,322,66,15,6,1,410,2,396,78.53658536585367,16.097560975609756,3.6585365853658534,1.4634146341463417,0.24390243902439024
28,전라남도,강진군,작천면,관내사전투표,866,866,784,53,16,5,2,860,6,0,91.16279069767442,6.162790697674419,1.8604651162790697,0.5813953488372093,0.23255813953488372
29,전라남도,강진군,작천면,작천면투표소,509,264,199,49,8,5,1,262,2,245,75.95419847328245,18.702290076335878,3.0534351145038165,1.9083969465648856,0.38167938931297707
30,전라남도,강진군,병영면,관내사전투표,812,812,734,50,15,2,2,803,9,0,91.40722291407222,6.226650062266501,1.86799501867995,0.24906600249066002,0.24906600249066002
31,전라남도,강진군,병영면,병영면투표소,473,241,190,42,4,4,0,240,1,232,79.16666666666666,17.5,1.6666666666666667,1.6666666666666667,0.0
32,전라남도,강진군,옴천면,관내사전투표,284,284,252,18,8,2,1,281,3,0,89.6797153024911,6.405693950177936,2.8469750889679712,0.7117437722419928,0.3558718861209964
33,전라남도,강진군,옴천면,옴천면투표소,176,89,72,13,4,0,0,89,0,87,80.89887640449437,14.606741573033707,4.49438202247191,0.0,0.0
34,전라남도,강진군,잘못 투입·구분된 투표지,,0,0,0,0,0,0,0,0,0,0,0.0,0.0,0.0,0.0,0.0
0,전라남도,완도군,거소·선상투표,,1022,972,887,34,21,4,3,949,23,50,93.4668071654373,3.5827186512118017,2.212855637513172,0.42149631190727077,0.31612223393045313
1,전라남도,완도군,관외사전투표,,3980,3980,3299,335,295,20,2,3951,29,0,83.49784864591243,8.47886610984561,7.4664641862819545,0.5062009617818274,0.05062009617818274
2,전라남도,완도군,재외투표,,116,87,74,7,2,3,0,86,1,29,86.04651162790698,8.13953488372093,2.3255813953488373,3.488372093023256,0.0
3,전라남도,완도군,완도읍,관내사전투표,7246,7246,6659,309,217,32,3,7220,26,0,92.22991689750693,4.2797783933518,3.005540166204986,0.443213296398892,0.04155124653739612
4,전라남도,완도군,완도읍,완도읍제1투,1350,695,550,100,30,7,0,687,8,655,80.05822416302766,14.556040756914118,4.366812227074235,1.0189228529839884,0.0
5,전라남도,완도군,완도읍,완도읍제2투,1418,872,727,93,33,8,2,863,9,546,84.24101969872537,10.776361529548089,3.8238702201622248,0.9269988412514484,0.2317497103128621
6,전라남도,완도군,완도읍,완도읍제3투,613,380,317,49,10,0,2,378,2,233,83.86243386243386,12.962962962962962,2.6455026455026456,0.0,0.5291005291005291
7,전라남도,완도군,완도읍,완도읍제4투,1535,900,733,124,32,6,0,895,5,635,81.89944134078212,13.854748603351954,3.5754189944134076,0.6703910614525139,0.0
8,전라남도,완도군,완도읍,완도읍제5투,570,343,285,39,10,3,0,337,6,227,84.56973293768546,11.572700296735905,2.967359050445104,0.8902077151335311,0.0
9,전라남도,완도군,완도읍,완도읍제6투,576,373,322,34,12,2,1,371,2,203,86.79245283018868,9.164420485175203,3.234501347708895,0.5390835579514826,0.2695417789757413
10,전라남도,완도군,금일읍,관내사전투표,1318,1318,1244,33,27,2,3,1309,9,0,95.03437738731857,2.5210084033613445,2.0626432391138274,0.15278838808250572,0.2291825821237586
11,전라남도,완도군,금일읍,금일읍제1투,216,130,111,16,3,0,0,130,0,86,85.38461538461539,12.307692307692308,2.307692307692308,0.0,0.0
12,전라남도,완도군,금일읍,금일읍제2투,370,277,248,20,4,3,1,276,1,93,89.85507246376811,7.246376811594203,1.4492753623188406,1.0869565217391304,0.36231884057971014
13,전라남도,완도군,금일읍,금일읍제3투,471,349,322,17,4,2,2,347,2,122,92.79538904899135,4.899135446685879,1.1527377521613833,0.5763688760806917,0.5763688760806917
14,전라남도,완도군,노화읍,관내사전투표,2097,2097,1966,48,42,10,7,2073,24,0,94.83839845634347,2.3154848046309695,2.0260492040520983,0.482392667631452,0.3376748673420164
15,전라남도,완도군,노화읍,노화읍제1투,673,369,309,37,14,2,1,363,6,304,85.12396694214877,10.192837465564738,3.8567493112947657,0.5509641873278237,0.27548209366391185
16,전라남도,완도군,노화읍,노화읍제2투,396,231,204,16,3,1,4,228,3,165,89.47368421052632,7.017543859649122,1.3157894736842104,0.43859649122807015,1.7543859649122806
17,전라남도,완도군,노화읍,노화읍제3투,402,321,299,11,1,2,2,315,6,81,94.92063492063491,3.492063492063492,0.31746031746031744,0.6349206349206349,0.6349206349206349
18,전라남도,완도군,군외면,관내사전투표,1342,1342,1226,70,30,6,1,1333,9,0,91.97299324831208,5.251312828207052,2.250562640660165,0.45011252813203295,0.07501875468867217
19,전라남도,완도군,군외면,군외면제1투,502,265,196,57,6,3,1,263,2,237,74.52471482889734,21.673003802281368,2.2813688212927756,1.1406844106463878,0.38022813688212925
20,전라남도,완도군,군외면,군외면제2투,472,306,244,32,13,5,5,299,7,166,81.60535117056857,10.702341137123746,4.3478260869565215,1.6722408026755853,1.6722408026755853
21,전라남도,완도군,신지면,관내사전투표,1580,1580,1455,70,40,3,1,1569,11,0,92.73422562141491,4.461440407903123,2.5493945188017846,0.19120458891013384,0.06373486297004462
22,전라남도,완도군,신지면,신지면제1투,510,273,222,27,15,3,1,268,5,237,82.83582089552239,10.074626865671641,5.597014925373134,1.1194029850746268,0.3731343283582089
23,전라남도,완도군,신지면,신지면제2투,476,274,227,34,5,0,1,267,7,202,85.0187265917603,12.734082397003746,1.8726591760299627,0.0,0.37453183520599254
24,전라남도,완도군,고금면,관내사전투표,2106,2106,1971,77,33,6,6,2093,13,0,94.1710463449594,3.678929765886288,1.5766841853798377,0.2866698518872432,0.2866698518872432
25,전라남도,완도군,고금면,고금면제1투,570,290,233,42,9,3,1,288,2,280,80.90277777777779,14.583333333333334,3.125,1.0416666666666665,0.3472222222222222
26,전라남도,완도군,고금면,고금면제2투,235,150,126,20,1,0,2,149,1,85,84.56375838926175,13.422818791946309,0.6711409395973155,0.0,1.342281879194631
27,전라남도,완도군,고금면,고금면제3투,240,149,126,11,6,2,1,146,3,91,86.3013698630137,7.534246575342466,4.10958904109589,1.36986301369863,0.684931506849315
28,전라남도,완도군,약산면,관내사전투표,935,935,873,33,9,3,8,926,9,0,94.27645788336933,3.5637149028077757,0.9719222462203023,0.32397408207343414,0.8639308855291578
29,전라남도,완도군,약산면,약산면제1투,439,246,192,42,4,1,2,241,5,193,79.66804979253112,17.42738589211618,1.6597510373443984,0.4149377593360996,0.8298755186721992
30,전라남도,완도군,약산면,약산면제2투,324,255,219,24,6,2,2,253,2,69,86.56126482213439,9.486166007905137,2.371541501976284,0.7905138339920948,0.7905138339920948
31,전라남도,완도군,청산면,관내사전투표,1024,1024,934,45,25,9,3,1016,8,0,91.92913385826772,4.429133858267717,2.4606299212598426,0.8858267716535433,0.2952755905511811
32,전라남도,완도군,청산면,청산면제1투,317,145,113,24,5,1,0,143,2,172,79.02097902097903,16.783216783216783,3.4965034965034967,0.6993006993006993,0.0
33,전라남도,완도군,청산면,청산면제2투,146,98,74,21,1,0,0,96,2,48,77.08333333333334,21.875,1.0416666666666665,0.0,0.0
34,전라남도,완도군,청산면,청산면제3투,136,106,101,3,1,0,0,105,1,30,96.19047619047619,2.857142857142857,0.9523809523809524,0.0,0.0
35,전라남도,완도군,소안면,관내사전투표,1156,1156,1082,37,21,2,5,1147,9,0,94.33304272013949,3.225806451612903,1.8308631211857016,0.17436791630340018,0.4359197907585004
36,전라남도,완도군,소안면,소안면제1투,293,143,116,21,3,1,0,141,2,150,82.26950354609929,14.893617021276595,2.127659574468085,0.7092198581560284,0.0
37,전라남도,완도군,소안면,소안면제2투,276,197,165,22,4,3,1,195,2,79,84.61538461538461,11.282051282051283,2.051282051282051,1.5384615384615385,0.5128205128205128
38,전라남도,완도군,금당면,관내사전투표,516,516,472,19,10,2,4,507,9,0,93.09664694280079,3.7475345167652856,1.9723865877712032,0.39447731755424065,0.7889546351084813
39,전라남도,완도군,금당면,금당면투표소,155,75,63,9,1,0,1,74,1,80,85.13513513513513,12.162162162162163,1.3513513513513513,0.0,1.3513513513513513
40,전라남도,완도군,보길면,관내사전투표,1255,1255,1174,40,27,5,1,1247,8,0,94.14595028067362,3.2076984763432237,2.165196471531676,0.40096230954290296,0.08019246190858059
41,전라남도,완도군,보길면,보길면제1투,272,154,123,17,8,3,1,152,2,118,80.92105263157895,11.18421052631579,5.263157894736842,1.9736842105263157,0.6578947368421052
42,전라남도,완도군,보길면,보길면제2투,363,246,217,14,8,1,1,241,5,117,90.04149377593362,5.809128630705394,3.319502074688797,0.4149377593360996,0.4149377593360996
43,전라남도,완도군,생일면,관내사전투표,356,356,325,10,7,1,4,347,9,0,93.65994236311239,2.881844380403458,2.0172910662824206,0.2881844380403458,1.1527377521613833
44,전라남도,완도군,생일면,생일면투표소,156,72,63,9,0,0,0,72,0,84,87.5,12.5,0.0,0.0,0.0
45,전라남도,완도군,잘못 투입·구분된 투표지,,0,0,0,0,0,0,0,0,0,0,0.0,0.0,0.0,0.0,0.0
0,전라남도,해남군,거소·선상투표,,1207,999,858,65,26,6,3,958,41,208,89.56158663883089,6.784968684759916,2.7139874739039667,0.6263048016701461,0.31315240083507306
1,전라남도,해남군,관외사전투표,,5836,5832,4792,465,472,51,4,5784,48,4,82.84923928077455,8.03941908713693,8.160442600276625,0.8817427385892116,0.06915629322268327
2,전라남도,해남군,재외투표,,160,110,95,7,7,1,0,110,0,50,86.36363636363636,6.363636363636363,6.363636363636363,0.9090909090909091,0.0
3,전라남도,해남군,해남읍,관내사전투표,8189,8189,7417,393,288,45,6,8149,40,0,91.01730273653209,4.822677629156952,3.5341759725119646,0.5522149957049945,0.07362866609399926
4,전라남도,해남군,해남읍,해남읍제1투,913,539,468,54,9,2,2,535,4,374,87.4766355140187,10.093457943925234,1.6822429906542056,0.3738317757009346,0.3738317757009346
5,전라남도,해남군,해남읍,해남읍제2투,1189,732,572,118,29,9,0,728,4,457,78.57142857142857,16.208791208791208,3.983516483516483,1.2362637362637363,0.0
6,전라남도,해남군,해남읍,해남읍제3투,1679,960,801,108,34,10,2,955,5,719,83.87434554973822,11.30890052356021,3.56020942408377,1.0471204188481675,0.20942408376963353
7,전라남도,해남군,해남읍,해남읍제4투,1757,953,757,124,54,6,3,944,9,804,80.1906779661017,13.135593220338984,5.720338983050848,0.6355932203389831,0.31779661016949157
8,전라남도,해남군,해남읍,해남읍제5투,632,300,238,41,16,4,0,299,1,332,79.59866220735786,13.712374581939798,5.351170568561873,1.3377926421404682,0.0
9,전라남도,해남군,해남읍,해남읍제6투,827,463,396,46,16,1,0,459,4,364,86.27450980392157,10.021786492374728,3.485838779956427,0.2178649237472767,0.0
10,전라남도,해남군,해남읍,해남읍제7투,523,336,289,29,13,1,0,332,4,187,87.04819277108435,8.734939759036145,3.91566265060241,0.30120481927710846,0.0
11,전라남도,해남군,삼산면,관내사전투표,1746,1746,1606,97,21,10,2,1736,10,0,92.51152073732719,5.587557603686636,1.2096774193548387,0.5760368663594471,0.1152073732718894
12,전라남도,해남군,삼산면,삼산면제1투,498,316,253,46,15,1,0,315,1,182,80.31746031746032,14.603174603174605,4.761904761904762,0.31746031746031744,0.0
13,전라남도,해남군,삼산면,삼산면제2투,369,251,216,30,2,0,1,249,2,118,86.74698795180723,12.048192771084338,0.8032128514056224,0.0,0.4016064257028112
14,전라남도,해남군,화산면,관내사전투표,1452,1452,1298,105,32,4,1,1440,12,0,90.13888888888889,7.291666666666667,2.2222222222222223,0.2777777777777778,0.06944444444444445
15,전라남도,해남군,화산면,화산면제1투,365,216,151,54,8,0,1,214,2,149,70.56074766355141,25.233644859813083,3.7383177570093453,0.0,0.46728971962616817
16,전라남도,해남군,화산면,화산면제2투,296,202,170,21,6,3,2,202,0,94,84.15841584158416,10.396039603960396,2.9702970297029703,1.4851485148514851,0.9900990099009901
17,전라남도,해남군,화산면,화산면제3투,331,227,185,36,3,1,0,225,2,104,82.22222222222221,16.0,1.3333333333333335,0.4444444444444444,0.0
18,전라남도,해남군,현산면,관내사전투표,1407,1407,1257,85,35,14,5,1396,11,0,90.0429799426934,6.088825214899714,2.5071633237822346,1.002865329512894,0.35816618911174786
19,전라남도,해남군,현산면,현산면제1투,468,274,236,29,5,2,0,272,2,194,86.76470588235294,10.661764705882353,1.8382352941176472,0.7352941176470588,0.0
20,전라남도,해남군,현산면,현산면제2투,492,355,280,51,12,2,2,347,8,137,80.69164265129683,14.697406340057636,3.45821325648415,0.5763688760806917,0.5763688760806917
21,전라남도,해남군,송지면,관내사전투표,2641,2640,2397,146,64,11,0,2618,22,1,91.55844155844156,5.576776165011459,2.4446142093200915,0.42016806722689076,0.0
22,전라남도,해남군,송지면,송지면제1투,992,530,434,78,8,3,1,524,6,462,82.82442748091603,14.885496183206106,1.5267175572519083,0.5725190839694656,0.19083969465648853
23,전라남도,해남군,송지면,송지면제2투,414,239,204,19,8,1,3,235,4,175,86.80851063829788,8.085106382978724,3.404255319148936,0.425531914893617,1.276595744680851
24,전라남도,해남군,송지면,송지면제3투,394,278,252,15,6,0,2,275,3,116,91.63636363636364,5.454545454545454,2.181818181818182,0.0,0.7272727272727273
25,전라남도,해남군,북평면,관내사전투표,1443,1443,1323,72,26,7,4,1432,11,0,92.38826815642457,5.027932960893855,1.8156424581005588,0.4888268156424581,0.27932960893854747
26,전라남도,해남군,북평면,북평면제1투,452,243,199,31,9,3,0,242,1,209,82.23140495867769,12.8099173553719,3.71900826446281,1.2396694214876034,0.0
27,전라남도,해남군,북평면,북평면제2투,294,211,186,19,3,1,1,210,1,83,88.57142857142857,9.047619047619047,1.4285714285714286,0.4761904761904762,0.4761904761904762
28,전라남도,해남군,북일면,관내사전투표,920,920,843,40,16,6,5,910,10,0,92.63736263736264,4.395604395604396,1.7582417582417582,0.6593406593406593,0.5494505494505495
29,전라남도,해남군,북일면,북일면제1투,332,219,187,23,5,3,0,218,1,113,85.77981651376146,10.550458715596331,2.293577981651376,1.3761467889908259,0.0
30,전라남도,해남군,북일면,북일면제2투,253,170,149,13,7,0,1,170,0,83,87.6470588235294,7.647058823529412,4.117647058823529,0.0,0.5882352941176471
31,전라남도,해남군,옥천면,관내사전투표,2320,2319,2088,127,59,18,7,2299,20,1,90.82209656372335,5.524140930839495,2.566333188342758,0.7829491083079599,0.3044802087864289
32,전라남도,해남군,옥천면,옥천면제1투,499,309,256,42,7,2,1,308,1,190,83.11688311688312,13.636363636363635,2.272727272727273,0.6493506493506493,0.3246753246753247
33,전라남도,해남군,옥천면,옥천면제2투,364,249,190,40,10,4,3,247,2,115,76.92307692307693,16.194331983805668,4.048582995951417,1.6194331983805668,1.214574898785425
34,전라남도,해남군,계곡면,관내사전투표,974,974,909,41,11,7,1,969,5,0,93.80804953560371,4.231166150670795,1.1351909184726523,0.7223942208462332,0.10319917440660474
35,전라남도,해남군,계곡면,계곡면제1투,358,214,174,32,5,1,1,213,1,144,81.69014084507043,15.023474178403756,2.3474178403755865,0.4694835680751174,0.4694835680751174
36,전라남도,해남군,계곡면,계곡면제2투,247,132,103,25,2,0,1,131,1,115,78.62595419847328,19.083969465648856,1.5267175572519083,0.0,0.7633587786259541
37,전라남도,해남군,마산면,관내사전투표,1092,1092,1008,46,20,6,3,1083,9,0,93.07479224376732,4.247460757156047,1.8467220683287167,0.554016620498615,0.2770083102493075
38,전라남도,해남군,마산면,마산면제1투,371,233,198,25,6,2,0,231,2,138,85.71428571428571,10.822510822510822,2.5974025974025974,0.8658008658008658,0.0
39,전라남도,해남군,마산면,마산면제2투,393,269,229,27,6,2,1,265,4,124,86.41509433962264,10.18867924528302,2.2641509433962264,0.7547169811320755,0.37735849056603776
40,전라남도,해남군,황산면,관내사전투표,2045,2045,1880,95,52,5,4,2036,9,0,92.33791748526524,4.6660117878192535,2.5540275049115913,0.2455795677799607,0.19646365422396855
41,전라남도,해남군,황산면,황산면제1투,715,401,330,48,12,5,1,396,5,314,83.33333333333334,12.121212121212121,3.0303030303030303,1.2626262626262625,0.25252525252525254
42,전라남도,해남군,황산면,황산면제2투,447,289,240,31,9,1,3,284,5,158,84.50704225352112,10.915492957746478,3.169014084507042,0.35211267605633806,1.056338028169014
43,전라남도,해남군,황산면,황산면제3투,354,238,198,29,6,0,1,234,4,116,84.61538461538461,12.393162393162394,2.564102564102564,0.0,0.4273504273504274
44,전라남도,해남군,산이면,관내사전투표,1301,1301,1206,50,28,7,3,1294,7,0,93.19938176197836,3.863987635239567,2.1638330757341575,0.5409582689335394,0.23183925811437403
45,전라남도,해남군,산이면,산이면제1투,689,391,340,33,12,2,2,389,2,298,87.40359897172236,8.483290488431876,3.0848329048843186,0.5141388174807198,0.5141388174807198
46,전라남도,해남군,산이면,산이면제2투,443,263,230,29,3,0,0,262,1,180,87.78625954198473,11.068702290076336,1.1450381679389312,0.0,0.0
47,전라남도,해남군,문내면,관내사전투표,1761,1761,1624,90,20,9,3,1746,15,0,93.01260022909507,5.154639175257731,1.145475372279496,0.5154639175257731,0.1718213058419244
48,전라남도,해남군,문내면,문내면제1투,812,408,336,48,11,6,1,402,6,404,83.5820895522388,11.940298507462686,2.736318407960199,1.4925373134328357,0.24875621890547264
49,전라남도,해남군,문내면,문내면제2투,342,238,201,26,7,0,0,234,4,104,85.8974358974359,11.11111111111111,2.9914529914529915,0.0,0.0
50,전라남도,해남군,화원면,관내사전투표,1674,1674,1545,87,22,6,5,1665,9,0,92.7927927927928,5.225225225225225,1.3213213213213213,0.36036036036036034,0.3003003003003003
51,전라남도,해남군,화원면,화원면제1투,687,356,295,46,8,2,3,354,2,331,83.33333333333334,12.994350282485875,2.2598870056497176,0.5649717514124294,0.847457627118644
52,전라남도,해남군,화원면,화원면제2투,252,145,115,19,5,1,4,144,1,107,79.86111111111111,13.194444444444445,3.4722222222222223,0.6944444444444444,2.7777777777777777
53,전라남도,해남군,잘못 투입·구분된 투표지,,0,1,1,0,0,0,0,1,0,-1,100.0,0.0,0.0,0.0,0.0
0,전라남도,진도군,거소·선상투표,,167,157,132,11,10,0,0,153,4,10,86.27450980392157,7.18954248366013,6.535947712418301,0.0,0.0
1,전라남도,진도군,관외사전투표,,2903,2901,2354,239,246,24,9,2872,29,2,81.96378830083565,8.321727019498608,8.565459610027855,0.8356545961002786,0.31337047353760444
2,전라남도,진도군,재외투표,,107,66,50,8,5,2,0,65,1,41,76.92307692307693,12.307692307692308,7.6923076923076925,3.076923076923077,0.0
3,전라남도,진도군,진도읍,관내사전투표,4847,4847,4320,298,162,28,3,4811,36,0,89.79422157555602,6.194138432758263,3.3672833090833505,0.5819995842860112,0.06235709831635835
4,전라남도,진도군,진도읍,진도읍제1투,1406,793,624,104,54,4,1,787,6,613,79.28843710292249,13.214739517153747,6.861499364675986,0.5082592121982211,0.12706480304955528
5,전라남도,진도군,진도읍,진도읍제2투,1169,598,438,121,28,6,3,596,2,571,73.48993288590604,20.302013422818792,4.697986577181208,1.006711409395973,0.5033557046979865
6,전라남도,진도군,진도읍,진도읍제3투,476,339,302,27,6,1,0,336,3,137,89.88095238095238,8.035714285714286,1.7857142857142856,0.2976190476190476,0.0
7,전라남도,진도군,군내면,관내사전투표,1551,1551,1418,74,38,6,3,1539,12,0,92.13775178687459,4.808317089018843,2.4691358024691357,0.3898635477582846,0.1949317738791423
8,전라남도,진도군,군내면,군내면제1투,194,113,88,19,4,0,1,112,1,81,78.57142857142857,16.964285714285715,3.571428571428571,0.0,0.8928571428571428
9,전라남도,진도군,군내면,군내면제2투,377,215,163,40,7,1,0,211,4,162,77.25118483412322,18.95734597156398,3.3175355450236967,0.47393364928909953,0.0
10,전라남도,진도군,군내면,군내면제3투,335,208,174,25,1,3,1,204,4,127,85.29411764705883,12.254901960784313,0.49019607843137253,1.4705882352941175,0.49019607843137253
11,전라남도,진도군,고군면,관내사전투표,1460,1460,1346,73,26,5,2,1452,8,0,92.69972451790633,5.027548209366391,1.790633608815427,0.34435261707988984,0.13774104683195593
12,전라남도,진도군,고군면,고군면제1투,353,174,137,30,5,1,0,173,1,179,79.1907514450867,17.341040462427745,2.8901734104046244,0.5780346820809248,0.0
13,전라남도,진도군,고군면,고군면제2투,393,255,208,35,8,1,0,252,3,138,82.53968253968253,13.88888888888889,3.1746031746031744,0.3968253968253968,0.0
14,전라남도,진도군,고군면,고군면제3투,358,240,208,25,5,1,1,240,0,118,86.66666666666667,10.416666666666668,2.083333333333333,0.4166666666666667,0.4166666666666667
15,전라남도,진도군,의신면,관내사전투표,1583,1582,1446,77,34,6,7,1570,12,1,92.10191082802548,4.904458598726115,2.1656050955414012,0.3821656050955414,0.445859872611465
16,전라남도,진도군,의신면,의신면제1투,439,211,160,34,8,2,2,206,5,228,77.66990291262135,16.50485436893204,3.8834951456310676,0.9708737864077669,0.9708737864077669
17,전라남도,진도군,의신면,의신면제2투,262,170,142,19,3,3,2,169,1,92,84.02366863905326,11.242603550295858,1.7751479289940828,1.7751479289940828,1.183431952662722
18,전라남도,진도군,의신면,의신면제3투,453,242,196,36,5,4,0,241,1,211,81.32780082987551,14.937759336099585,2.0746887966804977,1.6597510373443984,0.0
19,전라남도,진도군,임회면,관내사전투표,1485,1485,1360,63,37,8,3,1471,14,0,92.45411284840245,4.2828008157715844,2.515295717199184,0.5438477226376615,0.20394289598912305
20,전라남도,진도군,임회면,임회면제1투,410,205,153,30,11,4,0,198,7,205,77.27272727272727,15.151515151515152,5.555555555555555,2.0202020202020203,0.0
21,전라남도,진도군,임회면,임회면제2투,376,245,202,33,4,1,3,243,2,131,83.1275720164609,13.580246913580247,1.646090534979424,0.411522633744856,1.2345679012345678
22,전라남도,진도군,임회면,임회면제3투,382,227,174,42,4,1,1,222,5,155,78.37837837837837,18.91891891891892,1.8018018018018018,0.45045045045045046,0.45045045045045046
23,전라남도,진도군,지산면,관내사전투표,1351,1351,1241,61,29,3,5,1339,12,0,92.68110530246453,4.5556385362210605,2.165795369678865,0.22404779686333084,0.37341299477221807
24,전라남도,진도군,지산면,지산면제1투,340,171,135,23,7,1,0,166,5,169,81.32530120481928,13.855421686746988,4.216867469879518,0.6024096385542169,0.0
25,전라남도,진도군,지산면,지산면제2투,369,241,203,27,6,0,1,237,4,128,85.65400843881856,11.39240506329114,2.5316455696202533,0.0,0.42194092827004215
26,전라남도,진도군,지산면,지산면제3투,241,161,133,21,3,1,2,160,1,80,83.125,13.125,1.875,0.625,1.25
27,전라남도,진도군,조도면,관내사전투표,790,790,708,49,16,2,5,780,10,0,90.76923076923077,6.282051282051282,2.051282051282051,0.2564102564102564,0.641025641025641
28,전라남도,진도군,조도면,조도면제1투,422,210,166,37,5,1,0,209,1,212,79.42583732057416,17.703349282296653,2.3923444976076556,0.4784688995215311,0.0
29,전라남도,진도군,조도면,조도면제2투,74,52,47,2,0,1,1,51,1,22,92.15686274509804,3.9215686274509802,0.0,1.9607843137254901,1.9607843137254901
30,전라남도,진도군,조도면,조도면제3투,67,54,48,5,0,0,0,53,1,13,90.56603773584906,9.433962264150944,0.0,0.0,0.0
31,전라남도,진도군,조도면,조도면제4투,145,114,106,6,1,0,1,114,0,31,92.98245614035088,5.263157894736842,0.8771929824561403,0.0,0.8771929824561403
32,전라남도,진도군,조도면,조도면제5투,74,63,57,3,0,0,0,60,3,11,95.0,5.0,0.0,0.0,0.0
33,전라남도,진도군,조도면,조도면제6투,108,53,51,0,0,1,0,52,1,55,98.07692307692307,0.0,0.0,1.9230769230769231,0.0
34,전라남도,진도군,조도면,조도면제7투,167,130,123,5,2,0,0,130,0,37,94.61538461538461,3.8461538461538463,1.5384615384615385,0.0,0.0
35,전라남도,진도군,잘못 투입·구분된 투표지,,0,1,1,0,0,0,0,1,0,-1,100.0,0.0,0.0,0.0,0.0
0,전라남도,영암군,거소·선상투표,,199,190,105,30,24,0,3,162,28,9,64.81481481481481,18.51851851851852,14.814814814814813,0.0,1.8518518518518516
1,전라남도,영암군,관외사전투표,,6622,6621,5460,519,526,68,8,6581,40,1,82.96611457225346,7.886339462087828,7.992706275642,1.0332776173833764,0.1215620726333384
2,전라남도,영암군,재외투표,,153,103,73,19,5,4,0,101,2,50,72.27722772277228,18.81188118811881,4.9504950495049505,3.9603960396039604,0.0
3,전라남도,영암군,영암읍,관내사전투표,3450,3450,3130,161,103,34,2,3430,20,0,91.25364431486881,4.6938775510204085,3.002915451895044,0.9912536443148687,0.05830903790087463
4,전라남도,영암군,영암읍,영암읍제1투,1039,595,478,89,17,4,2,590,5,444,81.01694915254237,15.084745762711865,2.8813559322033897,0.6779661016949152,0.3389830508474576
5,전라남도,영암군,영암읍,영암읍제2투,526,295,239,42,10,2,0,293,2,231,81.56996587030717,14.334470989761092,3.4129692832764507,0.6825938566552902,0.0
6,전라남도,영암군,영암읍,영암읍제3투,868,516,389,103,16,2,1,511,5,352,76.1252446183953,20.15655577299413,3.131115459882583,0.3913894324853229,0.19569471624266144
7,전라남도,영암군,삼호읍,관내사전투표,5177,5177,4716,245,146,40,9,5156,21,0,91.46625290923195,4.751745539177657,2.8316524437548485,0.7757951900698216,0.17455391776570986
8,전라남도,영암군,삼호읍,삼호읍제1투,1426,816,654,115,37,6,1,813,3,610,80.44280442804428,14.145141451414514,4.551045510455105,0.7380073800738007,0.12300123001230012
9,전라남도,영암군,삼호읍,삼호읍제2투,1289,671,531,88,37,11,0,667,4,618,79.61019490254873,13.193403298350825,5.547226386806597,1.6491754122938531,0.0
10,전라남도,영암군,삼호읍,삼호읍제3투,535,356,290,48,9,2,2,351,5,179,82.62108262108262,13.675213675213676,2.564102564102564,0.5698005698005698,0.5698005698005698
11,전라남도,영암군,삼호읍,삼호읍제4투,3016,1892,1541,224,91,23,4,1883,9,1124,81.83749336165693,11.895910780669144,4.83271375464684,1.2214551248008496,0.21242697822623471
12,전라남도,영암군,삼호읍,삼호읍제5투,651,378,316,40,13,4,2,375,3,273,84.26666666666667,10.666666666666668,3.4666666666666663,1.0666666666666667,0.5333333333333333
13,전라남도,영암군,삼호읍,삼호읍제6투,2720,1755,1398,209,106,31,5,1749,6,965,79.93138936535163,11.949685534591195,6.0606060606060606,1.7724413950829045,0.2858776443682104
14,전라남도,영암군,덕진면,관내사전투표,806,806,734,41,16,8,0,799,7,0,91.8648310387985,5.131414267834793,2.002503128911139,1.0012515644555695,0.0
15,전라남도,영암군,덕진면,덕진면제1투,349,189,157,25,5,1,1,189,0,160,83.06878306878306,13.227513227513226,2.6455026455026456,0.5291005291005291,0.5291005291005291
16,전라남도,영암군,덕진면,덕진면제2투,305,195,161,23,8,3,0,195,0,110,82.56410256410255,11.794871794871794,4.102564102564102,1.5384615384615385,0.0
17,전라남도,영암군,금정면,관내사전투표,992,992,912,46,18,5,1,982,10,0,92.87169042769857,4.684317718940937,1.8329938900203666,0.5091649694501018,0.10183299389002036
18,전라남도,영암군,금정면,금정면투표소,568,255,193,46,6,3,2,250,5,313,77.2,18.4,2.4,1.2,0.8
19,전라남도,영암군,신북면,관내사전투표,1629,1629,1544,44,24,7,3,1622,7,0,95.19112207151665,2.7127003699136867,1.4796547472256474,0.43156596794081376,0.18495684340320592
20,전라남도,영암군,신북면,신북면제1투,520,281,231,36,11,0,0,278,3,239,83.09352517985612,12.949640287769784,3.9568345323741005,0.0,0.0
21,전라남도,영암군,신북면,신북면제2투,311,151,129,12,7,1,1,150,1,160,86.0,8.0,4.666666666666667,0.6666666666666667,0.6666666666666667
22,전라남도,영암군,신북면,신북면제3투,311,207,183,15,7,0,0,205,2,104,89.26829268292683,7.317073170731707,3.414634146341464,0.0,0.0
23,전라남도,영암군,시종면,관내사전투표,1498,1498,1386,63,28,8,3,1488,10,0,93.14516129032258,4.233870967741935,1.881720430107527,0.5376344086021506,0.20161290322580644
24,전라남도,영암군,시종면,시종면제1투,648,309,260,34,11,1,2,308,1,339,84.4155844155844,11.03896103896104,3.571428571428571,0.3246753246753247,0.6493506493506493
25,전라남도,영암군,시종면,시종면제2투,420,202,172,23,4,1,0,200,2,218,86.0,11.5,2.0,0.5,0.0
26,전라남도,영암군,도포면,관내사전투표,859,859,801,24,18,4,1,848,11,0,94.45754716981132,2.8301886792452833,2.1226415094339623,0.4716981132075472,0.1179245283018868
27,전라남도,영암군,도포면,도포면제1투,372,209,179,22,6,0,0,207,2,163,86.47342995169082,10.628019323671497,2.898550724637681,0.0,0.0
28,전라남도,영암군,도포면,도포면제2투,399,243,197,39,2,2,1,241,2,156,81.74273858921161,16.182572614107883,0.8298755186721992,0.8298755186721992,0.4149377593360996
29,전라남도,영암군,군서면,관내사전투표,1312,1312,1189,62,30,14,2,1297,15,0,91.67309175019275,4.780262143407865,2.313030069390902,1.0794140323824208,0.15420200462606012
30,전라남도,영암군,군서면,군서면제1투,444,244,204,34,3,1,1,243,1,200,83.9506172839506,13.991769547325102,1.2345679012345678,0.411522633744856,0.411522633744856
31,전라남도,영암군,군서면,군서면제2투,645,397,324,52,11,4,0,391,6,248,82.86445012787725,13.299232736572892,2.813299232736573,1.0230179028132993,0.0
32,전라남도,영암군,서호면,관내사전투표,793,793,710,48,21,5,1,785,8,0,90.44585987261146,6.114649681528663,2.67515923566879,0.6369426751592357,0.12738853503184713
33,전라남도,영암군,서호면,서호면투표소,590,310,238,59,6,2,2,307,3,280,77.52442996742671,19.218241042345277,1.9543973941368076,0.6514657980456027,0.6514657980456027
34,전라남도,영암군,학산면,관내사전투표,1885,1885,1678,130,43,15,7,1873,12,0,89.58889482114255,6.9407367859049645,2.2957821676454886,0.800854244527496,0.37373198077949815
35,전라남도,영암군,학산면,학산면제1투,432,208,153,38,13,2,0,206,2,224,74.27184466019418,18.446601941747574,6.310679611650485,0.9708737864077669,0.0
36,전라남도,영암군,학산면,학산면제2투,346,208,154,43,4,5,1,207,1,138,74.39613526570048,20.77294685990338,1.932367149758454,2.4154589371980677,0.4830917874396135
37,전라남도,영암군,학산면,학산면제3투,149,78,67,9,2,0,0,78,0,71,85.8974358974359,11.538461538461538,2.564102564102564,0.0,0.0
38,전라남도,영암군,미암면,관내사전투표,644,644,589,35,12,3,1,640,4,0,92.03125,5.46875,1.875,0.46875,0.15625
39,전라남도,영암군,미암면,미암면투표소,736,418,330,71,10,4,1,416,2,318,79.32692307692307,17.067307692307693,2.403846153846154,0.9615384615384616,0.2403846153846154
40,전라남도,영암군,잘못 투입·구분된 투표지,,0,0,0,0,0,0,0,0,0,0,0.0,0.0,0.0,0.0,0.0
0,전라남도,무안군,거소·선상투표,,639,613,453,68,40,9,9,579,34,26,78.23834196891191,11.744386873920552,6.90846286701209,1.5544041450777202,1.5544041450777202
1,전라남도,무안군,관외사전투표,,14960,14959,12615,922,1184,119,14,14854,105,1,84.92661909250033,6.20708226740272,7.9709169247340785,0.8011310084825637,0.0942507068803016
2,전라남도,무안군,재외투표,,233,187,157,15,13,1,0,186,1,46,84.40860215053763,8.064516129032258,6.989247311827956,0.5376344086021506,0.0
3,전라남도,무안군,무안읍,관내사전투표,5421,5421,4876,256,219,29,9,5389,32,0,90.48060864724438,4.750417517164594,4.0638337353869,0.5381332343663017,0.16700686583781776
4,전라남도,무안군,무안읍,무안읍제1투,1150,598,468,88,30,2,2,590,8,552,79.3220338983051,14.915254237288137,5.084745762711865,0.3389830508474576,0.3389830508474576
5,전라남도,무안군,무안읍,무안읍제2투,1426,865,662,142,48,5,4,861,4,561,76.88734030197445,16.492450638792103,5.574912891986063,0.5807200929152149,0.4645760743321719
6,전라남도,무안군,무안읍,무안읍제3투,289,190,167,17,4,0,0,188,2,99,88.82978723404256,9.042553191489363,2.127659574468085,0.0,0.0
7,전라남도,무안군,무안읍,무안읍제4투,689,366,292,52,12,3,3,362,4,323,80.66298342541437,14.3646408839779,3.314917127071823,0.8287292817679558,0.8287292817679558
8,전라남도,무안군,일로읍,관내사전투표,3803,3803,3543,144,78,15,5,3785,18,0,93.60634081902246,3.8044914134742402,2.0607661822985466,0.3963011889035667,0.13210039630118892
9,전라남도,무안군,일로읍,일로읍제1투,349,215,189,15,4,4,1,213,2,134,88.73239436619718,7.042253521126761,1.8779342723004695,1.8779342723004695,0.4694835680751174
10,전라남도,무안군,일로읍,일로읍제2투,249,158,133,19,4,1,1,158,0,91,84.17721518987342,12.025316455696203,2.5316455696202533,0.6329113924050633,0.6329113924050633
11,전라남도,무안군,일로읍,일로읍제3투,914,505,422,56,19,4,1,502,3,409,84.06374501992032,11.155378486055776,3.7848605577689245,0.796812749003984,0.199203187250996
12,전라남도,무안군,일로읍,일로읍제4투,175,111,98,8,4,0,0,110,1,64,89.0909090909091,7.2727272727272725,3.6363636363636362,0.0,0.0
13,전라남도,무안군,일로읍,일로읍제5투,455,261,228,22,5,3,3,261,0,194,87.35632183908046,8.42911877394636,1.9157088122605364,1.1494252873563218,1.1494252873563218
14,전라남도,무안군,일로읍,일로읍제6투,1853,1398,1068,202,96,24,2,1392,6,455,76.72413793103449,14.511494252873563,6.896551724137931,1.7241379310344827,0.14367816091954022
15,전라남도,무안군,일로읍,일로읍제7투,1511,1172,970,119,56,23,1,1169,3,339,82.97690333618478,10.179640718562874,4.790419161676647,1.9674935842600514,0.0855431993156544
16,전라남도,무안군,일로읍,일로읍제8투,1301,966,771,130,45,16,0,962,4,335,80.14553014553015,13.513513513513514,4.677754677754678,1.6632016632016633,0.0
17,전라남도,무안군,삼향읍,관내사전투표,10140,10139,9051,444,525,80,4,10104,35,1,89.57838479809976,4.394299287410926,5.195961995249406,0.791765637371338,0.0395882818685669
18,전라남도,무안군,삼향읍,삼향읍제1투,357,239,191,40,5,2,0,238,1,118,80.25210084033614,16.80672268907563,2.100840336134454,0.8403361344537815,0.0
19,전라남도,무안군,삼향읍,삼향읍제2투,559,355,288,43,12,8,0,351,4,204,82.05128205128204,12.250712250712251,3.418803418803419,2.2792022792022792,0.0
20,전라남도,무안군,삼향읍,삼향읍제3투,804,445,363,61,18,0,0,442,3,359,82.12669683257919,13.800904977375566,4.072398190045249,0.0,0.0
21,전라남도,무안군,삼향읍,삼향읍제4투,457,294,257,23,10,1,2,293,1,163,87.71331058020478,7.849829351535837,3.4129692832764507,0.3412969283276451,0.6825938566552902
22,전라남도,무안군,삼향읍,삼향읍제5투,1591,1038,792,146,81,12,0,1031,7,553,76.81862269641125,14.161008729388943,7.856450048496605,1.1639185257032008,0.0
23,전라남도,무안군,삼향읍,삼향읍제6투,1831,1241,961,170,92,7,0,1230,11,590,78.130081300813,13.821138211382115,7.479674796747967,0.5691056910569106,0.0
24,전라남도,무안군,삼향읍,삼향읍제7투,2212,1400,1021,217,119,25,2,1384,16,812,73.77167630057804,15.679190751445088,8.598265895953757,1.8063583815028903,0.1445086705202312
25,전라남도,무안군,삼향읍,삼향읍제8투,1678,1172,939,138,76,14,0,1167,5,506,80.46272493573264,11.825192802056556,6.512425021422451,1.1996572407883461,0.0
26,전라남도,무안군,삼향읍,삼향읍제9투,1807,1317,1069,131,85,25,2,1312,5,490,81.47865853658537,9.984756097560975,6.478658536585366,1.9054878048780488,0.1524390243902439
27,전라남도,무안군,삼향읍,삼향읍제10투,1774,1241,970,181,71,15,1,1238,3,533,78.35218093699515,14.620355411954765,5.735056542810986,1.2116316639741518,0.08077544426494346
28,전라남도,무안군,삼향읍,삼향읍제11투,926,644,445,122,63,7,0,637,7,282,69.85871271585557,19.15227629513344,9.89010989010989,1.098901098901099,0.0
29,전라남도,무안군,몽탄면,관내사전투표,1132,1132,1033,50,27,8,5,1123,9,0,91.98575244879787,4.452359750667854,2.404274265360641,0.7123775601068566,0.44523597506678536
30,전라남도,무안군,몽탄면,몽탄면제1투,339,212,180,27,4,0,1,212,0,127,84.90566037735849,12.735849056603774,1.8867924528301887,0.0,0.4716981132075472
31,전라남도,무안군,몽탄면,몽탄면제2투,162,92,74,10,7,0,0,91,1,70,81.31868131868131,10.989010989010989,7.6923076923076925,0.0,0.0
32,전라남도,무안군,몽탄면,몽탄면제3투,159,75,51,15,4,4,0,74,1,84,68.91891891891892,20.27027027027027,5.405405405405405,5.405405405405405,0.0
33,전라남도,무안군,몽탄면,몽탄면제4투,232,155,131,18,2,2,1,154,1,77,85.06493506493507,11.688311688311687,1.2987012987012987,1.2987012987012987,0.6493506493506493
34,전라남도,무안군,청계면,관내사전투표,2688,2688,2255,158,200,26,5,2644,44,0,85.2874432677761,5.975794251134644,7.564296520423601,0.9833585476550681,0.18910741301059003
35,전라남도,무안군,청계면,청계면제1투,379,228,199,19,4,2,1,225,3,151,88.44444444444444,8.444444444444445,1.7777777777777777,0.8888888888888888,0.4444444444444444
36,전라남도,무안군,청계면,청계면제2투,922,495,350,98,35,6,1,490,5,427,71.42857142857143,20.0,7.142857142857142,1.2244897959183674,0.20408163265306123
37,전라남도,무안군,청계면,청계면제3투,486,309,257,35,4,4,3,303,6,177,84.81848184818482,11.55115511551155,1.3201320132013201,1.3201320132013201,0.9900990099009901
38,전라남도,무안군,청계면,청계면제4투,438,323,284,23,6,1,4,318,5,115,89.30817610062893,7.232704402515723,1.8867924528301887,0.3144654088050315,1.257861635220126
39,전라남도,무안군,청계면,청계면제5투,466,304,252,42,6,2,1,303,1,162,83.16831683168317,13.861386138613863,1.9801980198019802,0.6600660066006601,0.33003300330033003
40,전라남도,무안군,현경면,관내사전투표,1517,1517,1425,58,23,9,0,1515,2,0,94.05940594059405,3.828382838283828,1.518151815181518,0.594059405940594,0.0
41,전라남도,무안군,현경면,현경면제1투,206,148,129,15,2,0,0,146,2,58,88.35616438356165,10.273972602739725,1.36986301369863,0.0,0.0
42,전라남도,무안군,현경면,현경면제2투,529,285,249,22,9,2,0,282,3,244,88.29787234042553,7.801418439716312,3.1914893617021276,0.7092198581560284,0.0
43,전라남도,무안군,현경면,현경면제3투,378,233,205,22,1,1,1,230,3,145,89.13043478260869,9.565217391304348,0.43478260869565216,0.43478260869565216,0.43478260869565216
44,전라남도,무안군,현경면,현경면제4투,379,210,174,21,10,2,2,209,1,169,83.25358851674642,10.047846889952153,4.784688995215311,0.9569377990430622,0.9569377990430622
45,전라남도,무안군,현경면,현경면제5투,341,233,189,36,5,1,0,231,2,108,81.81818181818183,15.584415584415584,2.1645021645021645,0.4329004329004329,0.0
46,전라남도,무안군,망운면,관내사전투표,889,889,828,40,12,3,0,883,6,0,93.77123442808607,4.530011325028313,1.3590033975084939,0.33975084937712347,0.0
47,전라남도,무안군,망운면,망운면제1투,407,202,162,35,3,2,0,202,0,205,80.19801980198021,17.326732673267326,1.4851485148514851,0.9900990099009901,0.0
48,전라남도,무안군,망운면,망운면제2투,210,133,115,14,4,0,0,133,0,77,86.46616541353383,10.526315789473683,3.007518796992481,0.0,0.0
49,전라남도,무안군,해제면,관내사전투표,2292,2292,2141,91,35,7,6,2280,12,0,93.90350877192982,3.9912280701754383,1.5350877192982455,0.30701754385964913,0.2631578947368421
50,전라남도,무안군,해제면,해제면제1투,388,173,145,18,5,1,2,171,2,215,84.7953216374269,10.526315789473683,2.923976608187134,0.5847953216374269,1.1695906432748537
51,전라남도,무안군,해제면,해제면제2투,476,233,185,35,9,1,1,231,2,243,80.08658008658008,15.151515151515152,3.896103896103896,0.4329004329004329,0.4329004329004329
52,전라남도,무안군,해제면,해제면제3투,297,159,131,22,1,0,1,155,4,138,84.51612903225806,14.193548387096774,0.6451612903225806,0.0,0.6451612903225806
53,전라남도,무안군,해제면,해제면제4투,387,189,152,30,3,1,0,186,3,198,81.72043010752688,16.129032258064516,1.6129032258064515,0.5376344086021506,0.0
54,전라남도,무안군,운남면,관내사전투표,1097,1097,998,62,26,6,1,1093,4,0,91.30832570905764,5.672461116193961,2.3787740164684354,0.5489478499542544,0.09149130832570906
55,전라남도,무안군,운남면,운남면제1투,279,147,116,24,5,2,0,147,0,132,78.91156462585033,16.3265306122449,3.4013605442176873,1.3605442176870748,0.0
56,전라남도,무안군,운남면,운남면제2투,512,311,242,59,7,3,0,311,0,201,77.81350482315112,18.971061093247588,2.2508038585209005,0.964630225080386,0.0
57,전라남도,무안군,운남면,운남면제3투,188,127,110,13,2,1,0,126,1,61,87.3015873015873,10.317460317460316,1.5873015873015872,0.7936507936507936,0.0
58,전라남도,무안군,잘못 투입·구분된 투표지,,0,1,1,0,0,0,0,1,0,-1,100.0,0.0,0.0,0.0,0.0
0,전라남도,영광군,거소·선상투표,,131,118,93,11,8,0,1,113,5,13,82.30088495575221,9.734513274336283,7.079646017699115,0.0,0.8849557522123894
1,전라남도,영광군,관외사전투표,,6675,6673,5363,549,653,56,6,6627,46,2,80.92651275086766,8.284291534631055,9.853629093103969,0.8450279161007999,0.09053870529651425
2,전라남도,영광군,재외투표,,151,122,98,11,13,0,0,122,0,29,80.32786885245902,9.01639344262295,10.655737704918032,0.0,0.0
3,전라남도,영광군,영광읍,관내사전투표,7144,7144,6509,326,243,34,8,7120,24,0,91.4185393258427,4.578651685393258,3.4129213483146073,0.47752808988764045,0.11235955056179776
4,전라남도,영광군,영광읍,영광읍제1투,693,329,258,46,21,2,1,328,1,364,78.65853658536585,14.02439024390244,6.402439024390244,0.6097560975609756,0.3048780487804878
5,전라남도,영광군,영광읍,영광읍제2투,1702,1043,821,157,49,9,0,1036,7,659,79.24710424710425,15.154440154440154,4.72972972972973,0.8687258687258688,0.0
6,전라남도,영광군,영광읍,영광읍제3투,1238,691,553,99,29,6,1,688,3,547,80.37790697674419,14.38953488372093,4.215116279069767,0.872093023255814,0.14534883720930233
7,전라남도,영광군,영광읍,영광읍제4투,1066,530,411,68,38,6,4,527,3,536,77.98861480075901,12.903225806451612,7.2106261859582546,1.1385199240986716,0.7590132827324478
8,전라남도,영광군,영광읍,영광읍제5투,540,333,281,33,10,1,5,330,3,207,85.15151515151516,10.0,3.0303030303030303,0.30303030303030304,1.5151515151515151
9,전라남도,영광군,영광읍,영광읍제6투,207,154,137,9,5,0,2,153,1,53,89.54248366013073,5.88235294117647,3.2679738562091507,0.0,1.3071895424836601
10,전라남도,영광군,영광읍,영광읍제7투,271,174,143,18,12,1,0,174,0,97,82.18390804597702,10.344827586206897,6.896551724137931,0.5747126436781609,0.0
11,전라남도,영광군,영광읍,영광읍제8투,1419,756,575,117,52,6,2,752,4,663,76.4627659574468,15.558510638297873,6.914893617021277,0.7978723404255319,0.26595744680851063
12,전라남도,영광군,영광읍,영광읍제9투,762,472,405,45,14,3,2,469,3,290,86.35394456289978,9.594882729211088,2.9850746268656714,0.6396588486140725,0.42643923240938164
13,전라남도,영광군,백수읍,관내사전투표,1691,1691,1558,80,34,2,8,1682,9,0,92.62782401902497,4.756242568370987,2.0214030915576697,0.11890606420927466,0.47562425683709864
14,전라남도,영광군,백수읍,백수읍제1투,257,132,102,19,7,1,1,130,2,125,78.46153846153847,14.615384615384617,5.384615384615385,0.7692307692307693,0.7692307692307693
15,전라남도,영광군,백수읍,백수읍제2투,525,313,250,52,3,1,2,308,5,212,81.16883116883116,16.883116883116884,0.974025974025974,0.3246753246753247,0.6493506493506493
16,전라남도,영광군,백수읍,백수읍제3투,404,231,210,16,5,0,0,231,0,173,90.9090909090909,6.926406926406926,2.1645021645021645,0.0,0.0
17,전라남도,영광군,백수읍,백수읍제4투,402,224,200,16,6,0,0,222,2,178,90.09009009009009,7.207207207207207,2.7027027027027026,0.0,0.0
18,전라남도,영광군,홍농읍,관내사전투표,2622,2622,2208,215,149,16,6,2594,28,0,85.1195065535852,8.288357748650732,5.74402467232074,0.6168080185042405,0.2313030069390902
19,전라남도,영광군,홍농읍,홍농읍제1투,438,207,153,41,9,1,2,206,1,231,74.27184466019418,19.902912621359224,4.368932038834951,0.48543689320388345,0.9708737864077669
20,전라남도,영광군,홍농읍,홍농읍제2투,162,87,74,12,1,0,0,87,0,75,85.0574712643678,13.793103448275861,1.1494252873563218,0.0,0.0
21,전라남도,영광군,홍농읍,홍농읍제3투,213,125,105,12,5,0,2,124,1,88,84.67741935483872,9.67741935483871,4.032258064516129,0.0,1.6129032258064515
22,전라남도,영광군,홍농읍,홍농읍제4투,367,220,198,20,1,1,0,220,0,147,90.0,9.090909090909092,0.45454545454545453,0.45454545454545453,0.0
23,전라남도,영광군,홍농읍,홍농읍제5투,1083,689,341,243,94,5,1,684,5,394,49.853801169590646,35.526315789473685,13.742690058479532,0.7309941520467835,0.14619883040935672
24,전라남도,영광군,대마면,관내사전투표,831,831,721,49,42,7,3,822,9,0,87.71289537712896,5.961070559610706,5.109489051094891,0.851581508515815,0.36496350364963503
25,전라남도,영광군,대마면,대마면제1투,351,191,149,29,6,4,0,188,3,160,79.25531914893617,15.425531914893616,3.1914893617021276,2.127659574468085,0.0
26,전라남도,영광군,대마면,대마면제2투,187,122,112,7,0,1,2,122,0,65,91.80327868852459,5.737704918032787,0.0,0.819672131147541,1.639344262295082
27,전라남도,영광군,묘량면,관내사전투표,845,845,765,41,23,3,4,836,9,0,91.50717703349282,4.904306220095694,2.751196172248804,0.3588516746411483,0.4784688995215311
28,전라남도,영광군,묘량면,묘량면제1투,285,151,106,36,9,0,0,151,0,134,70.19867549668875,23.841059602649008,5.960264900662252,0.0,0.0
29,전라남도,영광군,묘량면,묘량면제2투,270,188,167,16,2,2,1,188,0,82,88.82978723404256,8.51063829787234,1.0638297872340425,1.0638297872340425,0.5319148936170213
30,전라남도,영광군,불갑면,관내사전투표,809,809,741,50,9,6,1,807,2,0,91.82156133828995,6.195786864931847,1.1152416356877324,0.7434944237918215,0.12391573729863693
31,전라남도,영광군,불갑면,불갑면제1투,260,136,108,22,3,1,1,135,1,124,80.0,16.296296296296298,2.2222222222222223,0.7407407407407408,0.7407407407407408
32,전라남도,영광군,불갑면,불갑면제2투,148,96,81,10,2,0,2,95,1,52,85.26315789473684,10.526315789473683,2.1052631578947367,0.0,2.1052631578947367
33,전라남도,영광군,군서면,관내사전투표,1712,1712,1541,87,42,11,11,1692,20,0,91.07565011820331,5.141843971631205,2.4822695035460995,0.6501182033096926,0.6501182033096926
34,전라남도,영광군,군서면,군서면제1투,352,189,152,21,14,0,0,187,2,163,81.28342245989305,11.229946524064172,7.4866310160427805,0.0,0.0
35,전라남도,영광군,군서면,군서면제2투,453,284,233,38,7,0,1,279,5,169,83.51254480286738,13.620071684587815,2.5089605734767026,0.0,0.35842293906810035
36,전라남도,영광군,군남면,관내사전투표,1146,1146,1058,44,26,1,8,1137,9,0,93.051890941073,3.8698328935795954,2.2867194371152153,0.08795074758135445,0.7036059806508356
37,전라남도,영광군,군남면,군남면제1투,325,150,112,31,2,2,1,148,2,175,75.67567567567568,20.945945945945947,1.3513513513513513,1.3513513513513513,0.6756756756756757
38,전라남도,영광군,군남면,군남면제2투,209,118,97,9,4,1,4,115,3,91,84.34782608695653,7.82608695652174,3.4782608695652173,0.8695652173913043,3.4782608695652173
39,전라남도,영광군,군남면,군남면제3투,235,120,98,14,5,0,3,120,0,115,81.66666666666667,11.666666666666666,4.166666666666666,0.0,2.5
40,전라남도,영광군,염산면,관내사전투표,1753,1753,1624,74,33,4,7,1742,11,0,93.22617680826636,4.247990815154994,1.894374282433984,0.2296211251435132,0.4018369690011481
41,전라남도,영광군,염산면,염산면제1투,508,239,178,45,10,3,0,236,3,269,75.42372881355932,19.06779661016949,4.23728813559322,1.2711864406779663,0.0
42,전라남도,영광군,염산면,염산면제2투,339,202,173,25,1,0,0,199,3,137,86.93467336683418,12.562814070351758,0.5025125628140703,0.0,0.0
43,전라남도,영광군,염산면,염산면제3투,275,167,154,7,2,1,0,164,3,108,93.90243902439023,4.2682926829268295,1.2195121951219512,0.6097560975609756,0.0
44,전라남도,영광군,염산면,염산면제4투,226,117,99,15,3,0,0,117,0,109,84.61538461538461,12.82051282051282,2.564102564102564,0.0,0.0
45,전라남도,영광군,법성면,관내사전투표,2280,2280,2041,128,81,11,5,2266,14,0,90.07060900264784,5.648720211827008,3.5745807590467784,0.48543689320388345,0.22065313327449249
46,전라남도,영광군,법성면,법성면제1투,796,403,321,66,11,0,1,399,4,393,80.45112781954887,16.541353383458645,2.756892230576441,0.0,0.2506265664160401
47,전라남도,영광군,법성면,법성면제2투,236,126,107,16,2,1,0,126,0,110,84.92063492063492,12.698412698412698,1.5873015873015872,0.7936507936507936,0.0
48,전라남도,영광군,법성면,법성면제3투,236,121,105,10,3,2,0,120,1,115,87.5,8.333333333333332,2.5,1.6666666666666667,0.0
49,전라남도,영광군,법성면,법성면제4투,401,225,188,22,9,3,1,223,2,176,84.30493273542601,9.865470852017937,4.0358744394618835,1.345291479820628,0.4484304932735426
50,전라남도,영광군,법성면,법성면제5투,216,141,110,24,5,1,0,140,1,75,78.57142857142857,17.142857142857142,3.571428571428571,0.7142857142857143,0.0
51,전라남도,영광군,낙월면,관내사전투표,86,86,78,5,2,0,0,85,1,0,91.76470588235294,5.88235294117647,2.3529411764705883,0.0,0.0
52,전라남도,영광군,낙월면,낙월면제1투,71,17,13,2,2,0,0,17,0,54,76.47058823529412,11.76470588235294,11.76470588235294,0.0,0.0
53,전라남도,영광군,낙월면,낙월면제2투,81,56,53,2,1,0,0,56,0,25,94.64285714285714,3.571428571428571,1.7857142857142856,0.0,0.0
54,전라남도,영광군,낙월면,낙월면제3투,117,101,87,12,1,0,1,101,0,16,86.13861386138613,11.881188118811881,0.9900990099009901,0.0,0.9900990099009901
55,전라남도,영광군,잘못 투입·구분된 투표지,,0,0,0,0,0,0,0,0,0,0,0.0,0.0,0.0,0.0,0.0
0,전라남도,함평군,거소·선상투표,,180,167,140,11,11,1,0,163,4,13,85.88957055214725,6.748466257668712,6.748466257668712,0.6134969325153374,0.0
1,전라남도,함평군,관외사전투표,,4268,4267,3675,288,240,20,8,4231,36,1,86.85889860553061,6.806901441739542,5.672417868116285,0.4727014890096904,0.18908059560387616
2,전라남도,함평군,재외투표,,94,64,49,10,3,2,0,64,0,30,76.5625,15.625,4.6875,3.125,0.0
3,전라남도,함평군,함평읍,관내사전투표,3807,3808,3452,172,113,20,11,3768,40,-1,91.6135881104034,4.564755838641188,2.9989384288747347,0.5307855626326964,0.291932059447983
4,전라남도,함평군,함평읍,함평읍제1투,542,337,266,45,20,1,1,333,4,205,79.87987987987988,13.513513513513514,6.006006006006006,0.3003003003003003,0.3003003003003003
5,전라남도,함평군,함평읍,함평읍제2투,481,251,202,34,8,3,0,247,4,230,81.78137651821862,13.765182186234817,3.2388663967611335,1.214574898785425,0.0
6,전라남도,함평군,함평읍,함평읍제3투,287,169,139,21,2,4,1,167,2,118,83.23353293413174,12.574850299401197,1.1976047904191618,2.3952095808383236,0.5988023952095809
7,전라남도,함평군,함평읍,함평읍제4투,960,530,421,73,29,3,1,527,3,430,79.88614800759012,13.851992409867172,5.502846299810247,0.5692599620493358,0.18975332068311196
8,전라남도,함평군,함평읍,함평읍제5투,461,296,247,28,13,5,1,294,2,165,84.01360544217688,9.523809523809524,4.421768707482993,1.7006802721088436,0.3401360544217687
9,전라남도,함평군,손불면,관내사전투표,1369,1369,1261,52,31,6,5,1355,14,0,93.06273062730628,3.837638376383764,2.2878228782287824,0.44280442804428044,0.36900369003690037
10,전라남도,함평군,손불면,손불면제1투,597,310,242,49,10,3,0,304,6,287,79.60526315789474,16.11842105263158,3.289473684210526,0.9868421052631579,0.0
11,전라남도,함평군,손불면,손불면제2투,389,231,198,26,4,1,0,229,2,158,86.46288209606988,11.353711790393014,1.7467248908296942,0.43668122270742354,0.0
12,전라남도,함평군,신광면,관내사전투표,755,755,699,32,12,3,5,751,4,0,93.07589880159787,4.26098535286285,1.5978695073235687,0.3994673768308922,0.6657789613848202
13,전라남도,함평군,신광면,신광면제1투,381,230,193,20,7,4,5,229,1,151,84.27947598253274,8.73362445414847,3.056768558951965,1.7467248908296942,2.1834061135371177
14,전라남도,함평군,신광면,신광면제2투,154,102,87,10,2,1,0,100,2,52,87.0,10.0,2.0,1.0,0.0
15,전라남도,함평군,학교면,관내사전투표,1292,1292,1202,52,16,5,8,1283,9,0,93.68667186282151,4.053000779423227,1.2470771628994544,0.3897116134060795,0.6235385814497272
16,전라남도,함평군,학교면,학교면제1투,266,142,122,14,4,0,0,140,2,124,87.14285714285714,10.0,2.857142857142857,0.0,0.0
17,전라남도,함평군,학교면,학교면제2투,254,188,170,11,4,1,0,186,2,66,91.39784946236558,5.913978494623656,2.1505376344086025,0.5376344086021506,0.0
18,전라남도,함평군,학교면,학교면제3투,127,84,74,4,5,1,0,84,0,43,88.09523809523809,4.761904761904762,5.952380952380952,1.1904761904761905,0.0
19,전라남도,함평군,학교면,학교면제4투,568,286,222,45,14,3,0,284,2,282,78.16901408450704,15.845070422535212,4.929577464788732,1.056338028169014,0.0
20,전라남도,함평군,엄다면,관내사전투표,815,815,757,33,16,1,1,808,7,0,93.6881188118812,4.084158415841585,1.9801980198019802,0.12376237623762376,0.12376237623762376
21,전라남도,함평군,엄다면,엄다면투표소,534,322,249,52,12,3,2,318,4,212,78.30188679245283,16.352201257861633,3.7735849056603774,0.9433962264150944,0.628930817610063
22,전라남도,함평군,대동면,관내사전투표,1273,1273,1147,77,33,7,2,1266,7,0,90.60031595576619,6.082148499210111,2.6066350710900474,0.5529225908372828,0.1579778830963665
23,전라남도,함평군,대동면,대동면제1투,634,333,263,51,13,2,2,331,2,301,79.45619335347432,15.407854984894259,3.927492447129909,0.6042296072507553,0.6042296072507553
24,전라남도,함평군,대동면,대동면제2투,448,291,243,35,6,0,1,285,6,157,85.26315789473684,12.280701754385964,2.1052631578947367,0.0,0.3508771929824561
25,전라남도,함평군,나산면,관내사전투표,1124,1123,1012,57,20,6,5,1100,23,1,92.0,5.181818181818182,1.8181818181818181,0.5454545454545455,0.45454545454545453
26,전라남도,함평군,나산면,나산면제1투,631,340,261,70,5,2,0,338,2,291,77.2189349112426,20.710059171597635,1.4792899408284024,0.591715976331361,0.0
27,전라남도,함평군,나산면,나산면제2투,214,131,117,10,2,2,0,131,0,83,89.31297709923665,7.633587786259542,1.5267175572519083,1.5267175572519083,0.0
28,전라남도,함평군,해보면,관내사전투표,1190,1190,1107,43,22,4,5,1181,9,0,93.73412362404741,3.6409822184589333,1.8628281117696865,0.3386960203217612,0.42337002540220153
29,전라남도,함평군,해보면,해보면제1투,360,186,158,22,3,1,0,184,2,174,85.86956521739131,11.956521739130435,1.6304347826086956,0.5434782608695652,0.0
30,전라남도,함평군,해보면,해보면제2투,397,208,172,26,4,3,1,206,2,189,83.49514563106796,12.62135922330097,1.9417475728155338,1.4563106796116505,0.48543689320388345
31,전라남도,함평군,월야면,관내사전투표,1475,1475,1399,46,21,2,2,1470,5,0,95.17006802721089,3.1292517006802725,1.4285714285714286,0.13605442176870747,0.13605442176870747
32,전라남도,함평군,월야면,월야면제1투,513,284,244,30,3,2,1,280,4,229,87.14285714285714,10.714285714285714,1.0714285714285714,0.7142857142857143,0.35714285714285715
33,전라남도,함평군,월야면,월야면제2투,183,110,103,4,1,1,1,110,0,73,93.63636363636364,3.6363636363636362,0.9090909090909091,0.9090909090909091,0.9090909090909091
34,전라남도,함평군,월야면,월야면제3투,455,275,235,31,4,2,1,273,2,180,86.08058608058609,11.355311355311356,1.465201465201465,0.7326007326007326,0.3663003663003663
35,전라남도,함평군,잘못 투입·구분된 투표지,,0,0,0,0,0,0,0,0,0,0,0.0,0.0,0.0,0.0,0.0
0,전라남도,신안군,거소·선상투표,,156,149,125,12,11,0,0,148,1,7,84.45945945945947,8.108108108108109,7.4324324324324325,0.0,0.0
1,전라남도,신안군,관외사전투표,,8380,8378,7217,639,402,62,4,8324,54,2,86.7011052378664,7.676597789524267,4.829408938010571,0.7448342143200384,0.04805382027871216
2,전라남도,신안군,재외투표,,128,94,76,14,2,2,0,94,0,34,80.85106382978722,14.893617021276595,2.127659574468085,2.127659574468085,0.0
3,전라남도,신안군,지도읍,관내사전투표,1957,1957,1789,100,42,6,6,1943,14,0,92.07411219763253,5.14668039114771,2.1616057642820383,0.3088008234688626,0.3088008234688626
4,전라남도,신안군,지도읍,지도읍제1투,752,342,278,50,8,1,0,337,5,410,82.49258160237389,14.836795252225517,2.3738872403560833,0.2967359050445104,0.0
5,전라남도,신안군,지도읍,지도읍제2투,47,30,27,2,1,0,0,30,0,17,90.0,6.666666666666667,3.3333333333333335,0.0,0.0
6,전라남도,신안군,지도읍,지도읍제3투,260,143,124,13,5,0,0,142,1,117,87.32394366197182,9.15492957746479,3.5211267605633805,0.0,0.0
7,전라남도,신안군,지도읍,지도읍제4투,313,164,131,27,5,1,0,164,0,149,79.8780487804878,16.463414634146343,3.048780487804878,0.6097560975609756,0.0
8,전라남도,신안군,지도읍,지도읍제5투,130,98,81,9,1,2,1,94,4,32,86.17021276595744,9.574468085106384,1.0638297872340425,2.127659574468085,1.0638297872340425
9,전라남도,신안군,압해읍,관내사전투표,2643,2643,2408,123,66,12,7,2616,27,0,92.04892966360856,4.701834862385321,2.522935779816514,0.45871559633027525,0.2675840978593272
10,전라남도,신안군,압해읍,압해읍제1투,477,212,178,22,8,3,0,211,1,265,84.36018957345972,10.42654028436019,3.7914691943127963,1.4218009478672986,0.0
11,전라남도,신안군,압해읍,압해읍제2투,296,138,117,20,1,0,0,138,0,158,84.78260869565217,14.492753623188406,0.7246376811594203,0.0,0.0
12,전라남도,신안군,압해읍,압해읍제3투,413,224,185,34,4,0,0,223,1,189,82.95964125560538,15.246636771300448,1.7937219730941705,0.0,0.0
13,전라남도,신안군,압해읍,압해읍제4투,582,345,290,41,9,3,1,344,1,237,84.30232558139535,11.918604651162791,2.616279069767442,0.872093023255814,0.29069767441860467
14,전라남도,신안군,압해읍,압해읍제5투,124,97,87,9,1,0,0,97,0,27,89.69072164948454,9.278350515463918,1.0309278350515463,0.0,0.0
15,전라남도,신안군,압해읍,압해읍제6투,139,102,94,6,1,0,0,101,1,37,93.06930693069307,5.9405940594059405,0.9900990099009901,0.0,0.0
16,전라남도,신안군,증도면,관내사전투표,709,709,655,26,16,2,0,699,10,0,93.70529327610872,3.719599427753934,2.28898426323319,0.28612303290414876,0.0
17,전라남도,신안군,증도면,증도면제1투,188,73,56,13,2,1,0,72,1,115,77.77777777777779,18.055555555555554,2.7777777777777777,1.3888888888888888,0.0
18,전라남도,신안군,증도면,증도면제2투,198,88,70,14,2,0,1,87,1,110,80.45977011494253,16.091954022988507,2.2988505747126435,0.0,1.1494252873563218
19,전라남도,신안군,증도면,증도면제3투,198,152,134,12,3,1,0,150,2,46,89.33333333333333,8.0,2.0,0.6666666666666667,0.0
20,전라남도,신안군,임자면,관내사전투표,1180,1180,1070,64,26,6,2,1168,12,0,91.6095890410959,5.47945205479452,2.2260273972602738,0.5136986301369862,0.17123287671232876
21,전라남도,신안군,임자면,임자면제1투,661,305,238,50,11,1,2,302,3,356,78.80794701986756,16.55629139072848,3.642384105960265,0.33112582781456956,0.6622516556291391
22,전라남도,신안군,임자면,임자면제2투,174,110,100,5,3,1,0,109,1,64,91.74311926605505,4.587155963302752,2.7522935779816518,0.9174311926605505,0.0
23,전라남도,신안군,임자면,임자면제3투,65,34,34,0,0,0,0,34,0,31,100.0,0.0,0.0,0.0,0.0
24,전라남도,신안군,임자면,임자면제4투,154,74,60,7,1,2,1,71,3,80,84.50704225352112,9.859154929577464,1.4084507042253522,2.8169014084507045,1.4084507042253522
25,전라남도,신안군,자은면,관내사전투표,948,948,856,60,15,2,4,937,11,0,91.35538954108858,6.403415154749199,1.6008537886872998,0.21344717182497333,0.42689434364994666
26,전라남도,신안군,자은면,자은면제1투,547,247,203,35,4,2,1,245,2,300,82.85714285714286,14.285714285714285,1.6326530612244898,0.8163265306122449,0.40816326530612246
27,전라남도,신안군,자은면,자은면제2투,247,162,137,17,3,1,3,161,1,85,85.09316770186336,10.559006211180124,1.8633540372670807,0.6211180124223602,1.8633540372670807
28,전라남도,신안군,비금면,관내사전투표,1387,1387,1285,49,30,9,4,1377,10,0,93.31880900508351,3.558460421205519,2.178649237472767,0.6535947712418301,0.29048656499636893
29,전라남도,신안군,비금면,비금면제1투,440,196,158,31,4,3,0,196,0,244,80.61224489795919,15.816326530612246,2.0408163265306123,1.530612244897959,0.0
30,전라남도,신안군,비금면,비금면제2투,283,171,148,15,6,0,0,169,2,112,87.57396449704143,8.875739644970414,3.5502958579881656,0.0,0.0
31,전라남도,신안군,비금면,비금면제3투,237,112,102,9,1,0,0,112,0,125,91.07142857142857,8.035714285714286,0.8928571428571428,0.0,0.0
32,전라남도,신안군,비금면,비금면제4투,72,52,44,6,1,0,1,52,0,20,84.61538461538461,11.538461538461538,1.9230769230769231,0.0,1.9230769230769231
33,전라남도,신안군,도초면,관내사전투표,1169,1169,1068,61,11,8,8,1156,13,0,92.38754325259517,5.27681660899654,0.9515570934256056,0.6920415224913495,0.6920415224913495
34,전라남도,신안군,도초면,도초면제1투,334,151,118,27,6,0,0,151,0,183,78.1456953642384,17.880794701986755,3.9735099337748347,0.0,0.0
35,전라남도,신안군,도초면,도초면제2투,177,86,73,9,2,0,1,85,1,91,85.88235294117646,10.588235294117647,2.3529411764705883,0.0,1.1764705882352942
36,전라남도,신안군,도초면,도초면제3투,125,83,71,11,0,0,0,82,1,42,86.58536585365853,13.414634146341465,0.0,0.0,0.0
37,전라남도,신안군,흑산면,관내사전투표,772,772,677,49,30,7,2,765,7,0,88.49673202614379,6.405228758169934,3.9215686274509802,0.9150326797385622,0.261437908496732
38,전라남도,신안군,흑산면,흑산면제1투,356,110,88,16,3,0,0,107,3,246,82.2429906542056,14.953271028037381,2.803738317757009,0.0,0.0
39,전라남도,신안군,흑산면,흑산면제2투,92,51,43,7,0,1,0,51,0,41,84.31372549019608,13.725490196078432,0.0,1.9607843137254901,0.0
40,전라남도,신안군,흑산면,흑산면제3투,100,63,58,3,2,0,0,63,0,37,92.06349206349206,4.761904761904762,3.1746031746031744,0.0,0.0
41,전라남도,신안군,흑산면,흑산면제4투,104,78,69,8,1,0,0,78,0,26,88.46153846153845,10.256410256410255,1.282051282051282,0.0,0.0
42,전라남도,신안군,흑산면,흑산면제5투,220,161,150,7,2,2,0,161,0,59,93.16770186335404,4.3478260869565215,1.2422360248447204,1.2422360248447204,0.0
43,전라남도,신안군,흑산면,흑산면제6투,89,59,58,0,0,0,1,59,0,30,98.30508474576271,0.0,0.0,0.0,1.694915254237288
44,전라남도,신안군,흑산면,흑산면제7투,223,140,120,12,6,0,1,139,1,83,86.33093525179856,8.633093525179856,4.316546762589928,0.0,0.7194244604316548
45,전라남도,신안군,흑산면,흑산면제8투,28,21,17,2,1,0,0,20,1,7,85.0,10.0,5.0,0.0,0.0
46,전라남도,신안군,흑산면,흑산면제9투,41,30,26,3,0,0,0,29,1,11,89.65517241379311,10.344827586206897,0.0,0.0,0.0
47,전라남도,신안군,하의면,관내사전투표,599,599,548,22,15,2,5,592,7,0,92.56756756756756,3.7162162162162162,2.5337837837837838,0.33783783783783783,0.8445945945945946
48,전라남도,신안군,하의면,하의면제1투,236,113,96,14,3,0,0,113,0,123,84.95575221238938,12.389380530973451,2.6548672566371683,0.0,0.0
49,전라남도,신안군,하의면,하의면제2투,225,122,105,12,4,1,0,122,0,103,86.0655737704918,9.836065573770492,3.278688524590164,0.819672131147541,0.0
50,전라남도,신안군,하의면,하의면제3투,64,54,54,0,0,0,0,54,0,10,100.0,0.0,0.0,0.0,0.0
51,전라남도,신안군,신의면,관내사전투표,614,614,562,25,16,4,1,608,6,0,92.43421052631578,4.111842105263158,2.631578947368421,0.6578947368421052,0.1644736842105263
52,전라남도,신안군,신의면,신의면투표소,345,141,119,13,3,4,0,139,2,204,85.61151079136691,9.352517985611511,2.158273381294964,2.877697841726619,0.0
53,전라남도,신안군,장산면,관내사전투표,647,647,582,37,12,5,4,640,7,0,90.9375,5.78125,1.875,0.78125,0.625
54,전라남도,신안군,장산면,장산면제1투,231,120,95,20,3,1,0,119,1,111,79.83193277310924,16.80672268907563,2.5210084033613445,0.8403361344537815,0.0
55,전라남도,신안군,장산면,장산면제2투,143,64,52,9,1,1,0,63,1,79,82.53968253968253,14.285714285714285,1.5873015873015872,1.5873015873015872,0.0
56,전라남도,신안군,안좌면,관내사전투표,1130,1130,1004,73,25,11,2,1115,15,0,90.04484304932735,6.547085201793721,2.242152466367713,0.9865470852017937,0.17937219730941703
57,전라남도,신안군,안좌면,안좌면제1투,448,184,139,37,4,2,1,183,1,264,75.95628415300546,20.21857923497268,2.185792349726776,1.092896174863388,0.546448087431694
58,전라남도,신안군,안좌면,안좌면제2투,112,70,55,8,3,1,2,69,1,42,79.71014492753623,11.594202898550725,4.3478260869565215,1.4492753623188406,2.898550724637681
59,전라남도,신안군,안좌면,안좌면제3투,272,144,111,27,3,2,1,144,0,128,77.08333333333334,18.75,2.083333333333333,1.3888888888888888,0.6944444444444444
60,전라남도,신안군,안좌면,안좌면제4투,222,116,93,16,5,2,0,116,0,106,80.17241379310344,13.793103448275861,4.310344827586207,1.7241379310344827,0.0
61,전라남도,신안군,팔금면,관내사전투표,460,460,423,23,8,3,0,457,3,0,92.5601750547046,5.032822757111598,1.75054704595186,0.6564551422319475,0.0
62,전라남도,신안군,팔금면,팔금면투표소,263,118,92,20,1,3,0,116,2,145,79.3103448275862,17.24137931034483,0.8620689655172413,2.586206896551724,0.0
63,전라남도,신안군,암태면,관내사전투표,913,913,814,61,18,9,2,904,9,0,90.04424778761062,6.7477876106194685,1.991150442477876,0.995575221238938,0.22123893805309736
64,전라남도,신안군,암태면,암태면제1투,338,163,125,33,4,0,0,162,1,175,77.1604938271605,20.37037037037037,2.4691358024691357,0.0,0.0
65,전라남도,신안군,암태면,암태면제2투,163,106,96,8,0,0,0,104,2,57,92.3076923076923,7.6923076923076925,0.0,0.0,0.0
66,전라남도,신안군,암태면,암태면제3투,92,73,72,1,0,0,0,73,0,19,98.63013698630137,1.36986301369863,0.0,0.0,0.0
67,전라남도,신안군,잘못 투입·구분된 투표지,,0,0,0,0,0,0,0,0,0,0,0.0,0.0,0.0,0.0,0.0
0,경상북도,포항시북구,거소·선상투표,,392,363,87,200,63,1,2,353,10,29,24.645892351274785,56.657223796033996,17.847025495750707,0.28328611898017,0.56657223796034
1,경상북도,포항시북구,관외사전투표,,19111,19108,6989,8848,2836,222,18,18913,195,3,36.95341828372019,46.782636281922485,14.994976999947127,1.1737958018294294,0.09517263258076455
2,경상북도,포항시북구,재외투표,,891,685,393,199,76,14,0,682,3,206,57.62463343108505,29.178885630498534,11.143695014662756,2.0527859237536656,0.0
3,경상북도,포항시북구,흥해읍,관내사전투표,6973,6973,2860,3415,584,66,3,6928,45,0,41.28175519630485,49.29272517321016,8.429561200923787,0.9526558891454965,0.04330254041570439
4,경상북도,포항시북구,흥해읍,흥해읍제1투,1357,871,94,754,18,3,0,869,2,486,10.817031070195627,86.76639815880323,2.0713463751438432,0.34522439585730724,0.0
5,경상북도,포항시북구,흥해읍,흥해읍제2투,1245,892,120,736,27,6,0,889,3,353,13.498312710911136,82.7896512935883,3.0371203599550056,0.6749156355455568,0.0
6,경상북도,포항시북구,흥해읍,흥해읍제3투,1194,905,100,765,25,6,4,900,5,289,11.11111111111111,85.0,2.7777777777777777,0.6666666666666667,0.4444444444444444
7,경상북도,포항시북구,흥해읍,흥해읍제4투,1299,883,95,757,23,2,0,877,6,416,10.832383124287343,86.3169897377423,2.6225769669327255,0.22805017103762829,0.0
8,경상북도,포항시북구,흥해읍,흥해읍제5투,1451,1021,161,795,46,11,1,1014,7,430,15.877712031558186,78.40236686390533,4.536489151873767,1.0848126232741617,0.09861932938856016
9,경상북도,포항시북구,흥해읍,흥해읍제6투,1969,1352,149,1113,61,13,1,1337,15,617,11.144353029169784,83.24607329842932,4.56245325355273,0.9723261032161555,0.07479431563201197
10,경상북도,포항시북구,흥해읍,흥해읍제7투,706,493,42,438,11,1,0,492,1,213,8.536585365853659,89.02439024390245,2.2357723577235773,0.20325203252032523,0.0
11,경상북도,포항시북구,흥해읍,흥해읍제8투,3446,2407,543,1637,189,28,1,2398,9,1039,22.643869891576312,68.2652210175146,7.8815679733110935,1.1676396997497915,0.041701417848206836
12,경상북도,포항시북구,흥해읍,흥해읍제9투,1846,1277,244,938,72,15,2,1271,6,569,19.19748229740362,73.80015735641227,5.664830841856806,1.1801730920535012,0.15735641227380015
13,경상북도,포항시북구,흥해읍,흥해읍제10투,2900,2042,328,1561,127,15,1,2032,10,858,16.141732283464567,76.82086614173228,6.25,0.7381889763779528,0.049212598425196846
14,경상북도,포항시북구,흥해읍,흥해읍제11투,2550,1949,519,1283,116,21,5,1944,5,601,26.69753086419753,65.99794238683128,5.967078189300412,1.0802469135802468,0.257201646090535
15,경상북도,포항시북구,흥해읍,흥해읍제12투,3902,2982,827,1823,294,23,0,2967,15,920,27.873272665992587,61.44253454668015,9.908998988877654,0.7751937984496124,0.0
16,경상북도,포항시북구,흥해읍,흥해읍제13투,4238,3192,981,1884,264,46,2,3177,15,1046,30.878186968838527,59.301227573182246,8.309726156751653,1.447906830343091,0.06295247088448222
17,경상북도,포항시북구,흥해읍,흥해읍제14투,3147,2613,754,1528,283,33,4,2602,11,534,28.97770945426595,58.72405841660261,10.876249039200616,1.2682551883166795,0.15372790161414296
18,경상북도,포항시북구,흥해읍,흥해읍제15투,4151,3247,792,2051,346,36,5,3230,17,904,24.52012383900929,63.4984520123839,10.712074303405572,1.1145510835913313,0.15479876160990713
19,경상북도,포항시북구,신광면,관내사전투표,558,558,165,356,23,7,2,553,5,0,29.8372513562387,64.376130198915,4.159132007233273,1.2658227848101267,0.3616636528028933
20,경상북도,포항시북구,신광면,신광면제1투,834,598,60,520,14,1,0,595,3,236,10.084033613445378,87.39495798319328,2.3529411764705883,0.16806722689075632,0.0
21,경상북도,포항시북구,신광면,신광면제2투,474,348,36,297,11,0,1,345,3,126,10.434782608695652,86.08695652173914,3.1884057971014492,0.0,0.2898550724637681
22,경상북도,포항시북구,신광면,신광면제3투,589,421,38,373,9,0,0,420,1,168,9.047619047619047,88.80952380952381,2.142857142857143,0.0,0.0
23,경상북도,포항시북구,청하면,관내사전투표,1307,1307,400,790,63,23,2,1278,29,0,31.29890453834116,61.815336463223794,4.929577464788732,1.7996870109546166,0.1564945226917058
24,경상북도,포항시북구,청하면,청하면제1투,1475,981,112,820,38,4,1,975,6,494,11.487179487179487,84.1025641025641,3.897435897435898,0.41025641025641024,0.10256410256410256
25,경상북도,포항시북구,청하면,청하면제2투,970,673,59,589,11,1,1,661,12,297,8.925869894099849,89.10741301059002,1.6641452344931922,0.15128593040847202,0.15128593040847202
26,경상북도,포항시북구,청하면,청하면제3투,422,299,35,248,10,1,0,294,5,123,11.904761904761903,84.35374149659864,3.4013605442176873,0.3401360544217687,0.0
27,경상북도,포항시북구,송라면,관내사전투표,805,805,198,549,26,5,5,783,22,0,25.287356321839084,70.11494252873564,3.3205619412515963,0.6385696040868455,0.6385696040868455
28,경상북도,포항시북구,송라면,송라면투표소,1375,909,76,802,22,4,1,905,4,466,8.397790055248619,88.61878453038673,2.430939226519337,0.44198895027624313,0.11049723756906078
29,경상북도,포항시북구,기계면,관내사전투표,1581,1581,391,1105,55,10,0,1561,20,0,25.04804612427931,70.78795643818066,3.523382447149263,0.6406149903907752,0.0
30,경상북도,포항시북구,기계면,기계면제1투,1857,1299,141,1104,32,6,3,1286,13,558,10.964230171073094,85.8475894245723,2.488335925349922,0.46656298600311047,0.23328149300155523
31,경상북도,포항시북구,기계면,기계면제2투,567,367,25,334,6,2,0,367,0,200,6.811989100817439,91.00817438692098,1.6348773841961852,0.544959128065395,0.0
32,경상북도,포항시북구,기계면,기계면제3투,471,341,29,301,2,0,1,333,8,130,8.708708708708707,90.39039039039038,0.6006006006006006,0.0,0.3003003003003003
33,경상북도,포항시북구,죽장면,관내사전투표,655,655,127,484,31,3,2,647,8,0,19.629057187017,74.80680061823803,4.7913446676970635,0.46367851622874806,0.3091190108191654
34,경상북도,포항시북구,죽장면,죽장면제1투,1203,812,53,737,9,4,0,803,9,391,6.60024906600249,91.78082191780823,1.1207970112079702,0.49813200498132004,0.0
35,경상북도,포항시북구,죽장면,죽장면제2투,449,348,35,299,9,1,2,346,2,101,10.115606936416185,86.41618497109826,2.601156069364162,0.2890173410404624,0.5780346820809248
36,경상북도,포항시북구,기북면,관내사전투표,404,404,87,284,26,6,0,403,1,0,21.588089330024815,70.47146401985111,6.451612903225806,1.488833746898263,0.0
37,경상북도,포항시북구,기북면,기북면투표소,783,566,67,478,12,3,1,561,5,217,11.942959001782532,85.20499108734403,2.13903743315508,0.53475935828877,0.17825311942959002
38,경상북도,포항시북구,중앙동,관내사전투표,2983,2983,1079,1619,235,26,3,2962,21,0,36.42808912896691,54.65901417960837,7.933828494260635,0.8777852802160702,0.1012829169480081
39,경상북도,포항시북구,중앙동,중앙동제1투,1111,597,67,503,27,0,0,597,0,514,11.222780569514237,84.25460636515912,4.522613065326634,0.0,0.0
40,경상북도,포항시북구,중앙동,중앙동제2투,596,406,43,342,16,1,1,403,3,190,10.669975186104217,84.863523573201,3.970223325062035,0.24813895781637718,0.24813895781637718
41,경상북도,포항시북구,중앙동,중앙동제3투,1228,813,107,665,33,4,1,810,3,415,13.209876543209875,82.09876543209876,4.074074074074074,0.49382716049382713,0.12345679012345678
42,경상북도,포항시북구,중앙동,중앙동제4투,1970,1347,241,1010,72,13,1,1337,10,623,18.025430067314886,75.54225878833208,5.385190725504862,0.9723261032161555,0.07479431563201197
43,경상북도,포항시북구,중앙동,중앙동제5투,1613,1051,157,842,43,6,1,1049,2,562,14.966634890371783,80.26692087702574,4.0991420400381315,0.5719733079122974,0.09532888465204957
44,경상북도,포항시북구,중앙동,중앙동제6투,1141,723,88,590,39,4,1,722,1,418,12.18836565096953,81.7174515235457,5.401662049861495,0.554016620498615,0.13850415512465375
45,경상북도,포항시북구,중앙동,중앙동제7투,1782,1398,221,1084,78,8,1,1392,6,384,15.876436781609197,77.87356321839081,5.603448275862069,0.5747126436781609,0.07183908045977011
46,경상북도,포항시북구,양학동,관내사전투표,3269,3269,1364,1641,208,36,2,3251,18,0,41.9563211319594,50.476776376499544,6.39803137496155,1.1073515841279606,0.06151953245155337
47,경상북도,포항시북구,양학동,양학동제1투,2826,2149,434,1569,121,17,0,2141,8,677,20.27090144792153,73.28351237739375,5.651564689397478,0.7940214852872489,0.0
48,경상북도,포항시북구,양학동,양학동제2투,2180,1497,290,1108,72,15,1,1486,11,683,19.515477792732167,74.56258411843876,4.8452220726783315,1.0094212651413188,0.06729475100942127
49,경상북도,포항시북구,양학동,양학동제3투,2683,1882,426,1288,140,16,2,1872,10,801,22.756410256410255,68.80341880341881,7.478632478632479,0.8547008547008548,0.10683760683760685
50,경상북도,포항시북구,양학동,양학동제4투,1974,1572,321,1145,82,16,2,1566,6,402,20.49808429118774,73.11621966794381,5.236270753512133,1.0217113665389528,0.1277139208173691
51,경상북도,포항시북구,죽도동,관내사전투표,3284,3284,1087,1959,204,23,4,3277,7,0,33.17058285016783,59.780286847726586,6.225205981080256,0.7018614586512053,0.12206286237412267
52,경상북도,포항시북구,죽도동,죽도동제1투,1814,1292,163,1090,30,2,2,1287,5,522,12.665112665112666,84.6930846930847,2.331002331002331,0.1554001554001554,0.1554001554001554
53,경상북도,포항시북구,죽도동,죽도동제2투,3355,1979,285,1581,91,12,1,1970,9,1376,14.467005076142131,80.25380710659898,4.619289340101522,0.6091370558375634,0.050761421319796954
54,경상북도,포항시북구,죽도동,죽도동제3투,2600,1725,219,1416,72,8,1,1716,9,875,12.762237762237763,82.51748251748252,4.195804195804196,0.4662004662004662,0.05827505827505827
55,경상북도,포항시북구,죽도동,죽도동제4투,2157,1516,255,1185,63,7,0,1510,6,641,16.887417218543046,78.47682119205298,4.172185430463577,0.4635761589403974,0.0
56,경상북도,포항시북구,죽도동,죽도동제5투,3058,2048,328,1598,94,15,1,2036,12,1010,16.110019646365423,78.48722986247544,4.616895874263261,0.7367387033398821,0.04911591355599214
57,경상북도,포항시북구,용흥동,관내사전투표,2330,2330,971,1175,145,31,1,2323,7,0,41.799397331037454,50.58114507102884,6.241928540680155,1.334481274214378,0.04304778303917348
58,경상북도,포항시북구,용흥동,용흥동제1투,1992,1585,246,1272,51,9,1,1579,6,407,15.5794806839772,80.55731475617479,3.229892336922103,0.5699810006333123,0.06333122229259025
59,경상북도,포항시북구,용흥동,용흥동제2투,1985,1422,262,1098,45,11,0,1416,6,563,18.502824858757062,77.54237288135593,3.1779661016949152,0.7768361581920904,0.0
60,경상북도,포항시북구,용흥동,용흥동제3투,1542,1056,158,852,39,2,0,1051,5,486,15.033301617507137,81.06565176022835,3.7107516650808754,0.19029495718363465,0.0
61,경상북도,포항시북구,용흥동,용흥동제4투,1775,1363,232,1050,74,5,0,1361,2,412,17.046289493019838,77.14915503306392,5.437178545187362,0.36737692872887584,0.0
62,경상북도,포항시북구,용흥동,용흥동제5투,2191,1631,323,1194,93,17,0,1627,4,560,19.852489244007376,73.38660110633067,5.716041794714198,1.0448678549477566,0.0
63,경상북도,포항시북구,용흥동,용흥동제6투,1635,1187,219,891,65,5,1,1181,6,448,18.543607112616428,75.44453852667232,5.50381033022862,0.42337002540220153,0.0846740050804403
64,경상북도,포항시북구,용흥동,용흥동제7투,2042,1475,270,1106,76,16,1,1469,6,567,18.379850238257315,75.28931245745405,5.173587474472431,1.0891763104152483,0.06807351940095302
65,경상북도,포항시북구,우창동,관내사전투표,4872,4872,2145,2268,384,44,2,4843,29,0,44.290728887053476,46.83047697708032,7.92896964691307,0.9085277720421228,0.041296716911005574
66,경상북도,포항시북구,우창동,우창동제1투,2145,1554,278,1201,56,11,0,1546,8,591,17.981888745148773,77.6843467011643,3.6222509702457955,0.7115135834411385,0.0
67,경상북도,포항시북구,우창동,우창동제2투,1849,1347,226,1051,51,9,0,1337,10,502,16.903515332834704,78.60882572924459,3.8145100972326103,0.6731488406881078,0.0
68,경상북도,포항시북구,우창동,우창동제3투,2481,1866,380,1343,108,23,1,1855,11,615,20.485175202156334,72.3989218328841,5.822102425876011,1.2398921832884098,0.05390835579514825
69,경상북도,포항시북구,우창동,우창동제4투,1623,1152,210,879,51,6,1,1147,5,471,18.30863121185702,76.63469921534438,4.446381865736704,0.5231037489102005,0.08718395815170009
70,경상북도,포항시북구,우창동,우창동제5투,1270,941,160,727,41,8,0,936,5,329,17.094017094017094,77.67094017094017,4.38034188034188,0.8547008547008548,0.0
71,경상북도,포항시북구,우창동,우창동제6투,1555,1042,152,839,35,3,2,1031,11,513,14.742967992240544,81.37730358874879,3.394762366634336,0.2909796314258002,0.19398642095053348
72,경상북도,포항시북구,우창동,우창동제7투,2157,1511,292,1125,79,11,0,1507,4,646,19.376244193762442,74.65162574651626,5.242203052422031,0.7299270072992701,0.0
73,경상북도,포항시북구,우창동,우창동제8투,2730,2009,519,1294,166,22,1,2002,7,721,25.92407592407592,64.63536463536464,8.291708291708291,1.098901098901099,0.04995004995004995
74,경상북도,포항시북구,우창동,우창동제9투,3116,2358,654,1474,194,23,1,2346,12,758,27.877237851662407,62.830349531116795,8.269394714407502,0.9803921568627451,0.042625745950554135
75,경상북도,포항시북구,두호동,관내사전투표,4685,4685,1946,2332,334,38,6,4656,29,0,41.79553264604811,50.08591065292096,7.173539518900343,0.816151202749141,0.12886597938144329
76,경상북도,포항시북구,두호동,두호동제1투,2591,1734,242,1412,59,10,3,1726,8,857,14.020857473928158,81.80764774044033,3.4183082271147165,0.5793742757821553,0.17381228273464658
77,경상북도,포항시북구,두호동,두호동제2투,2233,1715,342,1261,89,19,0,1711,4,518,19.988310929281123,73.69959088252483,5.201636469900643,1.1104617182933958,0.0
78,경상북도,포항시북구,두호동,두호동제3투,2665,2149,417,1561,141,20,0,2139,10,516,19.49509116409537,72.97802711547452,6.5918653576437585,0.9350163627863487,0.0
79,경상북도,포항시북구,두호동,두호동제4투,3379,2589,536,1846,165,25,5,2577,12,790,20.799379123011253,71.6336825766395,6.402793946449361,0.9701202949165697,0.19402405898331393
80,경상북도,포항시북구,두호동,두호동제5투,2544,1971,412,1419,116,13,1,1961,10,573,21.009688934217234,72.36104028556859,5.915349311575727,0.6629270780214177,0.05099439061703213
81,경상북도,포항시북구,장량동,관내사전투표,7857,7857,3830,3168,731,72,7,7808,49,0,49.052254098360656,40.57377049180328,9.36219262295082,0.9221311475409836,0.08965163934426229
82,경상북도,포항시북구,장량동,장량동제1투,1589,1204,218,903,69,6,2,1198,6,385,18.196994991652755,75.37562604340567,5.759599332220367,0.5008347245409015,0.1669449081803005
83,경상북도,포항시북구,장량동,장량동제2투,2071,1525,248,1201,58,10,1,1518,7,546,16.337285902503293,79.11725955204216,3.820816864295125,0.6587615283267457,0.06587615283267458
84,경상북도,포항시북구,장량동,장량동제3투,1499,1144,315,743,76,8,0,1142,2,355,27.583187390542907,65.06129597197898,6.654991243432574,0.7005253940455342,0.0
85,경상북도,포항시북구,장량동,장량동제4투,2608,1992,466,1395,105,16,3,1985,7,616,23.476070528967256,70.27707808564232,5.289672544080604,0.8060453400503778,0.15113350125944583
86,경상북도,포항시북구,장량동,장량동제5투,3005,2003,403,1435,145,11,2,1996,7,1002,20.19038076152305,71.8937875751503,7.264529058116233,0.5511022044088176,0.1002004008016032
87,경상북도,포항시북구,장량동,장량동제6투,2847,2282,531,1571,147,13,3,2265,17,565,23.443708609271525,69.3598233995585,6.490066225165562,0.5739514348785872,0.13245033112582782
88,경상북도,포항시북구,장량동,장량동제7투,3433,2123,452,1463,172,22,1,2110,13,1310,21.421800947867297,69.33649289099526,8.151658767772512,1.042654028436019,0.047393364928909956
89,경상북도,포항시북구,장량동,장량동제8투,3382,2583,718,1644,171,34,0,2567,16,799,27.970393455395403,64.04363069731204,6.661472536034281,1.3245033112582782,0.0
90,경상북도,포항시북구,장량동,장량동제9투,3301,2325,540,1586,156,20,2,2304,21,976,23.4375,68.83680555555556,6.770833333333333,0.8680555555555556,0.08680555555555555
91,경상북도,포항시북구,장량동,장량동제10투,2704,2202,607,1407,157,19,1,2191,11,502,27.704244637151987,64.21725239616613,7.165677772706528,0.867183934276586,0.045641259698767686
92,경상북도,포항시북구,장량동,장량동제11투,3067,2088,478,1404,175,18,0,2075,13,979,23.03614457831325,67.66265060240964,8.433734939759036,0.8674698795180723,0.0
93,경상북도,포항시북구,장량동,장량동제12투,3821,2919,848,1818,210,32,1,2909,10,902,29.150910965967686,62.49570299071846,7.218975592987281,1.1000343760742524,0.034376074252320386
94,경상북도,포항시북구,장량동,장량동제13투,2013,1547,385,1033,111,11,0,1540,7,466,25.0,67.07792207792208,7.207792207792208,0.7142857142857143,0.0
95,경상북도,포항시북구,장량동,장량동제14투,2755,2057,568,1294,154,23,1,2040,17,698,27.84313725490196,63.431372549019606,7.549019607843137,1.1274509803921569,0.049019607843137254
96,경상북도,포항시북구,장량동,장량동제15투,2392,1954,558,1207,164,15,2,1946,8,438,28.674203494347378,62.02466598150052,8.427543679342241,0.7708119218910586,0.10277492291880781
97,경상북도,포항시북구,환여동,관내사전투표,1826,1826,800,845,140,27,1,1813,13,0,44.125758411472695,46.607832322118036,7.722007722007722,1.4892443463872034,0.05515719801434087
98,경상북도,포항시북구,환여동,환여동제1투,602,416,45,351,16,1,0,413,3,186,10.895883777239709,84.98789346246973,3.87409200968523,0.24213075060532688,0.0
99,경상북도,포항시북구,환여동,환여동제2투,907,615,80,512,20,2,0,614,1,292,13.029315960912053,83.38762214983714,3.257328990228013,0.32573289902280134,0.0
100,경상북도,포항시북구,환여동,환여동제3투,2657,2026,463,1397,125,24,3,2012,14,631,23.01192842942346,69.43339960238568,6.21272365805169,1.1928429423459244,0.14910536779324055
101,경상북도,포항시북구,환여동,환여동제4투,925,748,192,506,37,9,0,744,4,177,25.806451612903224,68.01075268817203,4.973118279569892,1.2096774193548387,0.0
102,경상북도,포항시북구,잘못 투입·구분된 투표지,,0,0,0,0,0,0,0,0,0,0,0.0,0.0,0.0,0.0,0.0
0,경상북도,포항시남구,거소·선상투표,,319,307,67,170,47,5,3,292,15,12,22.945205479452056,58.21917808219178,16.095890410958905,1.7123287671232876,1.0273972602739725
1,경상북도,포항시남구,관외사전투표,,12297,12294,4324,5899,1764,136,23,12146,148,3,35.60019759591635,48.5674296064548,14.523299851803062,1.1197101926560185,0.18936275316976783
2,경상북도,포항시남구,재외투표,,656,524,307,149,56,9,0,521,3,132,58.92514395393474,28.598848368522074,10.748560460652591,1.727447216890595,0.0
3,경상북도,포항시남구,구룡포읍,관내사전투표,1660,1660,354,1227,54,8,3,1646,14,0,21.506682867557718,74.54434993924666,3.2806804374240586,0.48602673147023084,0.18226002430133656
4,경상북도,포항시남구,구룡포읍,구룡포읍제1투,1945,1259,115,1106,19,9,0,1249,10,686,9.207365892714172,88.55084067253803,1.521216973578863,0.7205764611689351,0.0
5,경상북도,포항시남구,구룡포읍,구룡포읍제2투,940,588,61,505,8,6,1,581,7,352,10.499139414802066,86.91910499139415,1.376936316695353,1.0327022375215147,0.17211703958691912
6,경상북도,포항시남구,구룡포읍,구룡포읍제3투,514,349,26,307,10,1,1,345,4,165,7.536231884057972,88.98550724637681,2.898550724637681,0.2898550724637681,0.2898550724637681
7,경상북도,포항시남구,구룡포읍,구룡포읍제4투,974,577,64,490,17,2,0,573,4,397,11.169284467713787,85.51483420593368,2.966841186736475,0.34904013961605584,0.0
8,경상북도,포항시남구,연일읍,관내사전투표,4215,4215,1725,2120,303,34,4,4186,29,0,41.208791208791204,50.64500716674629,7.238413760152891,0.8122312470138557,0.09555661729574773
9,경상북도,포항시남구,연일읍,연일읍제1투,1509,984,162,775,31,7,1,976,8,525,16.598360655737704,79.40573770491804,3.1762295081967213,0.7172131147540983,0.10245901639344263
10,경상북도,포항시남구,연일읍,연일읍제2투,2182,1503,290,1105,88,13,1,1497,6,679,19.37207748830995,73.81429525718103,5.878423513694055,0.8684034736138945,0.06680026720106881
11,경상북도,포항시남구,연일읍,연일읍제3투,1410,962,160,737,45,7,3,952,10,448,16.80672268907563,77.41596638655463,4.726890756302521,0.7352941176470588,0.31512605042016806
12,경상북도,포항시남구,연일읍,연일읍제4투,2783,1946,466,1369,78,18,1,1932,14,837,24.12008281573499,70.8592132505176,4.037267080745342,0.9316770186335404,0.051759834368530024
13,경상북도,포항시남구,연일읍,연일읍제5투,2293,1720,407,1190,96,14,0,1707,13,573,23.84299941417692,69.71294669009959,5.623901581722319,0.8201523140011716,0.0
14,경상북도,포항시남구,연일읍,연일읍제6투,2687,2125,540,1382,175,19,0,2116,9,562,25.51984877126654,65.31190926275993,8.2703213610586,0.8979206049149339,0.0
15,경상북도,포항시남구,연일읍,연일읍제7투,2681,2135,594,1381,131,22,0,2128,7,546,27.913533834586467,64.89661654135338,6.156015037593985,1.0338345864661653,0.0
16,경상북도,포항시남구,연일읍,연일읍제8투,589,422,65,335,15,3,0,418,4,167,15.550239234449762,80.14354066985646,3.588516746411483,0.7177033492822966,0.0
17,경상북도,포항시남구,연일읍,연일읍제9투,882,642,65,549,19,4,0,637,5,240,10.204081632653061,86.18524332810047,2.9827315541601256,0.6279434850863422,0.0
18,경상북도,포항시남구,오천읍,관내사전투표,8430,8430,3890,3698,693,68,13,8362,68,0,46.51997129873236,44.2238698875867,8.287491030853863,0.8132025831140876,0.15546519971298733
19,경상북도,포항시남구,오천읍,오천읍제1투,3032,1893,513,1202,143,19,1,1878,15,1139,27.316293929712458,64.00425985090521,7.614483493077742,1.0117145899893505,0.05324813631522897
20,경상북도,포항시남구,오천읍,오천읍제2투,1903,1247,200,966,68,7,1,1242,5,656,16.10305958132045,77.77777777777779,5.475040257648954,0.5636070853462157,0.08051529790660225
21,경상북도,포항시남구,오천읍,오천읍제3투,1002,711,131,546,23,4,0,704,7,291,18.607954545454543,77.55681818181817,3.2670454545454546,0.5681818181818182,0.0
22,경상북도,포항시남구,오천읍,오천읍제4투,884,586,112,442,27,4,0,585,1,298,19.14529914529915,75.55555555555556,4.615384615384616,0.6837606837606838,0.0
23,경상북도,포항시남구,오천읍,오천읍제5투,1803,1199,210,920,50,10,0,1190,9,604,17.647058823529413,77.31092436974791,4.201680672268908,0.8403361344537815,0.0
24,경상북도,포항시남구,오천읍,오천읍제6투,1041,694,145,514,26,7,0,692,2,347,20.953757225433524,74.27745664739885,3.7572254335260116,1.0115606936416186,0.0
25,경상북도,포항시남구,오천읍,오천읍제7투,1944,1317,215,1025,53,10,2,1305,12,627,16.47509578544061,78.544061302682,4.061302681992337,0.7662835249042145,0.15325670498084293
26,경상북도,포항시남구,오천읍,오천읍제8투,2713,1896,444,1289,129,24,1,1887,9,817,23.52941176470588,68.30948595654478,6.836248012718602,1.2718600953895072,0.052994170641229466
27,경상북도,포항시남구,오천읍,오천읍제9투,2479,1465,386,948,100,19,3,1456,9,1014,26.51098901098901,65.10989010989012,6.868131868131869,1.304945054945055,0.20604395604395606
28,경상북도,포항시남구,오천읍,오천읍제10투,2668,1881,706,999,139,22,1,1867,14,787,37.814675950723085,53.50830208891269,7.445099089448312,1.1783610069630424,0.05356186395286556
29,경상북도,포항시남구,오천읍,오천읍제11투,1972,1130,310,709,85,16,2,1122,8,842,27.629233511586452,63.190730837789665,7.575757575757576,1.4260249554367201,0.17825311942959002
30,경상북도,포항시남구,오천읍,오천읍제12투,1794,1013,201,716,81,7,2,1007,6,781,19.960278053624627,71.10228401191658,8.04369414101291,0.6951340615690168,0.19860973187686196
31,경상북도,포항시남구,오천읍,오천읍제13투,2249,1490,361,1009,98,11,3,1482,8,759,24.358974358974358,68.08367071524967,6.612685560053981,0.7422402159244265,0.20242914979757085
32,경상북도,포항시남구,오천읍,오천읍제14투,2857,1732,469,1140,103,11,2,1725,7,1125,27.18840579710145,66.08695652173913,5.971014492753623,0.6376811594202898,0.11594202898550725
33,경상북도,포항시남구,오천읍,오천읍제15투,2484,1780,527,1094,126,18,3,1768,12,704,29.807692307692307,61.87782805429865,7.126696832579185,1.0180995475113122,0.16968325791855204
34,경상북도,포항시남구,오천읍,오천읍제16투,2352,1143,257,733,137,4,3,1134,9,1209,22.663139329805997,64.6384479717813,12.081128747795415,0.3527336860670194,0.26455026455026454
35,경상북도,포항시남구,오천읍,오천읍제17투,2402,1805,485,1083,205,21,2,1796,9,597,27.004454342984406,60.30066815144765,11.414253897550111,1.1692650334075725,0.11135857461024498
36,경상북도,포항시남구,대송면,관내사전투표,921,921,304,568,40,3,1,916,5,0,33.18777292576419,62.00873362445415,4.366812227074235,0.32751091703056767,0.10917030567685589
37,경상북도,포항시남구,대송면,대송면제1투,818,586,61,497,18,2,0,578,8,232,10.55363321799308,85.98615916955016,3.1141868512110724,0.34602076124567477,0.0
38,경상북도,포항시남구,대송면,대송면제2투,749,529,61,439,20,5,1,526,3,220,11.596958174904943,83.46007604562737,3.802281368821293,0.9505703422053232,0.19011406844106463
39,경상북도,포항시남구,대송면,대송면제3투,558,396,58,318,17,1,0,394,2,162,14.720812182741117,80.71065989847716,4.314720812182741,0.25380710659898476,0.0
40,경상북도,포항시남구,동해면,관내사전투표,2275,2275,728,1328,162,11,4,2233,42,0,32.60188087774294,59.47156291983878,7.254814151365875,0.49261083743842365,0.17913121361397222
41,경상북도,포항시남구,동해면,동해면제1투,1548,1035,176,802,43,8,1,1030,5,513,17.0873786407767,77.86407766990291,4.174757281553398,0.7766990291262136,0.0970873786407767
42,경상북도,포항시남구,동해면,동해면제2투,314,228,13,210,3,1,0,227,1,86,5.726872246696035,92.51101321585902,1.3215859030837005,0.4405286343612335,0.0
43,경상북도,포항시남구,동해면,동해면제3투,542,384,77,286,16,3,0,382,2,158,20.157068062827225,74.86910994764398,4.18848167539267,0.7853403141361256,0.0
44,경상북도,포항시남구,동해면,동해면제4투,1477,968,123,802,35,4,0,964,4,509,12.759336099585061,83.19502074688798,3.630705394190872,0.4149377593360996,0.0
45,경상북도,포항시남구,동해면,동해면제5투,1766,1232,227,924,62,9,3,1225,7,534,18.53061224489796,75.42857142857143,5.061224489795919,0.7346938775510203,0.24489795918367346
46,경상북도,포항시남구,장기면,관내사전투표,753,753,151,550,36,6,2,745,8,0,20.268456375838927,73.8255033557047,4.832214765100671,0.8053691275167786,0.2684563758389262
47,경상북도,포항시남구,장기면,장기면제1투,858,517,53,445,11,1,2,512,5,341,10.3515625,86.9140625,2.1484375,0.1953125,0.390625
48,경상북도,포항시남구,장기면,장기면제2투,962,638,56,554,20,0,2,632,6,324,8.860759493670885,87.65822784810126,3.1645569620253164,0.0,0.31645569620253167
49,경상북도,포항시남구,장기면,장기면제3투,693,459,40,404,10,0,0,454,5,234,8.81057268722467,88.98678414096916,2.2026431718061676,0.0,0.0
50,경상북도,포항시남구,호미곶면,관내사전투표,533,533,86,422,14,2,0,524,9,0,16.412213740458014,80.53435114503816,2.6717557251908395,0.38167938931297707,0.0
51,경상북도,포항시남구,호미곶면,호미곶면투표소,964,641,54,565,11,4,0,634,7,323,8.517350157728707,89.1167192429022,1.7350157728706623,0.6309148264984227,0.0
52,경상북도,포항시남구,상대동,관내사전투표,3770,3770,1306,2124,286,26,1,3743,27,0,34.891798022976225,56.74592572802565,7.640929735506279,0.6946299759551162,0.02671653753673524
53,경상북도,포항시남구,상대동,상대동제1투,1956,1292,203,1018,59,5,0,1285,7,664,15.797665369649804,79.22178988326849,4.591439688715954,0.38910505836575876,0.0
54,경상북도,포항시남구,상대동,상대동제2투,2268,1458,235,1135,73,9,1,1453,5,810,16.173434273916033,78.11424638678595,5.024088093599449,0.6194081211286993,0.06882312456985547
55,경상북도,포항시남구,상대동,상대동제3투,1795,1247,169,998,58,16,1,1242,5,548,13.607085346215781,80.35426731078906,4.669887278582931,1.288244766505636,0.08051529790660225
56,경상북도,포항시남구,상대동,상대동제4투,1848,1223,215,900,94,11,0,1220,3,625,17.62295081967213,73.77049180327869,7.704918032786885,0.9016393442622952,0.0
57,경상북도,포항시남구,상대동,상대동제5투,1899,1214,166,957,78,8,1,1210,4,685,13.71900826446281,79.0909090909091,6.446280991735537,0.6611570247933884,0.08264462809917356
58,경상북도,포항시남구,상대동,상대동제6투,1874,1269,207,985,50,15,2,1259,10,605,16.441620333598095,78.23669579030977,3.971405877680699,1.1914217633042097,0.15885623510722796
59,경상북도,포항시남구,상대동,상대동제7투,1602,1132,137,928,53,4,2,1124,8,470,12.188612099644129,82.56227758007117,4.715302491103203,0.3558718861209964,0.1779359430604982
60,경상북도,포항시남구,상대동,상대동제8투,2409,1689,225,1388,59,11,1,1684,5,720,13.36104513064133,82.42280285035629,3.503562945368171,0.6532066508313539,0.05938242280285036
61,경상북도,포항시남구,해도동,관내사전투표,2826,2826,867,1809,112,16,2,2806,20,0,30.898075552387738,64.46899501069137,3.9914468995010695,0.5702066999287242,0.07127583749109052
62,경상북도,포항시남구,해도동,해도동제1투,1733,1081,136,897,37,7,2,1079,2,652,12.604263206672844,83.13253012048193,3.429101019462465,0.6487488415199258,0.18535681186283595
63,경상북도,포항시남구,해도동,해도동제2투,982,685,86,579,11,4,0,680,5,297,12.647058823529411,85.1470588235294,1.6176470588235297,0.5882352941176471,0.0
64,경상북도,포항시남구,해도동,해도동제3투,1704,1146,145,951,40,6,0,1142,4,558,12.697022767075305,83.27495621716288,3.502626970227671,0.5253940455341506,0.0
65,경상북도,포항시남구,해도동,해도동제4투,1319,965,109,821,24,8,0,962,3,354,11.33056133056133,85.34303534303534,2.494802494802495,0.8316008316008316,0.0
66,경상북도,포항시남구,해도동,해도동제5투,840,542,78,441,15,4,1,539,3,298,14.471243042671613,81.81818181818183,2.782931354359926,0.7421150278293136,0.1855287569573284
67,경상북도,포항시남구,해도동,해도동제6투,2168,1481,235,1194,39,7,2,1477,4,687,15.910629654705485,80.83953960731212,2.640487474610697,0.47393364928909953,0.13540961408259986
68,경상북도,포항시남구,해도동,해도동제7투,1315,889,149,676,49,8,0,882,7,426,16.89342403628118,76.64399092970523,5.555555555555555,0.9070294784580499,0.0
69,경상북도,포항시남구,해도동,해도동제8투,1351,884,142,697,35,8,0,882,2,467,16.099773242630384,79.02494331065759,3.968253968253968,0.9070294784580499,0.0
70,경상북도,포항시남구,송도동,관내사전투표,2156,2156,568,1480,87,6,3,2144,12,0,26.492537313432834,69.02985074626866,4.057835820895522,0.2798507462686567,0.13992537313432835
71,경상북도,포항시남구,송도동,송도동제1투,1292,862,109,710,34,4,0,857,5,430,12.718786464410737,82.84714119019837,3.9673278879813303,0.4667444574095682,0.0
72,경상북도,포항시남구,송도동,송도동제2투,1303,876,116,719,34,3,1,873,3,427,13.287514318442154,82.35967926689575,3.8946162657502863,0.3436426116838488,0.11454753722794961
73,경상북도,포항시남구,송도동,송도동제3투,1624,1105,146,924,24,4,0,1098,7,519,13.296903460837886,84.15300546448088,2.185792349726776,0.36429872495446264,0.0
74,경상북도,포항시남구,송도동,송도동제4투,2045,1500,180,1253,48,9,3,1493,7,545,12.056262558606832,83.92498325519088,3.2150033489618215,0.6028131279303416,0.20093770931011384
75,경상북도,포항시남구,송도동,송도동제5투,1330,916,101,783,24,6,0,914,2,414,11.050328227571116,85.66739606126916,2.62582056892779,0.6564551422319475,0.0
76,경상북도,포항시남구,청림동,관내사전투표,1138,1138,366,598,148,12,1,1125,13,0,32.53333333333333,53.15555555555556,13.155555555555557,1.0666666666666667,0.08888888888888889
77,경상북도,포항시남구,청림동,청림동제1투,695,489,71,352,59,3,0,485,4,206,14.63917525773196,72.57731958762886,12.164948453608247,0.6185567010309279,0.0
78,경상북도,포항시남구,청림동,청림동제2투,1581,1028,207,762,44,6,0,1019,9,553,20.31403336604514,74.77919528949951,4.317958783120707,0.5888125613346418,0.0
79,경상북도,포항시남구,청림동,청림동제3투,807,571,96,433,33,7,0,569,2,236,16.87170474516696,76.09841827768014,5.799648506151142,1.2302284710017575,0.0
80,경상북도,포항시남구,제철동,관내사전투표,1311,1311,572,532,175,23,0,1302,9,0,43.93241167434716,40.86021505376344,13.440860215053762,1.7665130568356373,0.0
81,경상북도,포항시남구,제철동,제철동투표소,1414,947,168,697,63,10,1,939,8,467,17.89137380191693,74.22790202342918,6.7092651757188495,1.0649627263045793,0.10649627263045794
82,경상북도,포항시남구,효곡동,관내사전투표,5662,5662,2774,1934,820,87,4,5619,43,0,49.36821498487276,34.41893575369283,14.593344011389927,1.5483182060864922,0.07118704395799964
83,경상북도,포항시남구,효곡동,효곡동제1투,1995,1431,272,1022,119,10,1,1424,7,564,19.101123595505616,71.76966292134831,8.356741573033707,0.7022471910112359,0.0702247191011236
84,경상북도,포항시남구,효곡동,효곡동제2투,1914,1458,404,901,126,18,0,1449,9,456,27.881297446514836,62.180814354727396,8.695652173913043,1.2422360248447204,0.0
85,경상북도,포항시남구,효곡동,효곡동제3투,2076,1682,466,1057,129,18,1,1671,11,394,27.88749251944943,63.25553560742071,7.719928186714542,1.0771992818671454,0.059844404548174746
86,경상북도,포항시남구,효곡동,효곡동제4투,2327,1893,544,1188,133,21,0,1886,7,434,28.844114528101805,62.990455991516434,7.0519618239660655,1.1134676564156947,0.0
87,경상북도,포항시남구,효곡동,효곡동제5투,2201,1769,527,1048,156,29,2,1762,7,432,29.909194097616343,59.47786606129398,8.853575482406356,1.6458569807037458,0.11350737797956867
88,경상북도,포항시남구,효곡동,효곡동제6투,1944,1592,487,932,144,18,1,1582,10,352,30.78381795195955,58.91276864728192,9.102402022756005,1.1378002528445006,0.06321112515802782
89,경상북도,포항시남구,효곡동,효곡동제7투,2894,2230,561,1394,243,25,0,2223,7,664,25.236167341430498,62.7080521817364,10.931174089068826,1.1246063877642825,0.0
90,경상북도,포항시남구,대이동,관내사전투표,3710,3710,1713,1544,376,43,3,3679,31,0,46.56156564283773,41.967926066866,10.220168524055449,1.1687958684425115,0.08154389779831477
91,경상북도,포항시남구,대이동,대이동제1투,1276,938,219,637,72,6,0,934,4,338,23.447537473233403,68.20128479657387,7.708779443254818,0.6423982869379015,0.0
92,경상북도,포항시남구,대이동,대이동제2투,1938,1427,286,1013,107,12,0,1418,9,511,20.16925246826516,71.43864598025388,7.5458392101551475,0.846262341325811,0.0
93,경상북도,포항시남구,대이동,대이동제3투,1341,976,228,658,73,13,0,972,4,365,23.456790123456788,67.6954732510288,7.510288065843622,1.337448559670782,0.0
94,경상북도,포항시남구,대이동,대이동제4투,1740,1137,229,796,99,5,2,1131,6,603,20.247568523430594,70.38019451812555,8.753315649867375,0.4420866489832007,0.17683465959328026
95,경상북도,포항시남구,대이동,대이동제5투,2435,1846,459,1230,129,18,1,1837,9,589,24.986390854654328,66.95699510070767,7.022318998366902,0.979858464888405,0.05443658138268917
96,경상북도,포항시남구,대이동,대이동제6투,2726,2013,531,1301,151,16,0,1999,14,713,26.563281640820406,65.08254127063532,7.553776888444222,0.80040020010005,0.0
97,경상북도,포항시남구,대이동,대이동제7투,2353,1953,500,1188,227,26,2,1943,10,400,25.73340195573855,61.142563046834795,11.6829644879053,1.3381369016984046,0.1029336078229542
98,경상북도,포항시남구,잘못 투입·구분된 투표지,,0,0,0,0,0,0,0,0,0,0,0.0,0.0,0.0,0.0,0.0
0,경상북도,울릉군,거소·선상투표,,29,29,3,17,6,0,0,26,3,0,11.538461538461538,65.38461538461539,23.076923076923077,0.0,0.0
1,경상북도,울릉군,관외사전투표,,1373,1373,470,757,129,7,1,1364,9,0,34.457478005865106,55.49853372434017,9.457478005865102,0.5131964809384164,0.07331378299120235
2,경상북도,울릉군,재외투표,,15,11,8,3,0,0,0,11,0,4,72.72727272727273,27.27272727272727,0.0,0.0,0.0
3,경상북도,울릉군,울릉읍,관내사전투표,1405,1405,562,715,108,6,0,1391,14,0,40.402588066139465,51.4018691588785,7.764198418404026,0.4313443565780014,0.0
4,경상북도,울릉군,울릉읍,울릉읍제1투,1267,785,137,594,40,4,2,777,8,482,17.63191763191763,76.44787644787645,5.148005148005148,0.5148005148005148,0.2574002574002574
5,경상북도,울릉군,울릉읍,울릉읍제2투,1646,1081,177,851,41,5,0,1074,7,565,16.480446927374302,79.2364990689013,3.8175046554934826,0.4655493482309125,0.0
6,경상북도,울릉군,울릉읍,울릉읍제3투,463,274,56,198,19,0,0,273,1,189,20.51282051282051,72.52747252747253,6.95970695970696,0.0,0.0
7,경상북도,울릉군,서면,관내사전투표,382,382,119,229,31,1,0,380,2,0,31.31578947368421,60.26315789473684,8.157894736842106,0.2631578947368421,0.0
8,경상북도,울릉군,서면,서면제1투,488,343,45,275,19,1,1,341,2,145,13.196480938416421,80.64516129032258,5.571847507331378,0.2932551319648094,0.2932551319648094
9,경상북도,울릉군,서면,서면제2투,286,204,31,165,3,0,1,200,4,82,15.5,82.5,1.5,0.0,0.5
10,경상북도,울릉군,북면,관내사전투표,396,396,140,217,34,4,0,395,1,0,35.44303797468354,54.936708860759495,8.60759493670886,1.0126582278481013,0.0
11,경상북도,울릉군,북면,북면제1투,368,226,40,170,12,1,0,223,3,142,17.937219730941703,76.23318385650224,5.381165919282512,0.4484304932735426,0.0
12,경상북도,울릉군,북면,북면제2투,294,207,26,160,12,1,0,199,8,87,13.06532663316583,80.40201005025126,6.030150753768844,0.5025125628140703,0.0
13,경상북도,울릉군,잘못 투입·구분된 투표지,,0,0,0,0,0,0,0,0,0,0,0.0,0.0,0.0,0.0,0.0
0,경상북도,경주시,거소·선상투표,,461,440,96,236,56,6,6,400,40,21,24.0,59.0,14.000000000000002,1.5,1.5
1,경상북도,경주시,관외사전투표,,14111,14108,5182,6639,1949,176,21,13967,141,3,37.101739815278876,47.53347175485072,13.954320899262548,1.2601131237917949,0.15035440681606646
2,경상북도,경주시,재외투표,,995,730,420,202,89,12,1,724,6,265,58.011049723756905,27.900552486187845,12.292817679558011,1.6574585635359116,0.13812154696132595
3,경상북도,경주시,감포읍,관내사전투표,1341,1341,321,949,49,9,1,1329,12,0,24.153498871331827,71.40707298720844,3.6869826937547026,0.6772009029345373,0.07524454477050413
4,경상북도,경주시,감포읍,감포읍제1투,1790,996,114,845,24,3,1,987,9,794,11.55015197568389,85.612968591692,2.43161094224924,0.303951367781155,0.10131712259371835
5,경상북도,경주시,감포읍,감포읍제2투,1125,697,94,578,13,0,2,687,10,428,13.682678311499272,84.13391557496361,1.8922852983988356,0.0,0.2911208151382824
6,경상북도,경주시,안강읍,관내사전투표,4847,4846,1548,2945,247,66,3,4809,37,1,32.18964441671866,61.23934289873154,5.13620295279684,1.372426699937617,0.06238303181534623
7,경상북도,경주시,안강읍,안강읍제1투,1741,1107,110,941,31,18,0,1100,7,634,10.0,85.54545454545455,2.8181818181818183,1.6363636363636365,0.0
8,경상북도,경주시,안강읍,안강읍제2투,2543,1695,218,1416,45,10,0,1689,6,848,12.90704558910598,83.83658969804618,2.664298401420959,0.5920663114268798,0.0
9,경상북도,경주시,안강읍,안강읍제3투,892,599,75,501,13,5,2,596,3,293,12.583892617449665,84.06040268456377,2.1812080536912752,0.8389261744966443,0.33557046979865773
10,경상북도,경주시,안강읍,안강읍제4투,3152,2197,393,1685,81,20,0,2179,18,955,18.035796236805872,77.3290500229463,3.7173015144561727,0.9178522257916476,0.0
11,경상북도,경주시,안강읍,안강읍제5투,2311,1520,264,1124,103,24,1,1516,4,791,17.41424802110818,74.14248021108179,6.794195250659631,1.58311345646438,0.06596306068601583
12,경상북도,경주시,안강읍,안강읍제6투,2474,1768,390,1244,97,24,3,1758,10,706,22.18430034129693,70.76222980659841,5.517633674630262,1.3651877133105803,0.17064846416382254
13,경상북도,경주시,안강읍,안강읍제7투,1087,793,115,643,25,9,0,792,1,294,14.520202020202019,81.18686868686868,3.1565656565656566,1.1363636363636365,0.0
14,경상북도,경주시,건천읍,관내사전투표,2834,2834,895,1721,170,22,5,2813,21,0,31.81656594383221,61.18023462495557,6.043370067543548,0.7820831852115179,0.17774617845716317
15,경상북도,경주시,건천읍,건천읍제1투,2258,1488,187,1248,38,4,3,1480,8,770,12.635135135135133,84.32432432432432,2.5675675675675675,0.2702702702702703,0.20270270270270271
16,경상북도,경주시,건천읍,건천읍제2투,1589,980,124,814,30,8,0,976,4,609,12.704918032786885,83.40163934426229,3.0737704918032787,0.819672131147541,0.0
17,경상북도,경주시,건천읍,건천읍제3투,3655,2522,496,1820,160,29,5,2510,12,1133,19.760956175298805,72.50996015936255,6.374501992031872,1.1553784860557768,0.199203187250996
18,경상북도,경주시,외동읍,관내사전투표,3397,3397,1459,1660,211,45,4,3379,18,0,43.178455164249776,49.12696063924238,6.244451021012134,1.331754957087896,0.11837821840781297
19,경상북도,경주시,외동읍,외동읍제1투,1699,1049,206,789,40,10,1,1046,3,650,19.694072657743785,75.4302103250478,3.824091778202677,0.9560229445506693,0.09560229445506692
20,경상북도,경주시,외동읍,외동읍제2투,1966,1361,336,936,61,22,0,1355,6,605,24.797047970479706,69.07749077490774,4.501845018450185,1.6236162361623614,0.0
21,경상북도,경주시,외동읍,외동읍제3투,1017,647,130,488,19,3,3,643,4,370,20.21772939346812,75.89424572317263,2.9548989113530326,0.46656298600311047,0.46656298600311047
22,경상북도,경주시,외동읍,외동읍제4투,1278,832,128,665,30,4,0,827,5,446,15.4776299879081,80.41112454655381,3.6275695284159615,0.48367593712212814,0.0
23,경상북도,경주시,외동읍,외동읍제5투,1463,995,147,792,32,12,0,983,12,468,14.954221770091555,80.56968463886062,3.255340793489318,1.2207527975584944,0.0
24,경상북도,경주시,외동읍,외동읍제6투,2251,1375,327,937,86,12,2,1364,11,876,23.97360703812317,68.69501466275659,6.3049853372434015,0.8797653958944283,0.1466275659824047
25,경상북도,경주시,외동읍,외동읍제7투,2298,1643,614,854,141,22,1,1632,11,655,37.622549019607845,52.32843137254902,8.63970588235294,1.3480392156862746,0.061274509803921566
26,경상북도,경주시,외동읍,외동읍제8투,1869,1437,515,785,110,16,2,1428,9,432,36.06442577030812,54.971988795518214,7.703081232492997,1.1204481792717087,0.1400560224089636
27,경상북도,경주시,문무대왕면,관내사전투표,1263,1263,347,781,108,8,2,1246,17,0,27.84911717495987,62.68057784911717,8.667736757624397,0.6420545746388443,0.16051364365971107
28,경상북도,경주시,문무대왕면,문무대왕면투표소,2204,1434,155,1192,72,6,1,1426,8,770,10.869565217391305,83.59046283309958,5.049088359046284,0.42075736325385693,0.07012622720897616
29,경상북도,경주시,양남면,관내사전투표,1710,1710,624,944,100,23,0,1691,19,0,36.90124186871673,55.82495564754583,5.913660555884092,1.360141927853341,0.0
30,경상북도,경주시,양남면,양남면제1투,1946,1248,177,1028,29,6,2,1242,6,698,14.251207729468598,82.76972624798712,2.3349436392914655,0.4830917874396135,0.1610305958132045
31,경상북도,경주시,양남면,양남면제2투,1476,1025,204,726,79,7,1,1017,8,451,20.058997050147493,71.38643067846607,7.767944936086529,0.688298918387414,0.09832841691248771
32,경상북도,경주시,내남면,관내사전투표,1382,1382,431,860,63,12,1,1367,15,0,31.52889539136796,62.91148500365764,4.6086320409656185,0.8778346744696415,0.0731528895391368
33,경상북도,경주시,내남면,내남면투표소,2610,1754,234,1439,58,14,1,1746,8,856,13.402061855670103,82.41695303550974,3.3218785796105386,0.8018327605956471,0.057273768613974804
34,경상북도,경주시,산내면,관내사전투표,931,931,250,618,44,6,0,918,13,0,27.233115468409586,67.3202614379085,4.793028322440087,0.6535947712418301,0.0
35,경상북도,경주시,산내면,산내면투표소,1676,1056,124,891,21,12,0,1048,8,620,11.83206106870229,85.01908396946564,2.0038167938931295,1.1450381679389312,0.0
36,경상북도,경주시,서면,관내사전투표,870,870,258,550,39,11,3,861,9,0,29.965156794425084,63.879210220673635,4.529616724738676,1.2775842044134729,0.34843205574912894
37,경상북도,경주시,서면,서면투표소,1828,1255,139,1082,22,3,1,1247,8,573,11.146752205292703,86.7682437850842,1.7642341619887731,0.24057738572574178,0.08019246190858059
38,경상북도,경주시,현곡면,관내사전투표,3497,3497,1586,1553,259,73,6,3477,20,0,45.614035087719294,44.664941041127406,7.448950244463617,2.099511072763877,0.1725625539257981
39,경상북도,경주시,현곡면,현곡면제1투,1238,888,199,627,44,15,1,886,2,350,22.460496613995485,70.76749435665914,4.966139954853273,1.6930022573363432,0.1128668171557562
40,경상북도,경주시,현곡면,현곡면제2투,2648,2099,544,1374,124,35,1,2078,21,549,26.179018286814244,66.12127045235803,5.9672762271414825,1.6843118383060636,0.04812319538017325
41,경상북도,경주시,현곡면,현곡면제3투,2552,1870,422,1306,105,21,1,1855,15,682,22.749326145552562,70.4043126684636,5.660377358490567,1.1320754716981132,0.05390835579514825
42,경상북도,경주시,현곡면,현곡면제4투,2618,1926,338,1435,117,21,2,1913,13,692,17.66858337689493,75.01306847882906,6.1160480920020905,1.097752221641401,0.10454783063251437
43,경상북도,경주시,현곡면,현곡면제5투,3141,2606,745,1537,241,66,4,2593,13,535,28.73119938295411,59.27497107597377,9.294253760123409,2.545314307751639,0.15426147319706904
44,경상북도,경주시,강동면,관내사전투표,1456,1456,477,877,74,15,0,1443,13,0,33.056133056133056,60.77616077616078,5.128205128205128,1.0395010395010396,0.0
45,경상북도,경주시,강동면,강동면투표소,3578,2398,331,1949,88,19,2,2389,9,1180,13.855169526998745,81.58225198827962,3.683549602344077,0.7953118459606531,0.08371703641691085
46,경상북도,경주시,천북면,관내사전투표,1804,1804,653,999,112,22,1,1787,17,0,36.54168998321209,55.903749300503634,6.267487409065472,1.2311135982092893,0.05595970900951316
47,경상북도,경주시,천북면,천북면제1투,2490,1678,236,1319,96,20,0,1671,7,812,14.12327947336924,78.93476959904248,5.745062836624776,1.196888090963495,0.0
48,경상북도,경주시,천북면,천북면제2투,807,575,92,456,18,6,0,572,3,232,16.083916083916083,79.72027972027972,3.146853146853147,1.048951048951049,0.0
49,경상북도,경주시,중부동,관내사전투표,1543,1543,514,884,108,21,2,1529,14,0,33.616742969260955,57.8155657292348,7.063440156965337,1.3734466971877044,0.13080444735120994
50,경상북도,경주시,중부동,중부동제1투,1543,1023,151,830,29,7,0,1017,6,520,14.847590953785645,81.61258603736479,2.8515240904621435,0.688298918387414,0.0
51,경상북도,경주시,중부동,중부동제2투,1495,1076,118,915,27,7,0,1067,9,419,11.059044048734771,85.75445173383318,2.530459231490159,0.6560449859418931,0.0
52,경상북도,경주시,황오동,관내사전투표,2124,2124,653,1300,126,27,3,2109,15,0,30.962541488857276,61.64058795637744,5.974395448079658,1.2802275960170697,0.1422475106685633
53,경상북도,경주시,황오동,황오동제1투,2013,1392,160,1165,51,7,1,1384,8,621,11.560693641618498,84.17630057803468,3.6849710982658963,0.5057803468208093,0.0722543352601156
54,경상북도,경주시,황오동,황오동제2투,1635,1134,145,946,29,10,1,1131,3,501,12.82051282051282,83.64279398762157,2.564102564102564,0.8841732979664014,0.08841732979664013
55,경상북도,경주시,성건동,관내사전투표,2960,2960,1089,1628,184,35,2,2938,22,0,37.066031313818925,55.41184479237577,6.262763784887679,1.191286589516678,0.06807351940095302
56,경상북도,경주시,성건동,성건동제1투,1837,1260,153,1047,46,9,0,1255,5,577,12.191235059760956,83.42629482071713,3.6653386454183265,0.7171314741035857,0.0
57,경상북도,경주시,성건동,성건동제2투,2100,1487,170,1237,52,11,1,1471,16,613,11.556764106050306,84.0924541128484,3.5350101971447994,0.7477906186267845,0.06798096532970768
58,경상북도,경주시,성건동,성건동제3투,1920,1348,161,1115,52,14,2,1344,4,572,11.979166666666668,82.96130952380952,3.869047619047619,1.0416666666666665,0.1488095238095238
59,경상북도,경주시,성건동,성건동제4투,2677,1729,293,1288,126,14,2,1723,6,948,17.005223447475334,74.75333720255368,7.312826465467208,0.812536273940801,0.11607661056297155
60,경상북도,경주시,황남동,관내사전투표,1274,1274,435,739,70,18,0,1262,12,0,34.46909667194929,58.55784469096672,5.54675118858954,1.4263074484944533,0.0
61,경상북도,경주시,황남동,황남동투표소,2410,1587,174,1356,39,10,1,1580,7,823,11.012658227848101,85.82278481012658,2.4683544303797467,0.6329113924050633,0.06329113924050633
62,경상북도,경주시,월성동,관내사전투표,1146,1146,419,616,86,16,0,1137,9,0,36.85136323658751,54.177660510114336,7.563764291996482,1.4072119613016711,0.0
63,경상북도,경주시,월성동,월성동제1투,1207,825,98,693,23,4,0,818,7,382,11.98044009779951,84.71882640586797,2.8117359413202934,0.4889975550122249,0.0
64,경상북도,경주시,월성동,월성동제2투,2101,1559,289,1186,58,17,0,1550,9,542,18.64516129032258,76.51612903225806,3.741935483870968,1.096774193548387,0.0
65,경상북도,경주시,선도동,관내사전투표,3360,3360,1515,1515,246,60,4,3340,20,0,45.359281437125745,45.359281437125745,7.365269461077845,1.7964071856287425,0.11976047904191617
66,경상북도,경주시,선도동,선도동제1투,2329,1544,242,1202,80,13,0,1537,7,785,15.744957709824334,78.2042940793754,5.204944697462589,0.8458035133376708,0.0
67,경상북도,경주시,선도동,선도동제2투,3204,2229,465,1596,121,32,0,2214,15,975,21.00271002710027,72.08672086720867,5.4652213188798555,1.4453477868112015,0.0
68,경상북도,경주시,선도동,선도동제3투,2206,1480,264,1108,86,14,2,1474,6,726,17.91044776119403,75.1696065128901,5.834464043419267,0.9497964721845319,0.13568521031207598
69,경상북도,경주시,용강동,관내사전투표,2991,2991,1445,1200,248,76,3,2972,19,0,48.620457604306864,40.376850605652756,8.344549125168237,2.557200538358008,0.1009421265141319
70,경상북도,경주시,용강동,용강동제1투,4150,2912,589,2091,175,38,2,2895,17,1238,20.345423143350605,72.2279792746114,6.0449050086355784,1.3126079447322971,0.0690846286701209
71,경상북도,경주시,용강동,용강동제2투,4645,3541,1124,2032,300,67,4,3527,14,1104,31.86844343634817,57.61270201304225,8.505812305075136,1.8996314148001132,0.11341083073433512
72,경상북도,경주시,용강동,용강동제3투,2198,1670,321,1243,67,21,1,1653,17,528,19.419237749546276,75.19661222020568,4.053236539624924,1.2704174228675136,0.06049606775559589
73,경상북도,경주시,용강동,용강동제4투,2530,1918,420,1354,103,28,0,1905,13,612,22.04724409448819,71.0761154855643,5.406824146981627,1.4698162729658792,0.0
74,경상북도,경주시,황성동,관내사전투표,6722,6722,3238,2796,513,138,5,6690,32,0,48.40059790732437,41.79372197309417,7.668161434977579,2.062780269058296,0.07473841554559044
75,경상북도,경주시,황성동,황성동제1투,3494,2516,520,1804,143,39,0,2506,10,978,20.75019952114924,71.98723064644852,5.706304868316042,1.5562649640861932,0.0
76,경상북도,경주시,황성동,황성동제2투,2141,1614,314,1184,83,25,0,1606,8,527,19.551681195516814,73.72353673723536,5.168119551681196,1.5566625155666252,0.0
77,경상북도,경주시,황성동,황성동제3투,2585,1870,420,1268,133,33,2,1856,14,715,22.629310344827587,68.31896551724138,7.165948275862069,1.7780172413793105,0.10775862068965517
78,경상북도,경주시,황성동,황성동제4투,2482,1787,398,1223,103,44,1,1769,18,695,22.498586772187675,69.1351045788581,5.822498586772188,2.4872809496890897,0.05652911249293386
79,경상북도,경주시,황성동,황성동제5투,2432,1759,358,1249,113,30,1,1751,8,673,20.445459737292975,71.33066818960594,6.453455168475157,1.7133066818960592,0.05711022272986865
80,경상북도,경주시,황성동,황성동제6투,1784,1283,225,957,70,24,0,1276,7,501,17.63322884012539,75.0,5.4858934169279,1.8808777429467085,0.0
81,경상북도,경주시,동천동,관내사전투표,4672,4672,1723,2471,350,86,4,4634,38,0,37.181700474751835,53.32326283987915,7.552870090634441,1.855848079413034,0.08631851532153648
82,경상북도,경주시,동천동,동천동제1투,1653,1115,128,924,49,10,0,1111,4,538,11.521152115211521,83.16831683168317,4.41044104410441,0.9000900090009001,0.0
83,경상북도,경주시,동천동,동천동제2투,2169,1663,283,1265,81,25,1,1655,8,506,17.099697885196374,76.43504531722054,4.8942598187311175,1.5105740181268883,0.060422960725075525
84,경상북도,경주시,동천동,동천동제3투,2309,1593,264,1246,64,11,2,1587,6,716,16.6351606805293,78.51291745431632,4.0327662255828605,0.6931316950220542,0.1260239445494644
85,경상북도,경주시,동천동,동천동제4투,2047,1396,252,1055,70,9,1,1387,9,651,18.16870944484499,76.06344628695025,5.046863734679164,0.6488824801730353,0.07209805335255948
86,경상북도,경주시,동천동,동천동제5투,2392,1703,269,1332,74,21,0,1696,7,689,15.860849056603774,78.5377358490566,4.363207547169811,1.2382075471698113,0.0
87,경상북도,경주시,동천동,동천동제6투,2183,1578,295,1188,75,13,1,1572,6,605,18.765903307888042,75.57251908396947,4.770992366412214,0.826972010178117,0.06361323155216285
88,경상북도,경주시,불국동,관내사전투표,3190,3190,1182,1779,178,31,0,3170,20,0,37.28706624605678,56.1198738170347,5.615141955835963,0.9779179810725551,0.0
89,경상북도,경주시,불국동,불국동제1투,2621,1627,269,1272,68,13,1,1623,4,994,16.574245224892177,78.37338262476895,4.18977202711029,0.8009858287122612,0.06161429451632779
90,경상북도,경주시,불국동,불국동제2투,2716,1885,295,1475,74,20,7,1871,14,831,15.766969535008016,78.83484767504008,3.955104222340994,1.0689470871191877,0.3741314804917157
91,경상북도,경주시,보덕동,관내사전투표,1056,1056,364,576,88,20,0,1048,8,0,34.73282442748092,54.961832061068705,8.396946564885496,1.9083969465648856,0.0
92,경상북도,경주시,보덕동,보덕동투표소,905,610,80,494,29,2,2,607,3,295,13.179571663920923,81.38385502471169,4.7775947281713345,0.3294892915980231,0.3294892915980231
93,경상북도,경주시,잘못 투입·구분된 투표지,,0,0,0,0,0,0,0,0,0,0,0.0,0.0,0.0,0.0,0.0
0,경상북도,김천시,거소·선상투표,,299,284,70,161,28,7,5,271,13,15,25.830258302583026,59.40959409594095,10.33210332103321,2.5830258302583027,1.8450184501845017
1,경상북도,김천시,관외사전투표,,7779,7777,2705,3795,1102,81,15,7698,79,2,35.13899714211484,49.29851909586906,14.315406599116653,1.0522213561964147,0.19485580670303976
2,경상북도,김천시,재외투표,,622,401,202,143,48,6,0,399,2,221,50.6265664160401,35.83959899749373,12.030075187969924,1.5037593984962405,0.0
3,경상북도,김천시,아포읍,관내사전투표,2024,2024,606,1306,90,5,0,2007,17,0,30.194319880418536,65.07224713502741,4.484304932735426,0.2491280518186348,0.0
4,경상북도,김천시,아포읍,아포읍제1투,966,636,53,555,19,3,1,631,5,330,8.399366085578446,87.95562599049128,3.011093502377179,0.4754358161648178,0.15847860538827258
5,경상북도,김천시,아포읍,아포읍제2투,881,602,38,549,14,1,0,602,0,279,6.312292358803987,91.19601328903654,2.3255813953488373,0.16611295681063123,0.0
6,경상북도,김천시,아포읍,아포읍제3투,2887,1923,278,1523,99,14,1,1915,8,964,14.516971279373367,79.53002610966058,5.169712793733681,0.7310704960835509,0.05221932114882506
7,경상북도,김천시,농소면,관내사전투표,1046,1046,382,581,63,15,1,1042,4,0,36.660268714011515,55.75815738963532,6.046065259117082,1.4395393474088292,0.09596928982725528
8,경상북도,김천시,농소면,농소면제1투,979,667,80,561,21,1,0,663,4,312,12.066365007541478,84.61538461538461,3.167420814479638,0.1508295625942685,0.0
9,경상북도,김천시,농소면,농소면제2투,841,605,113,469,15,3,0,600,5,236,18.833333333333332,78.16666666666666,2.5,0.5,0.0
10,경상북도,김천시,남면,관내사전투표,827,827,284,475,58,4,0,821,6,0,34.59196102314251,57.85627283800243,7.064555420219245,0.48721071863580995,0.0
11,경상북도,김천시,남면,남면제1투,991,638,72,539,21,1,0,633,5,353,11.374407582938389,85.15007898894154,3.3175355450236967,0.1579778830963665,0.0
12,경상북도,김천시,남면,남면제2투,761,528,63,448,8,3,0,522,6,233,12.068965517241379,85.82375478927203,1.532567049808429,0.5747126436781609,0.0
13,경상북도,김천시,개령면,관내사전투표,683,683,151,478,41,5,2,677,6,0,22.304283604135893,70.60561299852289,6.056129985228951,0.7385524372230428,0.29542097488921715
14,경상북도,김천시,개령면,개령면투표소,1383,1000,90,878,23,6,0,997,3,383,9.027081243731194,88.06419257773321,2.3069207622868606,0.6018054162487462,0.0
15,경상북도,김천시,감문면,관내사전투표,969,969,170,753,34,5,0,962,7,0,17.671517671517673,78.27442827442827,3.5343035343035343,0.5197505197505198,0.0
16,경상북도,김천시,감문면,감문면제1투,959,593,83,482,19,3,0,587,6,366,14.139693356047701,82.11243611584327,3.2367972742759794,0.5110732538330494,0.0
17,경상북도,김천시,감문면,감문면제2투,779,570,40,502,21,4,1,568,2,209,7.042253521126761,88.38028169014085,3.697183098591549,0.7042253521126761,0.17605633802816903
18,경상북도,김천시,어모면,관내사전투표,1390,1390,398,859,109,12,1,1379,11,0,28.861493836113127,62.29151559100797,7.904278462654098,0.8701957940536621,0.0725163161711385
19,경상북도,김천시,어모면,어모면제1투,1323,884,111,732,31,4,0,878,6,439,12.64236902050114,83.37129840546697,3.530751708428246,0.45558086560364464,0.0
20,경상북도,김천시,어모면,어모면제2투,1018,624,53,543,18,1,1,616,8,394,8.603896103896105,88.14935064935064,2.922077922077922,0.16233766233766234,0.16233766233766234
21,경상북도,김천시,봉산면,관내사전투표,1221,1221,396,734,68,10,3,1211,10,0,32.70024772914946,60.611065235342686,5.615194054500413,0.8257638315441783,0.2477291494632535
22,경상북도,김천시,봉산면,봉산면제1투,951,668,79,563,18,2,0,662,6,283,11.933534743202417,85.04531722054381,2.719033232628399,0.3021148036253776,0.0
23,경상북도,김천시,봉산면,봉산면제2투,768,565,67,472,21,0,0,560,5,203,11.964285714285715,84.28571428571429,3.75,0.0,0.0
24,경상북도,김천시,대항면,관내사전투표,842,842,218,583,31,3,0,835,7,0,26.107784431137727,69.82035928143713,3.7125748502994016,0.3592814371257485,0.0
25,경상북도,김천시,대항면,대항면제1투,1085,709,82,594,24,3,0,703,6,376,11.66429587482219,84.4950213371266,3.4139402560455197,0.42674253200568996,0.0
26,경상북도,김천시,대항면,대항면제2투,908,696,93,568,26,4,1,692,4,212,13.439306358381502,82.08092485549133,3.7572254335260116,0.5780346820809248,0.1445086705202312
27,경상북도,김천시,감천면,관내사전투표,681,681,186,452,29,4,2,673,8,0,27.637444279346212,67.16196136701336,4.3090638930163445,0.5943536404160475,0.2971768202080238
28,경상북도,김천시,감천면,감천면투표소,1059,739,67,645,21,4,1,738,1,320,9.078590785907858,87.39837398373984,2.8455284552845526,0.5420054200542005,0.13550135501355012
29,경상북도,김천시,조마면,관내사전투표,797,797,165,585,28,8,0,786,11,0,20.99236641221374,74.42748091603053,3.5623409669211195,1.0178117048346056,0.0
30,경상북도,김천시,조마면,조마면투표소,961,604,39,539,22,2,0,602,2,357,6.4784053156146175,89.53488372093024,3.6544850498338874,0.33222591362126247,0.0
31,경상북도,김천시,구성면,관내사전투표,798,798,170,594,29,1,0,794,4,0,21.41057934508816,74.81108312342569,3.6523929471032743,0.12594458438287154,0.0
32,경상북도,김천시,구성면,구성면제1투,809,552,60,478,9,0,2,549,3,257,10.92896174863388,87.06739526411657,1.639344262295082,0.0,0.36429872495446264
33,경상북도,김천시,구성면,구성면제2투,646,427,35,379,5,1,1,421,6,219,8.31353919239905,90.02375296912113,1.187648456057007,0.23752969121140144,0.23752969121140144
34,경상북도,김천시,지례면,관내사전투표,512,512,138,340,27,3,0,508,4,0,27.165354330708663,66.92913385826772,5.31496062992126,0.5905511811023622,0.0
35,경상북도,김천시,지례면,지례면제1투,605,429,47,361,12,3,2,425,4,176,11.058823529411764,84.94117647058823,2.823529411764706,0.7058823529411765,0.4705882352941176
36,경상북도,김천시,지례면,지례면제2투,234,174,25,139,4,2,0,170,4,60,14.705882352941178,81.76470588235294,2.3529411764705883,1.1764705882352942,0.0
37,경상북도,김천시,부항면,관내사전투표,383,383,77,289,10,3,0,379,4,0,20.316622691292878,76.2532981530343,2.638522427440633,0.79155672823219,0.0
38,경상북도,김천시,부항면,부항면투표소,587,368,35,307,19,2,0,363,5,219,9.641873278236915,84.57300275482093,5.234159779614325,0.5509641873278237,0.0
39,경상북도,김천시,대덕면,관내사전투표,564,564,125,405,24,9,0,563,1,0,22.202486678507995,71.93605683836589,4.262877442273535,1.5985790408525755,0.0
40,경상북도,김천시,대덕면,대덕면투표소,1059,660,73,564,15,3,3,658,2,399,11.094224924012158,85.71428571428571,2.2796352583586628,0.4559270516717325,0.4559270516717325
41,경상북도,김천시,증산면,관내사전투표,375,375,80,265,19,4,1,369,6,0,21.680216802168022,71.81571815718158,5.149051490514905,1.084010840108401,0.27100271002710025
42,경상북도,김천시,증산면,증산면투표소,442,307,39,257,7,0,1,304,3,135,12.828947368421053,84.53947368421053,2.302631578947368,0.0,0.3289473684210526
43,경상북도,김천시,자산동,관내사전투표,1927,1927,541,1258,106,11,0,1916,11,0,28.235908141962422,65.65762004175365,5.532359081419624,0.5741127348643006,0.0
44,경상북도,김천시,자산동,자산동제1투,954,655,63,565,22,2,1,653,2,299,9.647779479326186,86.52373660030628,3.3690658499234303,0.3062787136294028,0.1531393568147014
45,경상북도,김천시,자산동,자산동제2투,1413,935,132,757,37,4,1,931,4,478,14.178302900107411,81.31041890440387,3.9742212674543502,0.4296455424274973,0.10741138560687433
46,경상북도,김천시,자산동,자산동제3투,1482,1045,114,875,34,6,2,1031,14,437,11.057225994180406,84.86905916585839,3.2977691561590685,0.5819592628516004,0.19398642095053348
47,경상북도,김천시,평화남산동,관내사전투표,1633,1633,482,1028,101,9,2,1622,11,0,29.716399506781748,63.37854500616523,6.226880394574599,0.5548705302096177,0.12330456226880394
48,경상북도,김천시,평화남산동,평화남산동제1투,1942,1292,124,1102,46,6,1,1279,13,650,9.695074276778733,86.16106333072713,3.596559812353401,0.46911649726348714,0.07818608287724785
49,경상북도,김천시,평화남산동,평화남산동제2투,1305,834,106,699,21,2,0,828,6,471,12.80193236714976,84.42028985507247,2.536231884057971,0.24154589371980675,0.0
50,경상북도,김천시,평화남산동,평화남산동제3투,1342,902,128,716,49,4,3,900,2,440,14.222222222222221,79.55555555555556,5.444444444444444,0.4444444444444444,0.33333333333333337
51,경상북도,김천시,양금동,관내사전투표,1022,1022,274,700,36,4,0,1014,8,0,27.021696252465482,69.0335305719921,3.5502958579881656,0.39447731755424065,0.0
52,경상북도,김천시,양금동,양금동제1투,984,757,66,656,21,3,1,747,10,227,8.835341365461847,87.81793842034806,2.8112449799196786,0.4016064257028112,0.13386880856760375
53,경상북도,김천시,양금동,양금동제2투,1272,880,95,748,26,4,0,873,7,392,10.882016036655212,85.6815578465063,2.978235967926689,0.45819014891179843,0.0
54,경상북도,김천시,대신동,관내사전투표,4658,4658,1745,2401,417,57,4,4624,34,0,37.7378892733564,51.924740484429066,9.018166089965398,1.2326989619377162,0.08650519031141869
55,경상북도,김천시,대신동,대신동제1투,2511,1512,244,1144,108,10,0,1506,6,999,16.201859229747676,75.96281540504648,7.171314741035857,0.6640106241699867,0.0
56,경상북도,김천시,대신동,대신동제2투,1630,1155,251,818,69,9,2,1149,6,475,21.84508268059182,71.19234116623151,6.005221932114883,0.7832898172323759,0.17406440382941687
57,경상북도,김천시,대신동,대신동제3투,2598,1848,383,1333,102,13,3,1834,14,750,20.88331515812432,72.68266085059977,5.561613958560523,0.7088331515812432,0.16357688113413305
58,경상북도,김천시,대신동,대신동제4투,1814,1392,287,990,91,10,0,1378,14,422,20.827285921625542,71.84325108853412,6.60377358490566,0.7256894049346879,0.0
59,경상북도,김천시,대신동,대신동제5투,1238,801,122,636,40,2,0,800,1,437,15.25,79.5,5.0,0.25,0.0
60,경상북도,김천시,대신동,대신동제6투,3396,2193,476,1543,141,18,4,2182,11,1203,21.814848762603116,70.71494042163154,6.461961503208066,0.8249312557286892,0.18331805682859761
61,경상북도,김천시,대곡동,관내사전투표,4775,4775,1672,2739,304,31,6,4752,23,0,35.18518518518518,57.638888888888886,6.397306397306397,0.6523569023569024,0.12626262626262627
62,경상북도,김천시,대곡동,대곡동제1투,1710,1123,191,874,51,1,1,1118,5,587,17.08407871198569,78.175313059034,4.561717352415027,0.08944543828264759,0.08944543828264759
63,경상북도,김천시,대곡동,대곡동제2투,1199,760,95,633,31,1,0,760,0,439,12.5,83.28947368421052,4.078947368421053,0.13157894736842105,0.0
64,경상북도,김천시,대곡동,대곡동제3투,4055,2988,625,2109,220,17,4,2975,13,1067,21.008403361344538,70.89075630252101,7.394957983193278,0.5714285714285714,0.13445378151260504
65,경상북도,김천시,대곡동,대곡동제4투,2297,1489,195,1197,84,4,0,1480,9,808,13.175675675675674,80.87837837837839,5.675675675675676,0.2702702702702703,0.0
66,경상북도,김천시,대곡동,대곡동제5투,1755,1078,159,841,58,5,3,1066,12,677,14.915572232645403,78.89305816135085,5.440900562851782,0.46904315196998125,0.28142589118198874
67,경상북도,김천시,지좌동,관내사전투표,2145,2145,729,1257,131,11,1,2129,16,0,34.241427900422735,59.04180366369187,6.15312353217473,0.5166744950681071,0.046970408642555195
68,경상북도,김천시,지좌동,지좌동제1투,3112,2000,345,1501,122,18,1,1987,13,1112,17.362858580775036,75.54101660795169,6.139909411172622,0.9058882737795673,0.050327126321087066
69,경상북도,김천시,지좌동,지좌동제2투,1492,912,106,754,39,7,0,906,6,580,11.699779249448124,83.22295805739515,4.304635761589404,0.772626931567329,0.0
70,경상북도,김천시,지좌동,지좌동제3투,1418,939,164,705,64,6,0,939,0,479,17.465388711395104,75.07987220447284,6.815761448349308,0.6389776357827476,0.0
71,경상북도,김천시,율곡동,관내사전투표,5449,5449,3045,1676,604,78,5,5408,41,0,56.305473372781066,30.99112426035503,11.168639053254438,1.4423076923076923,0.09245562130177515
72,경상북도,김천시,율곡동,율곡동제1투,2553,1833,522,1133,164,8,1,1828,5,720,28.555798687089716,61.98030634573304,8.971553610503284,0.437636761487965,0.05470459518599562
73,경상북도,김천시,율곡동,율곡동제2투,2362,1697,531,947,176,27,3,1684,13,665,31.532066508313537,56.23515439429929,10.451306413301662,1.6033254156769599,0.17814726840855108
74,경상북도,김천시,율곡동,율곡동제3투,2270,1626,546,922,143,9,2,1622,4,644,33.66214549938348,56.84340320591862,8.816276202219482,0.5548705302096177,0.12330456226880394
75,경상북도,김천시,율곡동,율곡동제4투,2366,1608,447,932,201,20,0,1600,8,758,27.9375,58.25,12.562499999999998,1.25,0.0
76,경상북도,김천시,잘못 투입·구분된 투표지,,0,0,0,0,0,0,0,0,0,0,0.0,0.0,0.0,0.0,0.0
0,경상북도,안동시,거소·선상투표,,336,321,124,152,28,2,3,309,12,15,40.1294498381877,49.19093851132686,9.06148867313916,0.6472491909385114,0.9708737864077669
1,경상북도,안동시,관외사전투표,,9654,9653,3956,4011,1458,110,14,9549,104,1,41.42842182427479,42.004398366321084,15.268614514608862,1.1519530840925751,0.1466122107026914
2,경상북도,안동시,재외투표,,500,363,225,86,46,4,0,361,2,137,62.32686980609419,23.822714681440445,12.742382271468145,1.10803324099723,0.0
3,경상북도,안동시,풍산읍,관내사전투표,1790,1790,722,924,108,14,1,1769,21,0,40.81401921989824,52.23289994347089,6.105144149236857,0.791407574901074,0.05652911249293386
4,경상북도,안동시,풍산읍,풍산읍제1투,2089,1332,291,941,77,9,3,1321,11,757,22.02876608629826,71.2339137017411,5.82891748675246,0.6813020439061317,0.22710068130204392
5,경상북도,안동시,풍산읍,풍산읍제2투,593,423,66,338,14,0,0,418,5,170,15.789473684210526,80.86124401913875,3.349282296650718,0.0,0.0
6,경상북도,안동시,풍산읍,풍산읍제3투,832,524,100,399,13,2,1,515,9,308,19.41747572815534,77.47572815533981,2.524271844660194,0.3883495145631068,0.1941747572815534
7,경상북도,안동시,풍산읍,풍산읍제4투,1174,801,141,616,30,3,1,791,10,373,17.825537294563844,77.87610619469027,3.792667509481669,0.37926675094816686,0.12642225031605564
8,경상북도,안동시,와룡면,관내사전투표,1041,1041,393,591,40,6,0,1030,11,0,38.15533980582524,57.37864077669903,3.8834951456310676,0.5825242718446602,0.0
9,경상북도,안동시,와룡면,와룡면제1투,1397,913,157,723,21,5,0,906,7,484,17.328918322295806,79.80132450331125,2.3178807947019866,0.5518763796909493,0.0
10,경상북도,안동시,와룡면,와룡면제2투,793,521,92,412,11,0,0,515,6,272,17.864077669902912,80.0,2.1359223300970873,0.0,0.0
11,경상북도,안동시,북후면,관내사전투표,950,950,312,528,49,7,1,897,53,0,34.78260869565217,58.862876254180605,5.4626532887402455,0.7803790412486065,0.11148272017837235
12,경상북도,안동시,북후면,북후면투표소,1686,1033,187,802,25,4,0,1018,15,653,18.36935166994106,78.7819253438114,2.455795677799607,0.3929273084479371,0.0
13,경상북도,안동시,서후면,관내사전투표,739,739,271,414,39,3,2,729,10,0,37.174211248285324,56.79012345679012,5.349794238683128,0.411522633744856,0.2743484224965706
14,경상북도,안동시,서후면,서후면제1투,1567,980,157,761,48,3,2,971,9,587,16.168898043254377,78.37281153450051,4.94335736354274,0.30895983522142123,0.20597322348094746
15,경상북도,안동시,서후면,서후면제2투,882,606,119,447,31,4,0,601,5,276,19.800332778702163,74.37603993344426,5.158069883527454,0.6655574043261231,0.0
16,경상북도,안동시,풍천면,관내사전투표,1122,1122,438,579,91,8,1,1117,5,0,39.21217547000895,51.83527305282005,8.146821844225604,0.7162041181736795,0.08952551477170993
17,경상북도,안동시,풍천면,풍천면제1투,1787,1129,215,827,75,6,1,1124,5,658,19.128113879003557,73.57651245551602,6.672597864768683,0.5338078291814947,0.0889679715302491
18,경상북도,안동시,풍천면,풍천면제2투,691,436,57,356,19,0,0,432,4,255,13.194444444444445,82.4074074074074,4.398148148148148,0.0,0.0
19,경상북도,안동시,풍천면,풍천면제3투,342,256,35,215,5,0,0,255,1,86,13.725490196078432,84.31372549019608,1.9607843137254901,0.0,0.0
20,경상북도,안동시,풍천면,풍천면제4투,1224,920,315,471,118,10,0,914,6,304,34.46389496717725,51.53172866520788,12.910284463894966,1.0940919037199124,0.0
21,경상북도,안동시,일직면,관내사전투표,867,867,229,595,34,3,1,862,5,0,26.5661252900232,69.02552204176334,3.944315545243619,0.34802784222737815,0.11600928074245939
22,경상북도,안동시,일직면,일직면제1투,621,395,59,328,5,0,0,392,3,226,15.051020408163266,83.6734693877551,1.2755102040816326,0.0,0.0
23,경상북도,안동시,일직면,일직면제2투,713,464,61,391,6,1,1,460,4,249,13.260869565217392,85.0,1.3043478260869565,0.21739130434782608,0.21739130434782608
24,경상북도,안동시,남후면,관내사전투표,739,739,258,422,49,7,0,736,3,0,35.05434782608695,57.33695652173913,6.657608695652175,0.9510869565217392,0.0
25,경상북도,안동시,남후면,남후면투표소,924,578,89,466,9,6,0,570,8,346,15.6140350877193,81.75438596491227,1.5789473684210527,1.0526315789473684,0.0
26,경상북도,안동시,남선면,관내사전투표,441,441,196,197,36,7,2,438,3,0,44.74885844748858,44.97716894977169,8.21917808219178,1.5981735159817352,0.45662100456621
27,경상북도,안동시,남선면,남선면제1투,788,569,92,450,19,3,0,564,5,219,16.312056737588655,79.7872340425532,3.368794326241135,0.5319148936170213,0.0
28,경상북도,안동시,남선면,남선면제2투,541,417,103,295,11,4,1,414,3,124,24.879227053140095,71.25603864734299,2.657004830917874,0.966183574879227,0.24154589371980675
29,경상북도,안동시,임하면,관내사전투표,865,865,308,482,32,16,3,841,24,0,36.623067776456594,57.31272294887039,3.804994054696789,1.9024970273483945,0.356718192627824
30,경상북도,안동시,임하면,임하면제1투,1127,662,106,520,24,5,0,655,7,465,16.18320610687023,79.38931297709924,3.6641221374045805,0.7633587786259541,0.0
31,경상북도,안동시,임하면,임하면제2투,370,271,30,233,6,0,0,269,2,99,11.152416356877323,86.61710037174721,2.2304832713754648,0.0,0.0
32,경상북도,안동시,길안면,관내사전투표,793,793,295,454,32,6,1,788,5,0,37.43654822335025,57.61421319796954,4.060913705583756,0.7614213197969544,0.12690355329949238
33,경상북도,안동시,길안면,길안면제1투,1261,821,105,696,16,1,0,818,3,440,12.836185819070906,85.08557457212714,1.9559902200488997,0.12224938875305623,0.0
34,경상북도,안동시,길안면,길안면제2투,365,257,24,216,11,3,0,254,3,108,9.448818897637794,85.03937007874016,4.330708661417323,1.1811023622047243,0.0
35,경상북도,안동시,임동면,관내사전투표,504,504,164,314,18,2,0,498,6,0,32.93172690763052,63.05220883534136,3.614457831325301,0.4016064257028112,0.0
36,경상북도,안동시,임동면,임동면투표소,895,592,85,491,8,1,1,586,6,303,14.505119453924914,83.78839590443687,1.3651877133105803,0.17064846416382254,0.17064846416382254
37,경상북도,안동시,예안면,관내사전투표,605,605,283,296,21,1,1,602,3,0,47.00996677740864,49.16943521594684,3.488372093023256,0.16611295681063123,0.16611295681063123
38,경상북도,안동시,예안면,예안면제1투,595,377,103,261,6,0,0,370,7,218,27.837837837837835,70.54054054054055,1.6216216216216217,0.0,0.0
39,경상북도,안동시,예안면,예안면제2투,305,216,97,111,5,1,0,214,2,89,45.32710280373832,51.86915887850467,2.336448598130841,0.46728971962616817,0.0
40,경상북도,안동시,도산면,관내사전투표,462,462,209,228,20,3,0,460,2,0,45.43478260869565,49.56521739130435,4.3478260869565215,0.6521739130434783,0.0
41,경상북도,안동시,도산면,도산면제1투,576,371,67,298,3,2,0,370,1,205,18.10810810810811,80.54054054054053,0.8108108108108109,0.5405405405405406,0.0
42,경상북도,안동시,도산면,도산면제2투,294,229,51,172,1,1,0,225,4,65,22.666666666666664,76.44444444444444,0.4444444444444444,0.4444444444444444,0.0
43,경상북도,안동시,녹전면,관내사전투표,355,355,125,213,7,2,2,349,6,0,35.816618911174785,61.03151862464183,2.005730659025788,0.5730659025787965,0.5730659025787965
44,경상북도,안동시,녹전면,녹전면제1투,684,486,86,376,11,4,1,478,8,198,17.99163179916318,78.66108786610879,2.301255230125523,0.8368200836820083,0.20920502092050208
45,경상북도,안동시,녹전면,녹전면제2투,393,276,37,232,1,1,2,273,3,117,13.553113553113553,84.98168498168498,0.3663003663003663,0.3663003663003663,0.7326007326007326
46,경상북도,안동시,중구동,관내사전투표,2018,2018,869,937,171,22,1,2000,18,0,43.45,46.85,8.55,1.0999999999999999,0.05
47,경상북도,안동시,중구동,중구동제1투,1023,687,112,525,35,7,1,680,7,336,16.470588235294116,77.20588235294117,5.147058823529411,1.0294117647058822,0.14705882352941177
48,경상북도,안동시,중구동,중구동제2투,805,571,94,447,21,1,0,563,8,234,16.69626998223801,79.39609236234459,3.7300177619893424,0.17761989342806395,0.0
49,경상북도,안동시,중구동,중구동제3투,1201,815,150,623,28,8,0,809,6,386,18.541409147095177,77.00865265760197,3.4610630407911,0.9888751545117428,0.0
50,경상북도,안동시,명륜동,관내사전투표,1380,1380,611,667,84,7,1,1370,10,0,44.598540145985396,48.68613138686131,6.131386861313868,0.5109489051094891,0.072992700729927
51,경상북도,안동시,명륜동,명륜동제1투,1938,1347,269,1004,53,8,2,1336,11,591,20.134730538922156,75.1497005988024,3.967065868263473,0.5988023952095809,0.14970059880239522
52,경상북도,안동시,명륜동,명륜동제2투,825,531,93,414,19,3,1,530,1,294,17.547169811320753,78.11320754716982,3.5849056603773586,0.5660377358490566,0.18867924528301888
53,경상북도,안동시,용상동,관내사전투표,5271,5271,2353,2396,410,61,4,5224,47,0,45.04211332312404,45.865237366003065,7.848392036753446,1.167687595712098,0.0765696784073507
54,경상북도,안동시,용상동,용상동제1투,1477,998,246,671,68,7,0,992,6,479,24.798387096774192,67.64112903225806,6.854838709677419,0.7056451612903225,0.0
55,경상북도,안동시,용상동,용상동제2투,2049,1393,390,880,104,8,1,1383,10,656,28.199566160520607,63.62979031091829,7.519884309472162,0.5784526391901663,0.07230657989877079
56,경상북도,안동시,용상동,용상동제3투,1882,1284,272,919,75,10,1,1277,7,598,21.29992169146437,71.96554424432263,5.873140172278778,0.7830853563038371,0.07830853563038372
57,경상북도,안동시,용상동,용상동제4투,868,543,119,401,13,5,0,538,5,325,22.118959107806692,74.53531598513011,2.41635687732342,0.929368029739777,0.0
58,경상북도,안동시,용상동,용상동제5투,1035,629,108,481,35,2,1,627,2,406,17.22488038277512,76.71451355661883,5.582137161084529,0.3189792663476874,0.1594896331738437
59,경상북도,안동시,용상동,용상동제6투,1848,1376,379,913,64,11,0,1367,9,472,27.724945135332845,66.7885881492319,4.681784930504755,0.8046817849305048,0.0
60,경상북도,안동시,용상동,용상동제7투,1971,1470,408,945,90,15,3,1461,9,501,27.92607802874743,64.68172484599589,6.160164271047227,1.0266940451745379,0.20533880903490762
61,경상북도,안동시,용상동,용상동제8투,2481,1724,334,1049,298,23,2,1706,18,757,19.577960140679952,61.48886283704572,17.46776084407972,1.3481828839390386,0.11723329425556857
62,경상북도,안동시,서구동,관내사전투표,1869,1868,855,861,123,13,1,1853,15,1,46.14139233675122,46.46519158121964,6.637884511602807,0.7015650296815974,0.053966540744738264
63,경상북도,안동시,서구동,서구동제1투,1729,1226,300,828,80,11,0,1219,7,503,24.61033634126333,67.9245283018868,6.562756357670222,0.9023789991796556,0.0
64,경상북도,안동시,서구동,서구동제2투,1417,973,138,792,34,3,1,968,5,444,14.256198347107437,81.81818181818183,3.512396694214876,0.30991735537190085,0.10330578512396695
65,경상북도,안동시,서구동,서구동제3투,955,667,135,493,26,2,4,660,7,288,20.454545454545457,74.69696969696969,3.939393939393939,0.30303030303030304,0.6060606060606061
66,경상북도,안동시,서구동,서구동제4투,831,591,106,465,17,3,0,591,0,240,17.93570219966159,78.68020304568529,2.8764805414551606,0.5076142131979695,0.0
67,경상북도,안동시,태화동,관내사전투표,2309,2309,893,1262,119,16,0,2290,19,0,38.995633187772924,55.109170305676855,5.1965065502183405,0.6986899563318777,0.0
68,경상북도,안동시,태화동,태화동제1투,878,564,84,464,10,0,0,558,6,314,15.053763440860216,83.15412186379928,1.7921146953405016,0.0,0.0
69,경상북도,안동시,태화동,태화동제2투,1309,836,137,648,41,6,1,833,3,473,16.44657863145258,77.79111644657863,4.921968787515006,0.7202881152460985,0.12004801920768307
70,경상북도,안동시,태화동,태화동제3투,1223,802,142,631,21,6,0,800,2,421,17.75,78.875,2.625,0.75,0.0
71,경상북도,안동시,태화동,태화동제4투,1217,817,112,665,32,4,1,814,3,400,13.75921375921376,81.6953316953317,3.9312039312039313,0.4914004914004914,0.12285012285012285
72,경상북도,안동시,태화동,태화동제5투,2190,1478,332,1040,89,6,0,1467,11,712,22.631220177232446,70.89297886843899,6.0668029993183366,0.408997955010225,0.0
73,경상북도,안동시,평화동,관내사전투표,1545,1545,678,758,89,8,0,1533,12,0,44.22700587084149,49.445531637312456,5.805609915198956,0.5218525766470972,0.0
74,경상북도,안동시,평화동,평화동제1투,1233,894,174,676,33,5,0,888,6,339,19.594594594594593,76.12612612612612,3.7162162162162162,0.5630630630630631,0.0
75,경상북도,안동시,평화동,평화동제2투,887,584,112,444,22,4,0,582,2,303,19.243986254295535,76.28865979381443,3.7800687285223367,0.6872852233676976,0.0
76,경상북도,안동시,평화동,평화동제3투,1480,1061,199,816,35,5,0,1055,6,419,18.862559241706162,77.34597156398104,3.3175355450236967,0.47393364928909953,0.0
77,경상북도,안동시,안기동,관내사전투표,1603,1603,692,797,87,17,2,1595,8,0,43.38557993730407,49.96865203761756,5.454545454545454,1.0658307210031348,0.12539184952978058
78,경상북도,안동시,안기동,안기동제1투,880,625,139,447,25,9,1,621,4,255,22.383252818035427,71.98067632850241,4.025764895330113,1.4492753623188406,0.1610305958132045
79,경상북도,안동시,안기동,안기동제2투,1060,712,119,559,26,1,1,706,6,348,16.855524079320112,79.17847025495752,3.6827195467422094,0.141643059490085,0.141643059490085
80,경상북도,안동시,안기동,안기동제3투,1415,1040,215,776,36,7,1,1035,5,375,20.77294685990338,74.97584541062801,3.4782608695652173,0.6763285024154589,0.0966183574879227
81,경상북도,안동시,옥동,관내사전투표,4341,4341,1990,1859,412,40,7,4308,33,0,46.19312906220984,43.152274837511605,9.563602599814299,0.9285051067780872,0.16248839368616527
82,경상북도,안동시,옥동,옥동제1투,2004,1287,262,931,81,11,1,1286,1,717,20.37325038880249,72.39502332814929,6.298600311041991,0.8553654743390358,0.07776049766718507
83,경상북도,안동시,옥동,옥동제2투,2067,1492,490,859,120,13,0,1482,10,575,33.063427800269906,57.962213225371116,8.097165991902834,0.8771929824561403,0.0
84,경상북도,안동시,옥동,옥동제3투,1571,1181,247,881,37,10,0,1175,6,390,21.02127659574468,74.97872340425532,3.148936170212766,0.851063829787234,0.0
85,경상북도,안동시,옥동,옥동제4투,1431,957,225,673,41,3,2,944,13,474,23.834745762711865,71.29237288135593,4.343220338983051,0.31779661016949157,0.211864406779661
86,경상북도,안동시,옥동,옥동제5투,1468,1038,288,685,48,12,1,1034,4,430,27.852998065764023,66.247582205029,4.642166344294004,1.160541586073501,0.09671179883945842
87,경상북도,안동시,옥동,옥동제6투,1303,906,293,558,40,10,1,902,4,397,32.48337028824834,61.86252771618626,4.434589800443459,1.1086474501108647,0.11086474501108648
88,경상북도,안동시,옥동,옥동제7투,1068,666,167,463,27,2,0,659,7,402,25.341426403641883,70.25796661608497,4.09711684370258,0.30349013657056145,0.0
89,경상북도,안동시,송하동,관내사전투표,4045,4045,1936,1776,276,35,1,4024,21,0,48.111332007952285,44.135188866799204,6.858846918489066,0.8697813121272366,0.024850894632206758
90,경상북도,안동시,송하동,송하동제1투,1479,946,223,648,55,9,3,938,8,533,23.773987206823026,69.08315565031982,5.863539445628998,0.9594882729211088,0.31982942430703626
91,경상북도,안동시,송하동,송하동제2투,1742,1128,297,757,61,4,1,1120,8,614,26.517857142857142,67.58928571428572,5.446428571428571,0.35714285714285715,0.08928571428571429
92,경상북도,안동시,송하동,송하동제3투,1093,725,130,555,25,6,0,716,9,368,18.156424581005588,77.51396648044692,3.4916201117318435,0.8379888268156425,0.0
93,경상북도,안동시,송하동,송하동제4투,2097,1550,423,995,109,9,0,1536,14,547,27.5390625,64.77864583333334,7.096354166666667,0.5859375,0.0
94,경상북도,안동시,송하동,송하동제5투,1486,1036,252,724,46,8,0,1030,6,450,24.466019417475728,70.29126213592232,4.466019417475728,0.7766990291262136,0.0
95,경상북도,안동시,강남동,관내사전투표,2655,2653,1410,977,214,31,2,2634,19,2,53.53075170842825,37.0918754745634,8.124525436598331,1.1769172361427487,0.07593014426727411
96,경상북도,안동시,강남동,강남동제1투,1416,950,211,667,54,6,0,938,12,466,22.494669509594882,71.10874200426439,5.756929637526652,0.6396588486140725,0.0
97,경상북도,안동시,강남동,강남동제2투,2153,1506,383,1007,87,19,1,1497,9,647,25.58450233800935,67.26786907147628,5.811623246492986,1.2692050768203071,0.06680026720106881
98,경상북도,안동시,강남동,강남동제3투,1538,1111,328,700,67,9,1,1105,6,427,29.683257918552037,63.348416289592755,6.0633484162895925,0.8144796380090499,0.09049773755656108
99,경상북도,안동시,잘못 투입·구분된 투표지,,0,1,1,0,0,0,0,1,0,-1,100.0,0.0,0.0,0.0,0.0
0,경상북도,구미시,거소·선상투표,,533,502,113,264,90,9,1,477,25,31,23.68972746331237,55.34591194968554,18.867924528301888,1.8867924528301887,0.20964360587002098
1,경상북도,구미시,관외사전투표,,20133,20130,6735,9416,3478,217,45,19891,239,3,33.85953446282238,47.33799205670907,17.48529485697049,1.0909456538132825,0.22623296968478207
2,경상북도,구미시,재외투표,,1065,776,457,215,94,9,0,775,1,289,58.96774193548387,27.741935483870968,12.129032258064516,1.1612903225806452,0.0
3,경상북도,구미시,선산읍,관내사전투표,3434,3434,962,2199,225,18,3,3407,27,0,28.235984737305547,64.54358673319635,6.604050484297036,0.5283240387437629,0.0880540064572938
4,경상북도,구미시,선산읍,선산읍제1투,1412,994,101,847,33,7,2,990,4,418,10.202020202020202,85.55555555555556,3.3333333333333335,0.7070707070707071,0.20202020202020202
5,경상북도,구미시,선산읍,선산읍제2투,1291,845,112,694,29,4,0,839,6,446,13.3492252681764,82.71752085816448,3.4564958283671037,0.47675804529201427,0.0
6,경상북도,구미시,선산읍,선산읍제3투,1734,1194,88,1062,29,4,1,1184,10,540,7.4324324324324325,89.69594594594594,2.449324324324324,0.33783783783783783,0.08445945945945946
7,경상북도,구미시,선산읍,선산읍제4투,590,456,53,379,15,2,1,450,6,134,11.777777777777777,84.22222222222221,3.3333333333333335,0.4444444444444444,0.2222222222222222
8,경상북도,구미시,선산읍,선산읍제5투,3321,2234,329,1784,94,11,4,2222,12,1087,14.806480648064808,80.28802880288029,4.23042304230423,0.49504950495049505,0.18001800180018002
9,경상북도,구미시,고아읍,관내사전투표,2426,2426,781,1445,171,10,2,2409,17,0,32.42009132420091,59.983395599833955,7.0983810709838115,0.4151100041511001,0.08302200083022
10,경상북도,구미시,고아읍,고아읍제1투,1430,977,100,832,30,4,1,967,10,453,10.341261633919338,86.0392967942089,3.1023784901758016,0.4136504653567736,0.1034126163391934
11,경상북도,구미시,고아읍,고아읍제2투,1892,1253,162,1023,48,10,2,1245,8,639,13.012048192771083,82.16867469879519,3.8554216867469884,0.8032128514056224,0.1606425702811245
12,경상북도,구미시,고아읍,고아읍제3투,4114,3015,645,2116,210,25,0,2996,19,1099,21.528704939919894,70.62750333778371,7.009345794392523,0.8344459279038717,0.0
13,경상북도,구미시,고아읍,고아읍제4투,2876,2122,404,1543,137,18,4,2106,16,754,19.183285849952515,73.26685660018994,6.505223171889838,0.8547008547008548,0.1899335232668566
14,경상북도,구미시,고아읍,고아읍제5투,974,722,60,632,22,2,1,717,5,252,8.368200836820083,88.14504881450488,3.0683403068340307,0.2789400278940028,0.1394700139470014
15,경상북도,구미시,고아읍,고아읍제6투,1888,1374,174,1124,57,13,2,1370,4,514,12.700729927007298,82.04379562043795,4.160583941605839,0.948905109489051,0.145985401459854
16,경상북도,구미시,고아읍,고아읍제7투,3511,2631,637,1795,165,17,3,2617,14,880,24.34084829957967,68.58998853649216,6.304929308368361,0.6495987772258311,0.11463507833397019
17,경상북도,구미시,고아읍,고아읍제8투,3005,2334,542,1604,154,22,0,2322,12,671,23.34194659776055,69.07838070628767,6.6322136089577945,0.9474590869939706,0.0
18,경상북도,구미시,고아읍,고아읍제9투,3695,2973,744,1980,208,24,5,2961,12,722,25.126646403242148,66.8693009118541,7.024653833164471,0.8105369807497468,0.16886187098953057
19,경상북도,구미시,산동읍,관내사전투표,4825,4825,2565,1569,610,35,2,4781,44,0,53.64986404517883,32.81740221710939,12.758837063375864,0.7320644216691069,0.04183225266680611
20,경상북도,구미시,산동읍,산동읍제1투,1697,1130,119,955,42,1,3,1120,10,567,10.625,85.26785714285714,3.75,0.08928571428571429,0.26785714285714285
21,경상북도,구미시,산동읍,산동읍제2투,3825,2860,1029,1517,267,21,1,2835,25,965,36.2962962962963,53.50970017636685,9.417989417989418,0.7407407407407408,0.035273368606701945
22,경상북도,구미시,산동읍,산동읍제3투,2846,2174,683,1225,241,13,1,2163,11,672,31.576514100785946,56.63430420711975,11.141932501155802,0.6010171058714748,0.04623208506703652
23,경상북도,구미시,산동읍,산동읍제4투,3943,2856,890,1550,366,31,5,2842,14,1087,31.31597466572836,54.53905700211119,12.878254750175932,1.0907811400422238,0.17593244194229415
24,경상북도,구미시,산동읍,산동읍제5투,2852,1799,509,1021,233,12,4,1779,20,1053,28.611579539066888,57.39179314221473,13.097245643620012,0.6745362563237773,0.22484541877459246
25,경상북도,구미시,무을면,관내사전투표,570,570,137,405,20,2,1,565,5,0,24.24778761061947,71.68141592920354,3.5398230088495577,0.35398230088495575,0.17699115044247787
26,경상북도,구미시,무을면,무을면투표소,1007,691,37,632,18,0,2,689,2,316,5.370101596516691,91.72714078374456,2.6124818577648767,0.0,0.29027576197387517
27,경상북도,구미시,옥성면,관내사전투표,404,404,87,294,19,1,1,402,2,0,21.641791044776117,73.13432835820896,4.72636815920398,0.24875621890547264,0.24875621890547264
28,경상북도,구미시,옥성면,옥성면투표소,984,710,62,627,11,2,0,702,8,274,8.831908831908832,89.31623931623932,1.566951566951567,0.2849002849002849,0.0
29,경상북도,구미시,도개면,관내사전투표,671,671,161,454,41,2,3,661,10,0,24.357034795763994,68.6838124054463,6.202723146747353,0.30257186081694404,0.45385779122541603
30,경상북도,구미시,도개면,도개면투표소,1251,838,64,754,15,2,0,835,3,413,7.664670658682635,90.2994011976048,1.7964071856287425,0.23952095808383234,0.0
31,경상북도,구미시,해평면,관내사전투표,1179,1179,299,818,53,5,0,1175,4,0,25.4468085106383,69.61702127659575,4.51063829787234,0.425531914893617,0.0
32,경상북도,구미시,해평면,해평면투표소,2190,1471,122,1296,36,7,2,1463,8,719,8.33902939166097,88.5850991114149,2.460697197539303,0.4784688995215311,0.1367053998632946
33,경상북도,구미시,장천면,관내사전투표,1000,1000,327,602,53,6,1,989,11,0,33.06370070778564,60.86956521739131,5.358948432760364,0.6066734074823054,0.10111223458038424
34,경상북도,구미시,장천면,장천면투표소,1719,1258,115,1107,23,5,0,1250,8,461,9.2,88.56,1.8399999999999999,0.4,0.0
35,경상북도,구미시,송정동,관내사전투표,4547,4547,1738,2269,449,38,4,4498,49,0,38.639395286794134,50.44464206313918,9.982214317474433,0.8448199199644287,0.08892841262783459
36,경상북도,구미시,송정동,송정동제1투,2510,1705,291,1279,116,6,0,1692,13,805,17.19858156028369,75.59101654846336,6.8557919621749415,0.3546099290780142,0.0
37,경상북도,구미시,송정동,송정동제2투,2396,1627,246,1230,134,8,0,1618,9,769,15.203955500618047,76.01977750309024,8.281829419035846,0.4944375772558714,0.0
38,경상북도,구미시,송정동,송정동제3투,2717,1916,307,1469,119,11,3,1909,7,801,16.08171817705605,76.95128339444736,6.233630172865374,0.5762179151388162,0.1571503404924044
39,경상북도,구미시,송정동,송정동제4투,2586,1720,276,1326,95,14,0,1711,9,866,16.130917592051432,77.49853886616013,5.5523085914669785,0.8182349503214494,0.0
40,경상북도,구미시,송정동,송정동제5투,3954,3110,679,2163,222,30,2,3096,14,844,21.93152454780362,69.86434108527132,7.170542635658915,0.9689922480620154,0.06459948320413438
41,경상북도,구미시,원평동,관내사전투표,3120,3120,1119,1651,289,25,4,3088,32,0,36.237046632124354,53.465025906735754,9.35880829015544,0.8095854922279792,0.1295336787564767
42,경상북도,구미시,원평동,원평동제1투,2374,1159,138,963,52,1,0,1154,5,1215,11.95840554592721,83.44887348353552,4.506065857885615,0.08665511265164644,0.0
43,경상북도,구미시,원평동,원평동제2투,2870,2195,471,1467,220,16,2,2176,19,675,21.645220588235293,67.41727941176471,10.11029411764706,0.7352941176470588,0.09191176470588235
44,경상북도,구미시,원평동,원평동제3투,835,587,77,485,19,3,1,585,2,248,13.162393162393164,82.90598290598291,3.2478632478632483,0.5128205128205128,0.17094017094017094
45,경상북도,구미시,지산동,관내사전투표,1757,1757,668,888,170,14,0,1740,17,0,38.39080459770115,51.03448275862069,9.770114942528735,0.8045977011494253,0.0
46,경상북도,구미시,지산동,지산동투표소,1292,935,88,819,21,2,0,930,5,357,9.46236559139785,88.06451612903226,2.258064516129032,0.21505376344086022,0.0
47,경상북도,구미시,도량동,관내사전투표,4528,4528,1728,2383,337,45,3,4496,32,0,38.43416370106761,53.002669039145914,7.495551601423488,1.0008896797153026,0.06672597864768684
48,경상북도,구미시,도량동,도량동제1투,1273,865,112,708,34,3,1,858,7,408,13.053613053613052,82.51748251748252,3.9627039627039626,0.34965034965034963,0.11655011655011654
49,경상북도,구미시,도량동,도량동제2투,2152,1614,355,1136,109,5,2,1607,7,538,22.09085252022402,70.69072806471686,6.782825140012445,0.3111387678904792,0.12445550715619166
50,경상북도,구미시,도량동,도량동제3투,1895,1430,287,1048,84,4,1,1424,6,465,20.154494382022474,73.59550561797754,5.8988764044943816,0.2808988764044944,0.0702247191011236
51,경상북도,구미시,도량동,도량동제4투,2472,1691,254,1321,93,9,1,1678,13,781,15.137067938021453,78.72467222884386,5.542312276519666,0.5363528009535161,0.05959475566150178
52,경상북도,구미시,도량동,도량동제5투,2344,1622,300,1226,79,10,1,1616,6,722,18.564356435643564,75.86633663366337,4.888613861386139,0.6188118811881188,0.06188118811881188
53,경상북도,구미시,도량동,도량동제6투,2943,2175,384,1642,113,18,3,2160,15,768,17.77777777777778,76.01851851851852,5.231481481481481,0.8333333333333334,0.1388888888888889
54,경상북도,구미시,도량동,도량동제7투,3638,2747,707,1781,202,32,7,2729,18,891,25.906925613777943,65.26200073286918,7.401978746793697,1.1725906925613778,0.2565042139978014
55,경상북도,구미시,선주원남동,관내사전투표,6410,6409,2888,2844,588,54,4,6378,31,1,45.28065224208216,44.590780809031045,9.219190968955786,0.8466603951081844,0.06271558482282848
56,경상북도,구미시,선주원남동,선주원남동제1투,2742,1974,553,1253,143,13,2,1964,10,768,28.156822810590633,63.79837067209776,7.281059063136457,0.6619144602851323,0.10183299389002036
57,경상북도,구미시,선주원남동,선주원남동제2투,2569,1727,309,1295,104,13,0,1721,6,842,17.954677513073793,75.24694944799535,6.042998256827426,0.7553747821034282,0.0
58,경상북도,구미시,선주원남동,선주원남동제3투,3382,1754,267,1353,113,4,4,1741,13,1628,15.33601378518093,77.71395749569213,6.490522688110281,0.22975301550832855,0.22975301550832855
59,경상북도,구미시,선주원남동,선주원남동제4투,2722,2045,451,1434,134,13,1,2033,12,677,22.18396458435809,70.5361534677816,6.591244466305953,0.6394490900147565,0.04918839153959665
60,경상북도,구미시,선주원남동,선주원남동제5투,2999,2245,337,1765,108,12,3,2225,20,754,15.146067415730338,79.32584269662921,4.853932584269663,0.5393258426966292,0.1348314606741573
61,경상북도,구미시,선주원남동,선주원남동제6투,1655,1194,152,973,53,6,2,1186,8,461,12.816188870151771,82.04047217537943,4.4688026981450255,0.5059021922428331,0.16863406408094433
62,경상북도,구미시,선주원남동,선주원남동제7투,2351,1780,475,1152,123,19,2,1771,9,571,26.82100508187465,65.04799548277809,6.945228684359119,1.0728402032749857,0.1129305477131564
63,경상북도,구미시,선주원남동,선주원남동제8투,3165,2113,523,1372,188,22,1,2106,7,1052,24.8338081671415,65.14719848053181,8.92687559354226,1.0446343779677114,0.04748338081671415
64,경상북도,구미시,형곡1동,관내사전투표,3904,3903,1443,2044,342,36,2,3867,36,1,37.315748642358415,52.857512283423844,8.844065166795966,0.9309542280837859,0.0517196793379881
65,경상북도,구미시,형곡1동,형곡1동제1투,920,684,103,536,34,6,0,679,5,236,15.169366715758468,78.93961708394698,5.007363770250368,0.8836524300441826,0.0
66,경상북도,구미시,형곡1동,형곡1동제2투,2112,1542,263,1166,94,12,1,1536,6,570,17.122395833333336,75.91145833333334,6.119791666666666,0.78125,0.06510416666666666
67,경상북도,구미시,형곡1동,형곡1동제3투,1799,1269,210,975,72,6,0,1263,6,530,16.6270783847981,77.19714964370546,5.7007125890736345,0.4750593824228029,0.0
68,경상북도,구미시,형곡1동,형곡1동제4투,2334,1684,304,1223,125,15,2,1669,15,650,18.214499700419413,73.27741162372678,7.489514679448773,0.8987417615338525,0.11983223487118035
69,경상북도,구미시,형곡2동,관내사전투표,2595,2595,949,1388,213,23,4,2577,18,0,36.825766395032986,53.86107877376794,8.265424912689173,0.892510671323244,0.15521924718665114
70,경상북도,구미시,형곡2동,형곡2동제1투,1952,1392,233,1073,70,6,1,1383,9,560,16.847433116413594,77.58496023138105,5.061460592913955,0.43383947939262474,0.07230657989877079
71,경상북도,구미시,형곡2동,형곡2동제2투,2007,1402,250,1052,82,9,0,1393,9,605,17.946877243359655,75.52045944005744,5.886575735821967,0.6460875807609476,0.0
72,경상북도,구미시,형곡2동,형곡2동제3투,1667,1163,210,862,75,8,1,1156,7,504,18.166089965397923,74.5674740484429,6.487889273356401,0.6920415224913495,0.08650519031141869
73,경상북도,구미시,형곡2동,형곡2동제4투,2018,1374,226,1055,75,9,1,1366,8,644,16.544655929721817,77.23279648609078,5.490483162518302,0.6588579795021963,0.07320644216691069
74,경상북도,구미시,형곡2동,형곡2동제5투,1980,1331,214,1017,82,9,0,1322,9,649,16.187594553706504,76.92889561270802,6.202723146747353,0.680786686838124,0.0
75,경상북도,구미시,신평1동,관내사전투표,1550,1550,563,753,208,13,0,1537,13,0,36.62979830839298,48.99154196486663,13.532856213402733,0.8458035133376708,0.0
76,경상북도,구미시,신평1동,신평1동제1투,1737,1387,219,1024,122,14,2,1381,6,350,15.858073859522085,74.14916727009413,8.834178131788558,1.0137581462708183,0.1448225923244026
77,경상북도,구미시,신평1동,신평1동제2투,1294,793,132,583,65,4,1,785,8,501,16.81528662420382,74.26751592356688,8.280254777070063,0.5095541401273885,0.12738853503184713
78,경상북도,구미시,신평2동,관내사전투표,600,600,200,328,65,4,0,597,3,0,33.50083752093803,54.941373534338354,10.887772194304858,0.6700167504187605,0.0
79,경상북도,구미시,신평2동,신평2동투표소,1675,1171,178,910,69,6,0,1163,8,504,15.30524505588994,78.24591573516767,5.932932072227,0.5159071367153912,0.0
80,경상북도,구미시,비산동,관내사전투표,3013,3013,1280,1347,337,23,2,2989,24,0,42.823686851789894,45.06523921043827,11.274673803947808,0.7694881231180997,0.06691201070592172
81,경상북도,구미시,비산동,비산동제1투,3515,2415,487,1726,166,17,3,2399,16,1100,20.300125052105045,71.94664443518133,6.919549812421842,0.70862859524802,0.12505210504376824
82,경상북도,구미시,비산동,비산동제2투,3497,2482,530,1678,228,26,2,2464,18,1015,21.50974025974026,68.10064935064936,9.253246753246753,1.0551948051948052,0.08116883116883117
83,경상북도,구미시,공단동,관내사전투표,2311,2311,1014,945,305,17,5,2286,25,0,44.35695538057743,41.338582677165356,13.342082239720035,0.7436570428696413,0.21872265966754156
84,경상북도,구미시,공단동,공단동투표소,2238,1467,310,1012,125,8,1,1456,11,771,21.291208791208792,69.5054945054945,8.585164835164836,0.5494505494505495,0.06868131868131869
85,경상북도,구미시,광평동,관내사전투표,1586,1586,649,745,164,18,2,1578,8,0,41.12801013941698,47.21166032953105,10.392902408111533,1.1406844106463878,0.12674271229404308
86,경상북도,구미시,광평동,광평동투표소,2440,1640,271,1212,137,6,3,1629,11,800,16.63597298956415,74.40147329650092,8.410067526089625,0.3683241252302026,0.1841620626151013
87,경상북도,구미시,상모사곡동,관내사전투표,4584,4584,1896,2172,433,40,5,4546,38,0,41.70699516058073,47.778266608007044,9.524857017157942,0.8798944126704795,0.10998680158380994
88,경상북도,구미시,상모사곡동,상모사곡동제1투,3553,2141,459,1471,187,13,1,2131,10,1412,21.539183481933364,69.02862505865791,8.775222900046927,0.6100422336931018,0.04692632566870014
89,경상북도,구미시,상모사곡동,상모사곡동제2투,2999,2124,426,1499,173,12,4,2114,10,875,20.151371807000945,70.90823084200568,8.183538315988647,0.5676442762535477,0.1892147587511826
90,경상북도,구미시,상모사곡동,상모사곡동제3투,4015,2392,517,1685,159,16,3,2380,12,1623,21.722689075630253,70.7983193277311,6.680672268907563,0.6722689075630253,0.12605042016806722
91,경상북도,구미시,상모사곡동,상모사곡동제4투,3323,2507,579,1694,198,20,2,2493,14,816,23.225030084235858,67.95026073004412,7.9422382671480145,0.8022462896109106,0.08022462896109105
92,경상북도,구미시,상모사곡동,상모사곡동제5투,2361,1750,429,1160,132,16,0,1737,13,611,24.697754749568222,66.78180771445021,7.599309153713299,0.9211283822682788,0.0
93,경상북도,구미시,상모사곡동,상모사곡동제6투,2183,1781,398,1205,147,16,2,1768,13,402,22.511312217194572,68.15610859728507,8.314479638009049,0.904977375565611,0.11312217194570137
94,경상북도,구미시,임오동,관내사전투표,2379,2379,994,1114,240,17,2,2367,12,0,41.994085340092944,47.06379383185467,10.139416983523446,0.7182087029995775,0.08449514152936206
95,경상북도,구미시,임오동,임오동제1투,1736,1019,179,759,65,3,2,1008,11,717,17.75793650793651,75.29761904761905,6.4484126984126995,0.2976190476190476,0.1984126984126984
96,경상북도,구미시,임오동,임오동제2투,2587,1765,409,1213,113,18,1,1754,11,822,23.31812998859749,69.15621436716077,6.442417331812998,1.0262257696693273,0.05701254275940707
97,경상북도,구미시,임오동,임오동제3투,2263,1625,401,1088,104,10,4,1607,18,638,24.95332918481643,67.70379589296826,6.471686372121967,0.6222775357809583,0.24891101431238333
98,경상북도,구미시,임오동,임오동제4투,1152,756,172,511,58,7,2,750,6,396,22.933333333333334,68.13333333333334,7.733333333333333,0.9333333333333335,0.26666666666666666
99,경상북도,구미시,임오동,임오동제5투,2665,1957,567,1159,188,28,1,1943,14,708,29.18167781780752,59.650025733401954,9.675759135357694,1.4410705095213587,0.0514668039114771
100,경상북도,구미시,인동동,관내사전투표,4836,4836,2189,2066,481,46,5,4787,49,0,45.72801336954251,43.158554418216,10.048046793398788,0.9609358679757677,0.10444955086693128
101,경상북도,구미시,인동동,인동동제1투,2405,1447,207,1122,100,8,3,1440,7,958,14.374999999999998,77.91666666666667,6.944444444444445,0.5555555555555556,0.20833333333333334
102,경상북도,구미시,인동동,인동동제2투,2536,1613,418,1034,132,12,2,1598,15,923,26.157697121401753,64.70588235294117,8.260325406758447,0.7509386733416771,0.1251564455569462
103,경상북도,구미시,인동동,인동동제3투,3668,2074,447,1408,181,19,0,2055,19,1594,21.751824817518248,68.51581508515815,8.80778588807786,0.9245742092457422,0.0
104,경상북도,구미시,인동동,인동동제4투,1611,979,219,690,50,10,0,969,10,632,22.60061919504644,71.20743034055728,5.159958720330237,1.0319917440660475,0.0
105,경상북도,구미시,인동동,인동동제5투,2161,1334,258,927,125,10,3,1323,11,827,19.501133786848072,70.06802721088435,9.44822373393802,0.7558578987150416,0.22675736961451248
106,경상북도,구미시,인동동,인동동제6투,2275,1522,375,1028,86,13,5,1507,15,753,24.883875248838752,68.21499668214996,5.706702057067021,0.8626410086264101,0.33178500331785005
107,경상북도,구미시,인동동,인동동제7투,3339,1697,456,1071,140,15,2,1684,13,1642,27.078384798099762,63.59857482185273,8.31353919239905,0.8907363420427553,0.11876484560570072
108,경상북도,구미시,인동동,인동동제8투,1719,880,168,645,61,3,2,879,1,839,19.112627986348123,73.37883959044369,6.939704209328783,0.3412969283276451,0.22753128555176336
109,경상북도,구미시,인동동,인동동제9투,2876,2006,584,1200,176,25,2,1987,19,870,29.391041771514846,60.392551585304474,8.857574232511324,1.2581781580271767,0.10065425264217413
110,경상북도,구미시,인동동,인동동제10투,4205,2715,860,1618,184,32,3,2697,18,1490,31.88728216536893,59.9925843529848,6.822395253985911,1.1865035224323321,0.11123470522803114
111,경상북도,구미시,인동동,인동동제11투,2762,1601,459,999,118,11,2,1589,12,1161,28.886091881686593,62.86972938955317,7.426054122089365,0.6922592825676527,0.12586532410320958
112,경상북도,구미시,진미동,관내사전투표,3923,3923,1742,1611,485,29,6,3873,50,0,44.97805318874258,41.59566227730441,12.522592305706171,0.7487735605473793,0.1549186676994578
113,경상북도,구미시,진미동,진미동제1투,808,521,96,328,82,5,1,512,9,287,18.75,64.0625,16.015625,0.9765625,0.1953125
114,경상북도,구미시,진미동,진미동제2투,2928,1221,216,839,140,14,1,1210,11,1707,17.85123966942149,69.33884297520662,11.570247933884298,1.1570247933884297,0.08264462809917356
115,경상북도,구미시,진미동,진미동제3투,3680,1574,318,1064,167,12,1,1562,12,2106,20.358514724711906,68.11779769526248,10.691421254801536,0.7682458386683738,0.06402048655569782
116,경상북도,구미시,진미동,진미동제4투,4183,1915,481,1181,216,18,3,1899,16,2268,25.3291205897841,62.190626645602954,11.374407582938389,0.9478672985781991,0.1579778830963665
117,경상북도,구미시,양포동,관내사전투표,6906,6905,3585,2305,878,71,11,6850,55,1,52.33576642335767,33.64963503649635,12.817518248175183,1.0364963503649636,0.16058394160583941
118,경상북도,구미시,양포동,양포동제1투,2936,1746,394,1093,232,16,1,1736,10,1190,22.69585253456221,62.96082949308756,13.36405529953917,0.9216589861751152,0.0576036866359447
119,경상북도,구미시,양포동,양포동제2투,3338,2402,743,1403,225,16,2,2389,13,936,31.100879028882378,58.72750104646296,9.41816659690247,0.6697362913352868,0.08371703641691085
120,경상북도,구미시,양포동,양포동제3투,3885,2741,649,1642,405,15,6,2717,24,1144,23.88663967611336,60.4343025395657,14.906146485093855,0.5520794994479205,0.22083179977916823
121,경상북도,구미시,양포동,양포동제4투,2613,1713,418,1119,146,16,2,1701,12,900,24.573780129335685,65.78483245149911,8.583186360964138,0.940623162845385,0.11757789535567313
122,경상북도,구미시,양포동,양포동제5투,2640,1863,491,1215,125,19,3,1853,10,777,26.497571505666485,65.569347004857,6.7458175930922835,1.0253642741500268,0.16189962223421478
123,경상북도,구미시,양포동,양포동제6투,2154,1418,378,925,91,9,0,1403,15,736,26.942266571632217,65.93014967925873,6.486101211689238,0.6414825374198148,0.0
124,경상북도,구미시,양포동,양포동제7투,2147,1472,356,937,139,16,2,1450,22,675,24.551724137931036,64.62068965517241,9.586206896551724,1.103448275862069,0.13793103448275862
125,경상북도,구미시,양포동,양포동제8투,1891,1320,404,794,104,11,0,1313,7,571,30.76923076923077,60.47220106626047,7.920792079207921,0.8377760853008377,0.0
126,경상북도,구미시,양포동,양포동제9투,2689,1997,744,1014,209,22,1,1990,7,692,37.38693467336683,50.95477386934674,10.50251256281407,1.105527638190955,0.05025125628140704
127,경상북도,구미시,양포동,양포동제10투,2486,1898,678,1003,178,14,7,1880,18,588,36.06382978723404,53.351063829787236,9.46808510638298,0.7446808510638299,0.37234042553191493
128,경상북도,구미시,잘못 투입·구분된 투표지,,0,3,2,1,0,0,0,3,0,-3,66.66666666666666,33.33333333333333,0.0,0.0,0.0
0,경상북도,영주시,거소·선상투표,,338,326,80,187,29,4,3,303,23,12,26.4026402640264,61.71617161716172,9.570957095709572,1.3201320132013201,0.9900990099009901
1,경상북도,영주시,관외사전투표,,5395,5394,1950,2471,844,48,12,5325,69,1,36.61971830985916,46.4037558685446,15.849765258215962,0.9014084507042254,0.22535211267605634
2,경상북도,영주시,재외투표,,272,210,146,40,20,2,0,208,2,62,70.1923076923077,19.230769230769234,9.615384615384617,0.9615384615384616,0.0
3,경상북도,영주시,풍기읍,관내사전투표,2456,2456,995,1291,139,11,1,2437,19,0,40.828887977020926,52.9749692244563,5.703734099302421,0.45137464095199015,0.04103405826836274
4,경상북도,영주시,풍기읍,풍기읍제1투,1199,850,130,696,17,3,1,847,3,349,15.348288075560804,82.17237308146399,2.0070838252656436,0.3541912632821724,0.11806375442739078
5,경상북도,영주시,풍기읍,풍기읍제2투,1392,953,119,795,26,3,1,944,9,439,12.60593220338983,84.21610169491525,2.754237288135593,0.31779661016949157,0.1059322033898305
6,경상북도,영주시,풍기읍,풍기읍제3투,1355,923,116,761,37,2,0,916,7,432,12.663755458515283,83.07860262008734,4.039301310043668,0.21834061135371177,0.0
7,경상북도,영주시,풍기읍,풍기읍제4투,1592,1004,181,758,50,6,1,996,8,588,18.17269076305221,76.10441767068274,5.020080321285141,0.6024096385542169,0.1004016064257028
8,경상북도,영주시,풍기읍,풍기읍제5투,829,601,84,493,14,2,2,595,6,228,14.117647058823529,82.85714285714286,2.3529411764705883,0.33613445378151263,0.33613445378151263
9,경상북도,영주시,이산면,관내사전투표,555,555,191,314,40,2,1,548,7,0,34.85401459854015,57.299270072992705,7.2992700729927,0.36496350364963503,0.18248175182481752
10,경상북도,영주시,이산면,이산면제1투,717,476,70,381,20,2,0,473,3,241,14.799154334038056,80.54968287526427,4.2283298097251585,0.42283298097251587,0.0
11,경상북도,영주시,이산면,이산면제2투,571,410,57,335,14,0,0,406,4,161,14.039408866995073,82.51231527093597,3.4482758620689653,0.0,0.0
12,경상북도,영주시,평은면,관내사전투표,431,431,115,294,15,3,0,427,4,0,26.93208430913349,68.85245901639344,3.51288056206089,0.702576112412178,0.0
13,경상북도,영주시,평은면,평은면투표소,814,560,53,493,8,1,0,555,5,254,9.54954954954955,88.82882882882883,1.4414414414414414,0.18018018018018017,0.0
14,경상북도,영주시,문수면,관내사전투표,634,634,205,378,31,5,2,621,13,0,33.011272141706925,60.86956521739131,4.99194847020934,0.8051529790660225,0.322061191626409
15,경상북도,영주시,문수면,문수면투표소,1049,686,98,544,21,7,3,673,13,363,14.561664190193166,80.83209509658246,3.1203566121842496,1.040118870728083,0.44576523031203563
16,경상북도,영주시,장수면,관내사전투표,663,663,204,399,46,7,0,656,7,0,31.097560975609756,60.82317073170732,7.01219512195122,1.0670731707317074,0.0
17,경상북도,영주시,장수면,장수면제1투,907,638,69,538,15,1,0,623,15,269,11.075441412520064,86.35634028892456,2.4077046548956664,0.16051364365971107,0.0
18,경상북도,영주시,장수면,장수면제2투,360,258,30,219,3,3,0,255,3,102,11.76470588235294,85.88235294117646,1.1764705882352942,1.1764705882352942,0.0
19,경상북도,영주시,안정면,관내사전투표,788,788,269,466,43,5,1,784,4,0,34.31122448979592,59.43877551020408,5.48469387755102,0.6377551020408163,0.12755102040816327
20,경상북도,영주시,안정면,안정면제1투,1216,819,102,684,19,4,0,809,10,397,12.60815822002472,84.54882571075402,2.3485784919653896,0.4944375772558714,0.0
21,경상북도,영주시,안정면,안정면제2투,570,440,55,372,8,1,0,436,4,130,12.614678899082568,85.3211009174312,1.834862385321101,0.22935779816513763,0.0
22,경상북도,영주시,봉현면,관내사전투표,560,560,210,319,23,5,1,558,2,0,37.634408602150536,57.168458781362006,4.121863799283155,0.8960573476702508,0.17921146953405018
23,경상북도,영주시,봉현면,봉현면제1투,1086,750,91,630,25,2,0,748,2,336,12.165775401069519,84.22459893048129,3.342245989304813,0.267379679144385,0.0
24,경상북도,영주시,봉현면,봉현면제2투,590,472,77,387,6,0,0,470,2,118,16.382978723404253,82.34042553191489,1.276595744680851,0.0,0.0
25,경상북도,영주시,순흥면,관내사전투표,722,722,199,475,30,6,0,710,12,0,28.028169014084508,66.90140845070422,4.225352112676056,0.8450704225352111,0.0
26,경상북도,영주시,순흥면,순흥면투표소,1071,777,100,642,23,6,1,772,5,294,12.953367875647666,83.16062176165802,2.9792746113989637,0.7772020725388601,0.1295336787564767
27,경상북도,영주시,단산면,관내사전투표,418,418,117,255,31,5,1,409,9,0,28.606356968215156,62.34718826405869,7.579462102689487,1.2224938875305624,0.24449877750611246
28,경상북도,영주시,단산면,단산면제1투,580,414,66,332,10,1,1,410,4,166,16.097560975609756,80.97560975609757,2.4390243902439024,0.24390243902439024,0.24390243902439024
29,경상북도,영주시,단산면,단산면제2투,534,411,55,339,7,3,1,405,6,123,13.580246913580247,83.7037037037037,1.728395061728395,0.7407407407407408,0.24691358024691357
30,경상북도,영주시,부석면,관내사전투표,800,800,253,495,35,5,0,788,12,0,32.10659898477157,62.817258883248726,4.441624365482234,0.6345177664974619,0.0
31,경상북도,영주시,부석면,부석면제1투,1278,884,130,709,32,3,1,875,9,394,14.857142857142858,81.02857142857142,3.6571428571428575,0.34285714285714286,0.1142857142857143
32,경상북도,영주시,부석면,부석면제2투,437,293,49,230,9,3,0,291,2,144,16.83848797250859,79.03780068728523,3.0927835051546393,1.0309278350515463,0.0
33,경상북도,영주시,상망동,관내사전투표,1562,1561,676,764,101,8,0,1549,12,1,43.64105874757908,49.32214331826985,6.520335700451904,0.5164622336991607,0.0
34,경상북도,영주시,상망동,상망동제1투,708,460,75,361,15,0,0,451,9,248,16.62971175166297,80.04434589800444,3.325942350332594,0.0,0.0
35,경상북도,영주시,상망동,상망동제2투,2017,1432,316,1025,72,11,2,1426,6,585,22.159887798036465,71.87938288920056,5.049088359046284,0.7713884992987377,0.1402524544179523
36,경상북도,영주시,상망동,상망동제3투,1250,849,151,654,33,2,0,840,9,401,17.976190476190474,77.85714285714286,3.9285714285714284,0.2380952380952381,0.0
37,경상북도,영주시,하망동,관내사전투표,1382,1381,506,779,65,6,2,1358,23,1,37.26067746686304,57.363770250368184,4.786450662739323,0.4418262150220913,0.14727540500736377
38,경상북도,영주시,하망동,하망동제1투,1291,873,131,703,31,1,1,867,6,418,15.109573241061131,81.08419838523645,3.575547866205306,0.11534025374855825,0.11534025374855825
39,경상북도,영주시,하망동,하망동제2투,843,661,167,440,41,9,2,659,2,182,25.341426403641883,66.76783004552352,6.22154779969651,1.3657056145675266,0.30349013657056145
40,경상북도,영주시,하망동,하망동제3투,1120,803,115,660,24,2,1,802,1,317,14.33915211970075,82.29426433915212,2.9925187032418954,0.24937655860349126,0.12468827930174563
41,경상북도,영주시,영주1동,관내사전투표,1099,1099,410,601,74,11,1,1097,2,0,37.3746581586144,54.78577939835916,6.74567000911577,1.0027347310847767,0.09115770282588878
42,경상북도,영주시,영주1동,영주1동제1투,1130,719,85,607,22,2,0,716,3,411,11.871508379888269,84.77653631284916,3.072625698324022,0.27932960893854747,0.0
43,경상북도,영주시,영주1동,영주1동제2투,1104,747,110,601,23,3,2,739,8,357,14.884979702300406,81.32611637347767,3.1123139377537212,0.40595399188092013,0.2706359945872801
44,경상북도,영주시,영주2동,관내사전투표,1898,1898,724,1045,103,15,1,1888,10,0,38.347457627118644,55.34957627118644,5.455508474576272,0.7944915254237288,0.05296610169491525
45,경상북도,영주시,영주2동,영주2동제1투,1766,1243,188,1001,47,2,0,1238,5,523,15.18578352180937,80.8562197092084,3.7964458804523424,0.16155088852988692,0.0
46,경상북도,영주시,영주2동,영주2동제2투,905,645,83,532,17,3,1,636,9,260,13.050314465408805,83.64779874213836,2.6729559748427674,0.4716981132075472,0.15723270440251574
47,경상북도,영주시,휴천1동,관내사전투표,1213,1213,518,602,70,10,1,1201,12,0,43.13072439633638,50.12489592006661,5.828476269775187,0.832639467110741,0.08326394671107411
48,경상북도,영주시,휴천1동,휴천1동제1투,1309,869,135,695,32,2,1,865,4,440,15.606936416184972,80.34682080924856,3.6994219653179194,0.23121387283236997,0.11560693641618498
49,경상북도,영주시,휴천1동,휴천1동제2투,1885,1279,278,912,70,10,4,1274,5,606,21.821036106750395,71.58555729984302,5.4945054945054945,0.7849293563579277,0.3139717425431711
50,경상북도,영주시,휴천2동,관내사전투표,2293,2293,970,1133,157,17,1,2278,15,0,42.58121158911325,49.736611062335385,6.892010535557507,0.7462686567164178,0.043898156277436345
51,경상북도,영주시,휴천2동,휴천2동제1투,1896,1323,173,1111,29,1,1,1315,8,573,13.155893536121674,84.48669201520913,2.2053231939163496,0.07604562737642585,0.07604562737642585
52,경상북도,영주시,휴천2동,휴천2동제2투,1543,960,202,664,75,7,2,950,10,583,21.263157894736842,69.89473684210526,7.894736842105263,0.7368421052631579,0.21052631578947367
53,경상북도,영주시,휴천2동,휴천2동제3투,1520,1154,218,856,56,16,1,1147,7,366,19.006102877070617,74.62946817785527,4.882301656495205,1.3949433304272014,0.08718395815170009
54,경상북도,영주시,휴천2동,휴천2동제4투,1016,684,89,566,20,4,2,681,3,332,13.069016152716593,83.11306901615272,2.936857562408223,0.5873715124816447,0.2936857562408223
55,경상북도,영주시,휴천3동,관내사전투표,1398,1398,567,739,66,16,0,1388,10,0,40.85014409221902,53.24207492795389,4.755043227665706,1.1527377521613833,0.0
56,경상북도,영주시,휴천3동,휴천3동제1투,1258,844,127,682,27,5,0,841,3,414,15.101070154577883,81.09393579072533,3.2104637336504163,0.5945303210463734,0.0
57,경상북도,영주시,휴천3동,휴천3동제2투,2957,2122,443,1549,105,12,2,2111,11,835,20.98531501657982,73.37754618664141,4.973945997157745,0.5684509711037423,0.09474182851729039
58,경상북도,영주시,가흥1동,관내사전투표,3803,3803,1894,1551,298,37,2,3782,21,0,50.07932310946589,41.01004759386568,7.879428873611846,0.9783183500793231,0.052882072977260705
59,경상북도,영주시,가흥1동,가흥1동제1투,2547,1528,352,1068,87,12,0,1519,9,1019,23.173140223831467,70.30941408821593,5.727452271231074,0.7899934167215273,0.0
60,경상북도,영주시,가흥1동,가흥1동제2투,2676,1705,374,1186,124,13,0,1697,8,971,22.038892162639954,69.88803771361226,7.307012374779022,0.7660577489687684,0.0
61,경상북도,영주시,가흥1동,가흥1동제3투,2241,1617,596,915,81,17,2,1611,6,624,36.995654872749846,56.79702048417133,5.027932960893855,1.0552451893234016,0.12414649286157665
62,경상북도,영주시,가흥2동,관내사전투표,1827,1827,787,877,125,15,2,1806,21,0,43.57696566998893,48.56035437430786,6.921373200442968,0.8305647840531563,0.11074197120708748
63,경상북도,영주시,가흥2동,가흥2동제1투,2404,1550,294,1162,71,11,0,1538,12,854,19.115734720416125,75.55266579973993,4.616384915474643,0.7152145643693107,0.0
64,경상북도,영주시,가흥2동,가흥2동제2투,2861,1825,439,1252,102,17,2,1812,13,1036,24.22737306843267,69.09492273730685,5.629139072847682,0.9381898454746136,0.11037527593818984
65,경상북도,영주시,잘못 투입·구분된 투표지,,0,1,1,0,0,0,0,1,0,-1,100.0,0.0,0.0,0.0,0.0
0,경상북도,영천시,거소·선상투표,,294,270,87,113,28,5,2,235,35,24,37.02127659574468,48.08510638297872,11.914893617021278,2.127659574468085,0.851063829787234
1,경상북도,영천시,관외사전투표,,7492,7491,2311,4309,742,53,10,7425,66,1,31.124579124579128,58.033670033670035,9.993265993265993,0.7138047138047138,0.13468013468013468
2,경상북도,영천시,재외투표,,345,212,115,72,17,4,0,208,4,133,55.28846153846154,34.61538461538461,8.173076923076923,1.9230769230769231,0.0
3,경상북도,영천시,금호읍,관내사전투표,1757,1757,469,1193,72,11,0,1745,12,0,26.876790830945556,68.36676217765043,4.126074498567335,0.6303724928366762,0.0
4,경상북도,영천시,금호읍,금호읍제1투,1318,857,85,740,24,3,2,854,3,461,9.953161592505854,86.65105386416862,2.810304449648712,0.351288056206089,0.234192037470726
5,경상북도,영천시,금호읍,금호읍제2투,1807,1254,165,1018,54,8,4,1249,5,553,13.210568454763811,81.50520416333067,4.323458767013611,0.6405124099279423,0.32025620496397117
6,경상북도,영천시,금호읍,금호읍제3투,836,577,47,511,10,2,1,571,6,259,8.231173380035026,89.49211908931699,1.7513134851138354,0.3502626970227671,0.17513134851138354
7,경상북도,영천시,금호읍,금호읍제4투,1107,786,76,673,19,9,2,779,7,321,9.75609756097561,86.39281129653402,2.4390243902439024,1.1553273427471118,0.25673940949935814
8,경상북도,영천시,금호읍,금호읍제5투,600,424,46,363,7,1,1,418,6,176,11.004784688995215,86.8421052631579,1.674641148325359,0.23923444976076555,0.23923444976076555
9,경상북도,영천시,금호읍,금호읍제6투,1146,711,118,568,21,3,0,710,1,435,16.619718309859156,80.0,2.9577464788732395,0.42253521126760557,0.0
10,경상북도,영천시,청통면,관내사전투표,854,854,180,637,27,2,1,847,7,0,21.251475796930343,75.20661157024794,3.187721369539551,0.23612750885478156,0.11806375442739078
11,경상북도,영천시,청통면,청통면제1투,1510,1026,101,891,29,1,1,1023,3,484,9.872922776148583,87.09677419354838,2.834799608993157,0.09775171065493646,0.09775171065493646
12,경상북도,영천시,청통면,청통면제2투,811,570,54,497,13,2,0,566,4,241,9.540636042402827,87.80918727915194,2.2968197879858656,0.35335689045936397,0.0
13,경상북도,영천시,신녕면,관내사전투표,1032,1032,196,788,37,3,0,1024,8,0,19.140625,76.953125,3.61328125,0.29296875,0.0
14,경상북도,영천시,신녕면,신녕면제1투,1008,636,55,559,11,3,2,630,6,372,8.73015873015873,88.73015873015872,1.746031746031746,0.4761904761904762,0.31746031746031744
15,경상북도,영천시,신녕면,신녕면제2투,986,640,64,553,14,1,0,632,8,346,10.126582278481013,87.5,2.2151898734177213,0.15822784810126583,0.0
16,경상북도,영천시,화산면,관내사전투표,746,746,193,500,29,6,2,730,16,0,26.438356164383563,68.4931506849315,3.9726027397260277,0.821917808219178,0.273972602739726
17,경상북도,영천시,화산면,화산면투표소,1793,1109,88,983,26,4,0,1101,8,684,7.992733878292461,89.28247048138056,2.361489554950045,0.36330608537693004,0.0
18,경상북도,영천시,화북면,관내사전투표,484,484,144,325,10,2,0,481,3,0,29.93762993762994,67.56756756756756,2.079002079002079,0.4158004158004158,0.0
19,경상북도,영천시,화북면,화북면투표소,1292,947,99,824,14,3,1,941,6,345,10.520722635494154,87.56641870350691,1.487778958554729,0.3188097768331562,0.10626992561105207
20,경상북도,영천시,화남면,관내사전투표,759,759,186,542,25,3,0,756,3,0,24.6031746031746,71.6931216931217,3.3068783068783065,0.3968253968253968,0.0
21,경상북도,영천시,화남면,화남면제1투,1223,832,68,741,16,1,0,826,6,391,8.232445520581114,89.70944309927361,1.937046004842615,0.12106537530266344,0.0
22,경상북도,영천시,화남면,화남면제2투,749,559,66,481,4,2,0,553,6,190,11.934900542495479,86.98010849909585,0.7233273056057866,0.3616636528028933,0.0
23,경상북도,영천시,자양면,관내사전투표,203,203,51,137,12,0,1,201,2,0,25.37313432835821,68.1592039800995,5.970149253731343,0.0,0.4975124378109453
24,경상북도,영천시,자양면,자양면투표소,721,498,38,446,7,2,1,494,4,223,7.6923076923076925,90.2834008097166,1.417004048582996,0.4048582995951417,0.20242914979757085
25,경상북도,영천시,임고면,관내사전투표,1087,1087,286,730,60,6,1,1083,4,0,26.408125577100645,67.40535549399816,5.540166204986149,0.554016620498615,0.09233610341643582
26,경상북도,영천시,임고면,임고면제1투,950,691,62,613,12,2,1,690,1,259,8.985507246376812,88.84057971014492,1.7391304347826086,0.2898550724637681,0.14492753623188406
27,경상북도,영천시,임고면,임고면제2투,886,654,66,570,10,2,0,648,6,232,10.185185185185185,87.96296296296296,1.5432098765432098,0.30864197530864196,0.0
28,경상북도,영천시,임고면,임고면제3투,734,534,51,468,5,4,0,528,6,200,9.659090909090908,88.63636363636364,0.946969696969697,0.7575757575757576,0.0
29,경상북도,영천시,고경면,관내사전투표,959,959,277,590,76,5,1,949,10,0,29.1886195995785,62.17070600632244,8.008429926238145,0.5268703898840885,0.10537407797681769
30,경상북도,영천시,고경면,고경면제1투,806,548,73,452,10,2,3,540,8,258,13.518518518518519,83.7037037037037,1.8518518518518516,0.3703703703703704,0.5555555555555556
31,경상북도,영천시,고경면,고경면제2투,1677,1139,159,920,46,4,1,1130,9,538,14.07079646017699,81.41592920353983,4.070796460176991,0.35398230088495575,0.08849557522123894
32,경상북도,영천시,고경면,고경면제3투,874,613,63,536,6,3,2,610,3,261,10.327868852459018,87.8688524590164,0.9836065573770493,0.49180327868852464,0.32786885245901637
33,경상북도,영천시,북안면,관내사전투표,1183,1183,334,792,44,6,0,1176,7,0,28.401360544217685,67.3469387755102,3.741496598639456,0.5102040816326531,0.0
34,경상북도,영천시,북안면,북안면제1투,1074,733,77,623,10,5,1,716,17,341,10.754189944134078,87.01117318435753,1.3966480446927374,0.6983240223463687,0.13966480446927373
35,경상북도,영천시,북안면,북안면제2투,1407,819,98,697,14,2,3,814,5,588,12.039312039312039,85.62653562653563,1.71990171990172,0.2457002457002457,0.36855036855036855
36,경상북도,영천시,대창면,관내사전투표,747,747,166,544,30,1,1,742,5,0,22.371967654986523,73.31536388140162,4.0431266846361185,0.13477088948787064,0.13477088948787064
37,경상북도,영천시,대창면,대창면투표소,1755,1207,115,1050,30,4,2,1201,6,548,9.575353871773522,87.42714404662782,2.497918401332223,0.33305578684429643,0.16652789342214822
38,경상북도,영천시,동부동,관내사전투표,2803,2803,925,1680,155,24,3,2787,16,0,33.18980983135988,60.279870828848225,5.561535701471116,0.8611410118406888,0.1076426264800861
39,경상북도,영천시,동부동,동부동제1투,1870,1322,188,1083,43,1,2,1317,5,548,14.274867122247532,82.23234624145786,3.264996203492786,0.07593014426727411,0.15186028853454822
40,경상북도,영천시,동부동,동부동제2투,3045,2261,464,1659,106,23,0,2252,9,784,20.603907637655418,73.66785079928952,4.706927175843695,1.0213143872113677,0.0
41,경상북도,영천시,동부동,동부동제3투,2207,1545,228,1233,65,11,0,1537,8,662,14.83409238776838,80.22121014964216,4.229017566688354,0.715679895901106,0.0
42,경상북도,영천시,동부동,동부동제4투,1922,1258,159,1051,33,2,1,1246,12,664,12.76083467094703,84.34991974317818,2.648475120385233,0.16051364365971107,0.08025682182985554
43,경상북도,영천시,동부동,동부동제5투,2612,1896,324,1469,76,14,1,1884,12,716,17.197452229299362,77.9723991507431,4.033970276008493,0.743099787685775,0.05307855626326964
44,경상북도,영천시,동부동,동부동제6투,2435,1724,293,1355,59,7,1,1715,9,711,17.08454810495627,79.00874635568513,3.4402332361516033,0.40816326530612246,0.05830903790087463
45,경상북도,영천시,동부동,동부동제7투,2293,1725,438,1161,100,14,2,1715,10,568,25.53935860058309,67.69679300291546,5.830903790087463,0.8163265306122449,0.11661807580174927
46,경상북도,영천시,중앙동,관내사전투표,2715,2715,924,1527,225,19,1,2696,19,0,34.27299703264095,56.63946587537092,8.345697329376854,0.7047477744807121,0.0370919881305638
47,경상북도,영천시,중앙동,중앙동제1투,2370,1569,272,1187,91,10,3,1563,6,801,17.402431222008957,75.94369801663467,5.82213691618682,0.6397952655150352,0.19193857965451055
48,경상북도,영천시,중앙동,중앙동제2투,1761,1305,175,1069,53,4,0,1301,4,456,13.45119139123751,82.16756341275942,4.073789392774789,0.3074558032282859,0.0
49,경상북도,영천시,중앙동,중앙동제3투,856,615,63,531,14,2,0,610,5,241,10.327868852459018,87.04918032786885,2.2950819672131146,0.32786885245901637,0.0
50,경상북도,영천시,서부동,관내사전투표,1343,1343,423,833,63,8,2,1329,14,0,31.82844243792325,62.67870579382995,4.740406320541761,0.601956358164033,0.15048908954100826
51,경상북도,영천시,서부동,서부동제1투,1541,1080,114,917,37,6,0,1074,6,461,10.614525139664805,85.38175046554935,3.445065176908752,0.5586592178770949,0.0
52,경상북도,영천시,서부동,서부동제2투,1189,801,102,656,29,8,1,796,5,388,12.814070351758794,82.41206030150754,3.6432160804020097,1.0050251256281406,0.12562814070351758
53,경상북도,영천시,완산동,관내사전투표,3264,3264,1084,1941,196,22,2,3245,19,0,33.40523882896764,59.8151001540832,6.040061633281972,0.6779661016949152,0.061633281972265024
54,경상북도,영천시,완산동,완산동제1투,3535,2582,433,2026,94,11,1,2565,17,953,16.881091617933723,78.98635477582846,3.6647173489278755,0.42884990253411304,0.03898635477582846
55,경상북도,영천시,완산동,완산동제2투,1684,1164,122,1002,30,5,0,1159,5,520,10.526315789473683,86.45383951682484,2.5884383088869716,0.4314063848144953,0.0
56,경상북도,영천시,남부동,관내사전투표,1069,1069,347,628,69,14,1,1059,10,0,32.76676109537299,59.301227573182246,6.515580736543909,1.3220018885741265,0.09442870632672333
57,경상북도,영천시,남부동,남부동제1투,637,452,51,389,11,0,0,451,1,185,11.30820399113082,86.25277161862527,2.4390243902439024,0.0,0.0
58,경상북도,영천시,남부동,남부동제2투,1731,1124,164,913,39,2,0,1118,6,607,14.669051878354203,81.66368515205724,3.488372093023256,0.17889087656529518,0.0
59,경상북도,영천시,잘못 투입·구분된 투표지,,0,1,1,0,0,0,0,1,0,-1,100.0,0.0,0.0,0.0,0.0
0,경상북도,상주시,거소·선상투표,,450,430,114,254,29,8,6,411,19,20,27.73722627737226,61.80048661800487,7.0559610705596105,1.9464720194647203,1.4598540145985401
1,경상북도,상주시,관외사전투표,,5735,5733,1916,2980,701,57,13,5667,66,2,33.80977589553555,52.58514205046762,12.369860596435505,1.0058231868713605,0.22939827068995938
2,경상북도,상주시,재외투표,,479,298,135,133,26,4,0,298,0,181,45.302013422818796,44.63087248322148,8.724832214765101,1.342281879194631,0.0
3,경상북도,상주시,함창읍,관내사전투표,1912,1912,454,1363,71,10,1,1899,13,0,23.9073196419168,71.77461822011585,3.738809899947341,0.526592943654555,0.0526592943654555
4,경상북도,상주시,함창읍,함창읍제1투,1462,969,128,787,44,2,1,962,7,493,13.305613305613306,81.8087318087318,4.5738045738045745,0.2079002079002079,0.10395010395010396
5,경상북도,상주시,함창읍,함창읍제2투,986,681,82,568,21,3,0,674,7,305,12.166172106824925,84.27299703264094,3.115727002967359,0.44510385756676557,0.0
6,경상북도,상주시,함창읍,함창읍제3투,783,506,59,430,13,0,0,502,4,277,11.752988047808765,85.65737051792829,2.589641434262948,0.0,0.0
7,경상북도,상주시,사벌국면,관내사전투표,1160,1160,243,835,50,9,2,1139,21,0,21.334503950834065,73.3099209833187,4.389815627743634,0.7901668129938543,0.17559262510974538
8,경상북도,상주시,사벌국면,사벌국면제1투,1224,794,97,664,25,1,1,788,6,430,12.30964467005076,84.26395939086294,3.1725888324873095,0.12690355329949238,0.12690355329949238
9,경상북도,상주시,사벌국면,사벌국면제2투,704,496,52,423,19,0,0,494,2,208,10.526315789473683,85.62753036437248,3.8461538461538463,0.0,0.0
10,경상북도,상주시,중동면,관내사전투표,464,464,82,357,17,0,0,456,8,0,17.982456140350877,78.28947368421053,3.7280701754385963,0.0,0.0
11,경상북도,상주시,중동면,중동면투표소,659,468,43,405,13,3,0,464,4,191,9.267241379310345,87.28448275862068,2.8017241379310347,0.646551724137931,0.0
12,경상북도,상주시,낙동면,관내사전투표,838,838,178,631,21,4,0,834,4,0,21.34292565947242,75.65947242206235,2.5179856115107913,0.4796163069544364,0.0
13,경상북도,상주시,낙동면,낙동면제1투,989,627,57,543,19,3,0,622,5,362,9.163987138263666,87.29903536977493,3.054662379421222,0.482315112540193,0.0
14,경상북도,상주시,낙동면,낙동면제2투,636,449,58,381,4,1,0,444,5,187,13.063063063063062,85.8108108108108,0.9009009009009009,0.22522522522522523,0.0
15,경상북도,상주시,낙동면,낙동면제3투,648,460,59,383,8,2,0,452,8,188,13.053097345132745,84.7345132743363,1.7699115044247788,0.4424778761061947,0.0
16,경상북도,상주시,청리면,관내사전투표,725,725,168,515,33,5,1,722,3,0,23.26869806094183,71.32963988919667,4.570637119113574,0.6925207756232686,0.13850415512465375
17,경상북도,상주시,청리면,청리면투표소,1426,1020,91,890,21,4,2,1008,12,406,9.027777777777777,88.29365079365078,2.083333333333333,0.3968253968253968,0.1984126984126984
18,경상북도,상주시,공성면,관내사전투표,929,929,215,670,35,1,1,922,7,0,23.318872017353577,72.66811279826464,3.7960954446854664,0.10845986984815618,0.10845986984815618
19,경상북도,상주시,공성면,공성면제1투,1063,766,61,672,16,3,0,752,14,297,8.111702127659575,89.36170212765957,2.127659574468085,0.39893617021276595,0.0
20,경상북도,상주시,공성면,공성면제2투,1205,794,103,666,21,1,0,791,3,411,13.02149178255373,84.19721871049305,2.6548672566371683,0.12642225031605564,0.0
21,경상북도,상주시,외남면,관내사전투표,419,419,108,293,9,6,0,416,3,0,25.961538461538463,70.4326923076923,2.1634615384615383,1.4423076923076923,0.0
22,경상북도,상주시,외남면,외남면투표소,929,644,75,542,16,2,1,636,8,285,11.79245283018868,85.22012578616352,2.515723270440252,0.3144654088050315,0.15723270440251574
23,경상북도,상주시,내서면,관내사전투표,511,511,136,341,23,5,0,505,6,0,26.930693069306933,67.52475247524752,4.554455445544554,0.9900990099009901,0.0
24,경상북도,상주시,내서면,내서면제1투,465,320,35,277,3,1,1,317,3,145,11.041009463722396,87.38170347003155,0.9463722397476341,0.31545741324921134,0.31545741324921134
25,경상북도,상주시,내서면,내서면제2투,564,383,51,314,11,2,0,378,5,181,13.492063492063492,83.06878306878306,2.91005291005291,0.5291005291005291,0.0
26,경상북도,상주시,모동면,관내사전투표,651,651,245,372,30,1,0,648,3,0,37.808641975308646,57.407407407407405,4.62962962962963,0.15432098765432098,0.0
27,경상북도,상주시,모동면,모동면제1투,790,550,103,422,17,2,0,544,6,240,18.933823529411764,77.57352941176471,3.125,0.3676470588235294,0.0
28,경상북도,상주시,모동면,모동면제2투,691,471,95,347,22,3,0,467,4,220,20.342612419700217,74.30406852248393,4.710920770877944,0.6423982869379015,0.0
29,경상북도,상주시,모서면,관내사전투표,677,677,199,426,42,3,0,670,7,0,29.701492537313435,63.582089552238806,6.26865671641791,0.44776119402985076,0.0
30,경상북도,상주시,모서면,모서면제1투,932,600,101,472,22,3,2,600,0,332,16.833333333333332,78.66666666666666,3.6666666666666665,0.5,0.33333333333333337
31,경상북도,상주시,모서면,모서면제2투,455,307,63,232,7,1,1,304,3,148,20.723684210526315,76.31578947368422,2.302631578947368,0.3289473684210526,0.3289473684210526
32,경상북도,상주시,화동면,관내사전투표,638,638,208,396,28,3,0,635,3,0,32.75590551181102,62.36220472440945,4.409448818897638,0.47244094488188976,0.0
33,경상북도,상주시,화동면,화동면투표소,1000,681,101,550,21,7,0,679,2,319,14.874815905743741,81.00147275405007,3.0927835051546393,1.0309278350515463,0.0
34,경상북도,상주시,화서면,관내사전투표,824,824,209,558,39,11,0,817,7,0,25.581395348837212,68.29865361077111,4.773561811505508,1.346389228886169,0.0
35,경상북도,상주시,화서면,화서면제1투,689,485,49,413,14,1,2,479,6,204,10.22964509394572,86.22129436325679,2.9227557411273484,0.20876826722338201,0.41753653444676403
36,경상북도,상주시,화서면,화서면제2투,820,543,59,456,14,6,1,536,7,277,11.007462686567164,85.07462686567165,2.6119402985074625,1.1194029850746268,0.18656716417910446
37,경상북도,상주시,화북면,관내사전투표,534,534,159,350,17,2,2,530,4,0,30.0,66.0377358490566,3.207547169811321,0.37735849056603776,0.37735849056603776
38,경상북도,상주시,화북면,화북면투표소,743,520,77,428,9,5,0,519,1,223,14.836223506743737,82.46628131021194,1.7341040462427744,0.9633911368015413,0.0
39,경상북도,상주시,외서면,관내사전투표,528,528,135,360,21,7,2,525,3,0,25.71428571428571,68.57142857142857,4.0,1.3333333333333335,0.38095238095238093
40,경상북도,상주시,외서면,외서면제1투,767,476,67,391,11,1,2,472,4,291,14.194915254237289,82.83898305084746,2.330508474576271,0.211864406779661,0.423728813559322
41,경상북도,상주시,외서면,외서면제2투,455,248,25,214,7,2,0,248,0,207,10.080645161290322,86.29032258064517,2.82258064516129,0.8064516129032258,0.0
42,경상북도,상주시,은척면,관내사전투표,428,428,101,289,28,2,1,421,7,0,23.990498812351543,68.646080760095,6.65083135391924,0.4750593824228029,0.23752969121140144
43,경상북도,상주시,은척면,은척면제1투,589,413,56,345,6,1,2,410,3,176,13.658536585365855,84.14634146341463,1.4634146341463417,0.24390243902439024,0.4878048780487805
44,경상북도,상주시,은척면,은척면제2투,258,191,22,165,2,2,0,191,0,67,11.518324607329843,86.38743455497382,1.0471204188481675,1.0471204188481675,0.0
45,경상북도,상주시,공검면,관내사전투표,829,829,186,586,39,9,1,821,8,0,22.655298416565163,71.37637028014616,4.750304506699147,1.0962241169305724,0.12180267965895249
46,경상북도,상주시,공검면,공검면제1투,623,381,42,319,12,0,1,374,7,242,11.229946524064172,85.29411764705883,3.2085561497326207,0.0,0.267379679144385
47,경상북도,상주시,공검면,공검면제2투,469,319,34,266,10,2,1,313,6,150,10.86261980830671,84.98402555910543,3.1948881789137378,0.6389776357827476,0.3194888178913738
48,경상북도,상주시,이안면,관내사전투표,591,591,147,410,20,4,1,582,9,0,25.257731958762886,70.44673539518901,3.436426116838488,0.6872852233676976,0.1718213058419244
49,경상북도,상주시,이안면,이안면투표소,975,665,74,570,8,4,2,658,7,310,11.246200607902736,86.62613981762918,1.21580547112462,0.60790273556231,0.303951367781155
50,경상북도,상주시,화남면,관내사전투표,185,185,45,121,17,1,0,184,1,0,24.456521739130434,65.76086956521739,9.239130434782608,0.5434782608695652,0.0
51,경상북도,상주시,화남면,화남면투표소,429,275,38,223,8,1,0,270,5,154,14.074074074074074,82.5925925925926,2.9629629629629632,0.3703703703703704,0.0
52,경상북도,상주시,남원동,관내사전투표,3077,3077,1020,1748,253,31,4,3056,21,0,33.37696335078534,57.19895287958116,8.278795811518325,1.0143979057591623,0.13089005235602094
53,경상북도,상주시,남원동,남원동제1투,1215,833,88,700,32,2,1,823,10,382,10.69258809234508,85.05467800729039,3.8882138517618468,0.24301336573511542,0.12150668286755771
54,경상북도,상주시,남원동,남원동제2투,1565,1110,186,873,42,5,1,1107,3,455,16.802168021680217,78.86178861788618,3.7940379403794036,0.45167118337850043,0.09033423667570009
55,경상북도,상주시,남원동,남원동제3투,869,601,84,483,29,1,0,597,4,268,14.07035175879397,80.90452261306532,4.857621440536013,0.16750418760469013,0.0
56,경상북도,상주시,남원동,남원동제4투,1147,832,150,652,25,1,1,829,3,315,18.094089264173704,78.64897466827503,3.0156815440289506,0.12062726176115801,0.12062726176115801
57,경상북도,상주시,남원동,남원동제5투,1030,713,113,545,39,8,1,706,7,317,16.005665722379604,77.19546742209631,5.524079320113314,1.13314447592068,0.141643059490085
58,경상북도,상주시,북문동,관내사전투표,2386,2386,780,1404,160,11,4,2359,27,0,33.064857990674014,59.51674438321323,6.782534972445951,0.4662992793556591,0.1695633743111488
59,경상북도,상주시,북문동,북문동제1투,849,613,72,507,23,3,1,606,7,236,11.881188118811881,83.66336633663366,3.7953795379537953,0.49504950495049505,0.16501650165016502
60,경상북도,상주시,북문동,북문동제2투,892,626,119,468,34,0,1,622,4,266,19.131832797427652,75.2411575562701,5.466237942122187,0.0,0.1607717041800643
61,경상북도,상주시,북문동,북문동제3투,1434,862,134,651,63,6,1,855,7,572,15.67251461988304,76.14035087719299,7.368421052631578,0.7017543859649122,0.11695906432748539
62,경상북도,상주시,북문동,북문동제4투,437,310,21,281,3,1,0,306,4,127,6.862745098039216,91.83006535947712,0.9803921568627451,0.32679738562091504,0.0
63,경상북도,상주시,북문동,북문동제5투,1079,747,134,558,43,7,1,743,4,332,18.0349932705249,75.10094212651414,5.787348586810229,0.9421265141318977,0.13458950201884254
64,경상북도,상주시,계림동,관내사전투표,2534,2534,790,1567,135,15,2,2509,25,0,31.48664806695895,62.45516141889199,5.3806297329613395,0.5978477481068154,0.07971303308090873
65,경상북도,상주시,계림동,계림동제1투,1555,1020,146,806,50,8,2,1012,8,535,14.42687747035573,79.64426877470355,4.940711462450593,0.7905138339920948,0.1976284584980237
66,경상북도,상주시,계림동,계림동제2투,1794,1208,268,840,81,13,0,1202,6,586,22.296173044925123,69.88352745424294,6.738768718801996,1.0815307820299502,0.0
67,경상북도,상주시,계림동,계림동제3투,1097,718,108,586,19,1,0,714,4,379,15.126050420168067,82.07282913165265,2.661064425770308,0.1400560224089636,0.0
68,경상북도,상주시,동문동,관내사전투표,2087,2087,647,1240,168,14,1,2070,17,0,31.256038647342994,59.90338164251207,8.115942028985506,0.6763285024154589,0.04830917874396135
69,경상북도,상주시,동문동,동문동제1투,1425,954,147,727,68,6,0,948,6,471,15.50632911392405,76.68776371308017,7.172995780590717,0.6329113924050633,0.0
70,경상북도,상주시,동문동,동문동제2투,873,574,73,475,19,3,1,571,3,299,12.784588441331,83.18739054290718,3.327495621716287,0.5253940455341506,0.17513134851138354
71,경상북도,상주시,동문동,동문동제3투,1017,669,101,519,39,8,0,667,2,348,15.142428785607196,77.81109445277362,5.847076461769116,1.199400299850075,0.0
72,경상북도,상주시,동문동,동문동제4투,652,466,68,373,19,2,0,462,4,186,14.71861471861472,80.73593073593074,4.112554112554113,0.4329004329004329,0.0
73,경상북도,상주시,동성동,관내사전투표,815,815,229,537,41,3,1,811,4,0,28.236744759556103,66.21454993834772,5.055487053020962,0.36991368680641185,0.12330456226880394
74,경상북도,상주시,동성동,동성동제1투,1361,929,139,749,29,3,0,920,9,432,15.108695652173912,81.41304347826087,3.152173913043478,0.32608695652173914,0.0
75,경상북도,상주시,동성동,동성동제2투,685,504,75,399,20,5,1,500,4,181,15.0,79.80000000000001,4.0,1.0,0.2
76,경상북도,상주시,신흥동,관내사전투표,1861,1861,655,1024,160,10,0,1849,12,0,35.42455381287182,55.381287182260685,8.653326122228231,0.5408328826392644,0.0
77,경상북도,상주시,신흥동,신흥동제1투,1311,927,160,722,35,6,0,923,4,384,17.33477789815818,78.22318526543879,3.791982665222102,0.6500541711809318,0.0
78,경상북도,상주시,신흥동,신흥동제2투,1233,759,103,595,53,4,0,755,4,474,13.642384105960264,78.80794701986756,7.0198675496688745,0.5298013245033113,0.0
79,경상북도,상주시,신흥동,신흥동제3투,1736,1141,220,829,74,13,0,1136,5,595,19.366197183098592,72.97535211267606,6.514084507042253,1.1443661971830987,0.0
80,경상북도,상주시,잘못 투입·구분된 투표지,,0,0,0,0,0,0,0,0,0,0,0.0,0.0,0.0,0.0,0.0
0,경상북도,문경시,거소·선상투표,,254,219,36,158,14,0,2,210,9,35,17.142857142857142,75.23809523809524,6.666666666666667,0.0,0.9523809523809524
1,경상북도,문경시,관외사전투표,,4582,4581,1613,2300,563,43,8,4527,54,1,35.63066048155512,50.806273470289376,12.436492158162139,0.9498564170532362,0.17671747294013695
2,경상북도,문경시,재외투표,,236,159,88,51,17,2,0,158,1,77,55.69620253164557,32.278481012658226,10.759493670886076,1.2658227848101267,0.0
3,경상북도,문경시,문경읍,관내사전투표,1761,1761,508,1167,70,11,0,1756,5,0,28.929384965831435,66.45785876993166,3.986332574031891,0.6264236902050113,0.0
4,경상북도,문경시,문경읍,문경읍제1투,1737,1165,132,983,37,4,0,1156,9,572,11.418685121107266,85.03460207612457,3.2006920415224913,0.34602076124567477,0.0
5,경상북도,문경시,문경읍,문경읍제2투,1511,991,117,832,26,6,1,982,9,520,11.914460285132384,84.72505091649694,2.6476578411405294,0.6109979633401221,0.10183299389002036
6,경상북도,문경시,문경읍,문경읍제3투,699,512,63,430,8,2,0,503,9,187,12.524850894632205,85.48707753479125,1.5904572564612325,0.3976143141153081,0.0
7,경상북도,문경시,가은읍,관내사전투표,1228,1228,332,820,42,26,2,1222,6,0,27.168576104746318,67.10310965630114,3.436988543371522,2.127659574468085,0.16366612111292964
8,경상북도,문경시,가은읍,가은읍제1투,1651,1118,134,946,23,5,2,1110,8,533,12.072072072072073,85.22522522522522,2.0720720720720722,0.45045045045045046,0.18018018018018017
9,경상북도,문경시,가은읍,가은읍제2투,418,274,42,218,6,6,0,272,2,144,15.441176470588236,80.14705882352942,2.2058823529411766,2.2058823529411766,0.0
10,경상북도,문경시,영순면,관내사전투표,742,742,166,538,29,3,2,738,4,0,22.493224932249323,72.89972899728997,3.9295392953929538,0.40650406504065045,0.27100271002710025
11,경상북도,문경시,영순면,영순면투표소,1126,753,67,658,15,4,0,744,9,373,9.005376344086022,88.44086021505376,2.0161290322580645,0.5376344086021506,0.0
12,경상북도,문경시,산양면,관내사전투표,774,774,171,560,34,3,0,768,6,0,22.265625,72.91666666666666,4.427083333333334,0.390625,0.0
13,경상북도,문경시,산양면,산양면제1투,821,519,57,451,8,0,0,516,3,302,11.046511627906977,87.40310077519379,1.550387596899225,0.0,0.0
14,경상북도,문경시,산양면,산양면제2투,810,559,71,474,7,2,0,554,5,251,12.815884476534295,85.5595667870036,1.263537906137184,0.36101083032490977,0.0
15,경상북도,문경시,호계면,관내사전투표,705,705,178,490,24,3,1,696,9,0,25.57471264367816,70.40229885057471,3.4482758620689653,0.43103448275862066,0.14367816091954022
16,경상북도,문경시,호계면,호계면투표소,1253,823,98,688,31,3,0,820,3,430,11.951219512195122,83.90243902439025,3.7804878048780486,0.3658536585365854,0.0
17,경상북도,문경시,산북면,관내사전투표,885,885,246,597,29,3,0,875,10,0,28.114285714285714,68.22857142857143,3.314285714285714,0.34285714285714286,0.0
18,경상북도,문경시,산북면,산북면투표소,1381,928,87,802,26,3,2,920,8,453,9.456521739130434,87.17391304347825,2.8260869565217392,0.32608695652173914,0.21739130434782608
19,경상북도,문경시,동로면,관내사전투표,677,677,153,489,24,6,1,673,4,0,22.73402674591382,72.65973254086181,3.566121842496285,0.8915304606240713,0.1485884101040119
20,경상북도,문경시,동로면,동로면투표소,887,581,57,496,20,1,0,574,7,306,9.930313588850174,86.41114982578398,3.484320557491289,0.17421602787456447,0.0
21,경상북도,문경시,마성면,관내사전투표,1086,1086,240,757,54,5,5,1061,25,0,22.620169651272384,71.34778510838832,5.089538171536287,0.47125353440150797,0.47125353440150797
22,경상북도,문경시,마성면,마성면투표소,1796,1133,124,975,27,2,1,1129,4,663,10.983170947741364,86.35961027457927,2.3914968999114263,0.1771479185119575,0.08857395925597875
23,경상북도,문경시,농암면,관내사전투표,684,684,160,492,20,4,1,677,7,0,23.63367799113737,72.67355982274741,2.954209748892171,0.5908419497784343,0.14771048744460857
24,경상북도,문경시,농암면,농암면투표소,1397,908,103,775,13,3,1,895,13,489,11.508379888268157,86.59217877094973,1.452513966480447,0.33519553072625696,0.11173184357541899
25,경상북도,문경시,점촌1동,관내사전투표,2235,2235,559,1527,103,16,3,2208,27,0,25.317028985507246,69.15760869565217,4.664855072463768,0.7246376811594203,0.1358695652173913
26,경상북도,문경시,점촌1동,점촌1동제1투,1312,877,88,764,19,3,1,875,2,435,10.057142857142857,87.31428571428572,2.1714285714285713,0.34285714285714286,0.1142857142857143
27,경상북도,문경시,점촌1동,점촌1동제2투,1578,1034,149,825,45,5,0,1024,10,544,14.55078125,80.56640625,4.39453125,0.48828125,0.0
28,경상북도,문경시,점촌2동,관내사전투표,1747,1747,538,1065,105,22,3,1733,14,0,31.04443162146567,61.45412579342181,6.058857472590883,1.269474899019042,0.17311021350259664
29,경상북도,문경시,점촌2동,점촌2동제1투,1507,1025,108,875,33,3,0,1019,6,482,10.598626104023552,85.8684985279686,3.23846908734053,0.2944062806673209,0.0
30,경상북도,문경시,점촌2동,점촌2동제2투,851,561,51,490,12,1,1,555,6,290,9.18918918918919,88.28828828828829,2.1621621621621623,0.18018018018018017,0.18018018018018017
31,경상북도,문경시,점촌2동,점촌2동제3투,1420,941,124,780,23,7,1,935,6,479,13.262032085561499,83.42245989304813,2.4598930481283423,0.7486631016042781,0.10695187165775401
32,경상북도,문경시,점촌3동,관내사전투표,1924,1924,606,1196,93,13,2,1910,14,0,31.727748691099478,62.617801047120416,4.869109947643979,0.6806282722513088,0.10471204188481677
33,경상북도,문경시,점촌3동,점촌3동제1투,2221,1472,210,1181,64,5,2,1462,10,749,14.36388508891929,80.77975376196991,4.377564979480164,0.3419972640218878,0.13679890560875513
34,경상북도,문경시,점촌3동,점촌3동제2투,2543,1748,256,1419,51,9,1,1736,12,795,14.746543778801843,81.73963133640552,2.9377880184331797,0.5184331797235023,0.0576036866359447
35,경상북도,문경시,점촌4동,관내사전투표,680,680,187,464,23,1,0,675,5,0,27.703703703703702,68.74074074074073,3.4074074074074074,0.14814814814814814,0.0
36,경상북도,문경시,점촌4동,점촌4동투표소,1719,1114,149,921,30,7,0,1107,7,605,13.459801264679314,83.19783197831978,2.710027100271003,0.6323396567299007,0.0
37,경상북도,문경시,점촌5동,관내사전투표,3564,3564,1339,1934,241,24,4,3542,22,0,37.80350084697911,54.60191981931113,6.804065499717674,0.6775832862789385,0.1129305477131564
38,경상북도,문경시,점촌5동,점촌5동제1투,2809,1891,310,1445,111,8,1,1875,16,918,16.53333333333333,77.06666666666668,5.92,0.4266666666666667,0.05333333333333334
39,경상북도,문경시,점촌5동,점촌5동제2투,2413,1606,255,1210,111,9,0,1585,21,807,16.08832807570978,76.34069400630915,7.003154574132492,0.5678233438485805,0.0
40,경상북도,문경시,점촌5동,점촌5동제3투,2163,1471,294,1044,106,14,0,1458,13,692,20.16460905349794,71.60493827160494,7.270233196159122,0.9602194787379973,0.0
41,경상북도,문경시,잘못 투입·구분된 투표지,,0,0,0,0,0,0,0,0,0,0,0.0,0.0,0.0,0.0,0.0
0,경상북도,예천군,거소·선상투표,,157,145,21,100,17,3,0,141,4,12,14.893617021276595,70.92198581560284,12.056737588652481,2.127659574468085,0.0
1,경상북도,예천군,관외사전투표,,4435,4434,1671,2188,492,43,5,4399,35,1,37.98590588770175,49.73857694930666,11.18436008183678,0.9774948852011821,0.11366219595362581
2,경상북도,예천군,재외투표,,219,142,87,43,9,1,0,140,2,77,62.142857142857146,30.714285714285715,6.428571428571428,0.7142857142857143,0.0
3,경상북도,예천군,예천읍,관내사전투표,3877,3877,1164,2444,193,29,2,3832,45,0,30.37578288100209,63.77870563674322,5.036534446764092,0.75678496868476,0.052192066805845504
4,경상북도,예천군,예천읍,예천읍제1투,1492,997,159,788,36,1,1,985,12,495,16.14213197969543,80.0,3.654822335025381,0.10152284263959391,0.10152284263959391
5,경상북도,예천군,예천읍,예천읍제2투,1823,1276,247,946,61,10,1,1265,11,547,19.525691699604746,74.78260869565217,4.822134387351778,0.7905138339920948,0.07905138339920949
6,경상북도,예천군,예천읍,예천읍제3투,2440,1690,233,1385,48,6,4,1676,14,750,13.902147971360382,82.63723150357995,2.863961813842482,0.35799522673031026,0.23866348448687352
7,경상북도,예천군,예천읍,예천읍제4투,2065,1397,216,1096,61,4,2,1379,18,668,15.663524292965917,79.4778825235678,4.423495286439449,0.290065264684554,0.145032632342277
8,경상북도,예천군,호명읍,관내사전투표,3658,3658,1927,1343,338,29,2,3639,19,0,52.954108271503166,36.90574333608134,9.28826600714482,0.7969222313822478,0.05496015388843088
9,경상북도,예천군,호명읍,호명읍제1투,1319,850,113,693,23,2,2,833,17,469,13.565426170468186,83.19327731092437,2.7611044417767108,0.24009603841536614,0.24009603841536614
10,경상북도,예천군,호명읍,호명읍제2투,2235,1641,560,912,134,21,3,1630,11,594,34.355828220858896,55.95092024539877,8.220858895705522,1.2883435582822087,0.18404907975460122
11,경상북도,예천군,호명읍,호명읍제3투,3120,2302,718,1302,246,22,1,2289,13,818,31.367409349060726,56.88073394495413,10.747051114023591,0.9611183923110528,0.043687199650502405
12,경상북도,예천군,호명읍,호명읍제4투,2157,1566,505,896,132,19,0,1552,14,591,32.53865979381443,57.73195876288659,8.505154639175258,1.2242268041237114,0.0
13,경상북도,예천군,용문면,관내사전투표,693,693,182,469,28,5,2,686,7,0,26.53061224489796,68.36734693877551,4.081632653061225,0.7288629737609329,0.2915451895043732
14,경상북도,예천군,용문면,용문면투표소,1174,799,100,672,17,2,1,792,7,375,12.626262626262626,84.84848484848484,2.146464646464646,0.25252525252525254,0.12626262626262627
15,경상북도,예천군,효자면,관내사전투표,363,363,90,250,16,2,1,359,4,0,25.069637883008355,69.63788300835655,4.456824512534819,0.5571030640668524,0.2785515320334262
16,경상북도,예천군,효자면,효자면투표소,601,441,44,376,17,0,0,437,4,160,10.068649885583524,86.04118993135012,3.8901601830663615,0.0,0.0
17,경상북도,예천군,은풍면,관내사전투표,455,455,130,291,28,3,0,452,3,0,28.761061946902654,64.38053097345133,6.1946902654867255,0.6637168141592921,0.0
18,경상북도,예천군,은풍면,은풍면투표소,723,529,61,444,19,4,0,528,1,194,11.553030303030303,84.0909090909091,3.5984848484848486,0.7575757575757576,0.0
19,경상북도,예천군,감천면,관내사전투표,752,752,195,508,35,5,1,744,8,0,26.209677419354836,68.27956989247312,4.704301075268817,0.6720430107526881,0.13440860215053765
20,경상북도,예천군,감천면,감천면투표소,1417,1006,121,838,23,8,1,991,15,411,12.209889001009081,84.56104944500504,2.320887991927346,0.8072653884964682,0.10090817356205853
21,경상북도,예천군,보문면,관내사전투표,478,478,118,329,21,4,0,472,6,0,25.0,69.70338983050848,4.4491525423728815,0.847457627118644,0.0
22,경상북도,예천군,보문면,보문면투표소,879,580,85,475,12,3,0,575,5,299,14.782608695652174,82.6086956521739,2.086956521739131,0.5217391304347827,0.0
23,경상북도,예천군,유천면,관내사전투표,722,722,191,444,74,3,1,713,9,0,26.788218793828893,62.272089761570825,10.37868162692847,0.42075736325385693,0.1402524544179523
24,경상북도,예천군,유천면,유천면투표소,1399,992,141,765,61,7,0,974,18,407,14.476386036960987,78.54209445585215,6.262833675564681,0.7186858316221766,0.0
25,경상북도,예천군,용궁면,관내사전투표,915,915,161,685,41,3,6,896,19,0,17.96875,76.45089285714286,4.575892857142857,0.33482142857142855,0.6696428571428571
26,경상북도,예천군,용궁면,용궁면투표소,1122,732,74,623,22,4,1,724,8,390,10.220994475138122,86.04972375690608,3.0386740331491713,0.5524861878453038,0.13812154696132595
27,경상북도,예천군,개포면,관내사전투표,436,436,76,325,25,3,0,429,7,0,17.715617715617714,75.75757575757575,5.827505827505827,0.6993006993006993,0.0
28,경상북도,예천군,개포면,개포면투표소,832,581,66,500,3,1,1,571,10,251,11.558669001751314,87.56567425569177,0.5253940455341506,0.17513134851138354,0.17513134851138354
29,경상북도,예천군,지보면,관내사전투표,727,727,161,511,33,6,1,712,15,0,22.6123595505618,71.76966292134831,4.634831460674158,0.8426966292134831,0.1404494382022472
30,경상북도,예천군,지보면,지보면투표소,1480,1019,120,859,21,5,2,1007,12,461,11.916583912611719,85.30287984111222,2.0854021847070507,0.49652432969215493,0.19860973187686196
31,경상북도,예천군,풍양면,관내사전투표,780,780,163,549,32,7,3,754,26,0,21.618037135278513,72.81167108753316,4.244031830238726,0.9283819628647214,0.3978779840848806
32,경상북도,예천군,풍양면,풍양면투표소,1712,1202,139,1016,18,7,3,1183,19,510,11.749788672865597,85.88334742180896,1.521555367709214,0.591715976331361,0.25359256128486896
33,경상북도,예천군,잘못 투입·구분된 투표지,,0,0,0,0,0,0,0,0,0,0,0.0,0.0,0.0,0.0,0.0
0,경상북도,경산시,거소·선상투표,,344,319,71,172,48,4,3,298,21,25,23.825503355704697,57.71812080536913,16.10738255033557,1.342281879194631,1.006711409395973
1,경상북도,경산시,관외사전투표,,17824,17822,6138,8698,2594,186,23,17639,183,2,34.797891036906854,49.311185441351554,14.706049095753729,1.054481546572935,0.1303928794149328
2,경상북도,경산시,재외투표,,840,639,391,155,78,13,0,637,2,201,61.38147566718995,24.332810047095762,12.244897959183673,2.0408163265306123,0.0
3,경상북도,경산시,하양읍,관내사전투표,5402,5402,2008,2651,602,67,10,5338,64,0,37.61708505058074,49.66279505432746,11.277632071937054,1.2551517422255525,0.18733608092918697
4,경상북도,경산시,하양읍,하양읍제1투,2077,1370,196,1014,122,13,1,1346,24,707,14.561664190193166,75.33432392273403,9.063893016344725,0.9658246656760773,0.07429420505200594
5,경상북도,경산시,하양읍,하양읍제2투,2072,1378,189,1062,112,10,0,1373,5,694,13.765477057538236,77.34887108521485,8.157319737800437,0.7283321194464676,0.0
6,경상북도,경산시,하양읍,하양읍제3투,3470,2550,528,1800,191,11,2,2532,18,920,20.85308056872038,71.09004739336493,7.543443917851501,0.4344391785150079,0.07898894154818326
7,경상북도,경산시,하양읍,하양읍제4투,586,430,40,362,19,0,0,421,9,156,9.501187648456057,85.98574821852732,4.513064133016627,0.0,0.0
8,경상북도,경산시,하양읍,하양읍제5투,1200,774,95,614,54,2,1,766,8,426,12.402088772845952,80.15665796344648,7.049608355091384,0.26109660574412535,0.13054830287206268
9,경상북도,경산시,하양읍,하양읍제6투,1394,935,129,727,62,10,1,929,6,459,13.885898815931109,78.2561894510226,6.673842841765339,1.0764262648008611,0.1076426264800861
10,경상북도,경산시,하양읍,하양읍제7투,2600,1839,355,1352,99,13,0,1819,20,761,19.516217702034087,74.326553051127,5.442550852116548,0.7146783947223749,0.0
11,경상북도,경산시,하양읍,하양읍제8투,1485,1181,204,887,70,11,0,1172,9,304,17.4061433447099,75.68259385665529,5.972696245733788,0.938566552901024,0.0
12,경상북도,경산시,하양읍,하양읍제9투,2116,1628,414,1050,137,17,3,1621,7,488,25.53979025293029,64.77483035163479,8.451573103022826,1.0487353485502777,0.1850709438618137
13,경상북도,경산시,하양읍,하양읍제10투,3553,2482,515,1656,269,20,2,2462,20,1071,20.917952883834282,67.26238830219334,10.926076360682373,0.8123476848090982,0.08123476848090982
14,경상북도,경산시,진량읍,관내사전투표,4741,4741,1864,2395,391,36,8,4694,47,0,39.71026842778014,51.0225820195995,8.329782701320836,0.7669365146996165,0.17043033659991477
15,경상북도,경산시,진량읍,진량읍제1투,3211,1867,340,1341,163,14,1,1859,8,1344,18.28940290478752,72.13555675094136,8.768154922001075,0.7530930607853685,0.05379236148466917
16,경상북도,경산시,진량읍,진량읍제2투,1723,1205,235,900,55,8,0,1198,7,518,19.61602671118531,75.12520868113522,4.590984974958263,0.667779632721202,0.0
17,경상북도,경산시,진량읍,진량읍제3투,1664,977,94,805,61,9,1,970,7,687,9.690721649484537,82.9896907216495,6.288659793814433,0.9278350515463918,0.10309278350515465
18,경상북도,경산시,진량읍,진량읍제4투,1891,1188,188,932,53,4,2,1179,9,703,15.945716709075489,79.05004240882103,4.495335029686174,0.33927056827820185,0.16963528413910092
19,경상북도,경산시,진량읍,진량읍제5투,2085,1332,195,1003,99,5,8,1310,22,753,14.885496183206106,76.56488549618321,7.557251908396946,0.38167938931297707,0.6106870229007634
20,경상북도,경산시,진량읍,진량읍제6투,1974,1524,256,1168,76,16,1,1517,7,450,16.875411997363216,76.99406723796967,5.009887936717205,1.054713249835201,0.06591957811470006
21,경상북도,경산시,진량읍,진량읍제7투,1735,1315,285,924,86,12,0,1307,8,420,21.80566182096404,70.69625095638867,6.5799540933435345,0.9181331293037491,0.0
22,경상북도,경산시,진량읍,진량읍제8투,1495,1052,171,799,69,7,0,1046,6,443,16.347992351816444,76.38623326959846,6.596558317399618,0.6692160611854685,0.0
23,경상북도,경산시,진량읍,진량읍제9투,2338,1610,340,1160,90,11,0,1601,9,728,21.236727045596503,72.45471580262335,5.621486570893191,0.6870705808869456,0.0
24,경상북도,경산시,진량읍,진량읍제10투,2165,1558,298,1139,89,19,0,1545,13,607,19.28802588996764,73.72168284789645,5.760517799352751,1.2297734627831716,0.0
25,경상북도,경산시,진량읍,진량읍제11투,2253,1700,414,1151,102,24,5,1696,4,553,24.410377358490564,67.86556603773585,6.014150943396227,1.4150943396226416,0.294811320754717
26,경상북도,경산시,압량읍,관내사전투표,3786,3786,1524,1765,423,27,5,3744,42,0,40.705128205128204,47.14209401709402,11.298076923076923,0.7211538461538461,0.13354700854700854
27,경상북도,경산시,압량읍,압량읍제1투,2965,1691,245,1299,126,9,2,1681,10,1274,14.57465794170137,77.27543129089828,7.495538370017847,0.5353955978584176,0.1189767995240928
28,경상북도,경산시,압량읍,압량읍제2투,1454,988,142,779,52,5,2,980,8,466,14.489795918367346,79.48979591836735,5.3061224489795915,0.5102040816326531,0.20408163265306123
29,경상북도,경산시,압량읍,압량읍제3투,3809,2375,441,1605,284,19,2,2351,24,1434,18.75797532964696,68.26882177796682,12.079965971926839,0.8081667375584858,0.08507018290089324
30,경상북도,경산시,압량읍,압량읍제4투,706,532,68,432,20,4,2,526,6,174,12.927756653992395,82.12927756653993,3.802281368821293,0.7604562737642585,0.38022813688212925
31,경상북도,경산시,압량읍,압량읍제5투,2522,1876,412,1271,165,15,3,1866,10,646,22.079314040728832,68.11361200428725,8.842443729903538,0.8038585209003215,0.1607717041800643
32,경상북도,경산시,압량읍,압량읍제6투,2422,1777,443,1142,155,22,1,1763,14,645,25.127623369256945,64.77595008508224,8.791832104367556,1.2478729438457177,0.05672149744753262
33,경상북도,경산시,와촌면,관내사전투표,1414,1414,454,826,89,9,5,1383,31,0,32.82718727404193,59.72523499638467,6.4352856109906,0.6507592190889371,0.3615328994938539
34,경상북도,경산시,와촌면,와촌면제1투,1221,758,89,627,30,6,1,753,5,463,11.819389110225764,83.26693227091634,3.9840637450199203,0.796812749003984,0.13280212483399734
35,경상북도,경산시,와촌면,와촌면제2투,1229,906,84,795,17,5,0,901,5,323,9.32297447280799,88.23529411764706,1.8867924528301887,0.5549389567147613,0.0
36,경상북도,경산시,와촌면,와촌면제3투,994,734,95,620,12,0,2,729,5,260,13.031550068587105,85.04801097393691,1.646090534979424,0.0,0.2743484224965706
37,경상북도,경산시,자인면,관내사전투표,1743,1743,494,1123,98,12,3,1730,13,0,28.55491329479769,64.91329479768785,5.664739884393064,0.6936416184971098,0.17341040462427745
38,경상북도,경산시,자인면,자인면제1투,1085,753,69,651,22,4,0,746,7,332,9.249329758713138,87.26541554959786,2.949061662198391,0.5361930294906166,0.0
39,경상북도,경산시,자인면,자인면제2투,1109,774,70,677,20,2,0,769,5,335,9.102730819245773,88.03641092327699,2.600780234070221,0.26007802340702213,0.0
40,경상북도,경산시,자인면,자인면제3투,1261,793,74,671,34,8,1,788,5,468,9.390862944162437,85.15228426395939,4.314720812182741,1.015228426395939,0.12690355329949238
41,경상북도,경산시,용성면,관내사전투표,834,834,205,573,45,7,1,831,3,0,24.6690734055355,68.95306859205776,5.415162454873646,0.842358604091456,0.12033694344163659
42,경상북도,경산시,용성면,용성면제1투,1700,1182,104,1042,26,2,0,1174,8,518,8.858603066439523,88.75638841567292,2.2146507666098807,0.17035775127768313,0.0
43,경상북도,경산시,용성면,용성면제2투,256,188,20,164,3,0,0,187,1,68,10.695187165775401,87.70053475935828,1.6042780748663104,0.0,0.0
44,경상북도,경산시,남산면,관내사전투표,811,811,242,502,49,6,2,801,10,0,30.21223470661673,62.67166042446941,6.117353308364544,0.7490636704119851,0.24968789013732834
45,경상북도,경산시,남산면,남산면제1투,1439,1045,107,890,29,4,3,1033,12,394,10.358180058083253,86.1568247821878,2.8073572120038723,0.3872216844143272,0.29041626331074544
46,경상북도,경산시,남산면,남산면제2투,940,674,60,583,20,6,2,671,3,266,8.941877794336811,86.88524590163934,2.9806259314456036,0.8941877794336811,0.29806259314456035
47,경상북도,경산시,남천면,관내사전투표,746,746,211,467,59,4,0,741,5,0,28.475033738191634,63.022941970310384,7.96221322537112,0.5398110661268556,0.0
48,경상북도,경산시,남천면,남천면제1투,1092,786,63,690,22,6,1,782,4,306,8.05626598465473,88.23529411764706,2.813299232736573,0.7672634271099744,0.1278772378516624
49,경상북도,경산시,남천면,남천면제2투,699,536,51,471,11,0,0,533,3,163,9.568480300187618,88.36772983114447,2.0637898686679175,0.0,0.0
50,경상북도,경산시,중앙동,관내사전투표,2271,2271,807,1176,242,19,3,2247,24,0,35.91455273698264,52.336448598130836,10.76991544281264,0.8455718736092568,0.13351134846461948
51,경상북도,경산시,중앙동,중앙동제1투,2348,1639,237,1309,67,14,2,1629,10,709,14.548802946593002,80.35604665438919,4.112952731737262,0.8594229588704727,0.12277470841006752
52,경상북도,경산시,중앙동,중앙동제2투,1603,987,122,789,62,5,3,981,6,616,12.436289500509684,80.42813455657493,6.320081549439347,0.509683995922528,0.3058103975535168
53,경상북도,경산시,동부동,관내사전투표,4696,4696,1906,2349,367,43,1,4666,30,0,40.84869267038148,50.342906129447066,7.865409344192027,0.9215602228889841,0.02143163309044149
54,경상북도,경산시,동부동,동부동제1투,2006,1207,185,925,76,11,2,1199,8,799,15.42952460383653,77.14762301918266,6.33861551292744,0.9174311926605505,0.16680567139282734
55,경상북도,경산시,동부동,동부동제2투,1352,856,105,707,22,6,3,843,13,496,12.455516014234876,83.86714116251483,2.6097271648873073,0.7117437722419928,0.3558718861209964
56,경상북도,경산시,동부동,동부동제3투,2295,1531,234,1174,98,10,2,1518,13,764,15.41501976284585,77.33860342555995,6.455862977602108,0.6587615283267457,0.13175230566534915
57,경상북도,경산시,동부동,동부동제4투,2248,1446,207,1132,86,10,1,1436,10,802,14.415041782729803,78.8300835654596,5.988857938718663,0.6963788300835655,0.06963788300835655
58,경상북도,경산시,동부동,동부동제5투,2569,1922,303,1390,194,16,2,1905,17,647,15.905511811023624,72.96587926509186,10.183727034120734,0.8398950131233596,0.10498687664041995
59,경상북도,경산시,동부동,동부동제6투,3601,2518,521,1785,172,21,5,2504,14,1083,20.80670926517572,71.28594249201278,6.869009584664537,0.8386581469648562,0.1996805111821086
60,경상북도,경산시,동부동,동부동제7투,2507,1798,410,1226,133,16,1,1786,12,709,22.956326987681972,68.64501679731244,7.446808510638298,0.8958566629339306,0.055991041433370664
61,경상북도,경산시,동부동,동부동제8투,3017,2206,468,1580,117,24,2,2191,15,811,21.360109539023277,72.11319032405295,5.340027384755819,1.0953902327704246,0.09128251939753537
62,경상북도,경산시,동부동,동부동제9투,3412,2583,582,1783,179,24,3,2571,12,829,22.63710618436406,69.35044729677169,6.962271489692727,0.9334889148191364,0.11668611435239205
63,경상북도,경산시,서부1동,관내사전투표,3183,3183,1212,1741,197,15,1,3166,17,0,38.281743524952624,54.990524320909664,6.22236260265319,0.4737839545167404,0.03158559696778269
64,경상북도,경산시,서부1동,서부1동제1투,2707,1944,344,1462,105,20,1,1932,12,763,17.805383022774325,75.67287784679088,5.434782608695652,1.0351966873706004,0.051759834368530024
65,경상북도,경산시,서부1동,서부1동제2투,1698,1118,184,859,55,11,1,1110,8,580,16.576576576576578,77.38738738738739,4.954954954954955,0.990990990990991,0.09009009009009009
66,경상북도,경산시,서부1동,서부1동제3투,2670,1696,258,1305,99,17,3,1682,14,974,15.338882282996433,77.58620689655173,5.885850178359096,1.0107015457788349,0.178359096313912
67,경상북도,경산시,서부1동,서부1동제4투,1754,1190,180,926,67,8,0,1181,9,564,15.241320914479257,78.40812870448772,5.6731583403895005,0.6773920406435224,0.0
68,경상북도,경산시,서부1동,서부1동제5투,2024,1552,247,1212,79,8,1,1547,5,472,15.966386554621847,78.34518422753717,5.106658047834518,0.5171299288946347,0.06464124111182934
69,경상북도,경산시,서부1동,서부1동제6투,845,527,53,443,23,5,0,524,3,318,10.114503816793894,84.54198473282443,4.3893129770992365,0.9541984732824428,0.0
70,경상북도,경산시,서부1동,서부1동제7투,2473,1811,401,1278,105,16,1,1801,10,662,22.26540810660744,70.96057745696835,5.830094392004441,0.8883953359244865,0.055524708495280406
71,경상북도,경산시,서부1동,서부1동제8투,2890,2184,611,1413,129,23,2,2178,6,706,28.05325987144169,64.87603305785123,5.922865013774105,1.0560146923783287,0.09182736455463728
72,경상북도,경산시,서부1동,서부1동제9투,2064,1648,355,1180,92,14,1,1642,6,416,21.619975639464066,71.86358099878197,5.602923264311815,0.8526187576126675,0.06090133982947624
73,경상북도,경산시,서부2동,관내사전투표,5026,5026,1887,2683,381,43,1,4995,31,0,37.77777777777778,53.713713713713716,7.627627627627627,0.8608608608608608,0.02002002002002002
74,경상북도,경산시,서부2동,서부2동제1투,3189,2320,400,1740,152,17,1,2310,10,869,17.316017316017316,75.32467532467533,6.58008658008658,0.735930735930736,0.04329004329004329
75,경상북도,경산시,서부2동,서부2동제2투,2843,2195,332,1697,141,13,2,2185,10,648,15.194508009153317,77.66590389016018,6.453089244851258,0.5949656750572082,0.09153318077803205
76,경상북도,경산시,서부2동,서부2동제3투,2295,1755,261,1369,104,13,1,1748,7,540,14.931350114416475,78.31807780320365,5.949656750572083,0.7437070938215103,0.057208237986270026
77,경상북도,경산시,서부2동,서부2동제4투,1892,1554,279,1154,108,8,1,1550,4,338,18.0,74.45161290322581,6.96774193548387,0.5161290322580645,0.06451612903225806
78,경상북도,경산시,서부2동,서부2동제5투,3450,2728,541,1945,198,19,2,2705,23,722,20.0,71.90388170055454,7.3197781885397415,0.7024029574861368,0.07393715341959334
79,경상북도,경산시,서부2동,서부2동제6투,1429,981,154,748,67,8,0,977,4,448,15.762538382804504,76.56090071647903,6.857727737973388,0.8188331627430911,0.0
80,경상북도,경산시,서부2동,서부2동제7투,3404,2804,677,1837,262,15,3,2794,10,600,24.230493915533284,65.74803149606299,9.377236936292055,0.5368647100930566,0.10737294201861132
81,경상북도,경산시,서부2동,서부2동제8투,3141,2481,580,1618,253,15,1,2467,14,660,23.510336441021483,65.58573165788407,10.255370895824889,0.6080259424402107,0.040535062829347386
82,경상북도,경산시,서부2동,서부2동제9투,3409,2771,652,1806,264,27,3,2752,19,638,23.691860465116278,65.625,9.593023255813954,0.9811046511627907,0.10901162790697674
83,경상북도,경산시,남부동,관내사전투표,3235,3235,1310,1696,190,24,2,3222,13,0,40.657976412166356,52.6381129733085,5.896958410924891,0.74487895716946,0.06207324643078833
84,경상북도,경산시,남부동,남부동제1투,2226,1543,250,1191,84,13,1,1539,4,683,16.244314489928524,77.38791423001949,5.458089668615984,0.8447043534762833,0.0649772579597141
85,경상북도,경산시,남부동,남부동제2투,552,357,46,285,21,4,0,356,1,195,12.921348314606742,80.0561797752809,5.8988764044943816,1.1235955056179776,0.0
86,경상북도,경산시,남부동,남부동제3투,3391,2374,500,1704,139,18,1,2362,12,1017,21.168501270110077,72.14225232853514,5.884843353090601,0.7620660457239627,0.04233700254022015
87,경상북도,경산시,남부동,남부동제4투,3222,2453,492,1792,134,21,2,2441,12,769,20.15567390413765,73.41253584596477,5.489553461696026,0.8603031544448997,0.0819336337566571
88,경상북도,경산시,남부동,남부동제5투,2402,1688,335,1231,106,9,2,1683,5,714,19.904931669637552,73.14319667260844,6.2982768865121805,0.53475935828877,0.11883541295306002
89,경상북도,경산시,북부동,관내사전투표,2110,2110,850,950,270,20,0,2090,20,0,40.66985645933015,45.45454545454545,12.918660287081341,0.9569377990430622,0.0
90,경상북도,경산시,북부동,북부동제1투,3347,2625,511,1918,172,14,1,2616,9,722,19.533639143730888,73.31804281345565,6.574923547400611,0.5351681957186544,0.0382262996941896
91,경상북도,경산시,북부동,북부동제2투,3058,1576,253,1170,129,13,3,1568,8,1482,16.135204081632654,74.61734693877551,8.22704081632653,0.8290816326530612,0.1913265306122449
92,경상북도,경산시,북부동,북부동제3투,4897,2930,446,2065,371,20,4,2906,24,1967,15.34755677907777,71.05987611837577,12.766689607708189,0.6882312456985548,0.13764624913971094
93,경상북도,경산시,중방동,관내사전투표,2491,2491,974,1295,186,19,1,2475,16,0,39.35353535353535,52.323232323232325,7.515151515151515,0.7676767676767676,0.0404040404040404
94,경상북도,경산시,중방동,중방동제1투,2531,1777,282,1359,120,11,2,1774,3,754,15.89627959413754,76.6065388951522,6.764374295377677,0.6200676437429538,0.11273957158962795
95,경상북도,경산시,중방동,중방동제2투,1580,1046,143,845,39,9,1,1037,9,534,13.789778206364515,81.4850530376085,3.7608486017357765,0.8678881388621021,0.09643201542912247
96,경상북도,경산시,중방동,중방동제3투,2824,2277,353,1739,161,19,1,2273,4,547,15.530136383633963,76.50681918169819,7.08315002199736,0.8358996920369556,0.04399472063352398
97,경상북도,경산시,잘못 투입·구분된 투표지,,0,0,0,0,0,0,0,0,0,0,0.0,0.0,0.0,0.0,0.0
0,경상북도,청도군,거소·선상투표,,144,137,38,74,17,3,1,133,4,7,28.57142857142857,55.639097744360896,12.781954887218044,2.2556390977443606,0.7518796992481203
1,경상북도,청도군,관외사전투표,,4107,4107,1249,2470,316,36,4,4075,32,0,30.650306748466257,60.613496932515346,7.754601226993866,0.8834355828220859,0.09815950920245399
2,경상북도,청도군,재외투표,,254,148,77,59,10,1,0,147,1,106,52.38095238095239,40.136054421768705,6.802721088435375,0.6802721088435374,0.0
3,경상북도,청도군,청도읍,관내사전투표,2614,2614,844,1573,159,12,2,2590,24,0,32.58687258687259,60.73359073359074,6.138996138996139,0.4633204633204633,0.07722007722007722
4,경상북도,청도군,청도읍,청도읍제1투,2044,1323,193,1057,54,9,3,1316,7,721,14.665653495440731,80.31914893617021,4.103343465045593,0.6838905775075987,0.22796352583586624
5,경상북도,청도군,청도읍,청도읍제2투,2180,1386,213,1110,48,6,1,1378,8,794,15.457184325108852,80.55152394775035,3.483309143686502,0.43541364296081275,0.07256894049346879
6,경상북도,청도군,청도읍,청도읍제3투,716,530,63,456,4,2,0,525,5,186,12.0,86.85714285714286,0.7619047619047619,0.38095238095238093,0.0
7,경상북도,청도군,청도읍,청도읍제4투,1079,791,98,662,21,4,2,787,4,288,12.452350698856417,84.11689961880559,2.6683608640406606,0.5082592121982211,0.25412960609911056
8,경상북도,청도군,청도읍,청도읍제5투,1080,806,98,680,15,5,1,799,7,274,12.265331664580724,85.1063829787234,1.877346683354193,0.6257822277847309,0.1251564455569462
9,경상북도,청도군,화양읍,관내사전투표,1312,1312,427,794,71,9,1,1302,10,0,32.795698924731184,60.98310291858679,5.453149001536098,0.6912442396313364,0.07680491551459294
10,경상북도,청도군,화양읍,화양읍제1투,1521,1050,99,885,38,12,3,1037,13,471,9.546769527483125,85.34233365477338,3.664416586306654,1.1571841851494697,0.28929604628736744
11,경상북도,청도군,화양읍,화양읍제2투,2226,1523,260,1155,87,7,4,1513,10,703,17.184401850627893,76.33840052875082,5.750165234633179,0.4626569729015202,0.2643754130865829
12,경상북도,청도군,화양읍,화양읍제3투,759,573,75,485,8,0,2,570,3,186,13.157894736842104,85.08771929824562,1.4035087719298245,0.0,0.3508771929824561
13,경상북도,청도군,각남면,관내사전투표,576,576,140,400,26,4,1,571,5,0,24.518388791593697,70.05253940455341,4.553415061295972,0.7005253940455342,0.17513134851138354
14,경상북도,청도군,각남면,각남면제1투,786,556,53,483,16,2,1,555,1,230,9.54954954954955,87.02702702702703,2.8828828828828827,0.36036036036036034,0.18018018018018017
15,경상북도,청도군,각남면,각남면제2투,415,296,32,249,11,0,1,293,3,119,10.921501706484642,84.98293515358361,3.754266211604096,0.0,0.3412969283276451
16,경상북도,청도군,풍각면,관내사전투표,1184,1184,306,822,44,5,0,1177,7,0,25.99830076465591,69.83857264231096,3.7383177570093453,0.4248088360237893,0.0
17,경상북도,청도군,풍각면,풍각면제1투,1639,1116,133,944,26,9,1,1113,3,523,11.949685534591195,84.81581311769992,2.336028751123091,0.8086253369272237,0.08984725965858043
18,경상북도,청도군,풍각면,풍각면제2투,507,347,28,304,9,0,1,342,5,160,8.187134502923977,88.88888888888889,2.631578947368421,0.0,0.29239766081871343
19,경상북도,청도군,각북면,관내사전투표,562,562,110,426,17,2,1,556,6,0,19.784172661870503,76.61870503597122,3.0575539568345325,0.3597122302158274,0.1798561151079137
20,경상북도,청도군,각북면,각북면투표소,1242,824,75,720,23,1,1,820,4,418,9.146341463414634,87.8048780487805,2.804878048780488,0.12195121951219512,0.12195121951219512
21,경상북도,청도군,이서면,관내사전투표,905,904,285,568,39,5,0,897,7,1,31.77257525083612,63.322185061315494,4.3478260869565215,0.5574136008918618,0.0
22,경상북도,청도군,이서면,이서면제1투,1744,1224,129,1041,37,5,1,1213,11,520,10.634789777411378,85.82028029678483,3.0502885408079146,0.4122011541632316,0.08244023083264633
23,경상북도,청도군,이서면,이서면제2투,943,695,73,596,17,3,1,690,5,248,10.579710144927535,86.37681159420289,2.4637681159420293,0.43478260869565216,0.14492753623188406
24,경상북도,청도군,운문면,관내사전투표,431,431,125,277,20,4,0,426,5,0,29.342723004694836,65.02347417840375,4.694835680751173,0.9389671361502347,0.0
25,경상북도,청도군,운문면,운문면제1투,344,249,18,223,4,0,0,245,4,95,7.346938775510205,91.02040816326532,1.6326530612244898,0.0,0.0
26,경상북도,청도군,운문면,운문면제2투,424,313,41,264,8,0,0,313,0,111,13.099041533546327,84.34504792332268,2.5559105431309903,0.0,0.0
27,경상북도,청도군,운문면,운문면제3투,421,307,39,255,6,3,0,303,4,114,12.871287128712872,84.15841584158416,1.9801980198019802,0.9900990099009901,0.0
28,경상북도,청도군,금천면,관내사전투표,777,777,207,529,29,4,2,771,6,0,26.848249027237355,68.61219195849546,3.761348897535668,0.5188067444876783,0.25940337224383914
29,경상북도,청도군,금천면,금천면제1투,648,443,42,386,12,0,0,440,3,205,9.545454545454547,87.72727272727273,2.727272727272727,0.0,0.0
30,경상북도,청도군,금천면,금천면제2투,496,356,35,305,12,0,0,352,4,140,9.943181818181818,86.64772727272727,3.4090909090909087,0.0,0.0
31,경상북도,청도군,금천면,금천면제3투,736,533,61,453,9,3,0,526,7,203,11.596958174904943,86.12167300380229,1.7110266159695817,0.5703422053231939,0.0
32,경상북도,청도군,매전면,관내사전투표,609,609,187,382,26,2,0,597,12,0,31.32328308207705,63.98659966499163,4.355108877721943,0.33500837520938026,0.0
33,경상북도,청도군,매전면,매전면제1투,555,391,31,345,11,0,1,388,3,164,7.989690721649484,88.91752577319588,2.8350515463917527,0.0,0.25773195876288657
34,경상북도,청도군,매전면,매전면제2투,576,420,54,353,7,2,0,416,4,156,12.980769230769232,84.85576923076923,1.6826923076923077,0.4807692307692308,0.0
35,경상북도,청도군,매전면,매전면제3투,381,254,33,209,5,2,1,250,4,127,13.200000000000001,83.6,2.0,0.8,0.4
36,경상북도,청도군,매전면,매전면제4투,833,577,74,486,11,2,0,573,4,256,12.914485165794066,84.81675392670157,1.9197207678883073,0.34904013961605584,0.0
37,경상북도,청도군,잘못 투입·구분된 투표지,,0,0,0,0,0,0,0,0,0,0,0.0,0.0,0.0,0.0,0.0
0,경상북도,고령군,거소·선상투표,,153,139,42,65,11,4,2,124,15,14,33.87096774193548,52.41935483870967,8.870967741935484,3.225806451612903,1.6129032258064515
1,경상북도,고령군,관외사전투표,,2677,2677,705,1686,239,25,3,2658,19,0,26.52370203160271,63.43115124153499,8.991723100075244,0.9405568096313018,0.1128668171557562
2,경상북도,고령군,재외투표,,192,95,42,36,10,5,0,93,2,97,45.16129032258064,38.70967741935484,10.75268817204301,5.376344086021505,0.0
3,경상북도,고령군,대가야읍,관내사전투표,2426,2426,699,1559,128,16,4,2406,20,0,29.052369077306732,64.79634247714048,5.320033250207814,0.6650041562759768,0.1662510390689942
4,경상북도,고령군,대가야읍,대가야읍제1투,1179,765,87,629,43,1,2,762,3,414,11.41732283464567,82.54593175853019,5.6430446194225725,0.13123359580052493,0.26246719160104987
5,경상북도,고령군,대가야읍,대가야읍제2투,438,312,47,255,3,1,0,306,6,126,15.359477124183007,83.33333333333334,0.9803921568627451,0.32679738562091504,0.0
6,경상북도,고령군,대가야읍,대가야읍제3투,1616,1000,139,826,28,1,1,995,5,616,13.969849246231156,83.01507537688441,2.814070351758794,0.10050251256281408,0.10050251256281408
7,경상북도,고령군,대가야읍,대가야읍제4투,285,190,21,162,5,0,0,188,2,95,11.170212765957446,86.17021276595744,2.6595744680851063,0.0,0.0
8,경상북도,고령군,대가야읍,대가야읍제5투,1841,1235,170,1006,51,3,2,1232,3,606,13.7987012987013,81.65584415584416,4.1396103896103895,0.2435064935064935,0.16233766233766234
9,경상북도,고령군,덕곡면,관내사전투표,280,280,72,189,11,2,0,274,6,0,26.277372262773724,68.97810218978103,4.014598540145985,0.7299270072992701,0.0
10,경상북도,고령군,덕곡면,덕곡면제1투,527,389,29,343,14,1,0,387,2,138,7.493540051679587,88.63049095607235,3.6175710594315245,0.2583979328165375,0.0
11,경상북도,고령군,덕곡면,덕곡면제2투,385,281,23,247,9,1,0,280,1,104,8.214285714285714,88.21428571428571,3.214285714285714,0.35714285714285715,0.0
12,경상북도,고령군,운수면,관내사전투표,352,352,100,230,12,4,1,347,5,0,28.818443804034583,66.28242074927954,3.45821325648415,1.1527377521613833,0.2881844380403458
13,경상북도,고령군,운수면,운수면제1투,828,579,53,501,12,2,1,569,10,249,9.314586994727591,88.04920913884007,2.10896309314587,0.35149384885764495,0.17574692442882248
14,경상북도,고령군,운수면,운수면제2투,311,234,20,204,3,1,0,228,6,77,8.771929824561402,89.47368421052632,1.3157894736842104,0.43859649122807015,0.0
15,경상북도,고령군,성산면,관내사전투표,543,543,123,386,20,5,0,534,9,0,23.03370786516854,72.28464419475655,3.7453183520599254,0.9363295880149813,0.0
16,경상북도,고령군,성산면,성산면제1투,951,662,56,573,24,0,4,657,5,289,8.52359208523592,87.21461187214612,3.65296803652968,0.0,0.60882800608828
17,경상북도,고령군,성산면,성산면제2투,558,388,31,346,8,1,0,386,2,170,8.031088082901555,89.63730569948186,2.072538860103627,0.2590673575129534,0.0
18,경상북도,고령군,다산면,관내사전투표,1646,1646,556,992,72,9,1,1630,16,0,34.11042944785276,60.858895705521476,4.41717791411043,0.5521472392638037,0.06134969325153375
19,경상북도,고령군,다산면,다산면제1투,2030,1497,211,1201,70,7,0,1489,8,533,14.17058428475487,80.658159838818,4.701141705842848,0.47011417058428473,0.0
20,경상북도,고령군,다산면,다산면제2투,2511,1799,278,1410,80,19,3,1790,9,712,15.53072625698324,78.77094972067039,4.4692737430167595,1.0614525139664803,0.16759776536312848
21,경상북도,고령군,다산면,다산면제3투,716,518,29,477,12,0,0,518,0,198,5.598455598455598,92.08494208494209,2.3166023166023164,0.0,0.0
22,경상북도,고령군,개진면,관내사전투표,293,293,65,212,12,1,0,290,3,0,22.413793103448278,73.10344827586206,4.137931034482759,0.3448275862068966,0.0
23,경상북도,고령군,개진면,개진면제1투,508,360,39,306,8,4,0,357,3,148,10.92436974789916,85.71428571428571,2.2408963585434174,1.1204481792717087,0.0
24,경상북도,고령군,개진면,개진면제2투,656,485,63,399,15,4,0,481,4,171,13.097713097713099,82.95218295218295,3.118503118503119,0.8316008316008316,0.0
25,경상북도,고령군,우곡면,관내사전투표,267,267,61,178,19,2,1,261,6,0,23.371647509578544,68.19923371647509,7.2796934865900385,0.7662835249042145,0.38314176245210724
26,경상북도,고령군,우곡면,우곡면제1투,344,243,35,200,6,1,0,242,1,101,14.46280991735537,82.64462809917356,2.479338842975207,0.4132231404958678,0.0
27,경상북도,고령군,우곡면,우곡면제2투,624,460,49,395,7,3,1,455,5,164,10.76923076923077,86.81318681318682,1.5384615384615385,0.6593406593406593,0.21978021978021978
28,경상북도,고령군,쌍림면,관내사전투표,608,608,140,434,28,1,1,604,4,0,23.178807947019866,71.8543046357616,4.635761589403973,0.16556291390728478,0.16556291390728478
29,경상북도,고령군,쌍림면,쌍림면제1투,671,467,51,393,14,1,1,460,7,204,11.08695652173913,85.43478260869564,3.0434782608695654,0.21739130434782608,0.21739130434782608
30,경상북도,고령군,쌍림면,쌍림면제2투,588,427,42,369,6,0,0,417,10,161,10.071942446043165,88.48920863309353,1.4388489208633095,0.0,0.0
31,경상북도,고령군,쌍림면,쌍림면제3투,764,546,52,475,10,1,1,539,7,218,9.647495361781075,88.12615955473099,1.855287569573284,0.1855287569573284,0.1855287569573284
32,경상북도,고령군,잘못 투입·구분된 투표지,,0,0,0,0,0,0,0,0,0,0,0.0,0.0,0.0,0.0,0.0
0,경상북도,성주군,거소·선상투표,,142,138,28,87,13,3,1,132,6,4,21.21212121212121,65.9090909090909,9.848484848484848,2.272727272727273,0.7575757575757576
1,경상북도,성주군,관외사전투표,,3956,3956,1045,2519,336,27,6,3933,23,0,26.570048309178745,64.04780066107297,8.543096872616324,0.6864988558352403,0.15255530129672007
2,경상북도,성주군,재외투표,,224,112,63,35,11,2,0,111,1,112,56.75675675675676,31.53153153153153,9.90990990990991,1.8018018018018018,0.0
3,경상북도,성주군,성주읍,관내사전투표,3582,3582,1140,2178,200,34,2,3554,28,0,32.07653348339899,61.283061339335966,5.627462014631401,0.9566685424873381,0.056274620146314014
4,경상북도,성주군,성주읍,성주읍제1투,1203,830,82,718,21,4,2,827,3,373,9.915356711003627,86.81983071342201,2.539298669891173,0.48367593712212814,0.24183796856106407
5,경상북도,성주군,성주읍,성주읍제2투,1747,1069,150,867,40,3,2,1062,7,678,14.124293785310735,81.63841807909604,3.766478342749529,0.2824858757062147,0.18832391713747645
6,경상북도,성주군,성주읍,성주읍제3투,2473,1678,300,1263,93,8,0,1664,14,795,18.028846153846153,75.9014423076923,5.588942307692308,0.4807692307692308,0.0
7,경상북도,성주군,성주읍,성주읍제4투,1497,1092,170,859,47,9,1,1086,6,405,15.65377532228361,79.09760589318601,4.327808471454881,0.8287292817679558,0.09208103130755065
8,경상북도,성주군,선남면,관내사전투표,1836,1836,329,1411,69,4,4,1817,19,0,18.10676940011007,77.65547605943863,3.79746835443038,0.2201430930104568,0.2201430930104568
9,경상북도,성주군,선남면,선남면제1투,1506,1040,86,902,37,5,1,1031,9,466,8.341416100872939,87.48787584869059,3.5887487875848687,0.4849660523763337,0.09699321047526674
10,경상북도,성주군,선남면,선남면제2투,1597,1130,94,994,32,1,1,1122,8,467,8.377896613190732,88.59180035650624,2.8520499108734403,0.08912655971479501,0.08912655971479501
11,경상북도,성주군,용암면,관내사전투표,1041,1041,196,799,33,6,1,1035,6,0,18.937198067632853,77.19806763285024,3.1884057971014492,0.5797101449275363,0.0966183574879227
12,경상북도,성주군,용암면,용암면제1투,861,628,59,529,31,2,1,622,6,233,9.485530546623794,85.04823151125403,4.983922829581994,0.3215434083601286,0.1607717041800643
13,경상북도,성주군,용암면,용암면제2투,922,641,60,553,25,1,0,639,2,281,9.389671361502346,86.5414710485133,3.912363067292645,0.1564945226917058,0.0
14,경상북도,성주군,수륜면,관내사전투표,780,780,177,562,25,3,1,768,12,0,23.046875,73.17708333333334,3.2552083333333335,0.390625,0.13020833333333331
15,경상북도,성주군,수륜면,수륜면제1투,1009,715,68,623,15,1,0,707,8,294,9.618104667609618,88.11881188118812,2.1216407355021216,0.14144271570014144,0.0
16,경상북도,성주군,수륜면,수륜면제2투,612,463,48,392,14,3,1,458,5,149,10.480349344978166,85.58951965065502,3.056768558951965,0.6550218340611353,0.21834061135371177
17,경상북도,성주군,가천면,관내사전투표,644,644,172,435,19,8,3,637,7,0,27.001569858712713,68.28885400313972,2.9827315541601256,1.2558869701726845,0.47095761381475665
18,경상북도,성주군,가천면,가천면투표소,994,693,69,611,11,0,0,691,2,301,9.985528219971057,88.42257597684515,1.5918958031837915,0.0,0.0
19,경상북도,성주군,금수강산면,관내사전투표,431,431,95,303,20,2,1,421,10,0,22.565320665083135,71.97149643705463,4.750593824228028,0.4750593824228029,0.23752969121140144
20,경상북도,성주군,금수강산면,금수강산면투표소,463,331,44,269,13,1,2,329,2,132,13.37386018237082,81.7629179331307,3.951367781155015,0.303951367781155,0.60790273556231
21,경상북도,성주군,대가면,관내사전투표,865,865,234,574,39,6,1,854,11,0,27.400468384074944,67.21311475409836,4.566744730679157,0.702576112412178,0.117096018735363
22,경상북도,성주군,대가면,대가면투표소,1142,823,103,688,24,3,0,818,5,319,12.591687041564793,84.10757946210269,2.93398533007335,0.36674816625916873,0.0
23,경상북도,성주군,벽진면,관내사전투표,1109,1109,218,828,40,7,0,1093,16,0,19.945105215004574,75.7548032936871,3.6596523330283626,0.6404391582799633,0.0
24,경상북도,성주군,벽진면,벽진면투표소,1364,987,135,808,29,5,2,979,8,377,13.789581205311544,82.53319713993871,2.96220633299285,0.5107252298263534,0.20429009193054137
25,경상북도,성주군,초전면,관내사전투표,1323,1323,316,929,58,9,2,1314,9,0,24.04870624048706,70.70015220700152,4.41400304414003,0.684931506849315,0.15220700152207
26,경상북도,성주군,초전면,초전면제1투,1278,873,111,728,26,1,0,866,7,405,12.817551963048498,84.06466512702079,3.0023094688221708,0.11547344110854503,0.0
27,경상북도,성주군,초전면,초전면제2투,1077,758,92,631,24,5,1,753,5,319,12.217795484727755,83.79814077025233,3.187250996015936,0.6640106241699867,0.13280212483399734
28,경상북도,성주군,월항면,관내사전투표,897,897,182,668,36,4,0,890,7,0,20.44943820224719,75.0561797752809,4.044943820224719,0.44943820224719105,0.0
29,경상북도,성주군,월항면,월항면제1투,1015,720,79,607,24,1,1,712,8,295,11.095505617977528,85.25280898876404,3.3707865168539324,0.1404494382022472,0.1404494382022472
30,경상북도,성주군,월항면,월항면제2투,646,462,44,405,11,2,0,462,0,184,9.523809523809524,87.66233766233766,2.380952380952381,0.4329004329004329,0.0
31,경상북도,성주군,잘못 투입·구분된 투표지,,0,0,0,0,0,0,0,0,0,0,0.0,0.0,0.0,0.0,0.0
0,경상북도,칠곡군,거소·선상투표,,158,153,27,88,32,0,1,148,5,5,18.243243243243242,59.45945945945946,21.62162162162162,0.0,0.6756756756756757
1,경상북도,칠곡군,관외사전투표,,7137,7137,2403,3670,894,68,20,7055,82,0,34.060949681077254,52.0198440822112,12.671863926293408,0.9638554216867471,0.28348688873139616
2,경상북도,칠곡군,재외투표,,329,208,123,58,17,3,0,201,7,121,61.19402985074627,28.855721393034827,8.45771144278607,1.4925373134328357,0.0
3,경상북도,칠곡군,왜관읍,관내사전투표,5241,5241,1936,2892,337,42,6,5213,28,0,37.13792441971993,55.47669288317667,6.464607711490504,0.8056781124112795,0.11509687320161135
4,경상북도,칠곡군,왜관읍,왜관읍제1투,3027,2186,310,1735,111,15,2,2173,13,841,14.26599171652094,79.84353428439944,5.108145421076853,0.6902899217671422,0.09203865623561897
5,경상북도,칠곡군,왜관읍,왜관읍제2투,1699,1180,148,973,46,8,1,1176,4,519,12.585034013605442,82.73809523809523,3.9115646258503403,0.6802721088435374,0.08503401360544217
6,경상북도,칠곡군,왜관읍,왜관읍제3투,924,557,81,435,32,3,2,553,4,367,14.647377938517177,78.6618444846293,5.786618444846293,0.5424954792043399,0.3616636528028933
7,경상북도,칠곡군,왜관읍,왜관읍제4투,3175,2089,418,1526,118,16,0,2078,11,1086,20.115495668912416,73.43599615014436,5.678537054860443,0.769971126082772,0.0
8,경상북도,칠곡군,왜관읍,왜관읍제5투,1736,1210,259,856,79,5,3,1202,8,526,21.547420965058237,71.21464226289518,6.572379367720465,0.4159733777038269,0.24958402662229617
9,경상북도,칠곡군,왜관읍,왜관읍제6투,1825,1324,253,979,73,7,2,1314,10,501,19.254185692541856,74.50532724505328,5.555555555555555,0.532724505327245,0.15220700152207
10,경상북도,칠곡군,왜관읍,왜관읍제7투,1445,993,162,783,38,6,1,990,3,452,16.363636363636363,79.0909090909091,3.8383838383838382,0.6060606060606061,0.10101010101010101
11,경상북도,칠곡군,왜관읍,왜관읍제8투,2775,1849,365,1355,105,15,0,1840,9,926,19.83695652173913,73.6413043478261,5.706521739130435,0.8152173913043478,0.0
12,경상북도,칠곡군,왜관읍,왜관읍제9투,2428,1778,407,1239,108,15,1,1770,8,650,22.994350282485875,70.0,6.101694915254238,0.847457627118644,0.05649717514124294
13,경상북도,칠곡군,북삼읍,관내사전투표,3904,3904,1560,2007,254,41,7,3869,35,0,40.32049625226157,51.8738692168519,6.565003876970793,1.059705350219695,0.18092530369604548
14,경상북도,칠곡군,북삼읍,북삼읍제1투,2077,1338,263,973,86,7,1,1330,8,739,19.774436090225564,73.15789473684211,6.466165413533835,0.5263157894736842,0.07518796992481204
15,경상북도,칠곡군,북삼읍,북삼읍제2투,1234,828,84,703,31,3,1,822,6,406,10.218978102189782,85.52311435523114,3.7712895377128954,0.36496350364963503,0.12165450121654502
16,경상북도,칠곡군,북삼읍,북삼읍제3투,2468,1490,321,1059,90,9,3,1482,8,978,21.65991902834008,71.45748987854252,6.0728744939271255,0.6072874493927125,0.20242914979757085
17,경상북도,칠곡군,북삼읍,북삼읍제4투,3693,2424,505,1745,138,17,1,2406,18,1269,20.989193682460517,72.52701579384872,5.7356608478802995,0.7065669160432253,0.04156275976724855
18,경상북도,칠곡군,북삼읍,북삼읍제5투,1995,1331,190,1065,61,6,3,1325,6,664,14.339622641509434,80.37735849056604,4.60377358490566,0.4528301886792453,0.22641509433962265
19,경상북도,칠곡군,북삼읍,북삼읍제6투,2585,1825,470,1222,103,17,2,1814,11,760,25.909592061742003,67.36493936052922,5.678059536934951,0.9371554575523704,0.11025358324145534
20,경상북도,칠곡군,석적읍,관내사전투표,3959,3959,2114,1400,389,30,3,3936,23,0,53.709349593495936,35.56910569105691,9.883130081300813,0.7621951219512195,0.07621951219512195
21,경상북도,칠곡군,석적읍,석적읍제1투,2910,1921,545,1181,156,14,4,1900,21,989,28.68421052631579,62.1578947368421,8.210526315789474,0.7368421052631579,0.21052631578947367
22,경상북도,칠곡군,석적읍,석적읍제2투,1894,844,217,542,73,3,1,836,8,1050,25.95693779904306,64.83253588516746,8.732057416267942,0.3588516746411483,0.11961722488038277
23,경상북도,칠곡군,석적읍,석적읍제3투,3743,2328,773,1327,174,25,6,2305,23,1415,33.53579175704989,57.5704989154013,7.548806941431669,1.0845986984815619,0.2603036876355748
24,경상북도,칠곡군,석적읍,석적읍제4투,3542,2565,767,1544,211,29,3,2554,11,977,30.031323414252153,60.45418950665623,8.261550509005481,1.1354737666405637,0.11746280344557558
25,경상북도,칠곡군,석적읍,석적읍제5투,467,338,41,285,9,0,0,335,3,129,12.238805970149254,85.07462686567165,2.6865671641791042,0.0,0.0
26,경상북도,칠곡군,석적읍,석적읍제6투,2410,1022,273,656,78,8,0,1015,7,1388,26.89655172413793,64.63054187192118,7.684729064039408,0.7881773399014778,0.0
27,경상북도,칠곡군,석적읍,석적읍제7투,2878,1758,572,986,166,22,2,1748,10,1120,32.723112128146454,56.40732265446224,9.496567505720824,1.2585812356979404,0.11441647597254005
28,경상북도,칠곡군,지천면,관내사전투표,851,851,213,582,51,2,0,848,3,0,25.117924528301888,68.63207547169812,6.014150943396227,0.2358490566037736,0.0
29,경상북도,칠곡군,지천면,지천면제1투,1733,1175,102,1016,49,4,1,1172,3,558,8.70307167235495,86.68941979522185,4.180887372013651,0.3412969283276451,0.08532423208191127
30,경상북도,칠곡군,지천면,지천면제2투,719,515,42,459,8,1,1,511,4,204,8.21917808219178,89.82387475538161,1.5655577299412915,0.19569471624266144,0.19569471624266144
31,경상북도,칠곡군,동명면,관내사전투표,942,942,231,659,35,7,1,933,9,0,24.758842443729904,70.63236870310826,3.751339764201501,0.7502679528403001,0.10718113612004287
32,경상북도,칠곡군,동명면,동명면제1투,970,675,70,580,18,6,0,674,1,295,10.385756676557865,86.05341246290801,2.6706231454005933,0.8902077151335311,0.0
33,경상북도,칠곡군,동명면,동명면제2투,1087,770,79,656,27,2,1,765,5,317,10.326797385620914,85.7516339869281,3.5294117647058822,0.261437908496732,0.130718954248366
34,경상북도,칠곡군,동명면,동명면제3투,1367,1011,94,880,26,4,1,1005,6,356,9.35323383084577,87.56218905472637,2.587064676616915,0.3980099502487562,0.09950248756218905
35,경상북도,칠곡군,가산면,관내사전투표,522,522,136,347,23,8,2,516,6,0,26.356589147286826,67.24806201550388,4.457364341085271,1.550387596899225,0.3875968992248062
36,경상북도,칠곡군,가산면,가산면제1투,1121,798,74,694,16,6,0,790,8,323,9.367088607594937,87.84810126582279,2.0253164556962027,0.7594936708860759,0.0
37,경상북도,칠곡군,가산면,가산면제2투,610,439,53,361,18,3,2,437,2,171,12.128146453089245,82.6086956521739,4.118993135011442,0.6864988558352403,0.4576659038901602
38,경상북도,칠곡군,가산면,가산면제3투,326,238,17,216,4,0,0,237,1,88,7.172995780590717,91.13924050632912,1.6877637130801686,0.0,0.0
39,경상북도,칠곡군,약목면,관내사전투표,1689,1689,458,1130,85,6,1,1680,9,0,27.26190476190476,67.26190476190477,5.059523809523809,0.35714285714285715,0.05952380952380953
40,경상북도,칠곡군,약목면,약목면제1투,1612,1142,119,977,34,2,2,1134,8,470,10.493827160493826,86.1552028218695,2.9982363315696645,0.1763668430335097,0.1763668430335097
41,경상북도,칠곡군,약목면,약목면제2투,1797,1199,160,976,51,7,0,1194,5,598,13.400335008375208,81.74204355108877,4.271356783919598,0.5862646566164154,0.0
42,경상북도,칠곡군,약목면,약목면제3투,868,585,71,490,15,2,0,578,7,283,12.283737024221452,84.77508650519032,2.5951557093425603,0.34602076124567477,0.0
43,경상북도,칠곡군,약목면,약목면제4투,1465,911,178,690,29,10,0,907,4,554,19.625137816979052,76.0749724366042,3.197353914002205,1.1025358324145533,0.0
44,경상북도,칠곡군,기산면,관내사전투표,1126,1126,359,667,66,8,5,1105,21,0,32.48868778280543,60.36199095022624,5.972850678733032,0.7239819004524887,0.4524886877828055
45,경상북도,칠곡군,기산면,기산면제1투,1447,1045,167,829,36,6,1,1039,6,402,16.07314725697786,79.78825794032723,3.4648700673724733,0.5774783445620789,0.0962463907603465
46,경상북도,칠곡군,기산면,기산면제2투,324,241,36,196,5,0,3,240,1,83,15.0,81.66666666666667,2.083333333333333,0.0,1.25
47,경상북도,칠곡군,잘못 투입·구분된 투표지,,0,0,0,0,0,0,0,0,0,0,0.0,0.0,0.0,0.0,0.0
0,경상북도,의성군,거소·선상투표,,216,192,42,123,17,2,1,185,7,24,22.702702702702705,66.48648648648648,9.18918918918919,1.0810810810810811,0.5405405405405406
1,경상북도,의성군,관외사전투표,,4311,4310,1137,2743,355,32,4,4271,39,1,26.621400140482322,64.22383516740811,8.31187075626317,0.7492390540856942,0.09365488176071178
2,경상북도,의성군,재외투표,,510,246,115,110,13,7,0,245,1,264,46.93877551020408,44.89795918367347,5.3061224489795915,2.857142857142857,0.0
3,경상북도,의성군,의성읍,관내사전투표,3146,3146,928,1965,190,25,3,3111,35,0,29.829636772741885,63.16297010607522,6.107360977177756,0.8036001285760206,0.09643201542912247
4,경상북도,의성군,의성읍,의성읍제1투,1004,703,85,601,12,3,0,701,2,301,12.125534950071327,85.73466476462197,1.7118402282453637,0.42796005706134094,0.0
5,경상북도,의성군,의성읍,의성읍제2투,2117,1354,211,1079,43,10,0,1343,11,763,15.711094564408043,80.34251675353686,3.201787043931496,0.7446016381236039,0.0
6,경상북도,의성군,의성읍,의성읍제3투,1996,1355,232,1069,35,6,0,1342,13,641,17.2876304023845,79.65722801788375,2.608047690014903,0.44709388971684055,0.0
7,경상북도,의성군,의성읍,의성읍제4투,1661,1169,131,998,27,4,1,1161,8,492,11.283376399655468,85.9603789836348,2.3255813953488373,0.34453057708871665,0.08613264427217916
8,경상북도,의성군,단촌면,관내사전투표,652,652,146,469,25,6,1,647,5,0,22.56568778979907,72.48840803709427,3.863987635239567,0.9273570324574961,0.1545595054095827
9,경상북도,의성군,단촌면,단촌면투표소,986,672,76,572,13,5,1,667,5,314,11.394302848575713,85.75712143928035,1.9490254872563717,0.7496251874062968,0.14992503748125938
10,경상북도,의성군,점곡면,관내사전투표,414,414,140,251,15,4,1,411,3,0,34.0632603406326,61.0705596107056,3.64963503649635,0.9732360097323601,0.24330900243309003
11,경상북도,의성군,점곡면,점곡면투표소,908,657,85,552,10,3,0,650,7,251,13.076923076923078,84.92307692307692,1.5384615384615385,0.46153846153846156,0.0
12,경상북도,의성군,옥산면,관내사전투표,455,455,113,321,18,1,0,453,2,0,24.944812362030905,70.86092715231787,3.9735099337748347,0.22075055187637968,0.0
13,경상북도,의성군,옥산면,옥산면투표소,969,709,93,603,6,0,1,703,6,260,13.229018492176387,85.77524893314367,0.8534850640113799,0.0,0.1422475106685633
14,경상북도,의성군,사곡면,관내사전투표,589,589,113,452,16,2,0,583,6,0,19.382504288164665,77.53001715265866,2.7444253859348198,0.34305317324185247,0.0
15,경상북도,의성군,사곡면,사곡면투표소,764,512,56,435,13,1,2,507,5,252,11.045364891518737,85.79881656804734,2.564102564102564,0.19723865877712032,0.39447731755424065
16,경상북도,의성군,춘산면,관내사전투표,287,287,70,204,12,0,0,286,1,0,24.475524475524477,71.32867132867133,4.195804195804196,0.0,0.0
17,경상북도,의성군,춘산면,춘산면투표소,887,664,74,569,13,2,1,659,5,223,11.229135053110774,86.34294385432474,1.9726858877086493,0.30349013657056145,0.15174506828528073
18,경상북도,의성군,가음면,관내사전투표,532,532,97,410,19,2,0,528,4,0,18.37121212121212,77.65151515151516,3.5984848484848486,0.3787878787878788,0.0
19,경상북도,의성군,가음면,가음면투표소,746,531,58,447,14,5,2,526,5,215,11.02661596958175,84.9809885931559,2.6615969581749046,0.9505703422053232,0.38022813688212925
20,경상북도,의성군,금성면,관내사전투표,1338,1338,272,978,53,16,3,1322,16,0,20.574886535552196,73.97881996974282,4.009077155824508,1.2102874432677762,0.22692889561270801
21,경상북도,의성군,금성면,금성면투표소,2212,1471,136,1273,43,7,0,1459,12,741,9.32145305003427,87.25154215215902,2.9472241261137766,0.47978067169294036,0.0
22,경상북도,의성군,봉양면,관내사전투표,1016,1016,232,716,55,3,1,1007,9,0,23.038728897715988,71.10228401191658,5.461767626613704,0.29791459781529295,0.09930486593843098
23,경상북도,의성군,봉양면,봉양면투표소,2204,1546,145,1335,48,12,1,1541,5,658,9.409474367293964,86.63205710577547,3.1148604802076574,0.7787151200519143,0.06489292667099286
24,경상북도,의성군,비안면,관내사전투표,583,583,127,432,18,2,0,579,4,0,21.934369602763386,74.61139896373057,3.1088082901554404,0.3454231433506045,0.0
25,경상북도,의성군,비안면,비안면투표소,1422,966,95,833,26,5,1,960,6,456,9.895833333333332,86.77083333333333,2.7083333333333335,0.5208333333333333,0.10416666666666667
26,경상북도,의성군,구천면,관내사전투표,454,454,94,333,20,1,1,449,5,0,20.93541202672606,74.16481069042317,4.4543429844097995,0.22271714922048996,0.22271714922048996
27,경상북도,의성군,구천면,구천면투표소,965,689,76,587,17,2,1,683,6,276,11.127379209370424,85.94436310395315,2.4890190336749636,0.29282576866764276,0.14641288433382138
28,경상북도,의성군,단밀면,관내사전투표,443,443,93,320,21,6,0,440,3,0,21.136363636363637,72.72727272727273,4.772727272727273,1.3636363636363635,0.0
29,경상북도,의성군,단밀면,단밀면투표소,844,574,60,489,18,3,1,571,3,270,10.507880910683012,85.63922942206655,3.1523642732049035,0.5253940455341506,0.17513134851138354
30,경상북도,의성군,단북면,관내사전투표,517,517,81,417,10,3,0,511,6,0,15.851272015655576,81.60469667318982,1.9569471624266144,0.5870841487279843,0.0
31,경상북도,의성군,단북면,단북면투표소,911,658,75,562,12,1,1,651,7,253,11.52073732718894,86.32872503840245,1.8433179723502304,0.15360983102918588,0.15360983102918588
32,경상북도,의성군,안계면,관내사전투표,1318,1318,330,902,63,7,5,1307,11,0,25.2486610558531,69.01300688599848,4.8201989288446825,0.5355776587605203,0.3825554705432288
33,경상북도,의성군,안계면,안계면투표소,2334,1683,160,1463,44,6,0,1673,10,651,9.563658099222954,87.44769874476988,2.630005977286312,0.35863717872086076,0.0
34,경상북도,의성군,다인면,관내사전투표,980,980,228,704,32,5,2,971,9,0,23.480947476828014,72.50257466529351,3.2955715756951593,0.5149330587023687,0.20597322348094746
35,경상북도,의성군,다인면,다인면투표소,1948,1342,139,1158,29,5,2,1333,9,606,10.427606901725431,86.87171792948237,2.175543885971493,0.3750937734433608,0.15003750937734434
36,경상북도,의성군,신평면,관내사전투표,351,351,70,265,5,4,0,344,7,0,20.348837209302324,77.03488372093024,1.4534883720930232,1.1627906976744187,0.0
37,경상북도,의성군,신평면,신평면투표소,320,212,24,180,3,0,1,208,4,108,11.538461538461538,86.53846153846155,1.4423076923076923,0.0,0.4807692307692308
38,경상북도,의성군,안평면,관내사전투표,606,606,121,456,20,3,1,601,5,0,20.133111480865225,75.87354409317804,3.3277870216306153,0.49916805324459235,0.16638935108153077
39,경상북도,의성군,안평면,안평면투표소,1095,777,70,676,13,5,2,766,11,318,9.138381201044385,88.25065274151436,1.6971279373368149,0.6527415143603132,0.26109660574412535
40,경상북도,의성군,안사면,관내사전투표,279,279,57,204,13,2,1,277,2,0,20.577617328519857,73.6462093862816,4.693140794223827,0.7220216606498195,0.36101083032490977
41,경상북도,의성군,안사면,안사면투표소,443,324,38,266,13,2,0,319,5,119,11.912225705329153,83.38557993730407,4.075235109717868,0.6269592476489028,0.0
42,경상북도,의성군,잘못 투입·구분된 투표지,,0,0,0,0,0,0,0,0,0,0,0.0,0.0,0.0,0.0,0.0
0,경상북도,청송군,거소·선상투표,,98,95,14,69,5,0,1,89,6,3,15.730337078651685,77.52808988764045,5.617977528089887,0.0,1.1235955056179776
1,경상북도,청송군,관외사전투표,,1796,1796,527,1050,178,25,2,1782,14,0,29.57351290684624,58.92255892255892,9.988776655443322,1.4029180695847363,0.11223344556677892
2,경상북도,청송군,재외투표,,118,69,35,29,3,1,0,68,1,49,51.470588235294116,42.64705882352941,4.411764705882353,1.4705882352941175,0.0
3,경상북도,청송군,청송읍,관내사전투표,1592,1592,514,946,94,25,0,1579,13,0,32.55224825839139,59.91133628879037,5.953134895503483,1.5832805573147564,0.0
4,경상북도,청송군,청송읍,청송읍제1투,814,575,67,486,16,1,0,570,5,239,11.75438596491228,85.26315789473684,2.807017543859649,0.17543859649122806,0.0
5,경상북도,청송군,청송읍,청송읍제2투,485,352,42,290,11,1,1,345,7,133,12.173913043478262,84.05797101449275,3.1884057971014492,0.2898550724637681,0.2898550724637681
6,경상북도,청송군,청송읍,청송읍제3투,849,639,84,524,23,3,2,636,3,210,13.20754716981132,82.38993710691824,3.6163522012578615,0.4716981132075472,0.3144654088050315
7,경상북도,청송군,청송읍,청송읍제4투,490,354,65,273,7,4,0,349,5,136,18.624641833810887,78.22349570200574,2.005730659025788,1.146131805157593,0.0
8,경상북도,청송군,주왕산면,관내사전투표,342,342,78,255,7,1,1,342,0,0,22.807017543859647,74.56140350877193,2.046783625730994,0.29239766081871343,0.29239766081871343
9,경상북도,청송군,주왕산면,주왕산면제1투,567,396,33,347,11,1,0,392,4,171,8.418367346938775,88.5204081632653,2.806122448979592,0.25510204081632654,0.0
10,경상북도,청송군,주왕산면,주왕산면제2투,512,391,84,285,13,1,0,383,8,121,21.93211488250653,74.41253263707573,3.3942558746736298,0.26109660574412535,0.0
11,경상북도,청송군,부남면,관내사전투표,704,704,197,464,32,3,0,696,8,0,28.304597701149426,66.66666666666666,4.597701149425287,0.43103448275862066,0.0
12,경상북도,청송군,부남면,부남면제1투,650,473,61,399,9,2,0,471,2,177,12.951167728237792,84.71337579617835,1.910828025477707,0.42462845010615713,0.0
13,경상북도,청송군,부남면,부남면제2투,763,585,72,488,10,8,1,579,6,178,12.435233160621761,84.28324697754749,1.7271157167530224,1.381692573402418,0.17271157167530224
14,경상북도,청송군,현동면,관내사전투표,595,595,139,415,35,3,0,592,3,0,23.47972972972973,70.10135135135135,5.912162162162162,0.5067567567567568,0.0
15,경상북도,청송군,현동면,현동면투표소,1136,837,85,717,30,0,0,832,5,299,10.216346153846153,86.17788461538461,3.6057692307692304,0.0,0.0
16,경상북도,청송군,현서면,관내사전투표,687,687,193,450,31,6,1,681,6,0,28.34067547723935,66.07929515418502,4.552129221732746,0.881057268722467,0.14684287812041116
17,경상북도,청송군,현서면,현서면제1투,944,711,99,589,14,3,1,706,5,233,14.022662889518415,83.42776203966005,1.9830028328611897,0.424929178470255,0.141643059490085
18,경상북도,청송군,현서면,현서면제2투,400,314,38,265,4,2,0,309,5,86,12.297734627831716,85.76051779935275,1.2944983818770228,0.6472491909385114,0.0
19,경상북도,청송군,안덕면,관내사전투표,640,640,162,449,21,1,0,633,7,0,25.59241706161137,70.93206951026856,3.3175355450236967,0.1579778830963665,0.0
20,경상북도,청송군,안덕면,안덕면제1투,1007,702,86,594,17,2,1,700,2,305,12.285714285714286,84.85714285714285,2.4285714285714284,0.2857142857142857,0.14285714285714285
21,경상북도,청송군,안덕면,안덕면제2투,366,279,19,254,3,0,1,277,2,87,6.859205776173286,91.69675090252709,1.083032490974729,0.0,0.36101083032490977
22,경상북도,청송군,파천면,관내사전투표,359,359,108,231,14,2,0,355,4,0,30.422535211267604,65.07042253521126,3.943661971830986,0.5633802816901409,0.0
23,경상북도,청송군,파천면,파천면제1투,576,420,47,356,11,1,0,415,5,156,11.325301204819278,85.78313253012048,2.6506024096385543,0.24096385542168677,0.0
24,경상북도,청송군,파천면,파천면제2투,450,339,53,269,10,0,1,333,6,111,15.915915915915916,80.78078078078079,3.003003003003003,0.0,0.3003003003003003
25,경상북도,청송군,진보면,관내사전투표,1615,1615,525,957,104,14,2,1602,13,0,32.77153558052434,59.737827715355806,6.491885143570538,0.8739076154806492,0.12484394506866417
26,경상북도,청송군,진보면,진보면제1투,1668,1116,167,870,52,10,3,1102,14,552,15.15426497277677,78.94736842105263,4.71869328493648,0.9074410163339384,0.27223230490018147
27,경상북도,청송군,진보면,진보면제2투,1223,829,136,656,26,2,1,821,8,394,16.56516443361754,79.90255785627284,3.1668696711327646,0.24360535931790497,0.12180267965895249
28,경상북도,청송군,진보면,진보면제3투,624,444,59,371,6,3,0,439,5,180,13.439635535307518,84.51025056947609,1.366742596810934,0.683371298405467,0.0
29,경상북도,청송군,잘못 투입·구분된 투표지,,0,0,0,0,0,0,0,0,0,0,0.0,0.0,0.0,0.0,0.0
0,경상북도,영양군,거소·선상투표,,29,27,3,20,3,0,0,26,1,2,11.538461538461538,76.92307692307693,11.538461538461538,0.0,0.0
1,경상북도,영양군,관외사전투표,,1084,1084,387,570,107,13,1,1078,6,0,35.89981447124304,52.875695732838594,9.925788497217068,1.2059369202226344,0.0927643784786642
2,경상북도,영양군,재외투표,,44,21,11,9,1,0,0,21,0,23,52.38095238095239,42.857142857142854,4.761904761904762,0.0,0.0
3,경상북도,영양군,영양읍,관내사전투표,1881,1881,701,1041,112,9,2,1865,16,0,37.58713136729222,55.81769436997319,6.005361930294907,0.482573726541555,0.10723860589812334
4,경상북도,영양군,영양읍,영양읍제1투,1421,988,150,790,33,4,2,979,9,433,15.321756894790603,80.69458631256384,3.3707865168539324,0.40858018386108275,0.20429009193054137
5,경상북도,영양군,영양읍,영양읍제2투,1186,815,115,675,15,3,1,809,6,371,14.215080346106305,83.43634116192831,1.8541409147095178,0.3708281829419036,0.12360939431396785
6,경상북도,영양군,영양읍,영양읍제3투,963,662,87,556,14,2,0,659,3,301,13.201820940819422,84.37025796661608,2.12443095599393,0.30349013657056145,0.0
7,경상북도,영양군,입암면,관내사전투표,647,647,219,394,28,1,1,643,4,0,34.05909797822706,61.27527216174183,4.354587869362364,0.15552099533437014,0.15552099533437014
8,경상북도,영양군,입암면,입암면투표소,1077,750,98,620,23,5,0,746,4,327,13.136729222520108,83.10991957104558,3.0831099195710454,0.6702412868632708,0.0
9,경상북도,영양군,청기면,관내사전투표,447,447,127,293,20,2,0,442,5,0,28.733031674208142,66.289592760181,4.524886877828054,0.4524886877828055,0.0
10,경상북도,영양군,청기면,청기면제1투,559,394,50,323,14,1,1,389,5,165,12.853470437017995,83.03341902313625,3.5989717223650386,0.2570694087403599,0.2570694087403599
11,경상북도,영양군,청기면,청기면제2투,382,290,45,232,9,1,2,289,1,92,15.570934256055363,80.27681660899654,3.1141868512110724,0.34602076124567477,0.6920415224913495
12,경상북도,영양군,일월면,관내사전투표,488,488,167,289,18,8,0,482,6,0,34.64730290456431,59.95850622406639,3.7344398340248963,1.6597510373443984,0.0
13,경상북도,영양군,일월면,일월면투표소,974,704,112,559,18,7,0,696,8,270,16.091954022988507,80.31609195402298,2.586206896551724,1.0057471264367817,0.0
14,경상북도,영양군,수비면,관내사전투표,454,454,176,250,19,7,0,452,2,0,38.93805309734513,55.309734513274336,4.20353982300885,1.5486725663716814,0.0
15,경상북도,영양군,수비면,수비면투표소,877,608,89,495,13,3,0,600,8,269,14.833333333333334,82.5,2.166666666666667,0.5,0.0
16,경상북도,영양군,석보면,관내사전투표,541,541,180,333,21,2,0,536,5,0,33.582089552238806,62.126865671641795,3.9179104477611943,0.3731343283582089,0.0
17,경상북도,영양군,석보면,석보면제1투,786,562,94,447,11,4,0,556,6,224,16.906474820143885,80.39568345323741,1.9784172661870503,0.7194244604316548,0.0
18,경상북도,영양군,석보면,석보면제2투,321,252,37,208,5,0,0,250,2,69,14.799999999999999,83.2,2.0,0.0,0.0
19,경상북도,영양군,잘못 투입·구분된 투표지,,0,0,0,0,0,0,0,0,0,0,0.0,0.0,0.0,0.0,0.0
0,경상북도,영덕군,거소·선상투표,,107,99,22,61,6,1,2,92,7,8,23.91304347826087,66.30434782608695,6.521739130434782,1.0869565217391304,2.1739130434782608
1,경상북도,영덕군,관외사전투표,,2215,2215,616,1348,212,20,3,2199,16,0,28.012733060482038,61.300591177808094,9.64074579354252,0.9095043201455207,0.1364256480218281
2,경상북도,영덕군,재외투표,,124,79,46,27,4,2,0,79,0,45,58.22784810126582,34.177215189873415,5.063291139240507,2.5316455696202533,0.0
3,경상북도,영덕군,영덕읍,관내사전투표,3281,3281,921,2116,185,29,2,3253,28,0,28.3123270826929,65.04764832462342,5.687058100215186,0.8914847832769751,0.06148170919151552
4,경상북도,영덕군,영덕읍,영덕읍제1투,2304,1595,207,1280,82,15,2,1586,9,709,13.05170239596469,80.7061790668348,5.170239596469105,0.9457755359394703,0.12610340479192939
5,경상북도,영덕군,영덕읍,영덕읍제2투,2119,1425,171,1196,43,8,1,1419,6,694,12.050739957716702,84.2847075405215,3.0303030303030303,0.5637773079633545,0.07047216349541931
6,경상북도,영덕군,영덕읍,영덕읍제3투,727,516,52,448,6,0,1,507,9,211,10.256410256410255,88.3629191321499,1.183431952662722,0.0,0.19723865877712032
7,경상북도,영덕군,강구면,관내사전투표,1446,1446,298,1067,50,11,1,1427,19,0,20.882971268395234,74.77224947442186,3.50385423966363,0.7708479327259986,0.0700770847932726
8,경상북도,영덕군,강구면,강구면제1투,2226,1413,169,1203,26,5,1,1404,9,813,12.037037037037036,85.68376068376068,1.8518518518518516,0.3561253561253561,0.07122507122507123
9,경상북도,영덕군,강구면,강구면제2투,1142,789,76,698,11,2,1,788,1,353,9.644670050761421,88.57868020304569,1.3959390862944163,0.25380710659898476,0.12690355329949238
10,경상북도,영덕군,남정면,관내사전투표,628,628,120,474,25,3,1,623,5,0,19.26163723916533,76.08346709470305,4.012841091492777,0.4815409309791332,0.16051364365971107
11,경상북도,영덕군,남정면,남정면제1투,840,543,46,469,18,3,0,536,7,297,8.582089552238806,87.5,3.3582089552238807,0.5597014925373134,0.0
12,경상북도,영덕군,남정면,남정면제2투,406,295,31,257,4,2,0,294,1,111,10.54421768707483,87.41496598639455,1.3605442176870748,0.6802721088435374,0.0
13,경상북도,영덕군,달산면,관내사전투표,337,337,67,250,16,2,1,336,1,0,19.940476190476193,74.40476190476191,4.761904761904762,0.5952380952380952,0.2976190476190476
14,경상북도,영덕군,달산면,달산면투표소,583,392,43,340,4,0,0,387,5,191,11.11111111111111,87.85529715762273,1.03359173126615,0.0,0.0
15,경상북도,영덕군,지품면,관내사전투표,376,376,86,262,19,1,0,368,8,0,23.369565217391305,71.19565217391305,5.163043478260869,0.2717391304347826,0.0
16,경상북도,영덕군,지품면,지품면제1투,770,563,69,475,11,2,0,557,6,207,12.387791741472173,85.27827648114902,1.9748653500897666,0.3590664272890485,0.0
17,경상북도,영덕군,지품면,지품면제2투,375,282,56,219,5,1,1,282,0,93,19.858156028368796,77.6595744680851,1.773049645390071,0.3546099290780142,0.3546099290780142
18,경상북도,영덕군,축산면,관내사전투표,893,893,152,710,16,6,1,885,8,0,17.17514124293785,80.22598870056498,1.807909604519774,0.6779661016949152,0.11299435028248588
19,경상북도,영덕군,축산면,축산면투표소,1142,703,80,600,12,5,0,697,6,439,11.477761836441895,86.0832137733142,1.721664275466284,0.7173601147776184,0.0
20,경상북도,영덕군,영해면,관내사전투표,1697,1697,418,1166,85,12,2,1683,14,0,24.836601307189543,69.28104575163398,5.05050505050505,0.7130124777183601,0.11883541295306002
21,경상북도,영덕군,영해면,영해면제1투,1735,1167,149,978,26,2,1,1156,11,568,12.889273356401384,84.60207612456747,2.249134948096886,0.17301038062283738,0.08650519031141869
22,경상북도,영덕군,영해면,영해면제2투,1659,1104,115,941,31,5,1,1093,11,555,10.521500457456542,86.09332113449221,2.8362305580969807,0.4574565416285453,0.09149130832570906
23,경상북도,영덕군,병곡면,관내사전투표,701,701,135,532,22,3,0,692,9,0,19.508670520231213,76.878612716763,3.1791907514450863,0.4335260115606936,0.0
24,경상북도,영덕군,병곡면,병곡면투표소,1402,931,86,799,24,7,0,916,15,471,9.388646288209607,87.22707423580786,2.6200873362445414,0.7641921397379913,0.0
25,경상북도,영덕군,창수면,관내사전투표,453,453,111,312,19,6,0,448,5,0,24.776785714285715,69.64285714285714,4.241071428571429,1.3392857142857142,0.0
26,경상북도,영덕군,창수면,창수면제1투,516,362,31,324,4,0,0,359,3,154,8.635097493036211,90.25069637883009,1.1142061281337048,0.0,0.0
27,경상북도,영덕군,창수면,창수면제2투,375,273,34,228,6,2,0,270,3,102,12.592592592592592,84.44444444444444,2.2222222222222223,0.7407407407407408,0.0
28,경상북도,영덕군,잘못 투입·구분된 투표지,,0,0,0,0,0,0,0,0,0,0,0.0,0.0,0.0,0.0,0.0
0,경상북도,봉화군,거소·선상투표,,66,63,17,36,7,0,0,60,3,3,28.333333333333332,60.0,11.666666666666666,0.0,0.0
1,경상북도,봉화군,관외사전투표,,2290,2289,851,1176,213,24,4,2268,21,1,37.52204585537919,51.85185185185185,9.39153439153439,1.0582010582010581,0.1763668430335097
2,경상북도,봉화군,재외투표,,84,61,42,13,3,2,0,60,1,23,70.0,21.666666666666668,5.0,3.3333333333333335,0.0
3,경상북도,봉화군,봉화읍,관내사전투표,2625,2625,931,1515,135,25,2,2608,17,0,35.6978527607362,58.09049079754601,5.176380368098159,0.9585889570552147,0.07668711656441718
4,경상북도,봉화군,봉화읍,봉화읍제1투,1492,971,189,732,41,2,3,967,4,521,19.54498448810755,75.69803516028955,4.239917269906929,0.2068252326783868,0.3102378490175801
5,경상북도,봉화군,봉화읍,봉화읍제2투,1169,762,109,624,24,1,1,759,3,407,14.361001317523057,82.21343873517787,3.1620553359683794,0.13175230566534915,0.13175230566534915
6,경상북도,봉화군,봉화읍,봉화읍제3투,1272,852,129,677,38,6,0,850,2,420,15.176470588235293,79.64705882352942,4.470588235294118,0.7058823529411765,0.0
7,경상북도,봉화군,봉화읍,봉화읍제4투,881,650,114,511,19,2,0,646,4,231,17.647058823529413,79.10216718266254,2.941176470588235,0.30959752321981426,0.0
8,경상북도,봉화군,물야면,관내사전투표,646,646,222,392,19,3,0,636,10,0,34.90566037735849,61.63522012578616,2.9874213836477987,0.4716981132075472,0.0
9,경상북도,봉화군,물야면,물야면투표소,1645,1150,165,943,25,4,2,1139,11,495,14.486391571553995,82.79192273924495,2.194907813871817,0.35118525021949076,0.17559262510974538
10,경상북도,봉화군,봉성면,관내사전투표,569,569,142,400,18,3,1,564,5,0,25.177304964539005,70.92198581560284,3.1914893617021276,0.5319148936170213,0.1773049645390071
11,경상북도,봉화군,봉성면,봉성면투표소,1038,683,86,570,19,1,0,676,7,355,12.721893491124261,84.31952662721893,2.8106508875739644,0.14792899408284024,0.0
12,경상북도,봉화군,법전면,관내사전투표,481,481,151,312,14,0,0,477,4,0,31.656184486373167,65.40880503144653,2.9350104821802936,0.0,0.0
13,경상북도,봉화군,법전면,법전면투표소,1098,724,105,577,26,4,1,713,11,374,14.726507713884992,80.92566619915848,3.6465638148667603,0.5610098176718092,0.1402524544179523
14,경상북도,봉화군,춘양면,관내사전투표,1186,1186,377,729,51,13,2,1172,14,0,32.16723549488055,62.20136518771331,4.351535836177475,1.1092150170648465,0.17064846416382254
15,경상북도,봉화군,춘양면,춘양면제1투,1728,1244,181,995,49,7,1,1233,11,484,14.679643146796431,80.69748580697485,3.9740470397404706,0.5677210056772101,0.08110300081103002
16,경상북도,봉화군,춘양면,춘양면제2투,776,569,89,459,13,2,0,563,6,207,15.808170515097691,81.52753108348135,2.3090586145648313,0.3552397868561279,0.0
17,경상북도,봉화군,소천면,관내사전투표,574,574,203,334,25,5,1,568,6,0,35.73943661971831,58.80281690140845,4.401408450704225,0.8802816901408451,0.17605633802816903
18,경상북도,봉화군,소천면,소천면제1투,811,530,57,448,18,2,1,526,4,281,10.836501901140684,85.17110266159695,3.4220532319391634,0.38022813688212925,0.19011406844106463
19,경상북도,봉화군,소천면,소천면제2투,366,276,46,220,4,3,0,273,3,90,16.84981684981685,80.58608058608058,1.465201465201465,1.098901098901099,0.0
20,경상북도,봉화군,석포면,관내사전투표,578,578,238,305,27,4,0,574,4,0,41.46341463414634,53.13588850174216,4.70383275261324,0.6968641114982579,0.0
21,경상북도,봉화군,석포면,석포면투표소,849,485,95,366,19,3,0,483,2,364,19.66873706004141,75.77639751552795,3.9337474120082816,0.6211180124223602,0.0
22,경상북도,봉화군,재산면,관내사전투표,364,364,129,215,9,4,2,359,5,0,35.93314763231198,59.888579387186624,2.5069637883008355,1.1142061281337048,0.5571030640668524
23,경상북도,봉화군,재산면,재산면투표소,810,519,108,384,14,6,1,513,6,291,21.052631578947366,74.85380116959064,2.729044834307992,1.1695906432748537,0.1949317738791423
24,경상북도,봉화군,명호면,관내사전투표,431,431,151,259,13,5,1,429,2,0,35.1981351981352,60.37296037296037,3.0303030303030303,1.1655011655011656,0.2331002331002331
25,경상북도,봉화군,명호면,명호면투표소,1163,820,126,663,19,2,0,810,10,343,15.555555555555555,81.85185185185185,2.345679012345679,0.24691358024691357,0.0
26,경상북도,봉화군,상운면,관내사전투표,523,523,119,374,12,5,0,510,13,0,23.333333333333332,73.33333333333333,2.3529411764705883,0.9803921568627451,0.0
27,경상북도,봉화군,상운면,상운면투표소,897,585,76,490,14,2,1,583,2,312,13.036020583190394,84.04802744425386,2.401372212692967,0.34305317324185247,0.17152658662092624
28,경상북도,봉화군,잘못 투입·구분된 투표지,,0,0,0,0,0,0,0,0,0,0,0.0,0.0,0.0,0.0,0.0
0,경상북도,울진군,거소·선상투표,,169,151,28,105,9,1,1,144,7,18,19.444444444444446,72.91666666666666,6.25,0.6944444444444444,0.6944444444444444
1,경상북도,울진군,관외사전투표,,2989,2988,946,1589,391,26,3,2955,33,1,32.01353637901862,53.77326565143824,13.231810490693741,0.8798646362098138,0.10152284263959391
2,경상북도,울진군,재외투표,,110,68,43,16,9,0,0,68,0,42,63.23529411764706,23.52941176470588,13.23529411764706,0.0,0.0
3,경상북도,울진군,울진읍,관내사전투표,3344,3344,1231,1844,219,22,2,3318,26,0,37.100663050030136,55.575647980711274,6.600361663652802,0.6630500301386377,0.06027727546714888
4,경상북도,울진군,울진읍,울진읍제1투,1515,1011,166,792,41,6,2,1007,4,504,16.48460774577954,78.64945382323734,4.07149950347567,0.5958291956305859,0.19860973187686196
5,경상북도,울진군,울진읍,울진읍제2투,1772,1179,215,899,53,10,0,1177,2,593,18.26677994902294,76.38062871707731,4.502973661852167,0.8496176720475787,0.0
6,경상북도,울진군,울진읍,울진읍제3투,2349,1661,272,1308,68,7,2,1657,4,688,16.415208207604103,78.93783946891973,4.103802051901026,0.4224502112251056,0.12070006035003018
7,경상북도,울진군,울진읍,울진읍제4투,1500,1057,181,825,40,6,0,1052,5,443,17.20532319391635,78.42205323193916,3.802281368821293,0.5703422053231939,0.0
8,경상북도,울진군,평해읍,관내사전투표,926,926,195,669,35,7,5,911,15,0,21.405049396267835,73.43578485181119,3.841931942919868,0.7683863885839737,0.5488474204171241
9,경상북도,울진군,평해읍,평해읍투표소,1376,867,92,733,29,3,2,859,8,509,10.71012805587893,85.33178114086147,3.3760186263096625,0.3492433061699651,0.23282887077997672
10,경상북도,울진군,북면,관내사전투표,2074,2074,721,1092,221,23,0,2057,17,0,35.05104521147302,53.087019931939714,10.743801652892563,1.118133203694701,0.0
11,경상북도,울진군,북면,북면제1투,1970,1247,179,1002,52,1,1,1235,12,723,14.493927125506072,81.13360323886639,4.2105263157894735,0.08097165991902834,0.08097165991902834
12,경상북도,울진군,북면,북면제2투,1672,1268,260,816,161,18,2,1257,11,404,20.684168655529035,64.9164677804296,12.808273667462212,1.431980906921241,0.15910898965791567
13,경상북도,울진군,금강송면,관내사전투표,339,339,108,214,10,1,0,333,6,0,32.432432432432435,64.26426426426426,3.003003003003003,0.3003003003003003,0.0
14,경상북도,울진군,금강송면,금강송면투표소,717,465,52,402,6,0,1,461,4,252,11.279826464208242,87.20173535791757,1.3015184381778742,0.0,0.21691973969631237
15,경상북도,울진군,근남면,관내사전투표,1013,1013,315,638,43,5,1,1002,11,0,31.437125748502993,63.67265469061876,4.291417165668663,0.499001996007984,0.09980039920159679
16,경상북도,울진군,근남면,근남면투표소,1497,990,124,827,27,2,0,980,10,507,12.653061224489795,84.38775510204081,2.7551020408163267,0.20408163265306123,0.0
17,경상북도,울진군,매화면,관내사전투표,651,651,186,428,28,0,1,643,8,0,28.92690513219285,66.56298600311042,4.354587869362364,0.0,0.15552099533437014
18,경상북도,울진군,매화면,매화면투표소,1056,678,80,574,11,3,0,668,10,378,11.976047904191617,85.92814371257485,1.6467065868263475,0.4491017964071856,0.0
19,경상북도,울진군,기성면,관내사전투표,767,767,191,524,41,1,2,759,8,0,25.164690382081687,69.03820816864295,5.401844532279315,0.13175230566534915,0.2635046113306983
20,경상북도,울진군,기성면,기성면투표소,1227,743,83,623,23,2,2,733,10,484,11.323328785811732,84.99317871759891,3.1377899045020468,0.2728512960436562,0.2728512960436562
21,경상북도,울진군,온정면,관내사전투표,410,410,81,312,10,2,0,405,5,0,20.0,77.03703703703704,2.4691358024691357,0.49382716049382713,0.0
22,경상북도,울진군,온정면,온정면투표소,941,676,60,589,18,3,1,671,5,265,8.941877794336811,87.77943368107303,2.682563338301043,0.44709388971684055,0.14903129657228018
23,경상북도,울진군,죽변면,관내사전투표,1586,1586,451,1025,82,13,1,1572,14,0,28.68956743002545,65.20356234096693,5.216284987277354,0.826972010178117,0.06361323155216285
24,경상북도,울진군,죽변면,죽변면제1투,1414,860,85,744,17,4,0,850,10,554,10.0,87.52941176470588,2.0,0.4705882352941176,0.0
25,경상북도,울진군,죽변면,죽변면제2투,2138,1381,208,1103,52,10,1,1374,7,757,15.138282387190685,80.27656477438137,3.7845705967976713,0.727802037845706,0.0727802037845706
26,경상북도,울진군,후포면,관내사전투표,1662,1662,447,1124,70,8,3,1652,10,0,27.058111380145277,68.03874092009686,4.23728813559322,0.48426150121065376,0.18159806295399517
27,경상북도,울진군,후포면,후포면제1투,942,679,65,592,14,2,0,673,6,263,9.658246656760774,87.96433878157504,2.080237741456166,0.2971768202080238,0.0
28,경상북도,울진군,후포면,후포면제2투,1601,1059,133,883,35,1,1,1053,6,542,12.630579297245964,83.85565052231719,3.323836657169991,0.0949667616334283,0.0949667616334283
29,경상북도,울진군,후포면,후포면제3투,1635,1030,129,837,44,10,1,1021,9,605,12.634671890303622,81.97845249755143,4.3095004897159646,0.9794319294809012,0.0979431929480901
30,경상북도,울진군,잘못 투입·구분된 투표지,,0,0,0,0,0,0,0,0,0,0,0.0,0.0,0.0,0.0,0.0
0,경상남도,진주시,거소·선상투표,,629,589,170,314,75,3,0,562,27,40,30.2491103202847,55.871886120996436,13.345195729537366,0.5338078291814947,0.0
1,경상남도,진주시,관외사전투표,,19240,19238,8707,6920,3083,238,46,18994,244,2,45.84079182899863,36.432557649784144,16.231441507844583,1.2530272717700326,0.24218174160261136
2,경상남도,진주시,재외투표,,1286,859,515,233,86,13,0,847,12,427,60.80283353010626,27.508854781582055,10.15348288075561,1.5348288075560803,0.0
3,경상남도,진주시,문산읍,관내사전투표,2596,2596,1335,981,231,27,5,2579,17,0,51.76424970918961,38.03799922450562,8.956960062039549,1.0469174098487786,0.19387359441644048
4,경상남도,진주시,문산읍,문산읍제1투,2315,1465,340,1038,67,10,1,1456,9,850,23.35164835164835,71.29120879120879,4.601648351648352,0.6868131868131868,0.06868131868131869
5,경상남도,진주시,문산읍,문산읍제2투,2212,1561,391,1054,78,9,1,1533,28,651,25.505544683626873,68.75407697325505,5.088062622309197,0.5870841487279843,0.06523157208088715
6,경상남도,진주시,내동면,관내사전투표,1529,1529,766,608,128,15,0,1517,12,0,50.49439683586026,40.07910349373764,8.437705998681608,0.988793671720501,0.0
7,경상남도,진주시,내동면,내동면투표소,2018,1474,386,984,85,8,1,1464,10,544,26.366120218579237,67.21311475409836,5.806010928961749,0.546448087431694,0.06830601092896176
8,경상남도,진주시,정촌면,관내사전투표,2429,2429,1197,987,193,32,1,2410,19,0,49.66804979253112,40.954356846473026,8.008298755186722,1.3278008298755186,0.04149377593360996
9,경상남도,진주시,정촌면,정촌면제1투,1352,938,159,741,25,7,0,932,6,414,17.06008583690987,79.50643776824035,2.682403433476395,0.7510729613733905,0.0
10,경상남도,진주시,정촌면,정촌면제2투,3294,2337,749,1319,230,22,0,2320,17,957,32.28448275862069,56.85344827586207,9.913793103448276,0.9482758620689655,0.0
11,경상남도,진주시,금곡면,관내사전투표,593,593,250,292,34,11,0,587,6,0,42.58943781942078,49.74446337308348,5.792163543441227,1.8739352640545146,0.0
12,경상남도,진주시,금곡면,금곡면투표소,1300,874,139,695,27,2,0,863,11,426,16.10660486674392,80.53302433371958,3.1286210892236386,0.2317497103128621,0.0
13,경상남도,진주시,진성면,관내사전투표,779,779,355,330,75,10,0,770,9,0,46.103896103896105,42.857142857142854,9.740259740259742,1.2987012987012987,0.0
14,경상남도,진주시,진성면,진성면투표소,1105,720,131,554,21,6,1,713,7,385,18.37307152875175,77.69985974754559,2.9453015427769986,0.8415147265077139,0.1402524544179523
15,경상남도,진주시,일반성면,관내사전투표,1023,1023,431,527,47,6,1,1012,11,0,42.58893280632411,52.07509881422925,4.644268774703558,0.592885375494071,0.09881422924901186
16,경상남도,진주시,일반성면,일반성면투표소,1412,930,202,683,27,5,3,920,10,482,21.956521739130437,74.23913043478261,2.9347826086956523,0.5434782608695652,0.32608695652173914
17,경상남도,진주시,이반성면,관내사전투표,424,424,185,202,23,8,1,419,5,0,44.1527446300716,48.21002386634845,5.4892601431980905,1.9093078758949882,0.23866348448687352
18,경상남도,진주시,이반성면,이반성면투표소,909,623,135,453,19,5,1,613,10,286,22.02283849918434,73.89885807504079,3.0995106035889073,0.8156606851549755,0.1631321370309951
19,경상남도,진주시,사봉면,관내사전투표,607,607,268,276,53,3,0,600,7,0,44.666666666666664,46.0,8.833333333333334,0.5,0.0
20,경상남도,진주시,사봉면,사봉면투표소,735,489,105,356,21,1,0,483,6,246,21.73913043478261,73.70600414078675,4.3478260869565215,0.2070393374741201,0.0
21,경상남도,진주시,지수면,관내사전투표,464,464,228,206,21,4,1,460,4,0,49.56521739130435,44.78260869565218,4.565217391304348,0.8695652173913043,0.21739130434782608
22,경상남도,진주시,지수면,지수면투표소,767,463,99,333,20,4,1,457,6,304,21.663019693654267,72.86652078774617,4.3763676148796495,0.87527352297593,0.2188183807439825
23,경상남도,진주시,대곡면,관내사전투표,1009,1009,417,525,49,7,0,998,11,0,41.78356713426854,52.605210420841686,4.909819639278557,0.7014028056112225,0.0
24,경상남도,진주시,대곡면,대곡면투표소,1849,1166,200,902,46,8,1,1157,9,683,17.28608470181504,77.96024200518582,3.9757994814174586,0.6914433880726015,0.08643042350907519
25,경상남도,진주시,금산면,관내사전투표,3955,3955,2182,1452,255,35,2,3926,29,0,55.57819663779928,36.984207845134996,6.495160468670402,0.891492613346918,0.05094243504839531
26,경상남도,진주시,금산면,금산면제1투,2300,1561,386,1076,72,14,1,1549,12,739,24.919302775984505,69.46417043253712,4.648160103292446,0.9038089089735314,0.06455777921239508
27,경상남도,진주시,금산면,금산면제2투,3021,2079,580,1335,131,18,1,2065,14,942,28.087167070217916,64.64891041162227,6.343825665859564,0.8716707021791767,0.048426150121065374
28,경상남도,진주시,금산면,금산면제3투,2002,1443,400,925,84,18,4,1431,12,559,27.952480782669465,64.64011180992313,5.870020964360587,1.257861635220126,0.2795248078266946
29,경상남도,진주시,금산면,금산면제4투,2871,2112,685,1212,172,25,2,2096,16,759,32.68129770992366,57.82442748091603,8.206106870229007,1.1927480916030535,0.09541984732824427
30,경상남도,진주시,집현면,관내사전투표,1162,1162,437,628,67,13,2,1147,15,0,38.09938971229293,54.751525719267654,5.841325196163906,1.1333914559721012,0.17436791630340018
31,경상남도,진주시,집현면,집현면투표소,2391,1519,306,1115,67,13,2,1503,16,872,20.35928143712575,74.18496340652028,4.45775116433799,0.8649367930805056,0.1330671989354624
32,경상남도,진주시,미천면,관내사전투표,320,320,102,195,15,2,0,314,6,0,32.48407643312102,62.101910828025474,4.777070063694268,0.6369426751592357,0.0
33,경상남도,진주시,미천면,미천면투표소,915,581,99,454,12,5,1,571,10,334,17.338003502626968,79.50963222416813,2.1015761821366024,0.8756567425569177,0.17513134851138354
34,경상남도,진주시,명석면,관내사전투표,1226,1226,472,674,59,7,1,1213,13,0,38.91178895300907,55.56471558120363,4.863973619126134,0.5770816158285244,0.08244023083264633
35,경상남도,진주시,명석면,명석면투표소,2223,1442,212,1160,58,7,0,1437,5,781,14.752957550452331,80.72372999304106,4.036186499652053,0.4871259568545582,0.0
36,경상남도,진주시,대평면,관내사전투표,366,366,114,224,19,3,1,361,5,0,31.57894736842105,62.04986149584487,5.263157894736842,0.8310249307479225,0.2770083102493075
37,경상남도,진주시,대평면,대평면투표소,495,330,56,259,10,1,1,327,3,165,17.12538226299694,79.20489296636084,3.058103975535168,0.3058103975535168,0.3058103975535168
38,경상남도,진주시,수곡면,관내사전투표,612,612,286,281,34,1,2,604,8,0,47.35099337748344,46.52317880794702,5.629139072847682,0.16556291390728478,0.33112582781456956
39,경상남도,진주시,수곡면,수곡면투표소,1298,860,160,663,23,3,0,849,11,438,18.84570082449941,78.09187279151944,2.7090694935217905,0.35335689045936397,0.0
40,경상남도,진주시,천전동,관내사전투표,5439,5439,2441,2389,524,36,9,5399,40,0,45.212076310427854,44.24893498796073,9.705501018707167,0.6667901463233933,0.16669753658084832
41,경상남도,진주시,천전동,천전동제1투,1280,898,159,692,36,6,1,894,4,382,17.78523489932886,77.40492170022371,4.026845637583892,0.6711409395973155,0.11185682326621924
42,경상남도,진주시,천전동,천전동제2투,2360,1545,352,966,186,13,4,1521,24,815,23.14266929651545,63.510848126232744,12.22879684418146,0.8547008547008548,0.26298487836949375
43,경상남도,진주시,천전동,천전동제3투,1741,1241,277,859,88,5,3,1232,9,500,22.483766233766232,69.72402597402598,7.142857142857142,0.4058441558441558,0.2435064935064935
44,경상남도,진주시,천전동,천전동제4투,1752,1326,363,816,122,8,3,1312,14,426,27.66768292682927,62.19512195121951,9.298780487804878,0.6097560975609756,0.22865853658536583
45,경상남도,진주시,천전동,천전동제5투,3131,2142,432,1552,126,11,0,2121,21,989,20.367751060820368,73.17303158887317,5.9405940594059405,0.5186232909005186,0.0
46,경상남도,진주시,천전동,천전동제6투,2206,1499,312,1069,88,15,0,1484,15,707,21.024258760107816,72.03504043126685,5.929919137466308,1.0107816711590296,0.0
47,경상남도,진주시,천전동,천전동제7투,2083,1653,405,1102,128,8,1,1644,9,430,24.635036496350367,67.0316301703163,7.785888077858881,0.48661800486618007,0.06082725060827251
48,경상남도,진주시,천전동,천전동제8투,2195,1760,534,1039,149,20,2,1744,16,435,30.619266055045873,59.575688073394495,8.543577981651376,1.146788990825688,0.11467889908256881
49,경상남도,진주시,성북동,관내사전투표,2593,2593,1141,1181,213,24,2,2561,32,0,44.5529090199141,46.11479890667708,8.317063647012885,0.9371339320577898,0.07809449433814916
50,경상남도,진주시,성북동,성북동제1투,2996,1842,328,1405,72,16,4,1825,17,1154,17.972602739726025,76.98630136986301,3.9452054794520546,0.8767123287671232,0.2191780821917808
51,경상남도,진주시,성북동,성북동제2투,3226,1920,348,1457,92,9,5,1911,9,1306,18.210361067503925,76.2428048142334,4.814233385661957,0.47095761381475665,0.2616431187859759
52,경상남도,진주시,중앙동,관내사전투표,1875,1875,635,1122,92,9,2,1860,15,0,34.13978494623656,60.322580645161295,4.946236559139785,0.4838709677419355,0.10752688172043011
53,경상남도,진주시,중앙동,중앙동제1투,1987,1322,194,1075,36,5,1,1311,11,665,14.797864225781845,81.99847444698703,2.745995423340961,0.38138825324180015,0.07627765064836003
54,경상남도,진주시,중앙동,중앙동제2투,2034,1388,236,1088,45,11,0,1380,8,646,17.101449275362317,78.84057971014494,3.260869565217391,0.7971014492753623,0.0
55,경상남도,진주시,중앙동,중앙동제3투,1320,799,121,641,25,1,1,789,10,521,15.335868187579212,81.24207858048163,3.1685678073510775,0.12674271229404308,0.12674271229404308
56,경상남도,진주시,중앙동,중앙동제4투,1525,986,180,743,51,4,3,981,5,539,18.34862385321101,75.73904179408767,5.198776758409786,0.40774719673802245,0.3058103975535168
57,경상남도,진주시,상봉동,관내사전투표,3440,3440,1339,1860,180,27,6,3412,28,0,39.243845252051585,54.513481828839396,5.275498241500586,0.7913247362250878,0.1758499413833529
58,경상남도,진주시,상봉동,상봉동제1투,1609,985,171,754,46,8,2,981,4,624,17.431192660550458,76.86034658511723,4.689092762487258,0.8154943934760449,0.20387359836901123
59,경상남도,진주시,상봉동,상봉동제2투,1618,1003,187,757,41,5,0,990,13,615,18.88888888888889,76.46464646464646,4.141414141414142,0.5050505050505051,0.0
60,경상남도,진주시,상봉동,상봉동제3투,2321,1542,252,1208,64,6,0,1530,12,779,16.470588235294116,78.95424836601308,4.183006535947712,0.39215686274509803,0.0
61,경상남도,진주시,상봉동,상봉동제4투,2494,1617,358,1151,82,12,3,1606,11,877,22.291407222914074,71.66874221668742,5.1058530510585305,0.7471980074719801,0.18679950186799502
62,경상남도,진주시,상대동,관내사전투표,4663,4663,2013,2159,370,62,4,4608,55,0,43.68489583333333,46.85329861111111,8.02951388888889,1.3454861111111112,0.08680555555555555
63,경상남도,진주시,상대동,상대동제1투,2293,1571,345,1094,106,9,2,1556,15,722,22.17223650385604,70.30848329048844,6.812339331619537,0.5784061696658097,0.12853470437017994
64,경상남도,진주시,상대동,상대동제2투,2204,1381,308,990,63,9,3,1373,8,823,22.432629278951204,72.1048798252003,4.588492352512746,0.6554989075018208,0.21849963583394028
65,경상남도,진주시,상대동,상대동제3투,2280,1422,253,1076,70,7,0,1406,16,858,17.99431009957326,76.52916073968706,4.978662873399715,0.4978662873399715,0.0
66,경상남도,진주시,상대동,상대동제4투,2172,1430,295,1029,86,9,2,1421,9,742,20.76002814919071,72.41379310344827,6.052076002814919,0.633356790992259,0.14074595355383532
67,경상남도,진주시,상대동,상대동제5투,2740,1987,386,1455,122,7,1,1971,16,753,19.58396752917301,73.82039573820396,6.1897513952308465,0.35514967021816335,0.050735667174023336
68,경상남도,진주시,하대동,관내사전투표,4818,4818,2186,2213,332,38,3,4772,46,0,45.808885163453475,46.37468566638726,6.957250628667226,0.7963118189438391,0.06286672254819782
69,경상남도,진주시,하대동,하대동제1투,1890,1360,349,914,70,17,2,1352,8,530,25.813609467455624,67.60355029585799,5.177514792899409,1.257396449704142,0.14792899408284024
70,경상남도,진주시,하대동,하대동제2투,2129,1395,286,991,92,12,1,1382,13,734,20.69464544138929,71.70767004341533,6.657018813314037,0.8683068017366137,0.0723589001447178
71,경상남도,진주시,하대동,하대동제3투,2449,1592,343,1117,100,18,0,1578,14,857,21.736375158428388,70.78580481622306,6.337135614702155,1.1406844106463878,0.0
72,경상남도,진주시,하대동,하대동제4투,2225,1426,317,1008,79,14,2,1420,6,799,22.323943661971832,70.98591549295776,5.563380281690141,0.9859154929577465,0.14084507042253522
73,경상남도,진주시,하대동,하대동제5투,2841,1955,533,1284,107,14,2,1940,15,886,27.474226804123713,66.18556701030927,5.515463917525773,0.7216494845360825,0.10309278350515465
74,경상남도,진주시,하대동,하대동제6투,2419,1614,389,1084,113,16,2,1604,10,805,24.251870324189525,67.58104738154613,7.0448877805486285,0.997506234413965,0.12468827930174563
75,경상남도,진주시,상평동,관내사전투표,2947,2947,1376,1317,204,20,6,2923,24,0,47.07492302429011,45.05644885391721,6.979131029763941,0.6842285323297981,0.20526855969893945
76,경상남도,진주시,상평동,상평동제1투,3371,2300,552,1571,136,26,1,2286,14,1071,24.146981627296586,68.72265966754155,5.94925634295713,1.1373578302712162,0.043744531933508315
77,경상남도,진주시,상평동,상평동제2투,3023,2028,379,1535,92,7,2,2015,13,995,18.80893300248139,76.1786600496278,4.56575682382134,0.34739454094292804,0.09925558312655086
78,경상남도,진주시,초장동,관내사전투표,5156,5156,2674,1895,476,55,9,5109,47,0,52.33900959091798,37.09140732041495,9.316891759639852,1.0765316108827558,0.17615971814445097
79,경상남도,진주시,초장동,초장동제1투,2379,1596,343,1125,95,21,2,1586,10,783,21.626733921815887,70.93316519546028,5.989911727616646,1.3240857503152585,0.12610340479192939
80,경상남도,진주시,초장동,초장동제2투,2025,1488,351,991,121,15,1,1479,9,537,23.732251521298174,67.00473292765382,8.181203515889115,1.0141987829614605,0.0676132521974307
81,경상남도,진주시,초장동,초장동제3투,2333,1885,550,1135,163,21,0,1869,16,448,29.4275013376137,60.72766185125735,8.721241305510969,1.1235955056179776,0.0
82,경상남도,진주시,초장동,초장동제4투,3323,2432,879,1303,188,36,4,2410,22,891,36.47302904564315,54.066390041493776,7.800829875518672,1.4937759336099585,0.16597510373443983
83,경상남도,진주시,초장동,초장동제5투,3653,2896,1133,1417,296,29,1,2876,20,757,39.39499304589708,49.26981919332406,10.292072322670375,1.0083449235048678,0.03477051460361613
84,경상남도,진주시,평거동,관내사전투표,4457,4457,2307,1731,334,46,6,4424,33,0,52.14737793851718,39.127486437613015,7.549728752260398,1.0397830018083183,0.13562386980108498
85,경상남도,진주시,평거동,평거동제1투,3462,2264,569,1494,160,23,2,2248,16,1198,25.311387900355868,66.45907473309609,7.11743772241993,1.0231316725978647,0.0889679715302491
86,경상남도,진주시,평거동,평거동제2투,2986,2225,632,1384,172,18,2,2208,17,761,28.6231884057971,62.68115942028986,7.789855072463768,0.8152173913043478,0.09057971014492754
87,경상남도,진주시,평거동,평거동제3투,2146,1558,398,1029,102,17,0,1546,12,588,25.74385510996119,66.55886157826649,6.597671410090557,1.0996119016817594,0.0
88,경상남도,진주시,평거동,평거동제4투,2436,1698,451,1089,122,20,1,1683,15,738,26.797385620915033,64.70588235294117,7.2489601901366605,1.1883541295306002,0.05941770647653001
89,경상남도,진주시,평거동,평거동제5투,2863,2064,516,1390,123,20,2,2051,13,799,25.15845928815212,67.77181862506094,5.997074597757192,0.9751340809361287,0.09751340809361286
90,경상남도,진주시,신안동,관내사전투표,3161,3161,1430,1403,279,24,4,3140,21,0,45.54140127388535,44.681528662420384,8.885350318471337,0.7643312101910829,0.12738853503184713
91,경상남도,진주시,신안동,신안동제1투,2731,2096,517,1410,137,19,2,2085,11,635,24.796163069544363,67.62589928057554,6.570743405275779,0.9112709832134293,0.09592326139088729
92,경상남도,진주시,신안동,신안동제2투,1994,1392,308,994,74,9,0,1385,7,602,22.23826714801444,71.76895306859205,5.342960288808665,0.6498194945848376,0.0
93,경상남도,진주시,신안동,신안동제3투,1929,1338,255,970,89,8,3,1325,13,591,19.245283018867926,73.20754716981132,6.716981132075471,0.6037735849056604,0.22641509433962265
94,경상남도,진주시,이현동,관내사전투표,2217,2217,919,1133,126,24,4,2206,11,0,41.65911151405258,51.359927470534906,5.711695376246601,1.087941976427924,0.1813236627379873
95,경상남도,진주시,이현동,이현동제1투,2401,1777,431,1206,118,13,2,1770,7,624,24.350282485875706,68.13559322033899,6.666666666666667,0.7344632768361582,0.11299435028248588
96,경상남도,진주시,이현동,이현동제2투,1838,1182,217,899,52,8,0,1176,6,656,18.452380952380953,76.44557823129252,4.421768707482993,0.6802721088435374,0.0
97,경상남도,진주시,이현동,이현동제3투,1431,992,211,734,35,7,1,988,4,439,21.356275303643724,74.2914979757085,3.54251012145749,0.708502024291498,0.10121457489878542
98,경상남도,진주시,판문동,관내사전투표,4052,4052,2220,1467,303,30,7,4027,25,0,55.12788676434071,36.42910355103054,7.524211571889744,0.7449714427613608,0.17382666997765084
99,경상남도,진주시,판문동,판문동제1투,2139,1445,341,1002,69,11,6,1429,16,694,23.862841147655704,70.11896431070679,4.828551434569629,0.7697690692792162,0.4198740377886634
100,경상남도,진주시,판문동,판문동제2투,2088,1437,345,1006,67,10,1,1429,8,651,24.142757172848146,70.39888033589922,4.688593421973408,0.6997900629811057,0.06997900629811056
101,경상남도,진주시,판문동,판문동제3투,1789,1206,364,744,78,14,0,1200,6,583,30.333333333333336,62.0,6.5,1.1666666666666667,0.0
102,경상남도,진주시,판문동,판문동제4투,2429,1915,652,1070,154,28,3,1907,8,514,34.18982695332984,56.10907184058731,8.075511274252753,1.4682747771368643,0.15731515469323545
103,경상남도,진주시,판문동,판문동제5투,1733,1280,485,675,104,9,3,1276,4,453,38.009404388714735,52.89968652037618,8.150470219435736,0.7053291536050157,0.23510971786833856
104,경상남도,진주시,가호동,관내사전투표,6518,6518,3348,1963,1049,78,5,6443,75,0,51.96337110041907,30.467173676858607,16.28123544932485,1.2106161725904083,0.07760360080707744
105,경상남도,진주시,가호동,가호동제1투,3590,2698,823,1496,315,39,6,2679,19,892,30.7204180664427,55.841731989548336,11.758118701007838,1.4557670772676372,0.22396416573348266
106,경상남도,진주시,가호동,가호동제2투,4227,2732,606,1654,410,27,2,2699,33,1495,22.452760281585775,61.28195628010374,15.19081141163394,1.0003705075954057,0.07410151908114117
107,경상남도,진주시,가호동,가호동제3투,2961,2240,567,1450,164,30,2,2213,27,721,25.621328513330322,65.52191595119747,7.410754631721645,1.3556258472661544,0.09037505648441031
108,경상남도,진주시,가호동,가호동제4투,3670,2670,798,1486,317,38,4,2643,27,1000,30.192962542565265,56.22398789254635,11.993946273174423,1.4377601210745365,0.1513431706394249
109,경상남도,진주시,가호동,가호동제5투,2411,1808,525,1075,165,23,1,1789,19,603,29.346003353828955,60.08943543879263,9.2230296254891,1.285634432643935,0.05589714924538849
110,경상남도,진주시,가호동,가호동제6투,3387,2655,993,1291,305,45,3,2637,18,732,37.65642775881683,48.95714827455442,11.566173682214638,1.7064846416382253,0.11376564277588168
111,경상남도,진주시,충무공동,관내사전투표,6255,6255,3674,1603,828,76,4,6185,70,0,59.40177849636217,25.917542441390463,13.387227162489895,1.2287793047696038,0.0646725949878739
112,경상남도,진주시,충무공동,충무공동제1투,3151,2412,881,1214,252,38,4,2389,23,739,36.877354541649225,50.81624110506488,10.548346588530766,1.5906236919213061,0.1674340728338217
113,경상남도,진주시,충무공동,충무공동제2투,3795,2916,1169,1406,289,33,2,2899,17,879,40.3242497412901,48.49948258020007,9.96895481200414,1.1383235598482235,0.0689893066574681
114,경상남도,진주시,충무공동,충무공동제3투,2782,2049,709,1068,235,13,2,2027,22,733,34.977799703996055,52.688702516033544,11.593487913172176,0.6413418845584609,0.09866798223976321
115,경상남도,진주시,충무공동,충무공동제4투,2469,1876,709,977,162,21,2,1871,5,593,37.8941742383752,52.21806520577231,8.65847140566542,1.122394441475147,0.10689470871191875
116,경상남도,진주시,충무공동,충무공동제5투,2707,2075,779,1050,199,29,1,2058,17,632,37.85228377065112,51.02040816326531,9.66958211856171,1.4091350826044704,0.048590864917395525
117,경상남도,진주시,잘못 투입·구분된 투표지,,0,0,0,0,0,0,0,0,0,0,0.0,0.0,0.0,0.0,0.0
0,경상남도,통영시,거소·선상투표,,376,350,100,186,40,3,1,330,20,26,30.303030303030305,56.36363636363636,12.121212121212121,0.9090909090909091,0.30303030303030304
1,경상남도,통영시,관외사전투표,,7148,7147,3282,2682,994,89,19,7066,81,1,46.447778092272856,37.95641098216813,14.067364845740164,1.2595527879988677,0.268893291819983
2,경상남도,통영시,재외투표,,258,186,132,36,14,1,1,184,2,72,71.73913043478261,19.565217391304348,7.608695652173914,0.5434782608695652,0.5434782608695652
3,경상남도,통영시,산양읍,관내사전투표,1026,1026,433,532,39,12,2,1018,8,0,42.5343811394892,52.25933202357563,3.831041257367387,1.1787819253438114,0.19646365422396855
4,경상남도,통영시,산양읍,산양읍제1투,1745,1079,253,774,31,7,5,1070,9,666,23.644859813084114,72.33644859813084,2.897196261682243,0.6542056074766356,0.46728971962616817
5,경상남도,통영시,산양읍,산양읍제2투,452,287,51,222,9,2,0,284,3,165,17.95774647887324,78.16901408450704,3.169014084507042,0.7042253521126761,0.0
6,경상남도,통영시,산양읍,산양읍제3투,161,102,11,89,2,0,0,102,0,59,10.784313725490197,87.25490196078431,1.9607843137254901,0.0,0.0
7,경상남도,통영시,산양읍,산양읍제4투,69,47,6,41,0,0,0,47,0,22,12.76595744680851,87.2340425531915,0.0,0.0,0.0
8,경상남도,통영시,용남면,관내사전투표,2420,2420,1211,1011,159,20,2,2403,17,0,50.3953391593841,42.072409488139826,6.6167290886392,0.8322929671244279,0.08322929671244278
9,경상남도,통영시,용남면,용남면제1투,2210,1405,437,863,84,12,3,1399,6,805,31.236597569692638,61.68691922802001,6.004288777698355,0.8577555396711937,0.21443888491779842
10,경상남도,통영시,용남면,용남면제2투,2241,1474,338,1051,65,9,3,1466,8,767,23.05593451568895,71.69167803547067,4.433833560709413,0.6139154160982265,0.20463847203274216
11,경상남도,통영시,용남면,용남면제3투,148,94,8,82,4,0,0,94,0,54,8.51063829787234,87.2340425531915,4.25531914893617,0.0,0.0
12,경상남도,통영시,용남면,용남면제4투,1648,1032,272,705,49,2,0,1028,4,616,26.459143968871597,68.57976653696498,4.766536964980545,0.19455252918287938,0.0
13,경상남도,통영시,도산면,관내사전투표,829,829,379,391,43,10,1,824,5,0,45.99514563106796,47.45145631067961,5.218446601941747,1.2135922330097086,0.12135922330097086
14,경상남도,통영시,도산면,도산면제1투,1259,837,160,648,21,3,2,834,3,422,19.18465227817746,77.6978417266187,2.5179856115107913,0.3597122302158274,0.2398081534772182
15,경상남도,통영시,도산면,도산면제2투,406,300,50,233,11,0,2,296,4,106,16.89189189189189,78.71621621621621,3.7162162162162162,0.0,0.6756756756756757
16,경상남도,통영시,광도면,관내사전투표,6440,6440,3710,2128,487,65,8,6398,42,0,57.98687089715536,33.260393873085334,7.61175367302282,1.015942482025633,0.12503907471084713
17,경상남도,통영시,광도면,광도면제1투,1117,777,195,544,23,2,2,766,11,340,25.45691906005222,71.01827676240208,3.0026109660574414,0.26109660574412535,0.26109660574412535
18,경상남도,통영시,광도면,광도면제2투,2603,1787,748,922,89,13,2,1774,13,816,42.16459977452086,51.97294250281848,5.016910935738444,0.7328072153325818,0.11273957158962795
19,경상남도,통영시,광도면,광도면제3투,1871,1281,380,825,60,9,1,1275,6,590,29.80392156862745,64.70588235294117,4.705882352941177,0.7058823529411765,0.0784313725490196
20,경상남도,통영시,광도면,광도면제4투,3136,1817,532,1154,105,12,3,1806,11,1319,29.457364341085274,63.89811738648948,5.813953488372093,0.6644518272425249,0.16611295681063123
21,경상남도,통영시,광도면,광도면제5투,2243,1593,517,950,96,20,0,1583,10,650,32.659507264687306,60.01263423878711,6.0644346178142765,1.2634238787113077,0.0
22,경상남도,통영시,광도면,광도면제6투,2029,1377,492,763,100,15,5,1375,2,652,35.78181818181818,55.49090909090909,7.2727272727272725,1.090909090909091,0.36363636363636365
23,경상남도,통영시,광도면,광도면제7투,2160,1308,409,775,97,13,1,1295,13,852,31.583011583011583,59.84555984555985,7.4903474903474905,1.0038610038610039,0.07722007722007722
24,경상남도,통영시,욕지면,관내사전투표,481,481,258,198,22,2,0,480,1,0,53.75,41.25,4.583333333333333,0.4166666666666667,0.0
25,경상남도,통영시,욕지면,욕지면제1투,681,402,75,313,10,0,2,400,2,279,18.75,78.25,2.5,0.0,0.5
26,경상남도,통영시,욕지면,욕지면제2투,144,97,22,67,3,0,1,93,4,47,23.655913978494624,72.04301075268818,3.225806451612903,0.0,1.0752688172043012
27,경상남도,통영시,욕지면,욕지면제3투,183,136,18,113,3,2,0,136,0,47,13.23529411764706,83.08823529411765,2.2058823529411766,1.4705882352941175,0.0
28,경상남도,통영시,한산면,관내사전투표,346,346,143,176,20,3,0,342,4,0,41.812865497076025,51.461988304093566,5.847953216374268,0.8771929824561403,0.0
29,경상남도,통영시,한산면,한산면제1투,809,538,83,434,8,0,2,527,11,271,15.749525616698293,82.35294117647058,1.5180265654648957,0.0,0.3795066413662239
30,경상남도,통영시,한산면,한산면제2투,125,99,19,78,0,0,0,97,2,26,19.587628865979383,80.41237113402062,0.0,0.0,0.0
31,경상남도,통영시,한산면,한산면제3투,87,51,14,31,3,1,0,49,2,36,28.57142857142857,63.26530612244898,6.122448979591836,2.0408163265306123,0.0
32,경상남도,통영시,사량면,관내사전투표,534,534,187,310,19,7,1,524,10,0,35.68702290076336,59.16030534351145,3.6259541984732824,1.3358778625954197,0.19083969465648853
33,경상남도,통영시,사량면,사량면투표소,606,360,63,282,7,3,0,355,5,246,17.74647887323944,79.43661971830987,1.971830985915493,0.8450704225352111,0.0
34,경상남도,통영시,도천동,관내사전투표,1279,1279,550,632,70,9,3,1264,15,0,43.5126582278481,50.0,5.537974683544303,0.7120253164556962,0.23734177215189875
35,경상남도,통영시,도천동,도천동제1투,1579,1038,193,796,26,10,2,1027,11,541,18.792599805258035,77.50730282375852,2.5316455696202533,0.9737098344693282,0.19474196689386564
36,경상남도,통영시,도천동,도천동제2투,1316,804,170,588,33,3,1,795,9,512,21.38364779874214,73.9622641509434,4.150943396226415,0.37735849056603776,0.12578616352201258
37,경상남도,통영시,도천동,도천동제3투,1557,1071,251,722,74,11,0,1058,13,486,23.72400756143667,68.24196597353497,6.994328922495274,1.0396975425330812,0.0
38,경상남도,통영시,도천동,도천동제4투,915,625,145,436,32,3,1,617,8,290,23.500810372771475,70.66450567260941,5.186385737439222,0.48622366288492713,0.1620745542949757
39,경상남도,통영시,명정동,관내사전투표,1371,1371,514,769,73,7,1,1364,7,0,37.683284457478,56.37829912023461,5.351906158357771,0.5131964809384164,0.07331378299120235
40,경상남도,통영시,명정동,명정동제1투,767,500,72,402,21,0,0,495,5,267,14.545454545454545,81.21212121212122,4.242424242424243,0.0,0.0
41,경상남도,통영시,명정동,명정동제2투,740,444,70,348,18,5,0,441,3,296,15.873015873015872,78.91156462585033,4.081632653061225,1.1337868480725624,0.0
42,경상남도,통영시,중앙동,관내사전투표,1067,1067,442,556,51,9,0,1058,9,0,41.77693761814745,52.55198487712666,4.8204158790170135,0.8506616257088847,0.0
43,경상남도,통영시,중앙동,중앙동투표소,2137,1366,226,1087,36,5,2,1356,10,771,16.666666666666664,80.16224188790561,2.6548672566371683,0.3687315634218289,0.14749262536873156
44,경상남도,통영시,정량동,관내사전투표,1602,1602,675,841,62,12,3,1593,9,0,42.3728813559322,52.79347143753923,3.89202762084118,0.7532956685499058,0.18832391713747645
45,경상남도,통영시,정량동,정량동제1투,1460,885,157,696,23,4,0,880,5,575,17.84090909090909,79.0909090909091,2.6136363636363633,0.45454545454545453,0.0
46,경상남도,통영시,정량동,정량동제2투,1742,1113,209,859,29,4,1,1102,11,629,18.96551724137931,77.9491833030853,2.631578947368421,0.3629764065335753,0.09074410163339383
47,경상남도,통영시,정량동,정량동제3투,1697,1079,251,767,45,7,1,1071,8,618,23.436041083099905,71.61531279178338,4.201680672268908,0.6535947712418301,0.09337068160597572
48,경상남도,통영시,북신동,관내사전투표,2310,2310,983,1164,120,15,7,2289,21,0,42.94451725644386,50.8519003931848,5.242463958060288,0.655307994757536,0.3058103975535168
49,경상남도,통영시,북신동,북신동제1투,2286,1684,362,1224,73,8,2,1669,15,602,21.689634511683643,73.33732774116237,4.373876572798083,0.4793289394847214,0.11983223487118035
50,경상남도,통영시,북신동,북신동제2투,1514,974,177,755,24,10,1,967,7,540,18.304033092037226,78.07652533609101,2.481902792140641,1.0341261633919339,0.1034126163391934
51,경상남도,통영시,북신동,북신동제3투,1985,1389,315,989,64,10,1,1379,10,596,22.84263959390863,71.71863669325597,4.641044234952864,0.7251631617113851,0.0725163161711385
52,경상남도,통영시,무전동,관내사전투표,3896,3896,1885,1637,298,38,4,3862,34,0,48.80890730191611,42.3873640600725,7.716209218021751,0.9839461418953911,0.10357327809425168
53,경상남도,통영시,무전동,무전동제1투,2670,1592,387,1119,67,5,0,1578,14,1078,24.524714828897338,70.91254752851711,4.245880861850444,0.3168567807351077,0.0
54,경상남도,통영시,무전동,무전동제2투,2364,1663,432,1110,99,11,2,1654,9,701,26.118500604594924,67.11003627569528,5.985489721886336,0.6650544135429262,0.12091898428053204
55,경상남도,통영시,무전동,무전동제3투,2279,1691,485,1069,107,11,0,1672,19,588,29.00717703349282,63.93540669856459,6.399521531100478,0.6578947368421052,0.0
56,경상남도,통영시,미수동,관내사전투표,2424,2424,1161,1093,142,13,1,2410,14,0,48.17427385892116,45.35269709543569,5.892116182572614,0.5394190871369294,0.04149377593360996
57,경상남도,통영시,미수동,미수동제1투,1358,853,205,606,34,5,0,850,3,505,24.11764705882353,71.29411764705881,4.0,0.5882352941176471,0.0
58,경상남도,통영시,미수동,미수동제2투,1647,1058,293,691,55,12,0,1051,7,589,27.87821122740247,65.74690770694576,5.233111322549953,1.141769743101808,0.0
59,경상남도,통영시,미수동,미수동제3투,1038,652,179,419,43,8,0,649,3,386,27.5808936825886,64.56086286594761,6.6255778120184905,1.2326656394453006,0.0
60,경상남도,통영시,미수동,미수동제4투,1329,906,225,619,47,4,3,898,8,423,25.05567928730512,68.93095768374164,5.233853006681515,0.4454342984409799,0.33407572383073497
61,경상남도,통영시,봉평동,관내사전투표,2229,2229,1075,994,126,16,2,2213,16,0,48.57659286037054,44.91640307275192,5.693628558517849,0.7230004518752825,0.09037505648441031
62,경상남도,통영시,봉평동,봉평동제1투,1453,945,252,635,46,3,1,937,8,508,26.894343649946638,67.76947705442903,4.909284951974386,0.32017075773745995,0.10672358591248667
63,경상남도,통영시,봉평동,봉평동제2투,1669,1067,255,727,51,12,2,1047,20,602,24.355300859598856,69.43648519579752,4.871060171919771,1.146131805157593,0.19102196752626552
64,경상남도,통영시,봉평동,봉평동제3투,1343,781,161,585,28,2,1,777,4,562,20.72072072072072,75.2895752895753,3.6036036036036037,0.2574002574002574,0.1287001287001287
65,경상남도,통영시,봉평동,봉평동제4투,1189,752,176,534,31,7,0,748,4,437,23.52941176470588,71.3903743315508,4.144385026737968,0.9358288770053476,0.0
66,경상남도,통영시,잘못 투입·구분된 투표지,,0,0,0,0,0,0,0,0,0,0,0.0,0.0,0.0,0.0,0.0
0,경상남도,고성군,거소·선상투표,,284,275,116,119,19,1,2,257,18,9,45.13618677042802,46.30350194552529,7.392996108949417,0.38910505836575876,0.7782101167315175
1,경상남도,고성군,관외사전투표,,3901,3901,1613,1813,401,35,4,3866,35,0,41.722710812209,46.896016554578374,10.372478013450595,0.9053285049146406,0.10346611484738748
2,경상남도,고성군,재외투표,,361,165,86,53,16,6,0,161,4,196,53.41614906832298,32.91925465838509,9.937888198757763,3.7267080745341614,0.0
3,경상남도,고성군,고성읍,관내사전투표,5216,5216,2537,2285,293,51,4,5170,46,0,49.071566731141196,44.197292069632496,5.667311411992263,0.9864603481624759,0.07736943907156672
4,경상남도,고성군,고성읍,고성읍제1투,2286,1438,329,1001,81,12,1,1424,14,848,23.103932584269664,70.29494382022472,5.688202247191011,0.8426966292134831,0.0702247191011236
5,경상남도,고성군,고성읍,고성읍제2투,3444,2274,548,1566,127,12,1,2254,20,1170,24.312333629103815,69.4764862466726,5.634427684117125,0.5323868677905945,0.044365572315882874
6,경상남도,고성군,고성읍,고성읍제3투,1775,1174,366,723,61,14,0,1164,10,601,31.443298969072163,62.11340206185567,5.240549828178694,1.202749140893471,0.0
7,경상남도,고성군,고성읍,고성읍제4투,1362,868,182,644,30,2,1,859,9,494,21.187427240977883,74.97089639115251,3.4924330616996504,0.23282887077997672,0.11641443538998836
8,경상남도,고성군,고성읍,고성읍제5투,1887,1173,311,784,57,10,2,1164,9,714,26.718213058419245,67.35395189003437,4.896907216494846,0.859106529209622,0.1718213058419244
9,경상남도,고성군,고성읍,고성읍제6투,809,537,122,391,14,3,0,530,7,272,23.0188679245283,73.77358490566037,2.6415094339622645,0.5660377358490566,0.0
10,경상남도,고성군,고성읍,고성읍제7투,888,577,122,431,17,5,0,575,2,311,21.217391304347828,74.95652173913044,2.9565217391304346,0.8695652173913043,0.0
11,경상남도,고성군,삼산면,관내사전투표,460,460,212,216,21,8,0,457,3,0,46.389496717724285,47.26477024070022,4.595185995623632,1.75054704595186,0.0
12,경상남도,고성군,삼산면,삼산면투표소,913,596,114,464,6,4,0,588,8,317,19.387755102040817,78.91156462585033,1.0204081632653061,0.6802721088435374,0.0
13,경상남도,고성군,하일면,관내사전투표,414,414,140,245,23,4,1,413,1,0,33.89830508474576,59.32203389830508,5.569007263922518,0.9685230024213075,0.24213075060532688
14,경상남도,고성군,하일면,하일면투표소,1036,674,79,559,19,5,1,663,11,362,11.91553544494721,84.31372549019608,2.865761689291101,0.7541478129713424,0.1508295625942685
15,경상남도,고성군,하이면,관내사전투표,582,582,230,321,26,2,1,580,2,0,39.6551724137931,55.344827586206904,4.482758620689655,0.3448275862068966,0.1724137931034483
16,경상남도,고성군,하이면,하이면투표소,1452,955,166,745,30,6,2,949,6,497,17.49209694415174,78.50368809272919,3.1612223393045316,0.6322444678609063,0.21074815595363539
17,경상남도,고성군,상리면,관내사전투표,436,436,204,208,17,3,0,432,4,0,47.22222222222222,48.148148148148145,3.935185185185185,0.6944444444444444,0.0
18,경상남도,고성군,상리면,상리면투표소,878,570,118,433,18,0,0,569,1,308,20.738137082601053,76.09841827768014,3.163444639718805,0.0,0.0
19,경상남도,고성군,대가면,관내사전투표,507,507,254,220,28,5,0,507,0,0,50.09861932938856,43.39250493096647,5.522682445759369,0.9861932938856016,0.0
20,경상남도,고성군,대가면,대가면투표소,963,664,116,524,12,7,1,660,4,299,17.575757575757574,79.39393939393939,1.8181818181818181,1.0606060606060608,0.15151515151515152
21,경상남도,고성군,영현면,관내사전투표,217,217,75,134,7,1,0,217,0,0,34.56221198156682,61.75115207373272,3.225806451612903,0.4608294930875576,0.0
22,경상남도,고성군,영현면,영현면투표소,505,346,77,257,8,2,0,344,2,159,22.38372093023256,74.70930232558139,2.3255813953488373,0.5813953488372093,0.0
23,경상남도,고성군,영오면,관내사전투표,323,323,112,186,19,2,0,319,4,0,35.10971786833856,58.307210031347964,5.956112852664576,0.6269592476489028,0.0
24,경상남도,고성군,영오면,영오면투표소,776,521,103,396,12,5,0,516,5,255,19.961240310077518,76.74418604651163,2.3255813953488373,0.9689922480620154,0.0
25,경상남도,고성군,개천면,관내사전투표,196,196,82,104,7,1,1,195,1,0,42.05128205128205,53.333333333333336,3.5897435897435894,0.5128205128205128,0.5128205128205128
26,경상남도,고성군,개천면,개천면제1투,392,268,49,209,5,0,0,263,5,124,18.631178707224336,79.46768060836501,1.9011406844106464,0.0,0.0
27,경상남도,고성군,개천면,개천면제2투,229,165,24,136,3,0,0,163,2,64,14.723926380368098,83.43558282208589,1.8404907975460123,0.0,0.0
28,경상남도,고성군,구만면,관내사전투표,278,278,153,116,6,0,0,275,3,0,55.63636363636364,42.18181818181818,2.181818181818182,0.0,0.0
29,경상남도,고성군,구만면,구만면투표소,557,377,105,257,10,1,0,373,4,180,28.150134048257375,68.90080428954424,2.680965147453083,0.2680965147453083,0.0
30,경상남도,고성군,회화면,관내사전투표,914,914,353,508,37,5,1,904,10,0,39.048672566371685,56.19469026548673,4.092920353982301,0.5530973451327433,0.11061946902654868
31,경상남도,고성군,회화면,회화면투표소,1916,1258,198,1004,38,8,0,1248,10,658,15.865384615384615,80.44871794871796,3.0448717948717947,0.641025641025641,0.0
32,경상남도,고성군,마암면,관내사전투표,397,397,152,214,23,5,0,394,3,0,38.578680203045685,54.314720812182735,5.83756345177665,1.2690355329949239,0.0
33,경상남도,고성군,마암면,마암면투표소,941,586,141,417,9,7,0,574,12,355,24.56445993031359,72.64808362369338,1.5679442508710801,1.2195121951219512,0.0
34,경상남도,고성군,동해면,관내사전투표,616,616,241,341,24,4,1,611,5,0,39.44353518821604,55.810147299509005,3.927986906710311,0.6546644844517185,0.16366612111292964
35,경상남도,고성군,동해면,동해면제1투,923,570,108,438,13,0,1,560,10,353,19.28571428571429,78.21428571428571,2.3214285714285716,0.0,0.17857142857142858
36,경상남도,고성군,동해면,동해면제2투,787,515,92,401,18,2,0,513,2,272,17.93372319688109,78.16764132553607,3.508771929824561,0.3898635477582846,0.0
37,경상남도,고성군,거류면,관내사전투표,893,893,360,479,42,5,0,886,7,0,40.63205417607224,54.06320541760722,4.740406320541761,0.5643340857787811,0.0
38,경상남도,고성군,거류면,거류면제1투,1678,1066,220,779,44,7,1,1051,15,612,20.932445290199812,74.11988582302568,4.186489058039962,0.6660323501427212,0.09514747859181732
39,경상남도,고성군,거류면,거류면제2투,895,618,134,452,21,4,1,612,6,277,21.895424836601308,73.8562091503268,3.431372549019608,0.6535947712418301,0.16339869281045752
40,경상남도,고성군,잘못 투입·구분된 투표지,,0,0,0,0,0,0,0,0,0,0,0.0,0.0,0.0,0.0,0.0
0,경상남도,사천시,거소·선상투표,,285,269,81,130,35,3,4,253,16,16,32.015810276679844,51.38339920948617,13.83399209486166,1.185770750988142,1.5810276679841897
1,경상남도,사천시,관외사전투표,,7365,7364,3225,2979,973,86,16,7279,85,1,44.30553647479049,40.92595136694601,13.367220772084076,1.1814809726610798,0.2198104135183404
2,경상남도,사천시,재외투표,,431,286,187,64,32,2,0,285,1,145,65.6140350877193,22.45614035087719,11.228070175438596,0.7017543859649122,0.0
3,경상남도,사천시,사천읍,관내사전투표,4687,4687,2460,1682,452,49,6,4649,38,0,52.914605291460525,36.17982361798236,9.722520972252097,1.0539901053990104,0.1290600129060013
4,경상남도,사천시,사천읍,사천읍제1투,3107,1965,549,1243,142,14,5,1953,12,1142,28.110599078341014,63.64567332309268,7.2708653353814645,0.7168458781362007,0.2560163850486431
5,경상남도,사천시,사천읍,사천읍제2투,2767,1796,474,1132,151,21,1,1779,17,971,26.644182124789207,63.63125351320967,8.487914558740865,1.1804384485666104,0.056211354693648116
6,경상남도,사천시,사천읍,사천읍제3투,3740,2182,473,1569,111,13,0,2166,16,1558,21.83748845798707,72.4376731301939,5.124653739612189,0.6001846722068329,0.0
7,경상남도,사천시,정동면,관내사전투표,1394,1394,750,519,100,15,1,1385,9,0,54.151624548736464,37.47292418772563,7.2202166064981945,1.083032490974729,0.07220216606498195
8,경상남도,사천시,정동면,정동면제1투,2982,2116,680,1251,148,20,2,2101,15,866,32.36554021894336,59.543074726320796,7.044264635887673,0.9519276534983341,0.09519276534983341
9,경상남도,사천시,정동면,정동면제2투,2164,1468,500,788,151,13,2,1454,14,696,34.3878954607978,54.19532324621733,10.385144429160935,0.8940852819807428,0.1375515818431912
10,경상남도,사천시,정동면,정동면제3투,2108,1337,377,877,61,15,0,1330,7,771,28.345864661654137,65.93984962406016,4.586466165413534,1.1278195488721803,0.0
11,경상남도,사천시,사남면,관내사전투표,3816,3816,2237,1194,306,41,5,3783,33,0,59.1329632566746,31.56225218080888,8.088818398096748,1.0837959291567538,0.13217023526301877
12,경상남도,사천시,사남면,사남면제1투,3159,2079,530,1364,137,20,3,2054,25,1080,25.803310613437198,66.40701071080818,6.6699123661148985,0.9737098344693282,0.1460564751703992
13,경상남도,사천시,사남면,사남면제2투,3160,2150,726,1156,221,26,1,2130,20,1010,34.08450704225352,54.27230046948357,10.375586854460094,1.2206572769953052,0.046948356807511735
14,경상남도,사천시,사남면,사남면제3투,3026,2121,852,1062,164,24,2,2104,17,905,40.49429657794677,50.475285171102655,7.79467680608365,1.1406844106463878,0.09505703422053231
15,경상남도,사천시,용현면,관내사전투표,1831,1830,865,812,104,25,3,1809,21,1,47.816473189607514,44.88667772249862,5.749032614704257,1.3819789939192924,0.16583747927031509
16,경상남도,사천시,용현면,용현면제1투,1466,834,223,555,45,3,1,827,7,632,26.964933494558647,67.11003627569528,5.441354292623942,0.36275695284159615,0.12091898428053204
17,경상남도,사천시,용현면,용현면제2투,2106,1321,265,964,63,14,2,1308,13,785,20.259938837920487,73.70030581039755,4.81651376146789,1.0703363914373087,0.1529051987767584
18,경상남도,사천시,축동면,관내사전투표,643,643,279,314,41,4,0,638,5,0,43.73040752351097,49.21630094043887,6.426332288401254,0.6269592476489028,0.0
19,경상남도,사천시,축동면,축동면투표소,948,651,87,535,23,2,0,647,4,297,13.446676970633694,82.68933539412674,3.554868624420402,0.3091190108191654,0.0
20,경상남도,사천시,곤양면,관내사전투표,861,861,325,461,36,8,5,835,26,0,38.92215568862276,55.209580838323355,4.311377245508982,0.9580838323353293,0.5988023952095809
21,경상남도,사천시,곤양면,곤양면제1투,1335,872,185,642,31,6,1,865,7,463,21.38728323699422,74.21965317919074,3.5838150289017343,0.6936416184971098,0.11560693641618498
22,경상남도,사천시,곤양면,곤양면제2투,559,385,80,290,11,0,0,381,4,174,20.99737532808399,76.11548556430446,2.8871391076115485,0.0,0.0
23,경상남도,사천시,곤명면,관내사전투표,598,598,235,321,35,2,0,593,5,0,39.62900505902192,54.131534569983145,5.902192242833052,0.33726812816188867,0.0
24,경상남도,사천시,곤명면,곤명면투표소,1559,1045,204,798,25,5,1,1033,12,514,19.748305905130685,77.25072604065828,2.420135527589545,0.48402710551790895,0.0968054211035818
25,경상남도,사천시,서포면,관내사전투표,949,949,365,527,40,5,3,940,9,0,38.82978723404255,56.06382978723404,4.25531914893617,0.5319148936170213,0.3191489361702127
26,경상남도,사천시,서포면,서포면투표소,1945,1150,194,907,26,8,3,1138,12,795,17.04745166959578,79.701230228471,2.2847100175746924,0.7029876977152899,0.26362038664323373
27,경상남도,사천시,동서동,관내사전투표,1273,1273,343,866,39,10,1,1259,14,0,27.243844320889593,68.7847498014297,3.0976965845909454,0.7942811755361397,0.07942811755361398
28,경상남도,사천시,동서동,동서동제1투,1173,759,105,624,17,5,2,753,6,414,13.94422310756972,82.86852589641434,2.257636122177955,0.6640106241699867,0.2656042496679947
29,경상남도,사천시,동서동,동서동제2투,1139,752,105,619,15,2,1,742,10,387,14.150943396226415,83.42318059299191,2.0215633423180592,0.2695417789757413,0.13477088948787064
30,경상남도,사천시,동서동,동서동제3투,960,652,105,522,16,4,0,647,5,308,16.228748068006183,80.68006182380216,2.472952086553323,0.6182380216383307,0.0
31,경상남도,사천시,동서동,동서동제4투,167,123,14,107,1,1,0,123,0,44,11.38211382113821,86.99186991869918,0.8130081300813009,0.8130081300813009,0.0
32,경상남도,사천시,선구동,관내사전투표,1030,1030,357,610,53,4,0,1024,6,0,34.86328125,59.5703125,5.17578125,0.390625,0.0
33,경상남도,사천시,선구동,선구동제1투,1656,1024,137,831,42,8,0,1018,6,632,13.457760314341845,81.63064833005895,4.12573673870334,0.7858546168958742,0.0
34,경상남도,사천시,선구동,선구동제2투,1183,729,154,526,44,2,1,727,2,454,21.182943603851445,72.35213204951857,6.052269601100413,0.2751031636863824,0.1375515818431912
35,경상남도,사천시,동서금동,관내사전투표,1878,1878,734,1001,117,10,2,1864,14,0,39.377682403433475,53.701716738197426,6.276824034334765,0.5364806866952789,0.1072961373390558
36,경상남도,사천시,동서금동,동서금동제1투,2427,1629,369,1155,79,8,6,1617,12,798,22.820037105751393,71.42857142857143,4.885590599876314,0.49474335188620905,0.3710575139146568
37,경상남도,사천시,동서금동,동서금동제2투,938,589,104,461,21,2,0,588,1,349,17.687074829931973,78.4013605442177,3.571428571428571,0.3401360544217687,0.0
38,경상남도,사천시,벌용동,관내사전투표,3371,3371,1591,1506,210,41,2,3350,21,0,47.492537313432834,44.95522388059702,6.26865671641791,1.2238805970149254,0.05970149253731343
39,경상남도,사천시,벌용동,벌용동제1투,2275,1610,486,1008,89,15,3,1601,9,665,30.356027482823233,62.96064959400375,5.559025608994379,0.9369144284821986,0.18738288569643974
40,경상남도,사천시,벌용동,벌용동제2투,1651,1123,206,852,44,12,1,1115,8,528,18.475336322869957,76.41255605381167,3.9461883408071747,1.0762331838565022,0.08968609865470852
41,경상남도,사천시,벌용동,벌용동제3투,2539,1618,342,1176,67,20,1,1606,12,921,21.29514321295143,73.22540473225405,4.171855541718555,1.2453300124533,0.062266500622665005
42,경상남도,사천시,벌용동,벌용동제4투,1911,1290,308,885,69,13,0,1275,15,621,24.15686274509804,69.41176470588235,5.411764705882352,1.019607843137255,0.0
43,경상남도,사천시,향촌동,관내사전투표,1942,1942,865,902,121,25,5,1918,24,0,45.099061522419184,47.028154327424396,6.308654848800835,1.3034410844629822,0.2606882168925964
44,경상남도,사천시,향촌동,향촌동제1투,2689,1692,381,1189,89,11,3,1673,19,997,22.773460848774658,71.06993424985056,5.319784817692767,0.657501494321578,0.17931858936043038
45,경상남도,사천시,향촌동,향촌동제2투,1034,632,130,465,32,2,1,630,2,402,20.634920634920633,73.80952380952381,5.079365079365079,0.31746031746031744,0.15873015873015872
46,경상남도,사천시,남양동,관내사전투표,1503,1503,661,752,64,11,1,1489,14,0,44.39220953660175,50.50369375419744,4.298186702484889,0.7387508394895903,0.0671591672263264
47,경상남도,사천시,남양동,남양동투표소,2626,1725,337,1302,56,12,6,1713,12,901,19.673088149445416,76.00700525394045,3.2691185055458263,0.7005253940455342,0.3502626970227671
48,경상남도,사천시,잘못 투입·구분된 투표지,,0,1,0,0,0,0,0,0,1,-1,0.0,0.0,0.0,0.0,0.0
0,경상남도,김해시,거소·선상투표,,1033,976,376,339,204,10,6,935,41,57,40.21390374331551,36.25668449197861,21.818181818181817,1.06951871657754,0.6417112299465241
1,경상남도,김해시,관외사전투표,,30799,30797,15672,9518,4832,316,67,30405,392,2,51.544153922052296,31.304061831935538,15.892123006084525,1.0393027462588391,0.22035849366880444
2,경상남도,김해시,재외투표,,1681,1277,823,286,147,16,1,1273,4,404,64.65043205027494,22.46661429693637,11.547525530243519,1.2568735271013356,0.07855459544383347
3,경상남도,김해시,진영읍,관내사전투표,9858,9858,6560,2483,627,104,10,9784,74,0,67.04824202780048,25.378168438266556,6.4084219133278815,1.062959934587081,0.10220768601798855
4,경상남도,김해시,진영읍,진영읍제1투,1376,946,350,515,62,15,1,943,3,430,37.11558854718982,54.612937433722166,6.574761399787911,1.5906680805938493,0.10604453870625664
5,경상남도,김해시,진영읍,진영읍제2투,2944,1883,799,924,128,18,3,1872,11,1061,42.68162393162393,49.358974358974365,6.837606837606838,0.9615384615384616,0.16025641025641024
6,경상남도,김해시,진영읍,진영읍제3투,3240,2072,919,934,171,25,2,2051,21,1168,44.80741101901511,45.53876157971721,8.3373963920039,1.218917601170161,0.09751340809361286
7,경상남도,김해시,진영읍,진영읍제4투,3395,2430,1174,1019,180,36,4,2413,17,965,48.653128885205135,42.22958972233734,7.459593866556154,1.491918773311231,0.16576875259013676
8,경상남도,김해시,진영읍,진영읍제5투,2806,1942,891,859,153,23,1,1927,15,864,46.23767514270887,44.57706279190452,7.939802802283342,1.1935651271406331,0.05189413596263622
9,경상남도,김해시,진영읍,진영읍제6투,2803,2077,978,943,118,20,4,2063,14,726,47.40668928744547,45.71013087736306,5.719825496849248,0.9694619486185166,0.19389238972370335
10,경상남도,김해시,진영읍,진영읍제7투,2838,1608,618,826,137,14,1,1596,12,1230,38.721804511278194,51.75438596491229,8.583959899749374,0.8771929824561403,0.06265664160401002
11,경상남도,김해시,진영읍,진영읍제8투,2539,1428,526,797,83,12,2,1420,8,1111,37.04225352112676,56.12676056338029,5.845070422535211,0.8450704225352111,0.14084507042253522
12,경상남도,김해시,진영읍,진영읍제9투,3459,2176,932,1051,152,12,6,2153,23,1283,43.288434742220154,48.81560613098003,7.0599163957268924,0.5573618207152811,0.27868091035764053
13,경상남도,김해시,진영읍,진영읍제10투,1453,885,319,527,31,5,0,882,3,568,36.16780045351474,59.750566893424036,3.5147392290249435,0.5668934240362812,0.0
14,경상남도,김해시,진영읍,진영읍제11투,2924,2211,1031,957,180,31,4,2203,8,713,46.79981842941444,43.44076259645938,8.170676350431231,1.407172038129823,0.18157058556513844
15,경상남도,김해시,주촌면,관내사전투표,3765,3765,2431,1033,250,31,5,3750,15,0,64.82666666666667,27.54666666666667,6.666666666666667,0.8266666666666667,0.13333333333333333
16,경상남도,김해시,주촌면,주촌면제1투,3080,1943,631,1154,129,13,0,1927,16,1137,32.745199792423456,59.8858329008822,6.694343539180073,0.6746237675142709,0.0
17,경상남도,김해시,주촌면,주촌면제2투,2763,2199,1025,918,214,22,2,2181,18,564,46.99679046309033,42.0907840440165,9.81201283814764,1.008711600183402,0.09170105456212746
18,경상남도,김해시,주촌면,주촌면제3투,3182,2536,1186,1077,229,30,1,2523,13,646,47.00753071739992,42.687277051129605,9.0764962346413,1.1890606420927468,0.03963535473642489
19,경상남도,김해시,주촌면,주촌면제4투,2281,1729,760,767,162,27,3,1719,10,552,44.21175101803374,44.618964514252475,9.424083769633508,1.5706806282722512,0.17452006980802792
20,경상남도,김해시,진례면,관내사전투표,2327,2327,1347,800,149,16,3,2315,12,0,58.18574514038877,34.557235421166304,6.436285097192225,0.6911447084233261,0.12958963282937366
21,경상남도,김해시,진례면,진례면제1투,1695,1048,311,679,42,8,1,1041,7,647,29.875120076849182,65.22574447646494,4.034582132564841,0.7684918347742555,0.09606147934678194
22,경상남도,김해시,진례면,진례면제2투,1750,1083,291,730,54,2,1,1078,5,667,26.99443413729128,67.71799628942486,5.009276437847866,0.1855287569573284,0.0927643784786642
23,경상남도,김해시,한림면,관내사전투표,1880,1880,1109,619,107,13,4,1852,28,0,59.88120950323974,33.423326133909285,5.777537796976242,0.7019438444924406,0.21598272138228944
24,경상남도,김해시,한림면,한림면제1투,883,547,177,339,23,6,0,545,2,336,32.477064220183486,62.20183486238532,4.220183486238533,1.1009174311926606,0.0
25,경상남도,김해시,한림면,한림면제2투,1141,707,199,472,31,3,0,705,2,434,28.22695035460993,66.95035460992908,4.397163120567376,0.425531914893617,0.0
26,경상남도,김해시,한림면,한림면제3투,1204,754,256,446,34,5,3,744,10,450,34.40860215053764,59.946236559139784,4.56989247311828,0.6720430107526881,0.4032258064516129
27,경상남도,김해시,한림면,한림면제4투,981,642,235,378,21,1,2,637,5,339,36.891679748822604,59.34065934065934,3.296703296703297,0.15698587127158556,0.3139717425431711
28,경상남도,김해시,생림면,관내사전투표,1388,1388,765,531,72,13,1,1382,6,0,55.35455861070911,38.42257597684515,5.209840810419681,0.9406657018813315,0.0723589001447178
29,경상남도,김해시,생림면,생림면제1투,1076,680,155,499,22,2,0,678,2,396,22.86135693215339,73.59882005899705,3.2448377581120944,0.2949852507374631,0.0
30,경상남도,김해시,생림면,생림면제2투,1065,724,189,504,20,6,0,719,5,341,26.286509040333794,70.09735744089014,2.781641168289291,0.8344923504867872,0.0
31,경상남도,김해시,상동면,관내사전투표,1172,1172,625,430,57,18,6,1136,36,0,55.017605633802816,37.852112676056336,5.017605633802817,1.584507042253521,0.528169014084507
32,경상남도,김해시,상동면,상동면제1투,1284,765,174,558,24,5,0,761,4,519,22.864651773981603,73.32457293035479,3.1537450722733245,0.657030223390276,0.0
33,경상남도,김해시,상동면,상동면제2투,515,354,95,235,19,1,2,352,2,161,26.988636363636363,66.76136363636364,5.3977272727272725,0.2840909090909091,0.5681818181818182
34,경상남도,김해시,대동면,관내사전투표,964,964,531,382,34,8,0,955,9,0,55.602094240837694,40.0,3.56020942408377,0.8376963350785341,0.0
35,경상남도,김해시,대동면,대동면제1투,1261,872,213,617,29,9,0,868,4,389,24.53917050691244,71.08294930875576,3.3410138248847927,1.0368663594470047,0.0
36,경상남도,김해시,대동면,대동면제2투,1187,802,169,591,30,7,1,798,4,385,21.17794486215539,74.06015037593986,3.7593984962406015,0.8771929824561403,0.12531328320802004
37,경상남도,김해시,대동면,대동면제3투,938,675,154,503,12,4,1,674,1,263,22.8486646884273,74.62908011869436,1.7804154302670623,0.5934718100890208,0.1483679525222552
38,경상남도,김해시,동상동,관내사전투표,2565,2565,1423,959,144,23,2,2551,14,0,55.78204625637005,37.59310074480596,5.64484515876127,0.901607212857703,0.07840062720501764
39,경상남도,김해시,동상동,동상동제1투,3066,1903,583,1178,110,13,2,1886,17,1163,30.911983032873806,62.460233297985155,5.832449628844114,0.689289501590668,0.10604453870625664
40,경상남도,김해시,동상동,동상동제2투,2268,1298,373,834,72,8,1,1288,10,970,28.959627329192543,64.75155279503106,5.590062111801243,0.6211180124223602,0.07763975155279502
41,경상남도,김해시,회현동,관내사전투표,3227,3227,1769,1209,191,36,5,3210,17,0,55.10903426791277,37.663551401869164,5.950155763239875,1.1214953271028036,0.1557632398753894
42,경상남도,김해시,회현동,회현동제1투,1901,1170,272,826,56,9,1,1164,6,731,23.367697594501717,70.96219931271477,4.810996563573884,0.7731958762886598,0.0859106529209622
43,경상남도,김해시,회현동,회현동제2투,2883,2006,659,1164,134,27,4,1988,18,877,33.14889336016096,58.55130784708249,6.740442655935613,1.358148893360161,0.2012072434607646
44,경상남도,김해시,부원동,관내사전투표,3550,3550,2060,1097,319,44,2,3522,28,0,58.489494605337875,31.147075525269734,9.057353776263486,1.2492901760363428,0.05678591709256105
45,경상남도,김해시,부원동,부원동제1투,2349,1484,450,919,93,9,3,1474,10,865,30.529172320217096,62.34735413839891,6.309362279511534,0.6105834464043419,0.20352781546811397
46,경상남도,김해시,부원동,부원동제2투,3071,1863,515,1204,116,14,4,1853,10,1208,27.792768483540204,64.97571505666487,6.260118726389638,0.7555315704263357,0.21586616297895306
47,경상남도,김해시,내외동,관내사전투표,12048,12048,7451,3539,854,128,9,11981,67,0,62.190134379434106,29.538435856773226,7.127952591603372,1.0683582338702946,0.0751189383190051
48,경상남도,김해시,내외동,내외동제1투,3078,2034,801,1043,153,21,2,2020,14,1044,39.65346534653465,51.633663366336634,7.574257425742574,1.0396039603960396,0.09900990099009901
49,경상남도,김해시,내외동,내외동제2투,2078,1184,424,675,69,9,1,1178,6,894,35.993208828522924,57.30050933786078,5.857385398981324,0.7640067911714771,0.08488964346349745
50,경상남도,김해시,내외동,내외동제3투,1901,1135,401,616,87,13,6,1123,12,766,35.707925200356186,54.853072128227964,7.747105966162065,1.157613535173642,0.5342831700801425
51,경상남도,김해시,내외동,내외동제4투,2661,1693,548,988,124,20,0,1680,13,968,32.61904761904762,58.80952380952381,7.380952380952381,1.1904761904761905,0.0
52,경상남도,김해시,내외동,내외동제5투,3380,2178,752,1211,178,21,0,2162,16,1202,34.78260869565217,56.01295097132285,8.233117483811286,0.971322849213691,0.0
53,경상남도,김해시,내외동,내외동제6투,3429,2518,949,1331,197,24,3,2504,14,911,37.89936102236422,53.15495207667732,7.867412140575079,0.9584664536741214,0.11980830670926518
54,경상남도,김해시,내외동,내외동제7투,2284,1170,391,669,90,9,0,1159,11,1114,33.73597929249353,57.72217428817946,7.765314926660914,0.7765314926660914,0.0
55,경상남도,김해시,내외동,내외동제8투,2370,1537,572,796,136,14,6,1524,13,833,37.53280839895013,52.23097112860893,8.923884514435695,0.9186351706036745,0.39370078740157477
56,경상남도,김해시,내외동,내외동제9투,2705,1922,757,995,129,18,5,1904,18,783,39.758403361344534,52.25840336134454,6.775210084033613,0.9453781512605042,0.26260504201680673
57,경상남도,김해시,내외동,내외동제10투,2452,1664,638,871,117,27,2,1655,9,788,38.54984894259819,52.62839879154079,7.069486404833837,1.6314199395770395,0.12084592145015105
58,경상남도,김해시,내외동,내외동제11투,1230,762,291,399,53,9,2,754,8,468,38.59416445623342,52.91777188328912,7.029177718832891,1.1936339522546418,0.2652519893899204
59,경상남도,김해시,내외동,내외동제12투,3097,2337,947,1179,164,23,2,2315,22,760,40.90712742980562,50.92872570194385,7.084233261339093,0.9935205183585313,0.08639308855291576
60,경상남도,김해시,내외동,내외동제13투,3101,1858,662,1009,146,20,2,1839,19,1243,35.99782490483959,54.866775421424684,7.939097335508428,1.0875475802066341,0.1087547580206634
61,경상남도,김해시,내외동,내외동제14투,3593,2314,892,1169,204,31,2,2298,16,1279,38.81636205395996,50.87032201914708,8.87728459530026,1.3489991296779809,0.08703220191470844
62,경상남도,김해시,내외동,내외동제15투,3225,2126,792,1150,135,28,3,2108,18,1099,37.571157495256166,54.55407969639469,6.404174573055029,1.3282732447817838,0.14231499051233396
63,경상남도,김해시,내외동,내외동제16투,2432,1878,888,772,170,28,3,1861,17,554,47.716281569048896,41.483073616335304,9.134873723804406,1.5045674368619022,0.16120365394948952
64,경상남도,김해시,북부동,관내사전투표,12272,12272,7897,3290,891,110,10,12198,74,0,64.7401213313658,26.971634694212167,7.304476143630104,0.9017871782259386,0.08198065256599442
65,경상남도,김해시,북부동,북부동제1투,2551,1415,468,830,90,14,3,1405,10,1136,33.30960854092527,59.07473309608541,6.405693950177936,0.99644128113879,0.21352313167259787
66,경상남도,김해시,북부동,북부동제2투,2381,1595,549,928,91,12,4,1584,11,786,34.659090909090914,58.58585858585859,5.744949494949495,0.7575757575757576,0.25252525252525254
67,경상남도,김해시,북부동,북부동제3투,2775,1899,673,1073,115,18,2,1881,18,876,35.77884104199894,57.0441254651781,6.113769271664009,0.9569377990430622,0.10632642211589581
68,경상남도,김해시,북부동,북부동제4투,3281,2446,1130,1044,222,29,3,2428,18,835,46.540362438220754,42.998352553542006,9.14332784184514,1.1943986820428336,0.12355848434925865
69,경상남도,김해시,북부동,북부동제5투,3201,2235,952,1043,188,34,4,2221,14,966,42.863574966231425,46.96082845565061,8.464655560558306,1.530841963079694,0.18009905447996397
70,경상남도,김해시,북부동,북부동제6투,3158,2222,865,1185,125,28,4,2207,15,936,39.19347530584504,53.6927956502039,5.6637970095151795,1.2686905301314002,0.18124150430448574
71,경상남도,김해시,북부동,북부동제7투,3255,2485,854,1405,174,34,5,2472,13,770,34.54692556634304,56.836569579288025,7.038834951456311,1.3754045307443366,0.20226537216828477
72,경상남도,김해시,북부동,북부동제8투,2724,1773,602,985,151,23,4,1765,8,951,34.107648725212464,55.80736543909348,8.555240793201133,1.3031161473087818,0.22662889518413595
73,경상남도,김해시,북부동,북부동제9투,1726,1108,380,613,96,11,0,1100,8,618,34.54545454545455,55.72727272727273,8.727272727272728,1.0,0.0
74,경상남도,김해시,북부동,북부동제10투,2510,1681,735,773,127,23,5,1663,18,829,44.19723391461214,46.48226097414312,7.636800962116657,1.3830426939266387,0.30066145520144316
75,경상남도,김해시,북부동,북부동제11투,2637,1848,748,890,160,30,2,1830,18,789,40.87431693989071,48.63387978142077,8.743169398907105,1.639344262295082,0.1092896174863388
76,경상남도,김해시,북부동,북부동제12투,2510,1463,508,790,128,14,3,1443,20,1047,35.2044352044352,54.74705474705475,8.87040887040887,0.9702009702009702,0.2079002079002079
77,경상남도,김해시,북부동,북부동제13투,2522,1677,646,850,146,19,3,1664,13,845,38.82211538461539,51.081730769230774,8.774038461538462,1.141826923076923,0.18028846153846154
78,경상남도,김해시,북부동,북부동제14투,2896,2074,923,947,169,17,2,2058,16,822,44.84936831875607,46.01554907677357,8.211856171039845,0.8260447035957239,0.09718172983479105
79,경상남도,김해시,북부동,북부동제15투,2804,1952,894,856,168,20,2,1940,12,852,46.08247422680412,44.123711340206185,8.65979381443299,1.0309278350515463,0.10309278350515465
80,경상남도,김해시,북부동,북부동제16투,2938,2197,952,1029,178,19,1,2179,18,741,43.689765947682424,47.22349701698027,8.168884809545665,0.8719596145020652,0.04589261128958238
81,경상남도,김해시,북부동,북부동제17투,3107,2408,1058,1047,251,27,1,2384,24,699,44.37919463087248,43.917785234899334,10.528523489932885,1.1325503355704698,0.04194630872483222
82,경상남도,김해시,칠산서부동,관내사전투표,3046,3046,1844,982,171,29,2,3028,18,0,60.898282694848085,32.43064729194188,5.647291941875825,0.9577278731836195,0.06605019815059446
83,경상남도,김해시,칠산서부동,칠산서부동제1투,1817,1169,365,734,50,11,3,1163,6,648,31.38435081685297,63.11263972484953,4.299226139294927,0.9458297506448838,0.2579535683576956
84,경상남도,김해시,칠산서부동,칠산서부동제2투,1951,1204,393,732,65,6,0,1196,8,747,32.85953177257525,61.20401337792642,5.434782608695652,0.5016722408026756,0.0
85,경상남도,김해시,칠산서부동,칠산서부동제3투,1690,1123,387,648,72,9,0,1116,7,567,34.67741935483871,58.06451612903226,6.451612903225806,0.8064516129032258,0.0
86,경상남도,김해시,활천동,관내사전투표,5836,5836,3531,1812,397,47,6,5793,43,0,60.95287415846712,31.27912998446401,6.853098567236319,0.8113240117383048,0.10357327809425168
87,경상남도,김해시,활천동,활천동제1투,3080,1817,633,1062,97,10,2,1804,13,1263,35.08869179600887,58.86917960088692,5.376940133037694,0.5543237250554324,0.11086474501108648
88,경상남도,김해시,활천동,활천동제2투,2870,1850,675,1005,144,14,3,1841,9,1020,36.66485605649103,54.58989679521999,7.821835958718087,0.7604562737642585,0.16295491580662683
89,경상남도,김해시,활천동,활천동제3투,2939,1893,602,1116,126,24,4,1872,21,1046,32.15811965811966,59.61538461538461,6.730769230769231,1.282051282051282,0.2136752136752137
90,경상남도,김해시,활천동,활천동제4투,4011,2411,856,1358,163,15,4,2396,15,1600,35.72621035058431,56.677796327212015,6.803005008347246,0.6260434056761269,0.1669449081803005
91,경상남도,김해시,활천동,활천동제5투,3570,2202,843,1135,172,24,6,2180,22,1368,38.6697247706422,52.06422018348624,7.889908256880735,1.1009174311926606,0.27522935779816515
92,경상남도,김해시,활천동,활천동제6투,3126,2263,895,1164,163,18,5,2245,18,863,39.86636971046771,51.84855233853006,7.260579064587973,0.8017817371937639,0.22271714922048996
93,경상남도,김해시,활천동,활천동제7투,3244,1825,681,995,107,27,2,1812,13,1419,37.58278145695364,54.911699779249446,5.905077262693157,1.490066225165563,0.11037527593818984
94,경상남도,김해시,삼안동,관내사전투표,7880,7880,4690,2486,576,50,8,7810,70,0,60.05121638924456,31.83098591549296,7.3751600512163895,0.6402048655569782,0.10243277848911651
95,경상남도,김해시,삼안동,삼안동제1투,2964,1762,625,947,157,15,2,1746,16,1202,35.79610538373425,54.238258877434134,8.991981672394044,0.859106529209622,0.11454753722794961
96,경상남도,김해시,삼안동,삼안동제2투,4274,3213,1287,1511,358,29,0,3185,28,1061,40.40816326530612,47.44113029827315,11.240188383045526,0.9105180533751962,0.0
97,경상남도,김해시,삼안동,삼안동제3투,4082,2779,1062,1477,183,29,5,2756,23,1303,38.53410740203193,53.5921625544267,6.640058055152395,1.0522496371552976,0.18142235123367198
98,경상남도,김해시,삼안동,삼안동제4투,2292,1340,421,765,125,15,4,1330,10,952,31.654135338345863,57.5187969924812,9.398496240601503,1.1278195488721803,0.30075187969924816
99,경상남도,김해시,삼안동,삼안동제5투,2870,2092,781,1081,183,31,2,2078,14,778,37.5842155919153,52.02117420596728,8.806544754571703,1.4918190567853706,0.0962463907603465
100,경상남도,김해시,삼안동,삼안동제6투,1986,1221,428,684,91,9,2,1214,7,765,35.25535420098847,56.34266886326195,7.495881383855024,0.7413509060955519,0.16474464579901155
101,경상남도,김해시,삼안동,삼안동제7투,2142,1353,488,756,86,14,0,1344,9,789,36.30952380952381,56.25,6.398809523809524,1.0416666666666665,0.0
102,경상남도,김해시,삼안동,삼안동제8투,2436,1301,387,778,109,12,0,1286,15,1135,30.093312597200622,60.49766718506998,8.475894245723174,0.9331259720062209,0.0
103,경상남도,김해시,불암동,관내사전투표,1935,1935,1237,566,107,8,3,1921,14,0,64.39354502863091,29.463820926600732,5.570015616866216,0.41644976574700676,0.15616866215512754
104,경상남도,김해시,불암동,불암동제1투,3310,2286,847,1241,152,23,1,2264,22,1024,37.41166077738516,54.814487632508836,6.713780918727916,1.0159010600706713,0.044169611307420496
105,경상남도,김해시,불암동,불암동제2투,614,412,115,271,23,1,0,410,2,202,28.04878048780488,66.09756097560975,5.609756097560976,0.24390243902439024,0.0
106,경상남도,김해시,장유1동,관내사전투표,9549,9549,6152,2566,695,78,4,9495,54,0,64.79199578725645,27.024749868351766,7.319641916798315,0.8214849921011059,0.042127435492364404
107,경상남도,김해시,장유1동,장유1동제1투,3632,2719,1272,1147,231,40,6,2696,23,913,47.18100890207715,42.54451038575668,8.568249258160238,1.483679525222552,0.22255192878338279
108,경상남도,김해시,장유1동,장유1동제2투,3710,2552,1098,1222,182,27,2,2531,21,1158,43.38206242591861,48.28131173449229,7.190833662583959,1.066772026866851,0.07902015013828526
109,경상남도,김해시,장유1동,장유1동제3투,3033,2083,853,1061,125,25,2,2066,17,950,41.28751210067764,51.35527589545015,6.050338818973863,1.2100677637947725,0.0968054211035818
110,경상남도,김해시,장유1동,장유1동제4투,3272,2465,1127,1097,193,24,2,2443,22,807,46.13180515759313,44.90380679492427,7.900122799836266,0.9823986901350797,0.08186655751125665
111,경상남도,김해시,장유1동,장유1동제5투,3433,2469,964,1266,191,24,3,2448,21,964,39.37908496732026,51.71568627450981,7.802287581699346,0.9803921568627451,0.12254901960784313
112,경상남도,김해시,장유1동,장유1동제6투,3841,2411,871,1287,203,29,2,2392,19,1430,36.41304347826087,53.80434782608695,8.486622073578594,1.2123745819397993,0.08361204013377926
113,경상남도,김해시,장유1동,장유1동제7투,4397,2798,1085,1415,241,30,4,2775,23,1599,39.0990990990991,50.990990990990994,8.684684684684685,1.0810810810810811,0.14414414414414414
114,경상남도,김해시,장유1동,장유1동제8투,4240,2924,1196,1417,254,33,4,2904,20,1316,41.18457300275482,48.794765840220386,8.7465564738292,1.1363636363636365,0.13774104683195593
115,경상남도,김해시,장유1동,장유1동제9투,3983,2729,1120,1306,252,27,3,2708,21,1254,41.3589364844904,48.2274741506647,9.30576070901034,0.9970457902511078,0.11078286558345643
116,경상남도,김해시,장유1동,장유1동제10투,2967,2371,1049,993,284,26,0,2352,19,596,44.60034013605442,42.21938775510204,12.074829931972788,1.1054421768707483,0.0
117,경상남도,김해시,장유2동,관내사전투표,8833,8834,6027,2042,626,69,7,8771,63,-1,68.71508379888269,23.281267814388325,7.137156538593091,0.7866833884391746,0.07980845969672785
118,경상남도,김해시,장유2동,장유2동제1투,2726,1667,627,907,107,7,5,1653,14,1059,37.93103448275862,54.86993345432547,6.47307924984876,0.42347247428917123,0.3024803387779794
119,경상남도,김해시,장유2동,장유2동제2투,2814,1985,882,900,164,22,1,1969,16,829,44.79431183341798,45.70848146267141,8.329101066531235,1.1173184357541899,0.050787201625190445
120,경상남도,김해시,장유2동,장유2동제3투,2335,1537,647,737,123,23,1,1531,6,798,42.25996080992815,48.13847158719791,8.033964728935336,1.5022860875244939,0.06531678641410843
121,경상남도,김해시,장유2동,장유2동제4투,3256,2180,877,1081,169,32,3,2162,18,1076,40.56429232192414,50.0,7.816836262719703,1.4801110083256246,0.13876040703052728
122,경상남도,김해시,장유2동,장유2동제5투,2950,1987,779,1025,139,24,1,1968,19,963,39.58333333333333,52.083333333333336,7.063008130081301,1.2195121951219512,0.05081300813008131
123,경상남도,김해시,장유2동,장유2동제6투,3067,2267,947,1072,204,32,1,2256,11,800,41.976950354609926,47.5177304964539,9.042553191489363,1.4184397163120568,0.044326241134751775
124,경상남도,김해시,장유2동,장유2동제7투,3379,2396,942,1137,269,25,4,2377,19,983,39.62978544383677,47.833403449726546,11.316785864535127,1.051745898190997,0.16827934371055953
125,경상남도,김해시,장유3동,관내사전투표,11193,11192,7754,2360,884,113,11,11122,70,1,69.71767667685668,21.219205178924653,7.948210753461607,1.0160043157705447,0.09890307498651321
126,경상남도,김해시,장유3동,장유3동제1투,3761,2794,1208,1340,198,27,4,2777,17,967,43.500180050414116,48.25351098307526,7.129996398991717,0.9722722362261434,0.14404033129276198
127,경상남도,김해시,장유3동,장유3동제2투,3106,2396,1104,1063,187,28,1,2383,13,710,46.328157784305496,44.60763743180864,7.847251363827108,1.1749895090222409,0.0419639110365086
128,경상남도,김해시,장유3동,장유3동제3투,3507,2409,1102,1058,197,30,1,2388,21,1098,46.14740368509212,44.30485762144053,8.249581239530988,1.256281407035176,0.04187604690117253
129,경상남도,김해시,장유3동,장유3동제4투,3189,2242,891,1119,189,22,2,2223,19,947,40.08097165991903,50.337381916329285,8.502024291497975,0.9896536212325686,0.0899685110211426
130,경상남도,김해시,장유3동,장유3동제5투,3622,2699,1285,1139,226,41,2,2693,6,923,47.716301522465656,42.294838470107685,8.392127738581507,1.5224656516895656,0.07426661715558856
131,경상남도,김해시,장유3동,장유3동제6투,3827,2749,1045,1435,226,24,2,2732,17,1078,38.250366032210835,52.52562225475842,8.272327964860908,0.8784773060029283,0.07320644216691069
132,경상남도,김해시,장유3동,장유3동제7투,3517,2762,1420,1021,252,45,1,2739,23,755,51.84373859072654,37.27637824023366,9.200438116100766,1.642935377875137,0.03650967506389193
133,경상남도,김해시,장유3동,장유3동제8투,3317,2209,877,1164,134,18,3,2196,13,1108,39.936247723132965,53.00546448087432,6.10200364298725,0.819672131147541,0.1366120218579235
134,경상남도,김해시,장유3동,장유3동제9투,3808,3000,1417,1171,348,44,1,2981,19,808,47.53438443475344,39.282120093928214,11.673934921167394,1.4760147601476015,0.03354579000335458
135,경상남도,김해시,장유3동,장유3동제10투,3266,2555,1234,1055,220,32,4,2545,10,711,48.48722986247544,41.45383104125737,8.644400785854616,1.2573673870333988,0.15717092337917485
136,경상남도,김해시,장유3동,장유3동제11투,3013,2106,780,1014,254,33,2,2083,23,907,37.445991358617384,48.67978876620259,12.193951032165147,1.584253480556889,0.09601536245799328
137,경상남도,김해시,잘못 투입·구분된 투표지,,0,1,1,0,0,0,0,1,0,-1,100.0,0.0,0.0,0.0,0.0
0,경상남도,밀양시,거소·선상투표,,255,241,77,104,34,4,3,222,19,14,34.68468468468468,46.846846846846844,15.315315315315313,1.8018018018018018,1.3513513513513513
1,경상남도,밀양시,관외사전투표,,6712,6712,2753,3089,736,56,19,6653,59,0,41.37982864872989,46.43018187283932,11.062678490906357,0.8417255373515706,0.28558545017285436
2,경상남도,밀양시,재외투표,,466,286,173,89,22,1,0,285,1,180,60.70175438596491,31.2280701754386,7.719298245614035,0.3508771929824561,0.0
3,경상남도,밀양시,삼랑진읍,관내사전투표,1312,1312,570,663,55,9,4,1301,11,0,43.81245196003075,50.96079938508839,4.227517294388932,0.6917755572636434,0.3074558032282859
4,경상남도,밀양시,삼랑진읍,삼랑진읍제1투,1742,1128,192,880,39,9,0,1120,8,614,17.142857142857142,78.57142857142857,3.482142857142857,0.8035714285714285,0.0
5,경상남도,밀양시,삼랑진읍,삼랑진읍제2투,1266,698,128,527,22,4,3,684,14,568,18.71345029239766,77.046783625731,3.216374269005848,0.5847953216374269,0.43859649122807015
6,경상남도,밀양시,삼랑진읍,삼랑진읍제3투,996,706,148,516,31,3,1,699,7,290,21.17310443490701,73.8197424892704,4.434907010014307,0.4291845493562232,0.14306151645207438
7,경상남도,밀양시,하남읍,관내사전투표,1775,1775,812,860,80,8,2,1762,13,0,46.08399545970488,48.80817253121453,4.540295119182747,0.4540295119182747,0.11350737797956867
8,경상남도,밀양시,하남읍,하남읍제1투,777,482,82,371,22,4,0,479,3,295,17.118997912317326,77.45302713987473,4.592901878914405,0.8350730688935281,0.0
9,경상남도,밀양시,하남읍,하남읍제2투,921,533,116,379,33,1,0,529,4,388,21.928166351606805,71.64461247637051,6.238185255198488,0.1890359168241966,0.0
10,경상남도,밀양시,하남읍,하남읍제3투,956,618,134,460,16,1,0,611,7,338,21.931260229132572,75.28641571194763,2.618657937806874,0.16366612111292964,0.0
11,경상남도,밀양시,하남읍,하남읍제4투,1479,914,216,650,34,4,3,907,7,565,23.814773980154357,71.66482910694597,3.7486218302094816,0.4410143329658214,0.33076074972436603
12,경상남도,밀양시,부북면,관내사전투표,1146,1146,477,599,60,7,0,1143,3,0,41.732283464566926,52.40594925634296,5.2493438320209975,0.6124234470691163,0.0
13,경상남도,밀양시,부북면,부북면제1투,1064,693,150,508,32,1,0,691,2,371,21.70767004341534,73.51664254703329,4.630969609261939,0.1447178002894356,0.0
14,경상남도,밀양시,부북면,부북면제2투,1104,742,138,560,28,10,1,737,5,362,18.724559023066487,75.98371777476255,3.7991858887381276,1.3568521031207599,0.13568521031207598
15,경상남도,밀양시,부북면,부북면제3투,1142,728,129,553,33,3,1,719,9,414,17.941585535465926,76.91237830319889,4.58970792767733,0.4172461752433936,0.13908205841446453
16,경상남도,밀양시,상동면,관내사전투표,819,819,348,437,23,1,1,810,9,0,42.96296296296296,53.95061728395062,2.8395061728395063,0.12345679012345678,0.12345679012345678
17,경상남도,밀양시,상동면,상동면제1투,1205,763,140,604,14,4,0,762,1,442,18.37270341207349,79.26509186351706,1.837270341207349,0.5249343832020997,0.0
18,경상남도,밀양시,상동면,상동면제2투,561,376,68,298,6,1,0,373,3,185,18.230563002680967,79.89276139410187,1.6085790884718498,0.2680965147453083,0.0
19,경상남도,밀양시,산외면,관내사전투표,960,960,424,472,52,4,0,952,8,0,44.537815126050425,49.57983193277311,5.46218487394958,0.42016806722689076,0.0
20,경상남도,밀양시,산외면,산외면제1투,941,645,129,488,19,7,0,643,2,296,20.06220839813375,75.89424572317263,2.9548989113530326,1.088646967340591,0.0
21,경상남도,밀양시,산외면,산외면제2투,665,444,81,345,12,3,0,441,3,221,18.367346938775512,78.2312925170068,2.7210884353741496,0.6802721088435374,0.0
22,경상남도,밀양시,산내면,관내사전투표,864,864,373,431,48,7,1,860,4,0,43.372093023255815,50.116279069767444,5.5813953488372094,0.813953488372093,0.11627906976744186
23,경상남도,밀양시,산내면,산내면제1투,1326,890,151,710,15,3,0,879,11,436,17.178612059158134,80.773606370876,1.7064846416382253,0.3412969283276451,0.0
24,경상남도,밀양시,산내면,산내면제2투,892,628,146,449,21,3,0,619,9,264,23.586429725363487,72.53634894991923,3.392568659127625,0.48465266558966075,0.0
25,경상남도,밀양시,단장면,관내사전투표,906,906,390,456,45,10,1,902,4,0,43.23725055432372,50.554323725055426,4.988913525498892,1.1086474501108647,0.11086474501108648
26,경상남도,밀양시,단장면,단장면제1투,732,509,98,385,16,3,1,503,6,223,19.4831013916501,76.54075546719682,3.180914512922465,0.5964214711729622,0.19880715705765406
27,경상남도,밀양시,단장면,단장면제2투,965,607,86,495,16,3,0,600,7,358,14.333333333333334,82.5,2.666666666666667,0.5,0.0
28,경상남도,밀양시,단장면,단장면제3투,840,591,112,456,18,1,0,587,4,249,19.08006814310051,77.68313458262351,3.0664395229982966,0.17035775127768313,0.0
29,경상남도,밀양시,상남면,관내사전투표,1143,1143,545,519,62,6,4,1136,7,0,47.975352112676056,45.686619718309856,5.457746478873239,0.528169014084507,0.35211267605633806
30,경상남도,밀양시,상남면,상남면제1투,1660,1139,274,803,45,4,1,1127,12,521,24.312333629103815,71.2511091393079,3.9929015084294592,0.354924578527063,0.08873114463176575
31,경상남도,밀양시,상남면,상남면제2투,1599,1111,313,730,53,11,0,1107,4,488,28.27461607949413,65.94399277326106,4.787714543812105,0.9936766034327009,0.0
32,경상남도,밀양시,상남면,상남면제3투,1632,1019,202,775,22,6,2,1007,12,613,20.05958291956306,76.96127110228402,2.1847070506454815,0.5958291956305859,0.19860973187686196
33,경상남도,밀양시,초동면,관내사전투표,879,879,321,509,30,10,0,870,9,0,36.896551724137936,58.50574712643678,3.4482758620689653,1.1494252873563218,0.0
34,경상남도,밀양시,초동면,초동면투표소,1758,1073,210,819,36,5,0,1070,3,685,19.626168224299064,76.54205607476635,3.364485981308411,0.46728971962616817,0.0
35,경상남도,밀양시,무안면,관내사전투표,1210,1210,507,630,53,6,1,1197,13,0,42.35588972431078,52.63157894736842,4.427736006683375,0.5012531328320802,0.0835421888053467
36,경상남도,밀양시,무안면,무안면제1투,1425,920,160,715,28,8,1,912,8,505,17.543859649122805,78.39912280701753,3.070175438596491,0.8771929824561403,0.10964912280701754
37,경상남도,밀양시,무안면,무안면제2투,1267,792,134,622,17,8,0,781,11,475,17.157490396927017,79.64148527528809,2.176696542893726,1.0243277848911652,0.0
38,경상남도,밀양시,청도면,관내사전투표,517,517,222,263,22,6,0,513,4,0,43.27485380116959,51.267056530214425,4.28849902534113,1.1695906432748537,0.0
39,경상남도,밀양시,청도면,청도면투표소,953,621,106,498,8,3,1,616,5,332,17.20779220779221,80.84415584415584,1.2987012987012987,0.487012987012987,0.16233766233766234
40,경상남도,밀양시,내일동,관내사전투표,829,829,319,468,33,4,1,825,4,0,38.666666666666664,56.72727272727273,4.0,0.48484848484848486,0.12121212121212122
41,경상남도,밀양시,내일동,내일동제1투,1264,795,154,601,28,8,0,791,4,469,19.469026548672566,75.97977243994943,3.5398230088495577,1.0113780025284451,0.0
42,경상남도,밀양시,내일동,내일동제2투,425,277,51,222,1,1,0,275,2,148,18.545454545454547,80.72727272727272,0.36363636363636365,0.36363636363636365,0.0
43,경상남도,밀양시,내이동,관내사전투표,2977,2977,1354,1397,161,32,4,2948,29,0,45.929443690637726,47.38805970149254,5.4613297150610585,1.0854816824966078,0.13568521031207598
44,경상남도,밀양시,내이동,내이동제1투,2312,1538,440,999,79,10,1,1529,9,774,28.776978417266186,65.33682145192937,5.166775670372792,0.6540222367560496,0.06540222367560497
45,경상남도,밀양시,내이동,내이동제2투,1543,948,188,715,34,5,1,943,5,595,19.936373276776244,75.82184517497349,3.6055143160127257,0.5302226935312832,0.10604453870625664
46,경상남도,밀양시,내이동,내이동제3투,2446,1381,354,907,97,12,2,1372,9,1065,25.801749271137027,66.10787172011662,7.069970845481049,0.8746355685131195,0.1457725947521866
47,경상남도,밀양시,내이동,내이동제4투,3140,2130,682,1256,150,24,3,2115,15,1010,32.24586288416076,59.385342789598106,7.092198581560284,1.1347517730496455,0.14184397163120568
48,경상남도,밀양시,교동,관내사전투표,2704,2704,1364,1065,218,32,4,2683,21,0,50.8386134923593,39.6943719716735,8.125232948192322,1.1926947446887812,0.14908684308609765
49,경상남도,밀양시,교동,교동제1투,1142,813,216,549,37,3,0,805,8,329,26.83229813664596,68.19875776397517,4.596273291925466,0.37267080745341613,0.0
50,경상남도,밀양시,교동,교동제2투,2171,1387,332,975,60,8,1,1376,11,784,24.12790697674419,70.85755813953489,4.3604651162790695,0.5813953488372093,0.07267441860465117
51,경상남도,밀양시,삼문동,관내사전투표,3863,3863,2051,1524,226,29,2,3832,31,0,53.522964509394576,39.77035490605428,5.897703549060543,0.75678496868476,0.052192066805845504
52,경상남도,밀양시,삼문동,삼문동제1투,1733,1267,338,849,58,13,0,1258,9,466,26.86804451510334,67.48807631160572,4.610492845786964,1.0333863275039745,0.0
53,경상남도,밀양시,삼문동,삼문동제2투,1514,952,213,681,44,8,2,948,4,562,22.468354430379748,71.83544303797468,4.641350210970464,0.8438818565400843,0.21097046413502107
54,경상남도,밀양시,삼문동,삼문동제3투,1981,1217,368,739,93,10,1,1211,6,764,30.388109000825764,61.023947151114776,7.679603633360858,0.8257638315441783,0.08257638315441783
55,경상남도,밀양시,삼문동,삼문동제4투,2254,1541,422,1009,87,9,3,1530,11,713,27.58169934640523,65.94771241830065,5.686274509803922,0.5882352941176471,0.19607843137254902
56,경상남도,밀양시,삼문동,삼문동제5투,2668,1809,618,1028,120,20,4,1790,19,859,34.52513966480447,57.43016759776536,6.70391061452514,1.1173184357541899,0.22346368715083798
57,경상남도,밀양시,가곡동,관내사전투표,2425,2425,1126,1089,165,17,3,2400,25,0,46.916666666666664,45.375,6.875000000000001,0.7083333333333333,0.125
58,경상남도,밀양시,가곡동,가곡동제1투,2089,1306,316,905,71,4,1,1297,9,783,24.363916730917502,69.77640709329222,5.474171164225135,0.30840400925212025,0.07710100231303006
59,경상남도,밀양시,가곡동,가곡동제2투,2338,1458,384,981,63,11,3,1442,16,880,26.629680998613036,68.03051317614425,4.368932038834951,0.7628294036061026,0.20804438280166435
60,경상남도,밀양시,잘못 투입·구분된 투표지,,0,0,0,0,0,0,0,0,0,0,0.0,0.0,0.0,0.0,0.0
0,경상남도,거제시,거소·선상투표,,647,621,200,194,105,12,13,524,97,26,38.16793893129771,37.02290076335878,20.0381679389313,2.2900763358778624,2.480916030534351
1,경상남도,거제시,관외사전투표,,12685,12683,6041,4374,1905,164,30,12514,169,2,48.2739331948218,34.95285280485856,15.222950295668852,1.3105322039315965,0.2397315007191945
2,경상남도,거제시,재외투표,,679,541,364,109,35,31,1,540,1,138,67.4074074074074,20.185185185185187,6.481481481481481,5.7407407407407405,0.1851851851851852
3,경상남도,거제시,일운면,관내사전투표,2447,2447,1381,891,128,26,1,2427,20,0,56.90152451586321,36.711990111248454,5.274000824062629,1.0712814173877214,0.04120313143798929
4,경상남도,거제시,일운면,일운면제1투,3296,1933,590,1219,79,25,2,1915,18,1363,30.809399477806785,63.65535248041776,4.12532637075718,1.3054830287206265,0.10443864229765012
5,경상남도,거제시,일운면,일운면제2투,675,433,91,313,19,2,1,426,7,242,21.36150234741784,73.47417840375586,4.460093896713615,0.4694835680751174,0.2347417840375587
6,경상남도,거제시,동부면,관내사전투표,951,951,457,427,52,8,0,944,7,0,48.41101694915254,45.233050847457626,5.508474576271186,0.847457627118644,0.0
7,경상남도,거제시,동부면,동부면투표소,1610,1083,180,853,34,8,2,1077,6,527,16.71309192200557,79.20148560817084,3.1569173630454963,0.7428040854224698,0.18570102135561745
8,경상남도,거제시,남부면,관내사전투표,367,367,168,167,24,3,0,362,5,0,46.408839779005525,46.13259668508287,6.629834254143646,0.8287292817679558,0.0
9,경상남도,거제시,남부면,남부면투표소,830,548,83,448,9,1,0,541,7,282,15.341959334565619,82.80961182994456,1.6635859519408502,0.18484288354898337,0.0
10,경상남도,거제시,거제면,관내사전투표,2134,2134,1109,902,92,12,7,2122,12,0,52.26201696512723,42.507068803016026,4.335532516493874,0.5655042412818096,0.3298774740810556
11,경상남도,거제시,거제면,거제면제1투,1891,1216,271,885,46,7,2,1211,5,675,22.378199834847234,73.08009909165979,3.7985136251032205,0.5780346820809248,0.16515276630883566
12,경상남도,거제시,거제면,거제면제2투,1992,1198,318,816,50,5,1,1190,8,794,26.722689075630253,68.57142857142857,4.201680672268908,0.42016806722689076,0.08403361344537816
13,경상남도,거제시,둔덕면,관내사전투표,830,830,357,425,34,4,2,822,8,0,43.43065693430657,51.70316301703163,4.13625304136253,0.48661800486618007,0.24330900243309003
14,경상남도,거제시,둔덕면,둔덕면투표소,1524,1012,168,792,46,2,2,1010,2,512,16.633663366336634,78.41584158415841,4.554455445544554,0.19801980198019803,0.19801980198019803
15,경상남도,거제시,사등면,관내사전투표,2022,2022,1084,800,108,13,1,2006,16,0,54.03788634097707,39.88035892323031,5.383848454636091,0.6480558325024925,0.049850448654037885
16,경상남도,거제시,사등면,사등면제1투,1294,779,184,559,29,2,0,774,5,515,23.772609819121445,72.22222222222221,3.7467700258397936,0.2583979328165375,0.0
17,경상남도,거제시,사등면,사등면제2투,1311,852,170,642,24,4,1,841,11,459,20.214030915576693,76.33769322235435,2.853745541022592,0.47562425683709864,0.11890606420927466
18,경상남도,거제시,사등면,사등면제3투,736,546,86,437,15,5,1,544,2,190,15.808823529411764,80.33088235294117,2.7573529411764706,0.9191176470588236,0.1838235294117647
19,경상남도,거제시,사등면,사등면제4투,3252,2148,748,1205,139,28,1,2121,27,1104,35.26638378123527,56.81282413955682,6.5535124941065535,1.3201320132013201,0.04714757190004715
20,경상남도,거제시,연초면,관내사전투표,1879,1879,1043,681,115,21,1,1861,18,0,56.04513702310586,36.59322944653412,6.179473401397098,1.1284255776464267,0.05373455131649651
21,경상남도,거제시,연초면,연초면제1투,2381,1406,408,893,75,17,1,1394,12,975,29.268292682926827,64.06025824964132,5.380200860832137,1.2195121951219512,0.07173601147776185
22,경상남도,거제시,연초면,연초면제2투,2175,1243,405,743,69,11,0,1228,15,932,32.98045602605863,60.504885993485345,5.618892508143322,0.8957654723127036,0.0
23,경상남도,거제시,연초면,연초면제3투,450,285,82,189,9,2,0,282,3,165,29.078014184397162,67.02127659574468,3.1914893617021276,0.7092198581560284,0.0
24,경상남도,거제시,하청면,관내사전투표,1260,1260,656,532,52,15,1,1256,4,0,52.22929936305732,42.35668789808918,4.140127388535031,1.194267515923567,0.07961783439490447
25,경상남도,거제시,하청면,하청면제1투,1711,1068,205,794,51,9,2,1061,7,643,19.321394910461827,74.83506126295947,4.806786050895382,0.8482563619227144,0.1885014137606032
26,경상남도,거제시,하청면,하청면제2투,661,460,71,373,6,3,0,453,7,201,15.673289183222957,82.33995584988962,1.3245033112582782,0.6622516556291391,0.0
27,경상남도,거제시,장목면,관내사전투표,944,943,379,511,42,6,0,938,5,1,40.405117270788914,54.47761194029851,4.477611940298507,0.6396588486140725,0.0
28,경상남도,거제시,장목면,장목면제1투,1675,1060,151,871,30,2,0,1054,6,615,14.32637571157495,82.63757115749526,2.846299810246679,0.18975332068311196,0.0
29,경상남도,거제시,장목면,장목면제2투,870,579,99,453,17,4,0,573,6,291,17.277486910994764,79.05759162303664,2.966841186736475,0.6980802792321117,0.0
30,경상남도,거제시,장승포동,관내사전투표,1985,1985,1255,583,106,27,0,1971,14,0,63.67326230339929,29.578893962455606,5.377980720446473,1.36986301369863,0.0
31,경상남도,거제시,장승포동,장승포동제1투,1497,840,231,543,55,5,1,835,5,657,27.66467065868263,65.02994011976048,6.58682634730539,0.5988023952095809,0.11976047904191617
32,경상남도,거제시,장승포동,장승포동제2투,1400,796,334,372,61,16,0,783,13,604,42.65644955300127,47.509578544061306,7.790549169859514,2.0434227330779056,0.0
33,경상남도,거제시,능포동,관내사전투표,1927,1927,1311,473,103,27,1,1915,12,0,68.45953002610966,24.699738903394255,5.3785900783289815,1.4099216710182767,0.05221932114882506
34,경상남도,거제시,능포동,능포동제1투,1323,706,218,442,30,14,0,704,2,617,30.96590909090909,62.78409090909091,4.261363636363636,1.9886363636363635,0.0
35,경상남도,거제시,능포동,능포동제2투,1866,1388,603,663,80,34,0,1380,8,478,43.69565217391304,48.04347826086956,5.797101449275362,2.4637681159420293,0.0
36,경상남도,거제시,능포동,능포동제3투,1751,1078,380,619,50,16,1,1066,12,673,35.647279549718576,58.067542213883684,4.690431519699812,1.5009380863039399,0.09380863039399624
37,경상남도,거제시,아주동,관내사전투표,3901,3901,2803,744,278,52,2,3879,22,0,72.26089198246972,19.180201082753285,7.166795565867491,1.3405516885795308,0.051559680329981955
38,경상남도,거제시,아주동,아주동제1투,3057,1642,783,681,139,22,0,1625,17,1415,48.184615384615384,41.90769230769231,8.553846153846154,1.353846153846154,0.0
39,경상남도,거제시,아주동,아주동제2투,2122,1356,713,528,93,16,0,1350,6,766,52.81481481481482,39.111111111111114,6.888888888888889,1.1851851851851851,0.0
40,경상남도,거제시,아주동,아주동제3투,2526,1707,928,618,125,22,1,1694,13,819,54.78158205430933,36.481700118063756,7.378984651711924,1.2987012987012987,0.05903187721369539
41,경상남도,거제시,아주동,아주동제4투,1804,1353,776,444,101,20,4,1345,8,451,57.69516728624535,33.01115241635688,7.5092936802973975,1.486988847583643,0.29739776951672864
42,경상남도,거제시,아주동,아주동제5투,1727,1317,795,379,110,24,2,1310,7,410,60.68702290076335,28.931297709923665,8.396946564885496,1.8320610687022902,0.15267175572519084
43,경상남도,거제시,아주동,아주동제6투,2088,1548,847,530,131,26,0,1534,14,540,55.21512385919165,34.55019556714472,8.539765319426335,1.694915254237288,0.0
44,경상남도,거제시,옥포1동,관내사전투표,2834,2834,1839,768,171,33,2,2813,21,0,65.37504443654461,27.301813011020265,6.07891930323498,1.1731247778172769,0.07109847138286526
45,경상남도,거제시,옥포1동,옥포1동제1투,2420,1351,524,702,101,16,0,1343,8,1069,39.01712583767684,52.27103499627699,7.520476545048399,1.1913626209977661,0.0
46,경상남도,거제시,옥포1동,옥포1동제2투,1582,912,310,534,55,10,0,909,3,670,34.1034103410341,58.745874587458744,6.050605060506051,1.1001100110011002,0.0
47,경상남도,거제시,옥포2동,관내사전투표,4576,4576,3011,1192,305,42,3,4553,23,0,66.13222051394685,26.180540303096862,6.69887985943334,0.9224687019547552,0.06589062156819679
48,경상남도,거제시,옥포2동,옥포2동제1투,1883,1070,378,608,61,15,2,1064,6,813,35.526315789473685,57.14285714285714,5.733082706766917,1.4097744360902256,0.18796992481203006
49,경상남도,거제시,옥포2동,옥포2동제2투,2413,1480,574,780,93,20,1,1468,12,933,39.1008174386921,53.13351498637602,6.335149863760218,1.3623978201634876,0.06811989100817438
50,경상남도,거제시,옥포2동,옥포2동제3투,2820,1987,954,835,138,32,2,1961,26,833,48.64864864864865,42.580316165221824,7.037225905150433,1.631820499745028,0.10198878123406425
51,경상남도,거제시,옥포2동,옥포2동제4투,1886,1125,397,648,54,14,1,1114,11,761,35.637342908438065,58.16876122082585,4.847396768402154,1.2567324955116697,0.08976660682226212
52,경상남도,거제시,옥포2동,옥포2동제5투,3504,2056,917,947,141,40,0,2045,11,1448,44.84107579462103,46.308068459657704,6.8948655256723725,1.9559902200488997,0.0
53,경상남도,거제시,옥포2동,옥포2동제6투,1156,760,293,409,44,8,1,755,5,396,38.80794701986755,54.17218543046357,5.827814569536424,1.0596026490066226,0.13245033112582782
54,경상남도,거제시,장평동,관내사전투표,6228,6228,3955,1671,484,55,11,6176,52,0,64.03821243523316,27.056347150259068,7.83678756476684,0.8905440414507773,0.17810880829015543
55,경상남도,거제시,장평동,장평동제1투,1861,1039,354,600,66,9,0,1029,10,822,34.40233236151604,58.309037900874635,6.41399416909621,0.8746355685131195,0.0
56,경상남도,거제시,장평동,장평동제2투,2242,1290,509,654,101,18,2,1284,6,952,39.6417445482866,50.93457943925234,7.8660436137071645,1.4018691588785046,0.1557632398753894
57,경상남도,거제시,장평동,장평동제3투,2135,1057,334,608,97,9,1,1049,8,1078,31.839847473784555,57.95996186844614,9.246901811248808,0.8579599618684461,0.09532888465204957
58,경상남도,거제시,장평동,장평동제4투,2293,1362,488,744,111,10,0,1353,9,931,36.067997043606795,54.988913525498894,8.2039911308204,0.7390983000739099,0.0
59,경상남도,거제시,장평동,장평동제5투,2628,1637,557,911,141,15,1,1625,12,991,34.276923076923076,56.06153846153846,8.676923076923076,0.9230769230769231,0.06153846153846154
60,경상남도,거제시,고현동,관내사전투표,5719,5718,3321,1792,486,63,9,5671,47,1,58.56110033503791,31.59936519132428,8.56991712220067,1.1109151825074943,0.15870216892964203
61,경상남도,거제시,고현동,고현동제1투,1436,794,200,531,52,4,0,787,7,642,25.412960609911057,67.47141041931386,6.607369758576874,0.5082592121982211,0.0
62,경상남도,거제시,고현동,고현동제2투,2307,1383,295,990,71,12,3,1371,12,924,21.517140773158278,72.21006564551422,5.178701677607585,0.87527352297593,0.2188183807439825
63,경상남도,거제시,고현동,고현동제3투,3964,2676,982,1401,241,27,4,2655,21,1288,36.986817325800374,52.76836158192091,9.077212806026365,1.0169491525423728,0.15065913370998116
64,경상남도,거제시,고현동,고현동제4투,1616,970,309,591,51,6,3,960,10,646,32.1875,61.5625,5.3125,0.625,0.3125
65,경상남도,거제시,고현동,고현동제5투,1574,932,237,635,46,5,0,923,9,642,25.677139761646806,68.79739978331527,4.9837486457204765,0.5417118093174431,0.0
66,경상남도,거제시,고현동,고현동제6투,3331,2344,1023,1116,166,23,3,2331,13,987,43.886743886743886,47.87644787644788,7.121407121407121,0.9867009867009866,0.1287001287001287
67,경상남도,거제시,고현동,고현동제7투,2219,1632,692,790,120,15,8,1625,7,587,42.58461538461538,48.61538461538461,7.384615384615385,0.9230769230769231,0.49230769230769234
68,경상남도,거제시,고현동,고현동제8투,2319,1730,796,759,136,21,6,1718,12,589,46.33294528521537,44.17927823050058,7.916181606519208,1.2223515715948778,0.3492433061699651
69,경상남도,거제시,고현동,고현동제9투,2744,1900,872,838,142,26,3,1881,19,844,46.35832004253057,44.55077086656034,7.549175970228601,1.3822434875066454,0.1594896331738437
70,경상남도,거제시,상문동,관내사전투표,6308,6306,4337,1379,472,69,3,6260,46,2,69.28115015974441,22.028753993610223,7.539936102236422,1.1022364217252396,0.04792332268370607
71,경상남도,거제시,상문동,상문동제1투,2141,1303,451,741,87,11,1,1291,12,838,34.93415956622773,57.3973663826491,6.738962044926414,0.8520526723470179,0.0774593338497289
72,경상남도,거제시,상문동,상문동제2투,2618,1953,915,815,161,38,6,1935,18,665,47.286821705426355,42.11886304909561,8.320413436692506,1.9638242894056845,0.31007751937984496
73,경상남도,거제시,상문동,상문동제3투,4255,2683,1071,1306,239,36,4,2656,27,1572,40.3237951807229,49.17168674698795,8.998493975903614,1.355421686746988,0.15060240963855423
74,경상남도,거제시,상문동,상문동제4투,3284,2156,908,1041,161,30,2,2142,14,1128,42.39028944911298,48.59943977591036,7.516339869281046,1.400560224089636,0.09337068160597572
75,경상남도,거제시,상문동,상문동제5투,4076,2704,1290,1110,229,42,7,2678,26,1372,48.17027632561613,41.44884241971621,8.551157580283794,1.568334578043316,0.2613890963405527
76,경상남도,거제시,수양동,관내사전투표,5502,5500,3681,1308,415,58,4,5466,34,2,67.34357848518113,23.929747530186606,7.592389315770216,1.0611050128064399,0.07317965605561653
77,경상남도,거제시,수양동,수양동제1투,2039,1494,648,690,130,21,0,1489,5,545,43.519140362659506,46.33982538616521,8.730691739422431,1.4103425117528543,0.0
78,경상남도,거제시,수양동,수양동제2투,2583,1639,505,983,124,13,1,1626,13,944,31.057810578105784,60.455104551045515,7.626076260762607,0.7995079950799507,0.06150061500615006
79,경상남도,거제시,수양동,수양동제3투,2296,1692,692,831,140,17,3,1683,9,604,41.11705288175877,49.376114081996434,8.318478906714201,1.0101010101010102,0.17825311942959002
80,경상남도,거제시,수양동,수양동제4투,3314,2242,892,1115,195,26,3,2231,11,1072,39.98207082025998,49.97758852532497,8.740475123263112,1.1653966831017482,0.1344688480502017
81,경상남도,거제시,잘못 투입·구분된 투표지,,0,0,0,0,0,0,0,0,0,0,0.0,0.0,0.0,0.0,0.0
0,경상남도,의령군,거소·선상투표,,93,90,33,47,4,1,1,86,4,3,38.372093023255815,54.65116279069767,4.651162790697675,1.1627906976744187,1.1627906976744187
1,경상남도,의령군,관외사전투표,,2505,2505,948,1289,220,26,4,2487,18,0,38.118214716525934,51.82951347004423,8.845999195818255,1.0454362685967027,0.16083634901487737
2,경상남도,의령군,재외투표,,295,113,45,62,4,0,0,111,2,182,40.54054054054054,55.85585585585585,3.6036036036036037,0.0,0.0
3,경상남도,의령군,의령읍,관내사전투표,2237,2237,1069,1004,130,16,2,2221,16,0,48.13147230977037,45.20486267447096,5.853219270598829,0.7203962179198559,0.09004952723998198
4,경상남도,의령군,의령읍,의령읍제1투,1918,1249,281,900,47,9,1,1238,11,669,22.69789983844911,72.6978998384491,3.7964458804523424,0.7269789983844911,0.08077544426494346
5,경상남도,의령군,의령읍,의령읍제2투,2725,1793,474,1206,83,14,3,1780,13,932,26.62921348314607,67.75280898876404,4.662921348314606,0.7865168539325843,0.16853932584269662
6,경상남도,의령군,가례면,관내사전투표,542,542,212,268,27,7,4,518,24,0,40.92664092664093,51.737451737451735,5.212355212355212,1.3513513513513513,0.7722007722007722
7,경상남도,의령군,가례면,가례면투표소,885,555,98,429,16,2,0,545,10,330,17.98165137614679,78.71559633027523,2.9357798165137616,0.3669724770642202,0.0
8,경상남도,의령군,칠곡면,관내사전투표,338,338,137,179,15,3,1,335,3,0,40.8955223880597,53.43283582089552,4.477611940298507,0.8955223880597015,0.2985074626865672
9,경상남도,의령군,칠곡면,칠곡면투표소,603,380,76,282,16,1,0,375,5,223,20.266666666666666,75.2,4.266666666666667,0.26666666666666666,0.0
10,경상남도,의령군,대의면,관내사전투표,233,233,82,131,16,1,1,231,2,0,35.4978354978355,56.709956709956714,6.926406926406926,0.4329004329004329,0.4329004329004329
11,경상남도,의령군,대의면,대의면투표소,594,406,77,303,10,3,1,394,12,188,19.543147208121827,76.90355329949239,2.5380710659898478,0.7614213197969544,0.25380710659898476
12,경상남도,의령군,화정면,관내사전투표,318,318,118,184,11,2,0,315,3,0,37.46031746031746,58.41269841269842,3.492063492063492,0.6349206349206349,0.0
13,경상남도,의령군,화정면,화정면투표소,846,562,111,424,18,1,0,554,8,284,20.03610108303249,76.53429602888086,3.2490974729241873,0.18050541516245489,0.0
14,경상남도,의령군,용덕면,관내사전투표,303,303,106,167,18,5,1,297,6,0,35.69023569023569,56.22895622895623,6.0606060606060606,1.6835016835016834,0.33670033670033667
15,경상남도,의령군,용덕면,용덕면제1투,464,334,59,257,5,0,0,321,13,130,18.38006230529595,80.06230529595015,1.557632398753894,0.0,0.0
16,경상남도,의령군,용덕면,용덕면제2투,437,286,63,215,5,2,0,285,1,151,22.105263157894736,75.43859649122807,1.7543859649122806,0.7017543859649122,0.0
17,경상남도,의령군,정곡면,관내사전투표,356,356,133,197,16,4,2,352,4,0,37.784090909090914,55.96590909090909,4.545454545454546,1.1363636363636365,0.5681818181818182
18,경상남도,의령군,정곡면,정곡면투표소,748,484,76,389,12,1,0,478,6,264,15.899581589958158,81.3807531380753,2.510460251046025,0.20920502092050208,0.0
19,경상남도,의령군,지정면,관내사전투표,386,386,155,199,21,3,2,380,6,0,40.78947368421053,52.368421052631575,5.526315789473684,0.7894736842105263,0.5263157894736842
20,경상남도,의령군,지정면,지정면투표소,1038,626,101,492,22,6,0,621,5,412,16.264090177133657,79.22705314009661,3.542673107890499,0.966183574879227,0.0
21,경상남도,의령군,낙서면,관내사전투표,142,142,41,91,4,3,1,140,2,0,29.28571428571429,65.0,2.857142857142857,2.142857142857143,0.7142857142857143
22,경상남도,의령군,낙서면,낙서면투표소,453,320,33,272,6,4,1,316,4,133,10.443037974683545,86.07594936708861,1.89873417721519,1.2658227848101267,0.31645569620253167
23,경상남도,의령군,부림면,관내사전투표,794,794,308,433,34,5,3,783,11,0,39.33588761174968,55.30012771392082,4.342273307790549,0.6385696040868455,0.38314176245210724
24,경상남도,의령군,부림면,부림면투표소,1507,978,179,759,25,2,2,967,11,529,18.510858324715613,78.49017580144778,2.5853154084798344,0.2068252326783868,0.2068252326783868
25,경상남도,의령군,봉수면,관내사전투표,225,225,52,162,5,2,0,221,4,0,23.52941176470588,73.30316742081448,2.262443438914027,0.904977375565611,0.0
26,경상남도,의령군,봉수면,봉수면투표소,478,286,33,239,6,3,1,282,4,192,11.702127659574469,84.75177304964538,2.127659574468085,1.0638297872340425,0.3546099290780142
27,경상남도,의령군,궁류면,관내사전투표,317,317,94,209,9,3,0,315,2,0,29.841269841269842,66.34920634920634,2.857142857142857,0.9523809523809524,0.0
28,경상남도,의령군,궁류면,궁류면투표소,607,370,60,290,9,3,2,364,6,237,16.483516483516482,79.67032967032966,2.4725274725274726,0.8241758241758242,0.5494505494505495
29,경상남도,의령군,유곡면,관내사전투표,195,195,74,110,4,3,0,191,4,0,38.7434554973822,57.59162303664922,2.094240837696335,1.5706806282722512,0.0
30,경상남도,의령군,유곡면,유곡면제1투,377,267,46,201,9,3,1,260,7,110,17.692307692307693,77.3076923076923,3.4615384615384617,1.153846153846154,0.38461538461538464
31,경상남도,의령군,유곡면,유곡면제2투,335,224,47,169,5,2,0,223,1,111,21.076233183856502,75.7847533632287,2.242152466367713,0.8968609865470852,0.0
32,경상남도,의령군,잘못 투입·구분된 투표지,,0,0,0,0,0,0,0,0,0,0,0.0,0.0,0.0,0.0,0.0
0,경상남도,함안군,거소·선상투표,,196,187,42,115,23,0,2,182,5,9,23.076923076923077,63.18681318681318,12.637362637362637,0.0,1.098901098901099
1,경상남도,함안군,관외사전투표,,4873,4873,2105,2141,504,49,8,4807,66,0,43.79030580403578,44.539213646765134,10.484709798210941,1.019346785937175,0.16642396505096732
2,경상남도,함안군,재외투표,,406,193,89,74,24,3,1,191,2,213,46.596858638743456,38.7434554973822,12.56544502617801,1.5706806282722512,0.5235602094240838
3,경상남도,함안군,가야읍,관내사전투표,3240,3240,1588,1412,182,34,3,3219,21,0,49.33209071140106,43.864554209381794,5.6539297918608264,1.056228642435539,0.09319664492078285
4,경상남도,함안군,가야읍,가야읍제1투,1762,1121,222,824,55,12,1,1114,7,641,19.92818671454219,73.96768402154399,4.937163375224417,1.0771992818671454,0.08976660682226212
5,경상남도,함안군,가야읍,가야읍제2투,2745,1782,497,1137,113,19,1,1767,15,963,28.12676853423882,64.34634974533107,6.395019807583475,1.0752688172043012,0.056593095642331635
6,경상남도,함안군,가야읍,가야읍제3투,2409,1534,406,1012,97,13,2,1530,4,875,26.535947712418302,66.1437908496732,6.339869281045751,0.8496732026143791,0.130718954248366
7,경상남도,함안군,가야읍,가야읍제4투,2332,1525,389,1042,68,10,4,1513,12,807,25.710508922670193,68.86979510905485,4.49438202247191,0.6609385327164574,0.2643754130865829
8,경상남도,함안군,칠원읍,관내사전투표,2635,2635,1272,1188,127,25,3,2615,20,0,48.64244741873805,45.430210325047796,4.8565965583174,0.9560229445506693,0.11472275334608031
9,경상남도,함안군,칠원읍,칠원읍제1투,2661,1761,400,1268,66,15,1,1750,11,900,22.857142857142858,72.45714285714286,3.7714285714285714,0.8571428571428572,0.05714285714285715
10,경상남도,함안군,칠원읍,칠원읍제2투,753,540,105,410,17,1,0,533,7,213,19.69981238273921,76.92307692307693,3.189493433395872,0.18761726078799248,0.0
11,경상남도,함안군,칠원읍,칠원읍제3투,2859,2331,949,1186,155,28,2,2320,11,528,40.9051724137931,51.12068965517241,6.68103448275862,1.206896551724138,0.08620689655172414
12,경상남도,함안군,칠원읍,칠원읍제4투,1774,1223,320,818,63,8,2,1211,12,551,26.424442609413706,67.54748142031379,5.202312138728324,0.6606110652353426,0.16515276630883566
13,경상남도,함안군,칠원읍,칠원읍제5투,2370,1804,728,925,104,28,4,1789,15,566,40.693124650642815,51.704863051984354,5.813303521520403,1.5651201788708775,0.22358859698155395
14,경상남도,함안군,함안면,관내사전투표,667,667,301,328,28,8,1,666,1,0,45.19519519519519,49.249249249249246,4.2042042042042045,1.2012012012012012,0.15015015015015015
15,경상남도,함안군,함안면,함안면투표소,1361,894,170,680,32,2,1,885,9,467,19.2090395480226,76.8361581920904,3.615819209039548,0.22598870056497175,0.11299435028248588
16,경상남도,함안군,군북면,관내사전투표,1536,1536,629,759,126,9,3,1526,10,0,41.218872870249015,49.737876802096984,8.256880733944955,0.5897771952817824,0.19659239842726078
17,경상남도,함안군,군북면,군북면제1투,1484,870,173,640,42,5,1,861,9,614,20.092915214866434,74.3321718931475,4.878048780487805,0.5807200929152149,0.11614401858304298
18,경상남도,함안군,군북면,군북면제2투,621,417,101,300,10,5,0,416,1,204,24.278846153846153,72.11538461538461,2.403846153846154,1.201923076923077,0.0
19,경상남도,함안군,군북면,군북면제3투,741,443,92,333,13,2,0,440,3,298,20.909090909090907,75.68181818181819,2.9545454545454546,0.45454545454545453,0.0
20,경상남도,함안군,군북면,군북면제4투,473,308,64,229,7,6,1,307,1,165,20.846905537459286,74.5928338762215,2.2801302931596092,1.9543973941368076,0.32573289902280134
21,경상남도,함안군,법수면,관내사전투표,744,744,310,371,51,5,1,738,6,0,42.00542005420054,50.271002710027105,6.910569105691057,0.6775067750677507,0.13550135501355012
22,경상남도,함안군,법수면,법수면투표소,1609,1003,204,753,28,8,3,996,7,606,20.481927710843372,75.6024096385542,2.8112449799196786,0.8032128514056224,0.30120481927710846
23,경상남도,함안군,대산면,관내사전투표,797,797,364,394,27,3,2,790,7,0,46.07594936708861,49.87341772151899,3.4177215189873418,0.37974683544303794,0.25316455696202533
24,경상남도,함안군,대산면,대산면투표소,1862,1146,184,909,27,9,2,1131,15,716,16.268788682581786,80.37135278514589,2.3872679045092835,0.7957559681697612,0.17683465959328026
25,경상남도,함안군,칠서면,관내사전투표,599,599,274,279,30,10,1,594,5,0,46.12794612794613,46.96969696969697,5.05050505050505,1.6835016835016834,0.16835016835016833
26,경상남도,함안군,칠서면,칠서면제1투,1786,1204,347,756,73,16,3,1195,9,582,29.03765690376569,63.26359832635984,6.108786610878661,1.3389121338912133,0.2510460251046025
27,경상남도,함안군,칠서면,칠서면제2투,490,295,57,223,8,2,1,291,4,195,19.587628865979383,76.6323024054983,2.7491408934707904,0.6872852233676976,0.3436426116838488
28,경상남도,함안군,칠서면,칠서면제3투,844,588,92,471,15,6,1,585,3,256,15.726495726495726,80.51282051282051,2.564102564102564,1.0256410256410255,0.17094017094017094
29,경상남도,함안군,칠북면,관내사전투표,455,455,157,266,26,3,0,452,3,0,34.73451327433628,58.849557522123895,5.752212389380531,0.6637168141592921,0.0
30,경상남도,함안군,칠북면,칠북면투표소,1170,797,102,666,20,3,1,792,5,373,12.878787878787879,84.0909090909091,2.525252525252525,0.3787878787878788,0.12626262626262627
31,경상남도,함안군,산인면,관내사전투표,1462,1462,712,642,66,16,3,1439,23,0,49.47880472550382,44.614315496872834,4.586518415566365,1.111883252258513,0.20847810979847115
32,경상남도,함안군,산인면,산인면투표소,1458,952,187,725,27,3,1,943,9,506,19.830328738069987,76.88229056203606,2.863202545068929,0.3181336161187699,0.10604453870625664
33,경상남도,함안군,여항면,관내사전투표,352,352,124,212,13,3,0,352,0,0,35.22727272727273,60.22727272727273,3.6931818181818183,0.8522727272727272,0.0
34,경상남도,함안군,여항면,여항면투표소,464,323,46,267,8,2,0,323,0,141,14.241486068111456,82.6625386996904,2.476780185758514,0.6191950464396285,0.0
35,경상남도,함안군,잘못 투입·구분된 투표지,,0,0,0,0,0,0,0,0,0,0,0.0,0.0,0.0,0.0,0.0
0,경상남도,창녕군,거소·선상투표,,146,139,36,77,17,1,0,131,8,7,27.480916030534353,58.778625954198475,12.977099236641221,0.7633587786259541,0.0
1,경상남도,창녕군,관외사전투표,,4183,4183,1619,2115,369,34,8,4145,38,0,39.05910735826297,51.025331724969845,8.902291917973463,0.8202653799758746,0.19300361881785283
2,경상남도,창녕군,재외투표,,333,164,92,49,18,5,0,164,0,169,56.09756097560976,29.878048780487802,10.975609756097562,3.048780487804878,0.0
3,경상남도,창녕군,창녕읍,관내사전투표,3134,3134,1315,1588,173,22,2,3100,34,0,42.41935483870968,51.2258064516129,5.580645161290323,0.7096774193548387,0.06451612903225806
4,경상남도,창녕군,창녕읍,창녕읍제1투,1630,1090,186,850,37,7,0,1080,10,540,17.22222222222222,78.70370370370371,3.425925925925926,0.6481481481481481,0.0
5,경상남도,창녕군,창녕읍,창녕읍제2투,1901,1091,233,807,38,7,0,1085,6,810,21.474654377880185,74.3778801843318,3.5023041474654377,0.6451612903225806,0.0
6,경상남도,창녕군,창녕읍,창녕읍제3투,2528,1638,343,1210,63,8,2,1626,12,890,21.094710947109473,74.41574415744158,3.8745387453874542,0.4920049200492005,0.12300123001230012
7,경상남도,창녕군,창녕읍,창녕읍제4투,2696,1736,403,1224,75,20,1,1723,13,960,23.38943702843877,71.0388856645386,4.352872896111434,1.1607661056297156,0.05803830528148578
8,경상남도,창녕군,남지읍,관내사전투표,2837,2836,1183,1462,143,19,7,2814,22,1,42.039800995024876,51.954513148543,5.081734186211798,0.6751954513148543,0.24875621890547264
9,경상남도,창녕군,남지읍,남지읍제1투,2542,1586,340,1174,47,12,0,1573,13,956,21.61474888747616,74.63445645263828,2.9879211697393515,0.7628734901462174,0.0
10,경상남도,창녕군,남지읍,남지읍제2투,3111,1961,485,1366,83,13,3,1950,11,1150,24.871794871794872,70.05128205128204,4.256410256410256,0.6666666666666667,0.15384615384615385
11,경상남도,창녕군,남지읍,남지읍제3투,704,478,94,366,9,4,1,474,4,226,19.831223628691983,77.21518987341773,1.89873417721519,0.8438818565400843,0.21097046413502107
12,경상남도,창녕군,고암면,관내사전투표,481,481,182,257,27,9,0,475,6,0,38.315789473684205,54.10526315789473,5.684210526315789,1.8947368421052633,0.0
13,경상남도,창녕군,고암면,고암면투표소,1022,670,110,533,17,5,1,666,4,352,16.516516516516518,80.03003003003003,2.5525525525525525,0.7507507507507507,0.15015015015015015
14,경상남도,창녕군,성산면,관내사전투표,306,306,94,194,10,6,0,304,2,0,30.92105263157895,63.81578947368421,3.289473684210526,1.9736842105263157,0.0
15,경상남도,창녕군,성산면,성산면투표소,923,617,70,517,19,3,1,610,7,306,11.475409836065573,84.75409836065573,3.114754098360656,0.49180327868852464,0.16393442622950818
16,경상남도,창녕군,대합면,관내사전투표,775,775,239,497,33,0,0,769,6,0,31.079323797139143,64.62938881664499,4.291287386215865,0.0,0.0
17,경상남도,창녕군,대합면,대합면투표소,2176,1269,185,1017,49,2,0,1253,16,907,14.764565043894654,81.16520351157223,3.910614525139665,0.1596169193934557,0.0
18,경상남도,창녕군,이방면,관내사전투표,477,477,134,299,32,4,2,471,6,0,28.450106157112526,63.481953290870486,6.794055201698514,0.8492569002123143,0.42462845010615713
19,경상남도,창녕군,이방면,이방면투표소,1249,807,101,670,16,8,0,795,12,442,12.70440251572327,84.27672955974843,2.0125786163522013,1.0062893081761006,0.0
20,경상남도,창녕군,유어면,관내사전투표,538,538,176,318,30,5,1,530,8,0,33.20754716981132,60.0,5.660377358490567,0.9433962264150944,0.18867924528301888
21,경상남도,창녕군,유어면,유어면투표소,979,597,115,459,14,0,0,588,9,382,19.5578231292517,78.06122448979592,2.380952380952381,0.0,0.0
22,경상남도,창녕군,대지면,관내사전투표,855,855,330,461,44,9,0,844,11,0,39.09952606635071,54.62085308056872,5.213270142180095,1.066350710900474,0.0
23,경상남도,창녕군,대지면,대지면투표소,1343,864,148,686,20,4,1,859,5,479,17.229336437718278,79.86030267753202,2.3282887077997674,0.46565774155995343,0.11641443538998836
24,경상남도,창녕군,계성면,관내사전투표,713,713,291,379,36,5,0,711,2,0,40.92827004219409,53.30520393811533,5.063291139240507,0.7032348804500703,0.0
25,경상남도,창녕군,계성면,계성면투표소,1225,776,107,631,27,2,1,768,8,449,13.932291666666666,82.16145833333334,3.515625,0.26041666666666663,0.13020833333333331
26,경상남도,창녕군,영산면,관내사전투표,1291,1291,510,709,52,9,2,1282,9,0,39.78159126365055,55.30421216848674,4.05616224648986,0.702028081123245,0.15600624024961
27,경상남도,창녕군,영산면,영산면제1투,2246,1420,284,1061,59,8,1,1413,7,826,20.099079971691435,75.08846426043878,4.175513092710545,0.5661712668082095,0.07077140835102619
28,경상남도,창녕군,영산면,영산면제2투,627,424,88,325,5,1,1,420,4,203,20.952380952380953,77.38095238095238,1.1904761904761905,0.2380952380952381,0.2380952380952381
29,경상남도,창녕군,장마면,관내사전투표,455,455,166,272,13,1,1,453,2,0,36.64459161147903,60.04415011037527,2.869757174392936,0.22075055187637968,0.22075055187637968
30,경상남도,창녕군,장마면,장마면투표소,1033,616,110,473,20,8,1,612,4,417,17.973856209150327,77.2875816993464,3.2679738562091507,1.3071895424836601,0.16339869281045752
31,경상남도,창녕군,도천면,관내사전투표,756,756,269,442,31,3,1,746,10,0,36.05898123324397,59.24932975871313,4.1554959785522785,0.40214477211796246,0.13404825737265416
32,경상남도,창녕군,도천면,도천면투표소,1322,820,145,642,23,5,0,815,5,502,17.791411042944784,78.77300613496932,2.8220858895705523,0.6134969325153374,0.0
33,경상남도,창녕군,길곡면,관내사전투표,383,383,150,203,20,5,0,378,5,0,39.682539682539684,53.70370370370371,5.291005291005291,1.3227513227513228,0.0
34,경상남도,창녕군,길곡면,길곡면투표소,810,556,100,435,15,2,0,552,4,254,18.115942028985508,78.80434782608695,2.717391304347826,0.36231884057971014,0.0
35,경상남도,창녕군,부곡면,관내사전투표,1063,1063,405,607,40,4,1,1057,6,0,38.31598864711447,57.42667928098392,3.7842951750236518,0.3784295175023652,0.0946073793755913
36,경상남도,창녕군,부곡면,부곡면투표소,1845,1158,175,934,36,3,1,1149,9,687,15.230635335073977,81.28807658833769,3.1331592689295036,0.26109660574412535,0.08703220191470844
37,경상남도,창녕군,잘못 투입·구분된 투표지,,0,1,0,1,0,0,0,1,0,-1,0.0,100.0,0.0,0.0,0.0
0,경상남도,양산시,거소·선상투표,,815,760,264,319,121,6,4,714,46,55,36.97478991596639,44.67787114845939,16.946778711484594,0.8403361344537815,0.5602240896358543
1,경상남도,양산시,관외사전투표,,21524,21518,11409,6824,2822,211,27,21293,225,6,53.58098905743671,32.04809092189922,13.25318179683464,0.9909359883529799,0.12680223547644767
2,경상남도,양산시,재외투표,,1164,951,605,205,116,17,1,944,7,213,64.08898305084746,21.716101694915256,12.288135593220339,1.8008474576271187,0.1059322033898305
3,경상남도,양산시,물금읍,관내사전투표,13181,13181,8542,3477,969,90,11,13089,92,0,65.26090610436243,26.564290625716254,7.403162961265185,0.68760027504011,0.08404003361601345
4,경상남도,양산시,물금읍,물금읍제1투,3392,2300,732,1369,156,16,4,2277,23,1092,32.14756258234519,60.12296881862099,6.851119894598155,0.7026789635485288,0.1756697408871322
5,경상남도,양산시,물금읍,물금읍제2투,3266,2269,811,1168,255,21,2,2257,12,997,35.93265396544085,51.75011076650421,11.29818342933097,0.930438635356668,0.08861320336730173
6,경상남도,양산시,물금읍,물금읍제3투,4026,3139,1436,1400,246,37,2,3121,18,887,46.010893944248636,44.85741749439282,7.882089074014739,1.1855174623518103,0.06408202499198974
7,경상남도,양산시,물금읍,물금읍제4투,2081,1375,477,771,100,10,3,1361,14,706,35.04775900073475,56.64952240999265,7.347538574577516,0.7347538574577517,0.2204261572373255
8,경상남도,양산시,물금읍,물금읍제5투,1535,1032,384,560,58,15,1,1018,14,503,37.721021611001966,55.0098231827112,5.697445972495088,1.4734774066797642,0.09823182711198428
9,경상남도,양산시,물금읍,물금읍제6투,1932,1480,575,748,125,11,2,1461,19,452,39.356605065023956,51.19780971937029,8.555783709787816,0.7529089664613279,0.13689253935660506
10,경상남도,양산시,물금읍,물금읍제7투,2765,1620,519,880,188,20,1,1608,12,1145,32.276119402985074,54.72636815920397,11.691542288557214,1.2437810945273633,0.06218905472636816
11,경상남도,양산시,물금읍,물금읍제8투,2847,2238,1024,1012,172,20,2,2230,8,609,45.91928251121076,45.38116591928251,7.713004484304934,0.8968609865470852,0.08968609865470852
12,경상남도,양산시,물금읍,물금읍제9투,2227,1783,789,834,127,15,1,1766,17,444,44.67723669309173,47.225368063420156,7.191392978482446,0.8493771234428085,0.05662514156285391
13,경상남도,양산시,물금읍,물금읍제10투,2519,2014,989,822,159,26,4,2000,14,505,49.45,41.099999999999994,7.95,1.3,0.2
14,경상남도,양산시,물금읍,물금읍제11투,4048,2925,1299,1284,284,34,3,2904,21,1123,44.731404958677686,44.214876033057855,9.77961432506887,1.1707988980716253,0.10330578512396695
15,경상남도,양산시,물금읍,물금읍제12투,2134,1775,871,701,169,16,2,1759,16,359,49.516770892552586,39.85218874360432,9.60773166571916,0.9096077316657191,0.11370096645821488
16,경상남도,양산시,물금읍,물금읍제13투,1863,1526,624,734,141,19,1,1519,7,337,41.07965766951942,48.32126398946676,9.282422646477945,1.2508229098090848,0.06583278472679394
17,경상남도,양산시,물금읍,물금읍제14투,1376,939,238,633,50,10,2,933,6,437,25.509110396570208,67.84565916398714,5.359056806002144,1.0718113612004287,0.21436227224008575
18,경상남도,양산시,물금읍,물금읍제15투,1738,1028,376,556,81,8,1,1022,6,710,36.79060665362035,54.40313111545988,7.925636007827788,0.7827788649706457,0.09784735812133072
19,경상남도,양산시,물금읍,물금읍제16투,2455,1721,597,963,132,12,2,1706,15,734,34.994138335287225,56.44783118405628,7.737397420867527,0.7033997655334115,0.11723329425556857
20,경상남도,양산시,물금읍,물금읍제17투,3217,2197,904,1064,179,27,1,2175,22,1020,41.56321839080459,48.91954022988506,8.229885057471265,1.2413793103448276,0.04597701149425287
21,경상남도,양산시,물금읍,물금읍제18투,3932,2733,1071,1412,195,34,4,2716,17,1199,39.43298969072165,51.98821796759942,7.179675994108983,1.251840942562592,0.14727540500736377
22,경상남도,양산시,물금읍,물금읍제19투,2692,2161,883,1096,150,20,1,2150,11,531,41.06976744186046,50.97674418604651,6.976744186046512,0.9302325581395349,0.046511627906976744
23,경상남도,양산시,물금읍,물금읍제20투,4211,3081,1353,1413,238,38,4,3046,35,1130,44.418910045961916,46.3887065003283,7.813525935653316,1.247537754432042,0.13131976362442546
24,경상남도,양산시,물금읍,물금읍제21투,3976,3001,1311,1396,249,30,2,2988,13,975,43.87550200803213,46.72021419009371,8.333333333333332,1.0040160642570282,0.06693440428380187
25,경상남도,양산시,물금읍,물금읍제22투,3614,2469,948,1322,164,19,0,2453,16,1145,38.64655523848349,53.89319200978394,6.685690990623725,0.7745617611088463,0.0
26,경상남도,양산시,물금읍,물금읍제23투,4374,3364,1378,1665,273,18,6,3340,24,1010,41.25748502994012,49.8502994011976,8.173652694610778,0.5389221556886228,0.17964071856287425
27,경상남도,양산시,물금읍,물금읍제24투,1904,1509,703,651,129,20,0,1503,6,395,46.77312042581504,43.31337325349301,8.582834331337326,1.330671989354624,0.0
28,경상남도,양산시,물금읍,물금읍제25투,1258,974,382,479,96,8,2,967,7,284,39.50361944157187,49.53464322647363,9.927611168562564,0.8273009307135472,0.2068252326783868
29,경상남도,양산시,동면,관내사전투표,5362,5362,3423,1464,394,43,3,5327,35,0,64.257555847569,27.4826356298104,7.3962830861648206,0.8072085601651963,0.056316876290595085
30,경상남도,양산시,동면,동면제1투,4137,2569,856,1538,122,23,4,2543,26,1568,33.661030279197796,60.47974832874557,4.797483287455761,0.9044435705859222,0.15729453401494298
31,경상남도,양산시,동면,동면제2투,3457,2482,912,1353,162,26,8,2461,21,975,37.058106460788295,54.97765136123527,6.5826899634295,1.0564811052417715,0.3250711093051605
32,경상남도,양산시,동면,동면제3투,1773,1366,538,738,63,14,1,1354,12,407,39.7341211225997,54.505169867060566,4.65288035450517,1.03397341211226,0.07385524372230429
33,경상남도,양산시,동면,동면제4투,608,457,78,349,18,2,2,449,8,151,17.37193763919822,77.728285077951,4.008908685968819,0.4454342984409799,0.4454342984409799
34,경상남도,양산시,동면,동면제5투,3732,2783,1302,1258,169,35,6,2770,13,949,47.00361010830325,45.415162454873645,6.101083032490974,1.263537906137184,0.21660649819494585
35,경상남도,양산시,동면,동면제6투,4031,2760,1234,1249,233,27,1,2744,16,1271,44.970845481049565,45.51749271137026,8.491253644314869,0.9839650145772596,0.03644314868804665
36,경상남도,양산시,동면,동면제7투,3635,2851,1341,1264,198,31,1,2835,16,784,47.3015873015873,44.58553791887125,6.984126984126984,1.09347442680776,0.035273368606701945
37,경상남도,양산시,동면,동면제8투,4552,3283,1274,1603,345,42,1,3265,18,1269,39.019908116385906,49.096477794793266,10.566615620214396,1.2863705972434916,0.030627871362940276
38,경상남도,양산시,동면,동면제9투,2952,2293,832,1189,227,19,3,2270,23,659,36.651982378854626,52.378854625550666,10.0,0.8370044052863436,0.13215859030837004
39,경상남도,양산시,동면,동면제10투,4673,3173,1202,1580,330,28,3,3143,30,1500,38.243716194718424,50.27044225262488,10.499522748965957,0.8908685968819599,0.09545020680878143
40,경상남도,양산시,원동면,관내사전투표,667,667,259,357,36,9,0,661,6,0,39.183055975794254,54.0090771558245,5.446293494704992,1.361573373676248,0.0
41,경상남도,양산시,원동면,원동면제1투,690,417,58,344,11,2,0,415,2,273,13.975903614457833,82.89156626506025,2.6506024096385543,0.48192771084337355,0.0
42,경상남도,양산시,원동면,원동면제2투,838,611,117,469,19,2,1,608,3,227,19.24342105263158,77.13815789473685,3.125,0.3289473684210526,0.1644736842105263
43,경상남도,양산시,원동면,원동면제3투,403,301,41,247,11,1,0,300,1,102,13.666666666666666,82.33333333333334,3.6666666666666665,0.33333333333333337,0.0
44,경상남도,양산시,상북면,관내사전투표,3582,3582,1845,1480,191,32,6,3554,28,0,51.91333708497468,41.64321890827237,5.374226223972988,0.9003939223410242,0.16882386043894204
45,경상남도,양산시,상북면,상북면제1투,988,653,160,447,36,3,1,647,6,335,24.72952086553323,69.08809891808346,5.564142194744977,0.46367851622874806,0.1545595054095827
46,경상남도,양산시,상북면,상북면제2투,3373,2174,603,1405,131,14,3,2156,18,1199,27.968460111317256,65.16697588126159,6.076066790352504,0.6493506493506493,0.13914656771799627
47,경상남도,양산시,상북면,상북면제3투,1915,1321,385,831,78,9,0,1303,18,594,29.547198772064466,63.77590176515733,5.986185725249425,0.6907137375287797,0.0
48,경상남도,양산시,상북면,상북면제4투,1351,928,286,589,43,6,0,924,4,423,30.952380952380953,63.74458874458875,4.653679653679654,0.6493506493506493,0.0
49,경상남도,양산시,상북면,상북면제5투,919,582,84,471,20,3,0,578,4,337,14.53287197231834,81.4878892733564,3.4602076124567476,0.5190311418685121,0.0
50,경상남도,양산시,하북면,관내사전투표,2032,2032,1008,868,133,11,1,2021,11,0,49.87629886194953,42.94903513112321,6.580900544285008,0.5442850074220682,0.04948045522018803
51,경상남도,양산시,하북면,하북면제1투,1989,1267,249,942,59,9,3,1262,5,722,19.730586370839937,74.64342313787638,4.675118858954041,0.7131537242472267,0.2377179080824089
52,경상남도,양산시,하북면,하북면제2투,600,389,66,307,13,1,0,387,2,211,17.05426356589147,79.32816537467701,3.359173126614987,0.2583979328165375,0.0
53,경상남도,양산시,하북면,하북면제3투,768,510,80,413,13,1,1,508,2,258,15.748031496062993,81.2992125984252,2.559055118110236,0.19685039370078738,0.19685039370078738
54,경상남도,양산시,하북면,하북면제4투,1320,860,209,623,19,4,0,855,5,460,24.444444444444443,72.86549707602339,2.2222222222222223,0.46783625730994155,0.0
55,경상남도,양산시,중앙동,관내사전투표,3094,3094,1594,1295,154,30,1,3074,20,0,51.85426154847105,42.12752114508783,5.009759271307742,0.9759271307742355,0.03253090435914119
56,경상남도,양산시,중앙동,중앙동제1투,2034,1241,351,801,76,5,0,1233,8,793,28.467153284671532,64.96350364963503,6.163828061638281,0.40551500405515,0.0
57,경상남도,양산시,중앙동,중앙동제2투,1745,1094,272,738,63,12,0,1085,9,651,25.069124423963135,68.0184331797235,5.806451612903226,1.1059907834101383,0.0
58,경상남도,양산시,중앙동,중앙동제3투,1426,799,198,545,43,9,0,795,4,627,24.90566037735849,68.55345911949685,5.4088050314465415,1.1320754716981132,0.0
59,경상남도,양산시,중앙동,중앙동제4투,1732,1064,267,720,62,7,2,1058,6,668,25.23629489603025,68.05293005671076,5.8601134215500945,0.6616257088846881,0.1890359168241966
60,경상남도,양산시,양주동,관내사전투표,8450,8450,5229,2475,590,83,8,8385,65,0,62.361359570661904,29.5169946332737,7.036374478234943,0.9898628503279666,0.09540846750149076
61,경상남도,양산시,양주동,양주동제1투,1565,927,302,527,82,12,0,923,4,638,32.71939328277356,57.0964247020585,8.884073672806068,1.3001083423618636,0.0
62,경상남도,양산시,양주동,양주동제2투,3366,2415,732,1452,195,20,2,2401,14,951,30.48729695960017,60.47480216576426,8.121615993336109,0.8329862557267805,0.08329862557267806
63,경상남도,양산시,양주동,양주동제3투,2549,1779,524,1118,102,20,5,1769,10,770,29.62125494629734,63.199547767100064,5.765969474279254,1.1305822498586773,0.2826455624646693
64,경상남도,양산시,양주동,양주동제4투,2671,2085,870,1048,130,26,3,2077,8,586,41.8873375060183,50.457390467019735,6.259027443428021,1.2518054886856043,0.14443909484833894
65,경상남도,양산시,양주동,양주동제5투,4743,3424,1177,1980,207,35,2,3401,23,1319,34.60746839164951,58.218171126139374,6.086445163187298,1.0291090855630698,0.058806233460746836
66,경상남도,양산시,양주동,양주동제6투,3098,2381,1028,1125,172,33,3,2361,20,717,43.540872511647606,47.64930114358323,7.285048708174502,1.3977128335451081,0.12706480304955528
67,경상남도,양산시,삼성동,관내사전투표,4579,4579,2588,1576,336,41,11,4552,27,0,56.854130052724074,34.62214411247803,7.381370826010544,0.9007029876977152,0.2416520210896309
68,경상남도,양산시,삼성동,삼성동제1투,3853,2527,747,1565,169,25,4,2510,17,1326,29.7609561752988,62.35059760956175,6.733067729083666,0.9960159362549801,0.1593625498007968
69,경상남도,양산시,삼성동,삼성동제2투,2611,1482,479,868,110,10,3,1470,12,1129,32.58503401360544,59.04761904761905,7.482993197278912,0.6802721088435374,0.20408163265306123
70,경상남도,양산시,삼성동,삼성동제3투,2212,1434,501,797,108,15,2,1423,11,778,35.20730850316233,56.008432888264224,7.58959943780745,1.0541110330288124,0.14054813773717498
71,경상남도,양산시,삼성동,삼성동제4투,2007,1371,557,720,74,13,0,1364,7,636,40.83577712609971,52.785923753665685,5.425219941348973,0.9530791788856305,0.0
72,경상남도,양산시,삼성동,삼성동제5투,2169,1378,476,785,91,16,3,1371,7,791,34.719183078045226,57.25747629467543,6.637490882567469,1.1670313639679066,0.2188183807439825
73,경상남도,양산시,강서동,관내사전투표,2397,2397,1477,687,192,24,2,2382,15,0,62.00671704450041,28.84130982367758,8.060453400503778,1.0075566750629723,0.08396305625524769
74,경상남도,양산시,강서동,강서동제1투,2936,1945,676,1104,131,25,1,1937,8,991,34.899328859060404,56.99535363964894,6.763035622096025,1.2906556530717606,0.05162622612287042
75,경상남도,양산시,강서동,강서동제2투,2043,1380,562,714,81,5,5,1367,13,663,41.11192392099488,52.23116313094367,5.92538405267008,0.36576444769568395,0.36576444769568395
76,경상남도,양산시,서창동,관내사전투표,5073,5073,2926,1763,305,42,4,5040,33,0,58.05555555555556,34.98015873015873,6.051587301587301,0.8333333333333334,0.07936507936507936
77,경상남도,양산시,서창동,서창동제1투,1397,927,213,660,38,9,1,921,6,470,23.12703583061889,71.66123778501628,4.125950054288817,0.9771986970684038,0.10857763300760044
78,경상남도,양산시,서창동,서창동제2투,2301,1577,565,879,93,22,1,1560,17,724,36.217948717948715,56.34615384615385,5.961538461538462,1.4102564102564104,0.0641025641025641
79,경상남도,양산시,서창동,서창동제3투,1905,1075,325,673,67,7,0,1072,3,830,30.317164179104477,62.779850746268664,6.25,0.6529850746268656,0.0
80,경상남도,양산시,서창동,서창동제4투,3631,2593,1091,1286,166,33,2,2578,15,1038,42.319627618308765,49.883630721489524,6.4391000775795195,1.2800620636152056,0.07757951900698215
81,경상남도,양산시,서창동,서창동제5투,1731,1079,354,640,66,5,1,1066,13,652,33.20825515947467,60.0375234521576,6.191369606003752,0.46904315196998125,0.09380863039399624
82,경상남도,양산시,서창동,서창동제6투,1942,985,293,621,60,5,1,980,5,957,29.897959183673468,63.36734693877551,6.122448979591836,0.5102040816326531,0.10204081632653061
83,경상남도,양산시,서창동,서창동제7투,2924,2085,858,1035,150,28,2,2073,12,839,41.38929088277858,49.92764109985528,7.23589001447178,1.3506994693680656,0.0964785335262904
84,경상남도,양산시,소주동,관내사전투표,3572,3572,2123,1187,214,25,2,3551,21,0,59.785975781470015,33.42720360461841,6.026471416502393,0.7040270346381301,0.056322162771050406
85,경상남도,양산시,소주동,소주동제1투,1605,1116,348,670,74,11,1,1104,12,489,31.521739130434785,60.68840579710145,6.702898550724639,0.9963768115942028,0.09057971014492754
86,경상남도,양산시,소주동,소주동제2투,3792,2445,807,1448,145,23,3,2426,19,1347,33.26463314097279,59.68672712283595,5.976916735366859,0.9480626545754328,0.12366034624896949
87,경상남도,양산시,소주동,소주동제3투,1361,960,380,510,47,14,0,951,9,401,39.95793901156677,53.62776025236593,4.942166140904311,1.4721345951629863,0.0
88,경상남도,양산시,소주동,소주동제4투,1678,960,241,658,36,12,1,948,12,718,25.421940928270043,69.40928270042194,3.79746835443038,1.2658227848101267,0.10548523206751054
89,경상남도,양산시,소주동,소주동제5투,3801,2522,1025,1286,161,27,3,2502,20,1279,40.96722621902478,51.398880895283774,6.434852118305355,1.079136690647482,0.1199040767386091
90,경상남도,양산시,평산동,관내사전투표,4704,4704,2896,1470,263,37,6,4672,32,0,61.986301369863014,31.464041095890412,5.629280821917808,0.7919520547945206,0.12842465753424656
91,경상남도,양산시,평산동,평산동제1투,4034,2640,945,1479,165,26,2,2617,23,1394,36.110049675200614,56.515093618647306,6.304929308368361,0.9935040122277417,0.07642338555598013
92,경상남도,양산시,평산동,평산동제2투,2146,1537,523,913,79,12,1,1528,9,609,34.22774869109947,59.75130890052356,5.170157068062827,0.7853403141361256,0.06544502617801047
93,경상남도,양산시,평산동,평산동제3투,1427,1055,362,634,43,7,2,1048,7,372,34.541984732824424,60.49618320610687,4.103053435114504,0.6679389312977099,0.19083969465648853
94,경상남도,양산시,평산동,평산동제4투,3223,1850,588,1137,94,12,1,1832,18,1373,32.096069868995635,62.06331877729257,5.131004366812228,0.6550218340611353,0.05458515283842794
95,경상남도,양산시,평산동,평산동제5투,2104,1259,416,734,89,11,0,1250,9,845,33.28,58.720000000000006,7.12,0.88,0.0
96,경상남도,양산시,평산동,평산동제6투,1582,1044,275,703,52,8,0,1038,6,538,26.49325626204239,67.72639691714836,5.009633911368015,0.7707129094412332,0.0
97,경상남도,양산시,평산동,평산동제7투,2432,1807,727,940,113,18,1,1799,8,625,40.411339633129515,52.25125069483047,6.281267370761534,1.000555864369094,0.055586436909394105
98,경상남도,양산시,덕계동,관내사전투표,5298,5298,3101,1790,333,35,5,5264,34,0,58.909574468085104,34.004559270516715,6.325987841945288,0.6648936170212766,0.09498480243161095
99,경상남도,양산시,덕계동,덕계동제1투,2907,1975,570,1224,145,20,3,1962,13,932,29.051987767584098,62.38532110091744,7.390417940876656,1.019367991845056,0.1529051987767584
100,경상남도,양산시,덕계동,덕계동제2투,3573,2402,701,1527,130,25,5,2388,14,1171,29.355108877721943,63.94472361809045,5.443886097152429,1.0469011725293134,0.20938023450586263
101,경상남도,양산시,덕계동,덕계동제3투,5670,4284,1857,2006,345,46,3,4257,27,1386,43.62226920366455,47.122386657270376,8.104298801973222,1.0805731735964295,0.07047216349541931
102,경상남도,양산시,잘못 투입·구분된 투표지,,0,0,0,0,0,0,0,0,0,0,0.0,0.0,0.0,0.0,0.0
0,경상남도,하동군,거소·선상투표,,183,170,61,75,10,4,2,152,18,13,40.131578947368425,49.34210526315789,6.578947368421052,2.631578947368421,1.3157894736842104
1,경상남도,하동군,관외사전투표,,3775,3775,1686,1694,315,40,7,3742,33,0,45.05611972207376,45.26990913949759,8.417958311063604,1.0689470871191877,0.18706574024585784
2,경상남도,하동군,재외투표,,223,151,97,44,8,1,0,150,1,72,64.66666666666666,29.333333333333332,5.333333333333334,0.6666666666666667,0.0
3,경상남도,하동군,하동읍,관내사전투표,3051,3051,1514,1272,185,36,2,3009,42,0,50.315719508142244,42.273180458624125,6.148222000664673,1.1964107676969093,0.06646726487205051
4,경상남도,하동군,하동읍,하동읍제1투,2482,1606,394,1122,67,8,6,1597,9,876,24.671258609893552,70.25673137132122,4.19536631183469,0.5009392611145899,0.37570444583594237
5,경상남도,하동군,하동읍,하동읍제2투,1920,1236,351,790,67,15,1,1224,12,684,28.676470588235293,64.54248366013073,5.473856209150327,1.2254901960784315,0.08169934640522876
6,경상남도,하동군,화개면,관내사전투표,950,950,512,385,35,5,0,937,13,0,54.64247598719317,41.088580576307365,3.7353255069370332,0.5336179295624333,0.0
7,경상남도,하동군,화개면,화개면제1투,879,522,153,342,15,4,1,515,7,357,29.708737864077673,66.40776699029126,2.912621359223301,0.7766990291262136,0.1941747572815534
8,경상남도,하동군,화개면,화개면제2투,452,329,105,212,3,1,2,323,6,123,32.50773993808049,65.63467492260062,0.9287925696594427,0.30959752321981426,0.6191950464396285
9,경상남도,하동군,악양면,관내사전투표,1130,1130,548,512,39,15,1,1115,15,0,49.14798206278027,45.91928251121076,3.497757847533632,1.345291479820628,0.08968609865470852
10,경상남도,하동군,악양면,악양면투표소,1591,950,223,659,38,17,2,939,11,641,23.74866879659212,70.18104366347177,4.046858359957402,1.810436634717785,0.21299254526091588
11,경상남도,하동군,적량면,관내사전투표,710,710,358,296,41,8,1,704,6,0,50.85227272727273,42.04545454545455,5.823863636363636,1.1363636363636365,0.14204545454545456
12,경상남도,하동군,적량면,적량면투표소,915,560,135,397,17,9,0,558,2,355,24.193548387096776,71.14695340501792,3.046594982078853,1.6129032258064515,0.0
13,경상남도,하동군,횡천면,관내사전투표,605,605,246,320,28,2,1,597,8,0,41.20603015075377,53.60134003350083,4.690117252931323,0.33500837520938026,0.16750418760469013
14,경상남도,하동군,횡천면,횡천면투표소,972,666,133,499,22,3,1,658,8,306,20.212765957446805,75.83586626139818,3.343465045592705,0.4559270516717325,0.1519756838905775
15,경상남도,하동군,고전면,관내사전투표,527,527,227,252,34,4,0,517,10,0,43.907156673114116,48.74274661508704,6.5764023210831715,0.7736943907156674,0.0
16,경상남도,하동군,고전면,고전면투표소,1092,658,173,448,21,10,0,652,6,434,26.533742331288344,68.71165644171779,3.2208588957055215,1.5337423312883436,0.0
17,경상남도,하동군,금남면,관내사전투표,894,894,377,452,49,5,1,884,10,0,42.64705882352941,51.13122171945701,5.542986425339366,0.5656108597285068,0.11312217194570137
18,경상남도,하동군,금남면,금남면투표소,1556,918,210,651,38,5,1,905,13,638,23.204419889502763,71.93370165745856,4.198895027624309,0.5524861878453038,0.11049723756906078
19,경상남도,하동군,금성면,관내사전투표,723,723,345,305,52,10,2,714,9,0,48.319327731092436,42.71708683473389,7.282913165266107,1.400560224089636,0.2801120448179272
20,경상남도,하동군,금성면,금성면투표소,1384,875,224,598,34,5,0,861,14,509,26.01626016260163,69.45412311265969,3.948896631823461,0.5807200929152149,0.0
21,경상남도,하동군,진교면,관내사전투표,1881,1881,763,974,104,13,3,1857,24,0,41.0877759827679,52.450188476036615,5.600430802369413,0.7000538502961766,0.16155088852988692
22,경상남도,하동군,진교면,진교면투표소,2730,1676,426,1164,64,5,1,1660,16,1054,25.662650602409638,70.12048192771084,3.8554216867469884,0.30120481927710846,0.06024096385542169
23,경상남도,하동군,양보면,관내사전투표,493,493,172,288,23,5,2,490,3,0,35.10204081632653,58.77551020408164,4.6938775510204085,1.0204081632653061,0.40816326530612246
24,경상남도,하동군,양보면,양보면투표소,823,565,113,418,24,4,1,560,5,258,20.17857142857143,74.64285714285714,4.285714285714286,0.7142857142857143,0.17857142857142858
25,경상남도,하동군,북천면,관내사전투표,562,562,190,336,20,6,0,552,10,0,34.42028985507246,60.86956521739131,3.6231884057971016,1.0869565217391304,0.0
26,경상남도,하동군,북천면,북천면투표소,716,427,64,341,10,3,2,420,7,289,15.238095238095239,81.19047619047619,2.380952380952381,0.7142857142857143,0.4761904761904762
27,경상남도,하동군,청암면,관내사전투표,410,410,165,220,14,2,1,402,8,0,41.04477611940299,54.72636815920397,3.482587064676617,0.4975124378109453,0.24875621890547264
28,경상남도,하동군,청암면,청암면제1투,305,208,30,169,4,3,0,206,2,97,14.563106796116504,82.03883495145631,1.9417475728155338,1.4563106796116505,0.0
29,경상남도,하동군,청암면,청암면제2투,296,215,76,130,6,1,0,213,2,81,35.68075117370892,61.03286384976526,2.8169014084507045,0.4694835680751174,0.0
30,경상남도,하동군,옥종면,관내사전투표,1193,1193,521,594,55,6,3,1179,14,0,44.18999151823579,50.38167938931297,4.664970313825275,0.5089058524173028,0.2544529262086514
31,경상남도,하동군,옥종면,옥종면투표소,2117,1456,312,1076,50,6,3,1447,9,661,21.56185210780926,74.36074637180373,3.455425017277125,0.414651002073255,0.2073255010366275
32,경상남도,하동군,잘못 투입·구분된 투표지,,0,0,0,0,0,0,0,0,0,0,0.0,0.0,0.0,0.0,0.0
0,경상남도,남해군,거소·선상투표,,104,98,32,51,10,0,1,94,4,6,34.04255319148936,54.25531914893617,10.638297872340425,0.0,1.0638297872340425
1,경상남도,남해군,관외사전투표,,2723,2723,1207,1186,268,30,2,2693,30,0,44.8199034533977,44.04010397326402,9.951726698848868,1.1139992573338284,0.07426661715558856
2,경상남도,남해군,재외투표,,232,114,73,34,5,2,0,114,0,118,64.03508771929825,29.82456140350877,4.385964912280701,1.7543859649122806,0.0
3,경상남도,남해군,남해읍,관내사전투표,4042,4042,2038,1629,255,52,5,3979,63,0,51.218899220909776,40.939934656948985,6.408645388288514,1.3068610203568736,0.12565971349585323
4,경상남도,남해군,남해읍,남해읍제1투,1483,936,289,576,49,13,1,928,8,547,31.14224137931034,62.06896551724138,5.280172413793103,1.4008620689655173,0.10775862068965517
5,경상남도,남해군,남해읍,남해읍제2투,921,604,139,433,14,7,2,595,9,317,23.361344537815125,72.77310924369748,2.3529411764705883,1.1764705882352942,0.33613445378151263
6,경상남도,남해군,남해읍,남해읍제3투,1548,962,282,612,45,13,1,953,9,586,29.590766002098633,64.21825813221406,4.72193074501574,1.3641133263378804,0.1049317943336831
7,경상남도,남해군,남해읍,남해읍제4투,1999,1311,317,888,71,16,3,1295,16,688,24.47876447876448,68.57142857142857,5.482625482625482,1.2355212355212355,0.23166023166023164
8,경상남도,남해군,이동면,관내사전투표,987,987,444,475,48,4,2,973,14,0,45.63206577595067,48.818088386433715,4.933196300102774,0.41109969167523125,0.20554984583761562
9,경상남도,남해군,이동면,이동면제1투,774,516,106,390,14,4,0,514,2,258,20.622568093385212,75.87548638132296,2.7237354085603114,0.7782101167315175,0.0
10,경상남도,남해군,이동면,이동면제2투,664,445,118,304,15,4,1,442,3,219,26.69683257918552,68.77828054298642,3.3936651583710407,0.904977375565611,0.22624434389140274
11,경상남도,남해군,이동면,이동면제3투,644,455,81,346,18,7,0,452,3,189,17.920353982300885,76.54867256637168,3.982300884955752,1.5486725663716814,0.0
12,경상남도,남해군,상주면,관내사전투표,539,539,234,258,19,17,2,530,9,0,44.15094339622642,48.679245283018865,3.5849056603773586,3.207547169811321,0.37735849056603776
13,경상남도,남해군,상주면,상주면투표소,761,444,115,301,17,3,1,437,7,317,26.31578947368421,68.8787185354691,3.8901601830663615,0.6864988558352403,0.2288329519450801
14,경상남도,남해군,삼동면,관내사전투표,1053,1053,470,510,50,9,0,1039,14,0,45.23580365736285,49.08565928777671,4.8123195380173245,0.8662175168431183,0.0
15,경상남도,남해군,삼동면,삼동면제1투,950,570,132,405,25,2,0,564,6,380,23.404255319148938,71.80851063829788,4.432624113475177,0.3546099290780142,0.0
16,경상남도,남해군,삼동면,삼동면제2투,1065,706,167,503,22,3,1,696,10,359,23.99425287356322,72.27011494252874,3.1609195402298855,0.43103448275862066,0.14367816091954022
17,경상남도,남해군,미조면,관내사전투표,596,596,279,284,17,8,2,590,6,0,47.28813559322034,48.13559322033898,2.8813559322033897,1.3559322033898304,0.3389830508474576
18,경상남도,남해군,미조면,미조면투표소,1131,761,139,589,24,2,1,755,6,370,18.41059602649007,78.01324503311258,3.1788079470198674,0.26490066225165565,0.13245033112582782
19,경상남도,남해군,남면,관내사전투표,1131,1131,455,600,56,6,2,1119,12,0,40.66130473637176,53.61930294906166,5.004468275245755,0.5361930294906166,0.17873100983020554
20,경상남도,남해군,남면,남면제1투,948,562,117,415,23,3,0,558,4,386,20.967741935483872,74.37275985663082,4.121863799283155,0.5376344086021506,0.0
21,경상남도,남해군,남면,남면제2투,695,351,74,267,6,1,1,349,2,344,21.20343839541547,76.50429799426934,1.7191977077363898,0.28653295128939826,0.28653295128939826
22,경상남도,남해군,서면,관내사전투표,693,693,297,347,33,8,1,686,7,0,43.29446064139942,50.583090379008745,4.810495626822157,1.1661807580174928,0.1457725947521866
23,경상남도,남해군,서면,서면제1투,896,542,130,386,16,1,0,533,9,354,24.390243902439025,72.42026266416511,3.0018761726078798,0.18761726078799248,0.0
24,경상남도,남해군,서면,서면제2투,523,382,84,285,9,0,0,378,4,141,22.22222222222222,75.39682539682539,2.380952380952381,0.0,0.0
25,경상남도,남해군,고현면,관내사전투표,1107,1107,534,504,43,12,1,1094,13,0,48.81170018281536,46.06946983546618,3.930530164533821,1.0968921389396709,0.09140767824497258
26,경상남도,남해군,고현면,고현면제1투,884,529,116,386,20,4,1,527,2,355,22.011385199240987,73.24478178368122,3.795066413662239,0.7590132827324478,0.18975332068311196
27,경상남도,남해군,고현면,고현면제2투,854,604,206,366,16,7,3,598,6,250,34.448160535117054,61.20401337792642,2.6755852842809364,1.1705685618729096,0.5016722408026756
28,경상남도,남해군,설천면,관내사전투표,671,670,299,333,28,4,2,666,4,1,44.8948948948949,50.0,4.2042042042042045,0.6006006006006006,0.3003003003003003
29,경상남도,남해군,설천면,설천면제1투,968,613,135,435,28,7,1,606,7,355,22.277227722772277,71.78217821782178,4.62046204620462,1.155115511551155,0.16501650165016502
30,경상남도,남해군,설천면,설천면제2투,513,387,102,255,19,4,0,380,7,126,26.842105263157894,67.10526315789474,5.0,1.0526315789473684,0.0
31,경상남도,남해군,창선면,관내사전투표,1544,1544,450,1025,39,6,1,1521,23,0,29.585798816568047,67.38987508218277,2.564102564102564,0.39447731755424065,0.06574621959237344
32,경상남도,남해군,창선면,창선면제1투,1991,1231,194,979,40,7,0,1220,11,760,15.901639344262295,80.24590163934427,3.278688524590164,0.5737704918032787,0.0
33,경상남도,남해군,창선면,창선면제2투,870,549,75,451,15,3,1,545,4,321,13.761467889908257,82.75229357798165,2.7522935779816518,0.5504587155963303,0.1834862385321101
34,경상남도,남해군,잘못 투입·구분된 투표지,,0,1,1,0,0,0,0,1,0,-1,100.0,0.0,0.0,0.0,0.0
0,경상남도,함양군,거소·선상투표,,149,145,65,50,14,7,2,138,7,4,47.10144927536232,36.231884057971016,10.144927536231885,5.072463768115942,1.4492753623188406
1,경상남도,함양군,관외사전투표,,2671,2671,1146,1219,259,20,2,2646,25,0,43.31065759637188,46.06953892668179,9.788359788359788,0.7558578987150416,0.07558578987150416
2,경상남도,함양군,재외투표,,213,128,65,48,11,2,0,126,2,85,51.587301587301596,38.095238095238095,8.73015873015873,1.5873015873015872,0.0
3,경상남도,함양군,함양읍,관내사전투표,4302,4302,2036,1932,261,45,2,4276,26,0,47.61459307764266,45.182413470533206,6.103835360149672,1.0523854069223575,0.04677268475210477
4,경상남도,함양군,함양읍,함양읍제1투,1017,609,122,453,20,3,1,599,10,408,20.36727879799666,75.62604340567613,3.33889816360601,0.5008347245409015,0.1669449081803005
5,경상남도,함양군,함양읍,함양읍제2투,1238,786,161,582,28,8,1,780,6,452,20.64102564102564,74.61538461538461,3.5897435897435894,1.0256410256410255,0.1282051282051282
6,경상남도,함양군,함양읍,함양읍제3투,2558,1647,485,1023,105,16,1,1630,17,911,29.754601226993866,62.76073619631902,6.441717791411043,0.98159509202454,0.06134969325153375
7,경상남도,함양군,함양읍,함양읍제4투,792,523,123,376,10,2,1,512,11,269,24.0234375,73.4375,1.953125,0.390625,0.1953125
8,경상남도,함양군,함양읍,함양읍제5투,1539,1064,250,747,53,6,3,1059,5,475,23.60717658168083,70.53824362606233,5.004721435316336,0.56657223796034,0.28328611898017
9,경상남도,함양군,함양읍,함양읍제6투,1054,643,164,439,27,5,0,635,8,411,25.826771653543307,69.13385826771653,4.251968503937007,0.7874015748031495,0.0
10,경상남도,함양군,함양읍,함양읍제7투,528,328,67,250,6,3,1,327,1,200,20.489296636085626,76.45259938837921,1.834862385321101,0.9174311926605505,0.3058103975535168
11,경상남도,함양군,마천면,관내사전투표,707,707,339,316,36,8,3,702,5,0,48.29059829059829,45.01424501424501,5.128205128205128,1.1396011396011396,0.4273504273504274
12,경상남도,함양군,마천면,마천면투표소,1016,634,135,472,16,2,0,625,9,382,21.6,75.52,2.56,0.32,0.0
13,경상남도,함양군,휴천면,관내사전투표,533,533,226,268,31,3,1,529,4,0,42.722117202268436,50.661625708884685,5.8601134215500945,0.5671077504725899,0.1890359168241966
14,경상남도,함양군,휴천면,휴천면투표소,683,405,96,293,10,3,0,402,3,278,23.88059701492537,72.88557213930348,2.4875621890547266,0.7462686567164178,0.0
15,경상남도,함양군,유림면,관내사전투표,420,420,155,236,17,8,0,416,4,0,37.25961538461539,56.730769230769226,4.086538461538462,1.9230769230769231,0.0
16,경상남도,함양군,유림면,유림면투표소,840,507,89,396,14,1,1,501,6,333,17.764471057884233,79.04191616766467,2.7944111776447107,0.19960079840319359,0.19960079840319359
17,경상남도,함양군,수동면,관내사전투표,769,769,287,405,51,9,3,755,14,0,38.01324503311258,53.64238410596026,6.754966887417218,1.1920529801324504,0.3973509933774834
18,경상남도,함양군,수동면,수동면투표소,1243,812,161,619,22,2,2,806,6,431,19.975186104218363,76.79900744416874,2.729528535980149,0.24813895781637718,0.24813895781637718
19,경상남도,함양군,지곡면,관내사전투표,818,818,333,418,38,8,1,798,20,0,41.72932330827068,52.38095238095239,4.761904761904762,1.0025062656641603,0.12531328320802004
20,경상남도,함양군,지곡면,지곡면투표소,1039,694,127,532,18,7,4,688,6,345,18.459302325581394,77.32558139534885,2.616279069767442,1.0174418604651163,0.5813953488372093
21,경상남도,함양군,안의면,관내사전투표,1422,1422,482,846,63,10,2,1403,19,0,34.354953670705626,60.29935851746258,4.490377761938703,0.7127583749109052,0.14255167498218105
22,경상남도,함양군,안의면,안의면제1투,1125,729,123,562,30,3,2,720,9,396,17.083333333333332,78.05555555555556,4.166666666666666,0.4166666666666667,0.2777777777777778
23,경상남도,함양군,안의면,안의면제2투,1074,639,114,489,22,5,0,630,9,435,18.095238095238095,77.61904761904762,3.492063492063492,0.7936507936507936,0.0
24,경상남도,함양군,서하면,관내사전투표,399,399,157,207,21,5,2,392,7,0,40.05102040816326,52.806122448979586,5.357142857142857,1.2755102040816326,0.5102040816326531
25,경상남도,함양군,서하면,서하면투표소,679,445,76,346,11,2,0,435,10,234,17.47126436781609,79.54022988505747,2.528735632183908,0.45977011494252873,0.0
26,경상남도,함양군,서상면,관내사전투표,599,599,239,310,40,5,0,594,5,0,40.235690235690235,52.18855218855219,6.7340067340067336,0.8417508417508417,0.0
27,경상남도,함양군,서상면,서상면투표소,889,591,111,454,16,2,0,583,8,298,19.039451114922812,77.87307032590051,2.7444253859348198,0.34305317324185247,0.0
28,경상남도,함양군,백전면,관내사전투표,437,437,191,215,23,5,1,435,2,0,43.9080459770115,49.42528735632184,5.287356321839081,1.1494252873563218,0.22988505747126436
29,경상남도,함양군,백전면,백전면투표소,791,505,85,400,13,3,0,501,4,286,16.966067864271455,79.84031936127745,2.5948103792415167,0.5988023952095809,0.0
30,경상남도,함양군,병곡면,관내사전투표,509,509,197,267,29,9,0,502,7,0,39.243027888446214,53.18725099601593,5.776892430278884,1.7928286852589643,0.0
31,경상남도,함양군,병곡면,병곡면투표소,649,428,82,333,6,2,0,423,5,221,19.38534278959811,78.72340425531915,1.4184397163120568,0.4728132387706856,0.0
32,경상남도,함양군,잘못 투입·구분된 투표지,,0,0,0,0,0,0,0,0,0,0,0.0,0.0,0.0,0.0,0.0
0,경상남도,산청군,거소·선상투표,,141,133,41,69,9,3,2,124,9,8,33.064516129032256,55.64516129032258,7.258064516129033,2.4193548387096775,1.6129032258064515
1,경상남도,산청군,관외사전투표,,3514,3512,1417,1735,294,37,6,3489,23,2,40.613356262539405,49.72771567784465,8.426483233018056,1.0604757810260819,0.17196904557179707
2,경상남도,산청군,재외투표,,224,118,79,28,11,0,0,118,0,106,66.94915254237289,23.728813559322035,9.322033898305085,0.0,0.0
3,경상남도,산청군,산청읍,관내사전투표,1761,1761,788,804,114,29,3,1738,23,0,45.33947065592635,46.260069044879174,6.559263521288838,1.668584579976985,0.17261219792865362
4,경상남도,산청군,산청읍,산청읍제1투,2579,1640,343,1190,74,18,1,1626,14,939,21.094710947109473,73.18573185731857,4.551045510455105,1.107011070110701,0.06150061500615006
5,경상남도,산청군,산청읍,산청읍제2투,734,481,91,369,16,1,1,478,3,253,19.03765690376569,77.19665271966527,3.3472803347280333,0.20920502092050208,0.20920502092050208
6,경상남도,산청군,차황면,관내사전투표,344,344,127,197,14,1,0,339,5,0,37.46312684365782,58.11209439528023,4.129793510324483,0.2949852507374631,0.0
7,경상남도,산청군,차황면,차황면투표소,761,514,97,401,5,4,0,507,7,247,19.13214990138067,79.09270216962526,0.9861932938856016,0.7889546351084813,0.0
8,경상남도,산청군,오부면,관내사전투표,264,264,87,154,13,4,1,259,5,0,33.59073359073359,59.45945945945946,5.019305019305019,1.5444015444015444,0.3861003861003861
9,경상남도,산청군,오부면,오부면투표소,533,347,48,281,11,4,0,344,3,186,13.953488372093023,81.68604651162791,3.1976744186046515,1.1627906976744187,0.0
10,경상남도,산청군,생초면,관내사전투표,500,500,146,322,24,2,0,494,6,0,29.554655870445345,65.18218623481782,4.8582995951417,0.4048582995951417,0.0
11,경상남도,산청군,생초면,생초면투표소,1042,670,102,529,24,4,2,661,9,372,15.431164901664147,80.0302571860817,3.6308623298033282,0.6051437216338881,0.30257186081694404
12,경상남도,산청군,금서면,관내사전투표,806,806,348,384,46,12,1,791,15,0,43.994943109987354,48.54614412136536,5.815423514538559,1.5170670037926675,0.12642225031605564
13,경상남도,산청군,금서면,금서면제1투,1129,675,149,493,19,4,3,668,7,454,22.305389221556887,73.80239520958084,2.844311377245509,0.5988023952095809,0.4491017964071856
14,경상남도,산청군,금서면,금서면제2투,487,341,59,260,11,4,2,336,5,146,17.559523809523807,77.38095238095238,3.273809523809524,1.1904761904761905,0.5952380952380952
15,경상남도,산청군,삼장면,관내사전투표,489,489,178,282,26,1,0,487,2,0,36.55030800821355,57.90554414784395,5.338809034907597,0.20533880903490762,0.0
16,경상남도,산청군,삼장면,삼장면투표소,947,661,108,534,12,1,2,657,4,286,16.43835616438356,81.27853881278538,1.82648401826484,0.15220700152207,0.30441400304414
17,경상남도,산청군,시천면,관내사전투표,1147,1147,524,569,35,11,1,1140,7,0,45.96491228070175,49.91228070175438,3.070175438596491,0.9649122807017544,0.08771929824561403
18,경상남도,산청군,시천면,시천면제1투,1152,778,145,607,18,2,0,772,6,374,18.78238341968912,78.62694300518135,2.33160621761658,0.2590673575129534,0.0
19,경상남도,산청군,시천면,시천면제2투,979,665,111,530,15,3,1,660,5,314,16.818181818181817,80.3030303030303,2.272727272727273,0.45454545454545453,0.15151515151515152
20,경상남도,산청군,단성면,관내사전투표,1546,1546,611,844,60,16,0,1531,15,0,39.90855649902025,55.12736773350751,3.9190071848465053,1.0450685826257349,0.0
21,경상남도,산청군,단성면,단성면제1투,2299,1408,242,1096,37,9,5,1389,19,891,17.42260619150468,78.90568754499641,2.663786897048236,0.6479481641468683,0.3599712023038157
22,경상남도,산청군,단성면,단성면제2투,613,436,94,318,16,4,0,432,4,177,21.75925925925926,73.61111111111111,3.7037037037037033,0.9259259259259258,0.0
23,경상남도,산청군,신안면,관내사전투표,1442,1442,688,657,75,13,1,1434,8,0,47.977684797768475,45.81589958158996,5.230125523012552,0.906555090655509,0.0697350069735007
24,경상남도,산청군,신안면,신안면제1투,2037,1350,245,1010,62,14,0,1331,19,687,18.407212622088657,75.88279489105936,4.658151765589782,1.051840721262209,0.0
25,경상남도,산청군,신안면,신안면제2투,821,551,110,417,16,3,1,547,4,270,20.109689213893965,76.23400365630712,2.9250457038391224,0.5484460694698354,0.18281535648994515
26,경상남도,산청군,생비량면,관내사전투표,316,316,93,204,10,2,0,309,7,0,30.097087378640776,66.01941747572816,3.2362459546925564,0.6472491909385114,0.0
27,경상남도,산청군,생비량면,생비량면투표소,635,437,58,356,13,4,0,431,6,198,13.45707656612529,82.5986078886311,3.0162412993039442,0.9280742459396751,0.0
28,경상남도,산청군,신등면,관내사전투표,598,598,222,337,25,6,1,591,7,0,37.56345177664975,57.021996615905245,4.230118443316413,1.015228426395939,0.1692047377326565
29,경상남도,산청군,신등면,신등면투표소,1128,738,127,571,25,3,2,728,10,390,17.445054945054945,78.43406593406593,3.4340659340659343,0.4120879120879121,0.27472527472527475
30,경상남도,산청군,잘못 투입·구분된 투표지,,0,0,0,0,0,0,0,0,0,0,0.0,0.0,0.0,0.0,0.0
0,경상남도,거창군,거소·선상투표,,106,101,29,52,17,0,0,98,3,5,29.591836734693878,53.06122448979592,17.346938775510203,0.0,0.0
1,경상남도,거창군,관외사전투표,,3872,3870,1532,1715,534,38,7,3826,44,2,40.041819132253,44.82488238369054,13.95713538944067,0.9932043910088865,0.18295870360690017
2,경상남도,거창군,재외투표,,380,221,134,63,15,8,0,220,1,159,60.909090909090914,28.636363636363637,6.8181818181818175,3.6363636363636362,0.0
3,경상남도,거창군,거창읍,관내사전투표,8033,8033,3572,3687,628,77,9,7973,60,0,44.80120406371504,46.24357205568795,7.876583469208579,0.9657594381035997,0.11288097328483633
4,경상남도,거창군,거창읍,거창읍제1투,2999,1952,601,1185,132,15,2,1935,17,1047,31.059431524547804,61.240310077519375,6.821705426356589,0.7751937984496124,0.10335917312661498
5,경상남도,거창군,거창읍,거창읍제2투,2110,1383,280,1008,75,6,2,1371,12,727,20.423048869438365,73.52297592997812,5.470459518599562,0.437636761487965,0.14587892049598833
6,경상남도,거창군,거창읍,거창읍제3투,2153,1484,349,1035,78,8,2,1472,12,669,23.709239130434785,70.3125,5.298913043478261,0.5434782608695652,0.1358695652173913
7,경상남도,거창군,거창읍,거창읍제4투,2810,1827,405,1276,111,19,1,1812,15,983,22.350993377483444,70.41942604856513,6.125827814569536,1.0485651214128036,0.05518763796909492
8,경상남도,거창군,거창읍,거창읍제5투,2680,1755,357,1277,86,14,4,1738,17,925,20.540851553509782,73.47525891829689,4.9482163406214035,0.805523590333717,0.23014959723820483
9,경상남도,거창군,거창읍,거창읍제6투,1808,1200,254,887,43,6,1,1191,9,608,21.326616288832913,74.4752308984047,3.6104114189756507,0.5037783375314862,0.08396305625524769
10,경상남도,거창군,거창읍,거창읍제7투,2214,1428,360,916,120,10,1,1407,21,786,25.5863539445629,65.10305614783228,8.528784648187633,0.7107320540156361,0.07107320540156362
11,경상남도,거창군,거창읍,거창읍제8투,1061,747,123,581,26,3,2,735,12,314,16.73469387755102,79.04761904761905,3.537414965986395,0.40816326530612246,0.27210884353741494
12,경상남도,거창군,거창읍,거창읍제9투,1244,848,226,558,45,9,0,838,10,396,26.968973747016705,66.5871121718377,5.369928400954653,1.0739856801909307,0.0
13,경상남도,거창군,거창읍,거창읍제10투,2032,1313,294,916,78,8,3,1299,14,719,22.632794457274827,70.51578137028484,6.0046189376443415,0.6158583525789069,0.23094688221709006
14,경상남도,거창군,주상면,관내사전투표,728,728,244,433,31,4,2,714,14,0,34.173669467787114,60.64425770308123,4.341736694677871,0.5602240896358543,0.2801120448179272
15,경상남도,거창군,주상면,주상면투표소,761,528,76,424,17,0,1,518,10,233,14.671814671814673,81.85328185328186,3.2818532818532815,0.0,0.19305019305019305
16,경상남도,거창군,웅양면,관내사전투표,667,667,249,370,35,6,1,661,6,0,37.67019667170953,55.975794251134644,5.29500756429652,0.9077155824508321,0.15128593040847202
17,경상남도,거창군,웅양면,웅양면투표소,904,608,133,439,17,10,2,601,7,296,22.129783693843592,73.04492512479202,2.828618968386023,1.6638935108153077,0.33277870216306155
18,경상남도,거창군,고제면,관내사전투표,571,571,215,321,24,3,2,565,6,0,38.05309734513274,56.81415929203539,4.2477876106194685,0.5309734513274336,0.35398230088495575
19,경상남도,거창군,고제면,고제면투표소,718,465,88,355,18,1,1,463,2,253,19.00647948164147,76.67386609071274,3.8876889848812093,0.21598272138228944,0.21598272138228944
20,경상남도,거창군,북상면,관내사전투표,596,596,234,325,26,3,2,590,6,0,39.66101694915255,55.08474576271186,4.406779661016949,0.5084745762711864,0.3389830508474576
21,경상남도,거창군,북상면,북상면투표소,713,444,82,335,13,2,2,434,10,269,18.89400921658986,77.18894009216591,2.995391705069124,0.4608294930875576,0.4608294930875576
22,경상남도,거창군,위천면,관내사전투표,691,691,244,386,45,6,0,681,10,0,35.82966226138032,56.6813509544787,6.607929515418502,0.881057268722467,0.0
23,경상남도,거창군,위천면,위천면투표소,967,638,99,494,29,6,3,631,7,329,15.689381933438987,78.28843106180665,4.595879556259905,0.9508716323296356,0.4754358161648178
24,경상남도,거창군,마리면,관내사전투표,845,845,319,466,48,7,0,840,5,0,37.976190476190474,55.47619047619048,5.714285714285714,0.8333333333333334,0.0
25,경상남도,거창군,마리면,마리면투표소,1070,682,109,544,19,1,0,673,9,388,16.196136701337295,80.83209509658246,2.823179791976226,0.1485884101040119,0.0
26,경상남도,거창군,남상면,관내사전투표,928,928,336,513,47,10,4,910,18,0,36.92307692307693,56.37362637362637,5.164835164835164,1.098901098901099,0.43956043956043955
27,경상남도,거창군,남상면,남상면투표소,1239,759,138,576,30,1,2,747,12,480,18.473895582329316,77.10843373493977,4.016064257028113,0.13386880856760375,0.2677376171352075
28,경상남도,거창군,남하면,관내사전투표,995,995,374,539,61,9,3,986,9,0,37.93103448275862,54.66531440162272,6.186612576064909,0.9127789046653144,0.3042596348884381
29,경상남도,거창군,남하면,남하면투표소,738,485,95,362,18,2,2,479,6,253,19.832985386221296,75.5741127348643,3.7578288100208765,0.41753653444676403,0.41753653444676403
30,경상남도,거창군,신원면,관내사전투표,529,529,164,330,21,4,2,521,8,0,31.477927063339735,63.339731285988485,4.030710172744722,0.7677543186180422,0.3838771593090211
31,경상남도,거창군,신원면,신원면투표소,742,476,92,349,19,4,1,465,11,266,19.78494623655914,75.05376344086021,4.086021505376344,0.8602150537634409,0.21505376344086022
32,경상남도,거창군,가조면,관내사전투표,1419,1419,413,906,66,15,1,1401,18,0,29.478943611705926,64.66809421841542,4.710920770877944,1.070663811563169,0.07137758743754462
33,경상남도,거창군,가조면,가조면투표소,1898,1294,197,1023,47,13,0,1280,14,604,15.390625,79.921875,3.671875,1.015625,0.0
34,경상남도,거창군,가북면,관내사전투표,383,383,124,238,13,1,0,376,7,0,32.97872340425532,63.297872340425535,3.4574468085106385,0.26595744680851063,0.0
35,경상남도,거창군,가북면,가북면투표소,712,480,82,375,8,3,0,468,12,232,17.52136752136752,80.12820512820514,1.7094017094017095,0.641025641025641,0.0
36,경상남도,거창군,잘못 투입·구분된 투표지,,0,0,0,0,0,0,0,0,0,0,0.0,0.0,0.0,0.0,0.0
0,경상남도,합천군,거소·선상투표,,259,215,34,130,21,4,6,195,20,44,17.435897435897434,66.66666666666666,10.76923076923077,2.051282051282051,3.076923076923077
1,경상남도,합천군,관외사전투표,,3422,3422,1175,1930,262,31,3,3401,21,0,34.54866215818877,56.7480152896207,7.703616583357836,0.911496618641576,0.08820935019112026
2,경상남도,합천군,재외투표,,305,131,65,54,9,1,0,129,2,174,50.3875968992248,41.86046511627907,6.976744186046512,0.7751937984496124,0.0
3,경상남도,합천군,합천읍,관내사전투표,3149,3149,1259,1634,189,40,0,3122,27,0,40.3267136450993,52.33824471492633,6.053811659192825,1.2812299807815504,0.0
4,경상남도,합천군,합천읍,합천읍제1투,2993,1862,321,1460,61,4,1,1847,15,1131,17.379534380075796,79.04710341093666,3.302652950730915,0.2165674066053059,0.05414185165132648
5,경상남도,합천군,합천읍,합천읍제2투,2410,1614,265,1262,62,11,2,1602,12,796,16.541822721598002,78.7765293383271,3.870162297128589,0.686641697877653,0.12484394506866417
6,경상남도,합천군,봉산면,관내사전투표,339,339,100,225,8,0,0,333,6,0,30.03003003003003,67.56756756756756,2.4024024024024024,0.0,0.0
7,경상남도,합천군,봉산면,봉산면투표소,772,464,68,378,9,1,0,456,8,308,14.912280701754385,82.89473684210526,1.9736842105263157,0.21929824561403508,0.0
8,경상남도,합천군,묘산면,관내사전투표,375,375,107,250,11,1,0,369,6,0,28.997289972899733,67.75067750677508,2.9810298102981028,0.27100271002710025,0.0
9,경상남도,합천군,묘산면,묘산면투표소,844,536,65,442,13,3,0,523,13,308,12.4282982791587,84.51242829827916,2.48565965583174,0.5736137667304015,0.0
10,경상남도,합천군,가야면,관내사전투표,776,776,300,427,32,8,1,768,8,0,39.0625,55.598958333333336,4.166666666666666,1.0416666666666665,0.13020833333333331
11,경상남도,합천군,가야면,가야면제1투,992,633,89,514,25,0,2,630,3,359,14.126984126984127,81.58730158730158,3.968253968253968,0.0,0.31746031746031744
12,경상남도,합천군,가야면,가야면제2투,985,714,100,589,11,3,1,704,10,271,14.204545454545455,83.66477272727273,1.5625,0.4261363636363636,0.14204545454545456
13,경상남도,합천군,가야면,가야면제3투,419,275,69,189,13,1,1,273,2,144,25.274725274725274,69.23076923076923,4.761904761904762,0.3663003663003663,0.3663003663003663
14,경상남도,합천군,야로면,관내사전투표,557,557,165,359,20,2,1,547,10,0,30.16453382084095,65.63071297989032,3.656307129798903,0.3656307129798903,0.18281535648994515
15,경상남도,합천군,야로면,야로면투표소,1321,845,112,694,21,4,0,831,14,476,13.477737665463296,83.51383874849579,2.527075812274368,0.48134777376654636,0.0
16,경상남도,합천군,율곡면,관내사전투표,471,471,134,305,23,3,2,467,4,0,28.693790149892934,65.31049250535332,4.925053533190578,0.6423982869379015,0.4282655246252677
17,경상남도,합천군,율곡면,율곡면투표소,1239,804,115,648,19,5,2,789,15,435,14.575411913814957,82.12927756653993,2.4081115335868186,0.6337135614702154,0.25348542458808615
18,경상남도,합천군,초계면,관내사전투표,561,561,162,369,24,1,0,556,5,0,29.136690647482016,66.36690647482014,4.316546762589928,0.1798561151079137,0.0
19,경상남도,합천군,초계면,초계면투표소,1316,875,146,695,16,6,3,866,9,441,16.859122401847575,80.2540415704388,1.8475750577367205,0.6928406466512702,0.3464203233256351
20,경상남도,합천군,쌍책면,관내사전투표,234,234,59,149,18,0,0,226,8,0,26.10619469026549,65.929203539823,7.964601769911504,0.0,0.0
21,경상남도,합천군,쌍책면,쌍책면투표소,801,594,58,511,13,4,0,586,8,207,9.897610921501707,87.20136518771331,2.218430034129693,0.6825938566552902,0.0
22,경상남도,합천군,덕곡면,관내사전투표,183,183,46,126,9,0,1,182,1,0,25.274725274725274,69.23076923076923,4.945054945054945,0.0,0.5494505494505495
23,경상남도,합천군,덕곡면,덕곡면투표소,494,331,42,279,4,1,0,326,5,163,12.883435582822086,85.58282208588957,1.2269938650306749,0.3067484662576687,0.0
24,경상남도,합천군,청덕면,관내사전투표,249,249,73,165,7,2,1,248,1,0,29.435483870967744,66.53225806451613,2.82258064516129,0.8064516129032258,0.4032258064516129
25,경상남도,합천군,청덕면,청덕면투표소,933,605,81,497,6,3,1,588,17,328,13.77551020408163,84.52380952380952,1.0204081632653061,0.5102040816326531,0.17006802721088435
26,경상남도,합천군,적중면,관내사전투표,276,276,81,172,15,5,1,274,2,0,29.56204379562044,62.77372262773723,5.474452554744526,1.824817518248175,0.36496350364963503
27,경상남도,합천군,적중면,적중면투표소,833,543,84,433,12,1,1,531,12,290,15.819209039548024,81.54425612052731,2.2598870056497176,0.18832391713747645,0.18832391713747645
28,경상남도,합천군,대양면,관내사전투표,309,308,114,169,20,4,0,307,1,1,37.13355048859935,55.048859934853425,6.514657980456026,1.3029315960912053,0.0
29,경상남도,합천군,대양면,대양면투표소,962,606,86,487,21,3,0,597,9,356,14.40536013400335,81.57453936348409,3.5175879396984926,0.5025125628140703,0.0
30,경상남도,합천군,쌍백면,관내사전투표,401,401,122,252,18,1,2,395,6,0,30.886075949367086,63.79746835443038,4.556962025316456,0.25316455696202533,0.5063291139240507
31,경상남도,합천군,쌍백면,쌍백면투표소,940,573,75,460,18,4,3,560,13,367,13.392857142857142,82.14285714285714,3.214285714285714,0.7142857142857143,0.5357142857142857
32,경상남도,합천군,삼가면,관내사전투표,777,777,258,466,29,10,1,764,13,0,33.7696335078534,60.994764397905755,3.7958115183246073,1.3089005235602094,0.13089005235602094
33,경상남도,합천군,삼가면,삼가면투표소,1814,1163,185,916,34,10,3,1148,15,651,16.114982578397214,79.79094076655052,2.961672473867596,0.8710801393728222,0.2613240418118467
34,경상남도,합천군,가회면,관내사전투표,447,447,163,256,18,5,2,444,3,0,36.711711711711715,57.65765765765766,4.054054054054054,1.1261261261261262,0.45045045045045046
35,경상남도,합천군,가회면,가회면투표소,863,537,92,416,14,1,2,525,12,326,17.523809523809526,79.23809523809524,2.666666666666667,0.19047619047619047,0.38095238095238093
36,경상남도,합천군,대병면,관내사전투표,549,549,168,338,25,7,1,539,10,0,31.16883116883117,62.708719851577,4.638218923933209,1.2987012987012987,0.1855287569573284
37,경상남도,합천군,대병면,대병면투표소,1032,630,75,532,12,2,0,621,9,402,12.077294685990339,85.6682769726248,1.932367149758454,0.322061191626409,0.0
38,경상남도,합천군,용주면,관내사전투표,601,601,174,390,27,7,0,598,3,0,29.09698996655518,65.21739130434783,4.51505016722408,1.1705685618729096,0.0
39,경상남도,합천군,용주면,용주면투표소,1126,710,114,564,19,1,2,700,10,416,16.28571428571429,80.57142857142857,2.7142857142857144,0.14285714285714285,0.2857142857142857
40,경상남도,합천군,잘못 투입·구분된 투표지,,0,0,0,0,0,0,0,0,0,0,0.0,0.0,0.0,0.0,0.0
0,경상남도,창원시의창구,거소·선상투표,,409,395,104,205,62,5,1,377,18,14,27.586206896551722,54.37665782493368,16.445623342175068,1.3262599469496021,0.2652519893899204
1,경상남도,창원시의창구,관외사전투표,,16918,16917,8042,6042,2420,204,27,16735,182,1,48.054974604123096,36.103973707798026,14.460711084553331,1.2190020914251567,0.1613385121003884
2,경상남도,창원시의창구,재외투표,,719,540,342,121,64,9,0,536,4,179,63.80597014925373,22.574626865671643,11.940298507462686,1.6791044776119404,0.0
3,경상남도,창원시의창구,동읍,관내사전투표,3326,3326,1809,1239,202,46,7,3303,23,0,54.76839237057221,37.51135331516803,6.115652437178323,1.392673327278232,0.2119285498032092
4,경상남도,창원시의창구,동읍,동읍제1투,1026,749,289,349,82,21,1,742,7,277,38.94878706199461,47.03504043126684,11.05121293800539,2.8301886792452833,0.13477088948787064
5,경상남도,창원시의창구,동읍,동읍제2투,1862,1205,315,790,80,13,1,1199,6,657,26.271893244370307,65.8882402001668,6.672226855713094,1.084236864053378,0.08340283569641367
6,경상남도,창원시의창구,동읍,동읍제3투,1524,1101,349,677,50,13,0,1089,12,423,32.047750229568415,62.16712580348944,4.591368227731864,1.1937557392102847,0.0
7,경상남도,창원시의창구,동읍,동읍제4투,2297,1722,686,881,114,24,2,1707,15,575,40.18746338605741,51.611013473930875,6.6783831282952555,1.4059753954305798,0.11716461628588166
8,경상남도,창원시의창구,동읍,동읍제5투,2691,1818,570,1087,115,33,4,1809,9,873,31.509121061359867,60.08844665561084,6.357103372028745,1.8242122719734661,0.22111663902708678
9,경상남도,창원시의창구,동읍,동읍제6투,1100,757,147,563,34,5,1,750,7,343,19.6,75.06666666666668,4.533333333333333,0.6666666666666667,0.13333333333333333
10,경상남도,창원시의창구,동읍,동읍제7투,1025,695,142,516,27,8,0,693,2,330,20.49062049062049,74.45887445887446,3.896103896103896,1.1544011544011543,0.0
11,경상남도,창원시의창구,북면,관내사전투표,6782,6782,3906,2210,531,90,6,6743,39,0,57.926738840278816,32.77472934895447,7.8748331603144,1.3347174847990508,0.08898116565327006
12,경상남도,창원시의창구,북면,북면제1투,3342,2506,816,1473,175,27,1,2492,14,836,32.74478330658106,59.1091492776886,7.02247191011236,1.0834670947030496,0.04012841091492777
13,경상남도,창원시의창구,북면,북면제2투,2223,1673,548,971,123,21,1,1664,9,550,32.93269230769231,58.35336538461539,7.391826923076923,1.2620192307692308,0.06009615384615385
14,경상남도,창원시의창구,북면,북면제3투,2224,1815,696,946,142,25,0,1809,6,409,38.47429519071311,52.29408512990602,7.849640685461582,1.3819789939192924,0.0
15,경상남도,창원시의창구,북면,북면제4투,2451,1812,660,940,167,19,3,1789,23,639,36.8921185019564,52.54332029066517,9.334823923979876,1.0620458356623812,0.16769144773616546
16,경상남도,창원시의창구,북면,북면제5투,2160,1529,446,958,98,17,1,1520,9,631,29.342105263157897,63.026315789473685,6.447368421052632,1.118421052631579,0.06578947368421052
17,경상남도,창원시의창구,북면,북면제6투,2233,1643,687,765,152,24,4,1632,11,590,42.095588235294116,46.875,9.313725490196079,1.4705882352941175,0.24509803921568626
18,경상남도,창원시의창구,북면,북면제7투,2924,2204,870,1098,188,26,1,2183,21,720,39.85341273476867,50.297755382501144,8.612001832340816,1.1910215300045808,0.04580852038479157
19,경상남도,창원시의창구,북면,북면제8투,3133,2090,495,1488,83,10,2,2078,12,1043,23.820981713185756,71.60731472569779,3.994225216554379,0.4812319538017324,0.0962463907603465
20,경상남도,창원시의창구,북면,북면제9투,771,561,116,421,17,2,0,556,5,210,20.863309352517987,75.71942446043165,3.0575539568345325,0.3597122302158274,0.0
21,경상남도,창원시의창구,북면,북면제10투,2325,1653,580,853,172,26,1,1632,21,672,35.53921568627451,52.267156862745104,10.53921568627451,1.5931372549019607,0.061274509803921566
22,경상남도,창원시의창구,대산면,관내사전투표,1532,1532,830,589,88,11,1,1519,13,0,54.64121132323897,38.775510204081634,5.793285055957867,0.7241606319947334,0.06583278472679394
23,경상남도,창원시의창구,대산면,대산면제1투,1195,802,204,554,29,7,2,796,6,393,25.628140703517587,69.59798994974874,3.6432160804020097,0.8793969849246231,0.25125628140703515
24,경상남도,창원시의창구,대산면,대산면제2투,2179,1297,363,836,67,16,3,1285,12,882,28.249027237354085,65.05836575875486,5.214007782101167,1.245136186770428,0.23346303501945526
25,경상남도,창원시의창구,대산면,대산면제3투,845,567,173,355,25,12,0,565,2,278,30.619469026548675,62.83185840707964,4.424778761061947,2.1238938053097343,0.0
26,경상남도,창원시의창구,의창동,관내사전투표,5840,5840,2895,2421,414,65,5,5800,40,0,49.91379310344828,41.741379310344826,7.137931034482758,1.1206896551724137,0.08620689655172414
27,경상남도,창원시의창구,의창동,의창동제1투,1604,1119,223,825,58,7,0,1113,6,485,20.035938903863432,74.12398921832884,5.211141060197664,0.628930817610063,0.0
28,경상남도,창원시의창구,의창동,의창동제2투,2232,1588,364,1124,73,12,3,1576,12,644,23.096446700507613,71.31979695431471,4.631979695431472,0.7614213197969544,0.1903553299492386
29,경상남도,창원시의창구,의창동,의창동제3투,2255,1634,512,974,121,13,1,1621,13,621,31.585441085749537,60.086366440468844,7.464528069093153,0.8019740900678594,0.061690314620604564
30,경상남도,창원시의창구,의창동,의창동제4투,2477,1657,442,1071,98,22,3,1636,21,820,27.017114914425427,65.4645476772616,5.990220048899755,1.3447432762836184,0.18337408312958436
31,경상남도,창원시의창구,의창동,의창동제5투,2490,1802,462,1183,105,36,2,1788,14,688,25.838926174496645,66.16331096196868,5.87248322147651,2.013422818791946,0.11185682326621924
32,경상남도,창원시의창구,의창동,의창동제6투,2222,1485,380,957,114,21,1,1473,12,737,25.797691785471827,64.96945010183299,7.739307535641547,1.4256619144602851,0.0678886625933469
33,경상남도,창원시의창구,의창동,의창동제7투,1642,1207,342,786,61,7,1,1197,10,435,28.57142857142857,65.6641604010025,5.096073517126149,0.5847953216374269,0.0835421888053467
34,경상남도,창원시의창구,의창동,의창동제8투,1437,1075,307,680,67,10,1,1065,10,362,28.826291079812204,63.84976525821596,6.291079812206572,0.9389671361502347,0.09389671361502347
35,경상남도,창원시의창구,의창동,의창동제9투,2838,1766,516,1020,188,16,5,1745,21,1072,29.570200573065904,58.45272206303726,10.773638968481375,0.9169054441260744,0.28653295128939826
36,경상남도,창원시의창구,의창동,의창동제10투,3176,2694,911,1499,249,23,4,2686,8,482,33.91660461653016,55.80789277736411,9.270290394638868,0.8562918838421444,0.14892032762472077
37,경상남도,창원시의창구,의창동,의창동제11투,2146,1747,572,971,178,17,1,1739,8,399,32.892466935020124,55.83668775158137,10.235767682576192,0.9775733179988499,0.05750431282346176
38,경상남도,창원시의창구,의창동,의창동제12투,2589,2217,719,1244,216,23,0,2202,15,372,32.65213442325159,56.49409627611263,9.809264305177113,1.0445049954586738,0.0
39,경상남도,창원시의창구,의창동,의창동제13투,3084,2580,882,1401,249,35,1,2568,12,504,34.345794392523366,54.556074766355145,9.69626168224299,1.3629283489096573,0.03894080996884735
40,경상남도,창원시의창구,팔룡동,관내사전투표,5352,5352,2751,2028,474,59,5,5317,35,0,51.73970283994734,38.141809290953546,8.914801579838254,1.1096482979123568,0.0940379913485048
41,경상남도,창원시의창구,팔룡동,팔룡동제1투,2145,1498,388,972,109,17,1,1487,11,647,26.09280430396772,65.36650975117688,7.330195023537324,1.1432414256893073,0.06724949562878278
42,경상남도,창원시의창구,팔룡동,팔룡동제2투,2048,1249,310,804,97,22,2,1235,14,799,25.101214574898783,65.10121457489878,7.854251012145749,1.7813765182186234,0.16194331983805668
43,경상남도,창원시의창구,팔룡동,팔룡동제3투,2687,1764,491,1116,121,23,3,1754,10,923,27.99315849486887,63.625997719498294,6.8985176738882545,1.3112884834663627,0.17103762827822122
44,경상남도,창원시의창구,팔룡동,팔룡동제4투,2666,1975,687,1027,201,39,3,1957,18,691,35.104752171691366,52.47828308635667,10.27082268778743,1.992846193152785,0.1532958610117527
45,경상남도,창원시의창구,팔룡동,팔룡동제5투,2981,2357,874,1218,202,37,3,2334,23,624,37.44644387317909,52.185089974293064,8.654670094258783,1.5852613538988862,0.12853470437017994
46,경상남도,창원시의창구,팔룡동,팔룡동제6투,2179,1628,607,819,169,17,5,1617,11,551,37.53865182436611,50.649350649350644,10.451453308596166,1.051329622758194,0.30921459492888065
47,경상남도,창원시의창구,명곡동,관내사전투표,7162,7162,3830,2635,558,84,6,7113,49,0,53.84507240264305,37.0448474623928,7.844791227330241,1.180936313791649,0.08435259384226065
48,경상남도,창원시의창구,명곡동,명곡동제1투,2808,1999,593,1227,135,21,1,1977,22,809,29.994941831057158,62.06373292867981,6.828528072837632,1.062215477996965,0.05058168942842691
49,경상남도,창원시의창구,명곡동,명곡동제2투,2826,2037,659,1192,137,30,2,2020,17,789,32.62376237623762,59.009900990099005,6.782178217821783,1.4851485148514851,0.09900990099009901
50,경상남도,창원시의창구,명곡동,명곡동제3투,2456,1851,615,1048,146,28,5,1842,9,605,33.387622149837135,56.89467969598263,7.926167209554831,1.520086862106406,0.2714440825190011
51,경상남도,창원시의창구,명곡동,명곡동제4투,1970,1259,381,757,93,19,2,1252,7,711,30.431309904153352,60.4632587859425,7.4281150159744405,1.5175718849840254,0.1597444089456869
52,경상남도,창원시의창구,명곡동,명곡동제5투,2839,2293,627,1416,213,24,1,2281,12,546,27.48794388426129,62.07803594914512,9.33800964489259,1.052170100832968,0.04384042086804033
53,경상남도,창원시의창구,명곡동,명곡동제6투,1984,1366,391,866,89,9,1,1356,10,618,28.83480825958702,63.86430678466076,6.563421828908554,0.6637168141592921,0.07374631268436578
54,경상남도,창원시의창구,명곡동,명곡동제7투,2309,1622,380,1101,113,10,4,1608,14,687,23.6318407960199,68.47014925373134,7.027363184079602,0.6218905472636816,0.24875621890547264
55,경상남도,창원시의창구,명곡동,명곡동제8투,2139,1446,369,940,104,18,1,1432,14,693,25.768156424581008,65.64245810055866,7.262569832402235,1.2569832402234637,0.06983240223463687
56,경상남도,창원시의창구,명곡동,명곡동제9투,2150,1459,417,938,86,10,1,1452,7,691,28.719008264462808,64.60055096418733,5.922865013774105,0.6887052341597797,0.06887052341597796
57,경상남도,창원시의창구,명곡동,명곡동제10투,1750,1237,361,772,75,15,2,1225,12,513,29.46938775510204,63.02040816326531,6.122448979591836,1.2244897959183674,0.163265306122449
58,경상남도,창원시의창구,명곡동,명곡동제11투,1695,1132,284,747,78,14,0,1123,9,563,25.289403383793413,66.51825467497774,6.945681211041853,1.2466607301869992,0.0
59,경상남도,창원시의창구,봉림동,관내사전투표,4557,4557,2411,1709,344,54,3,4521,36,0,53.32890953328909,37.80137137801371,7.6089360760893605,1.1944260119442602,0.06635700066357
60,경상남도,창원시의창구,봉림동,봉림동제1투,2724,1823,496,1184,115,13,2,1810,13,901,27.40331491712707,65.41436464088399,6.353591160220995,0.7182320441988951,0.11049723756906078
61,경상남도,창원시의창구,봉림동,봉림동제2투,2419,1693,486,1060,120,15,1,1682,11,726,28.894173602853744,63.020214030915575,7.13436385255648,0.89179548156956,0.05945303210463733
62,경상남도,창원시의창구,봉림동,봉림동제3투,2209,1448,388,928,108,14,2,1440,8,761,26.944444444444443,64.44444444444444,7.5,0.9722222222222222,0.1388888888888889
63,경상남도,창원시의창구,봉림동,봉림동제4투,2159,1451,441,871,111,16,1,1440,11,708,30.625000000000004,60.48611111111111,7.708333333333334,1.1111111111111112,0.06944444444444445
64,경상남도,창원시의창구,봉림동,봉림동제5투,3100,2089,633,1260,160,15,5,2073,16,1011,30.535455861070908,60.781476121562946,7.718282682103232,0.723589001447178,0.241196333815726
65,경상남도,창원시의창구,봉림동,봉림동제6투,3939,2671,680,1663,290,18,1,2652,19,1268,25.64102564102564,62.70739064856712,10.935143288084465,0.6787330316742082,0.037707390648567124
66,경상남도,창원시의창구,봉림동,봉림동제7투,2584,1758,475,1101,145,17,1,1739,19,826,27.314548591144334,63.3122484186314,8.338125359401955,0.9775733179988499,0.05750431282346176
67,경상남도,창원시의창구,잘못 투입·구분된 투표지,,0,1,0,1,0,0,0,1,0,-1,0.0,100.0,0.0,0.0,0.0
0,경상남도,창원시성산구,거소·선상투표,,412,400,108,203,70,5,2,388,12,12,27.835051546391753,52.31958762886598,18.04123711340206,1.2886597938144329,0.5154639175257731
1,경상남도,창원시성산구,관외사전투표,,16799,16797,7781,5796,2738,259,26,16600,197,2,46.873493975903614,34.91566265060241,16.49397590361446,1.5602409638554218,0.15662650602409636
2,경상남도,창원시성산구,재외투표,,896,712,413,183,98,14,0,708,4,184,58.333333333333336,25.847457627118644,13.841807909604519,1.977401129943503,0.0
3,경상남도,창원시성산구,반송동,관내사전투표,6831,6831,3959,2178,537,108,6,6788,43,0,58.32351208014143,32.08603417796111,7.91101944608132,1.5910430170889804,0.0883912787271656
4,경상남도,창원시성산구,반송동,반송동제1투,1872,1533,462,931,115,18,2,1528,5,339,30.23560209424084,60.92931937172775,7.526178010471204,1.1780104712041886,0.13089005235602094
5,경상남도,창원시성산구,반송동,반송동제2투,2049,1621,494,925,152,32,1,1604,17,428,30.798004987531176,57.66832917705735,9.476309226932669,1.99501246882793,0.062344139650872814
6,경상남도,창원시성산구,반송동,반송동제3투,1904,1528,521,808,164,24,1,1518,10,376,34.32147562582345,53.22793148880105,10.80368906455863,1.5810276679841897,0.06587615283267458
7,경상남도,창원시성산구,반송동,반송동제4투,1971,1595,563,862,133,28,2,1588,7,376,35.45340050377834,54.28211586901763,8.375314861460957,1.7632241813602016,0.12594458438287154
8,경상남도,창원시성산구,반송동,반송동제5투,1759,1386,435,811,116,14,0,1376,10,373,31.613372093023255,58.93895348837209,8.430232558139535,1.0174418604651163,0.0
9,경상남도,창원시성산구,반송동,반송동제6투,1944,1549,504,877,141,20,1,1543,6,395,32.66364225534672,56.83732987686325,9.138042773817238,1.2961762799740766,0.06480881399870382
10,경상남도,창원시성산구,반송동,반송동제7투,2159,1629,510,966,120,17,0,1613,16,530,31.61810291382517,59.88840669559826,7.439553626782393,1.0539367637941723,0.0
11,경상남도,창원시성산구,반송동,반송동제8투,2177,1575,432,1013,100,20,2,1567,8,602,27.568602425015953,64.64582003828973,6.381620931716656,1.2763241863433312,0.12763241863433314
12,경상남도,창원시성산구,반송동,반송동제9투,2130,1550,478,927,110,23,1,1539,11,580,31.059129304743337,60.23391812865497,7.147498375568551,1.4944769330734242,0.0649772579597141
13,경상남도,창원시성산구,반송동,반송동제10투,2102,1538,501,882,117,21,3,1524,14,564,32.874015748031496,57.874015748031496,7.677165354330709,1.3779527559055118,0.19685039370078738
14,경상남도,창원시성산구,반송동,반송동제11투,2470,2070,721,1164,139,32,1,2057,13,400,35.05104521147302,56.5872630043753,6.757413709285368,1.5556635877491491,0.04861448711716091
15,경상남도,창원시성산구,중앙동,관내사전투표,5445,5445,3001,1669,651,86,1,5408,37,0,55.491863905325445,30.861686390532544,12.037721893491124,1.5902366863905326,0.01849112426035503
16,경상남도,창원시성산구,중앙동,중앙동제1투,2283,1314,329,831,132,9,2,1303,11,969,25.249424405218722,63.77590176515733,10.130468150422104,0.6907137375287797,0.15349194167306215
17,경상남도,창원시성산구,중앙동,중앙동제2투,3322,1831,425,1146,226,16,0,1813,18,1491,23.44180915609487,63.21014892443464,12.465526751241036,0.882515168229454,0.0
18,경상남도,창원시성산구,중앙동,중앙동제3투,1840,1206,306,765,110,15,2,1198,8,634,25.542570951585976,63.856427378964945,9.181969949916526,1.2520868113522539,0.1669449081803005
19,경상남도,창원시성산구,중앙동,중앙동제4투,2926,1777,484,1040,222,15,1,1762,15,1149,27.468785471055618,59.02383654937571,12.599318955732123,0.851305334846765,0.056753688989784334
20,경상남도,창원시성산구,중앙동,중앙동제5투,1845,1271,424,704,117,19,1,1265,6,574,33.51778656126482,55.65217391304348,9.24901185770751,1.5019762845849802,0.07905138339920949
21,경상남도,창원시성산구,중앙동,중앙동제6투,2850,2259,841,1149,211,34,1,2236,23,591,37.61180679785331,51.38640429338104,9.436493738819319,1.520572450805009,0.044722719141323794
22,경상남도,창원시성산구,중앙동,중앙동제7투,3298,2689,993,1363,261,47,0,2664,25,609,37.27477477477478,51.16366366366366,9.797297297297296,1.7642642642642643,0.0
23,경상남도,창원시성산구,중앙동,중앙동제8투,2163,1693,611,925,117,26,4,1683,10,470,36.30421865715983,54.96137849079026,6.951871657754011,1.5448603683897801,0.23767082590612004
24,경상남도,창원시성산구,중앙동,중앙동제9투,1828,1493,378,968,121,17,2,1486,7,335,25.437415881561236,65.1413189771198,8.142664872139974,1.1440107671601614,0.13458950201884254
25,경상남도,창원시성산구,중앙동,중앙동제10투,2236,1832,669,886,231,29,1,1816,16,404,36.83920704845815,48.78854625550661,12.720264317180616,1.5969162995594712,0.05506607929515419
26,경상남도,창원시성산구,용지동,관내사전투표,4474,4474,2474,1361,504,81,3,4423,51,0,55.934885824101286,30.770969929911825,11.394980782274475,1.8313361971512547,0.06782726656115759
27,경상남도,창원시성산구,용지동,용지동제1투,3482,2677,827,1518,279,31,0,2655,22,805,31.148775894538606,57.175141242937855,10.508474576271185,1.167608286252354,0.0
28,경상남도,창원시성산구,용지동,용지동제2투,2376,1682,409,1068,170,14,1,1662,20,694,24.60890493381468,64.25992779783394,10.22864019253911,0.842358604091456,0.060168471720818295
29,경상남도,창원시성산구,용지동,용지동제3투,2515,1832,567,1063,143,37,2,1812,20,683,31.29139072847682,58.66445916114791,7.891832229580574,2.041942604856512,0.11037527593818984
30,경상남도,창원시성산구,용지동,용지동제4투,2103,1462,441,888,109,15,3,1456,6,641,30.288461538461537,60.98901098901099,7.486263736263736,1.0302197802197801,0.20604395604395606
31,경상남도,창원시성산구,용지동,용지동제5투,3158,2173,637,1313,174,29,3,2156,17,985,29.545454545454547,60.89981447124304,8.070500927643785,1.3450834879406308,0.13914656771799627
32,경상남도,창원시성산구,용지동,용지동제6투,2501,1940,577,1154,166,31,1,1929,11,561,29.91187143597719,59.82374287195438,8.605495075168482,1.607050285121825,0.05184033177812338
33,경상남도,창원시성산구,상남동,관내사전투표,6434,6434,3716,1971,606,89,6,6388,46,0,58.17157169693174,30.85472761427677,9.486537257357545,1.393237319974953,0.09392611145898559
34,경상남도,창원시성산구,상남동,상남동제1투,2374,1732,579,924,186,29,3,1721,11,642,33.6432306798373,53.6897152818129,10.807669959325974,1.68506682161534,0.17431725740848344
35,경상남도,창원시성산구,상남동,상남동제2투,1873,1315,411,746,121,20,2,1300,15,558,31.615384615384617,57.38461538461539,9.307692307692307,1.5384615384615385,0.15384615384615385
36,경상남도,창원시성산구,상남동,상남동제3투,2381,1852,598,1063,145,38,1,1845,7,529,32.41192411924119,57.61517615176152,7.8590785907859075,2.059620596205962,0.05420054200542006
37,경상남도,창원시성산구,상남동,상남동제4투,2448,1821,556,1083,147,25,0,1811,10,627,30.701270016565434,59.80121479845389,8.117062396466041,1.3804527885146327,0.0
38,경상남도,창원시성산구,상남동,상남동제5투,2985,2247,793,1204,198,42,1,2238,9,738,35.43342269883824,53.798033958891864,8.847184986595174,1.876675603217158,0.044682752457551385
39,경상남도,창원시성산구,상남동,상남동제6투,2868,1909,508,1216,145,32,2,1903,6,959,26.694692590646348,63.899106673673145,7.619548081975827,1.6815554387808722,0.10509721492380451
40,경상남도,창원시성산구,사파동,관내사전투표,8048,8046,4757,2441,651,125,11,7985,61,2,59.574201628052606,30.569818409517847,8.15278647463995,1.5654351909830932,0.1377582968065122
41,경상남도,창원시성산구,사파동,사파동제1투,3214,2264,763,1248,196,34,3,2244,20,950,34.001782531194294,55.61497326203209,8.73440285204991,1.5151515151515151,0.1336898395721925
42,경상남도,창원시성산구,사파동,사파동제2투,2264,1634,472,996,131,17,0,1616,18,630,29.207920792079207,61.633663366336634,8.106435643564357,1.051980198019802,0.0
43,경상남도,창원시성산구,사파동,사파동제3투,1548,1178,432,604,114,22,0,1172,6,370,36.86006825938566,51.5358361774744,9.726962457337883,1.877133105802048,0.0
44,경상남도,창원시성산구,사파동,사파동제4투,2574,1929,663,1055,152,41,3,1914,15,645,34.639498432601876,55.12016718913271,7.941483803552769,2.1421107628004177,0.1567398119122257
45,경상남도,창원시성산구,사파동,사파동제5투,2695,1972,642,1128,155,38,2,1965,7,723,32.671755725190835,57.404580152671755,7.888040712468193,1.9338422391857506,0.10178117048346055
46,경상남도,창원시성산구,사파동,사파동제6투,2160,1719,601,926,140,34,3,1704,15,441,35.26995305164319,54.34272300469484,8.215962441314554,1.9953051643192488,0.17605633802816903
47,경상남도,창원시성산구,사파동,사파동제7투,2736,1864,534,1089,186,36,3,1848,16,872,28.8961038961039,58.92857142857143,10.064935064935066,1.948051948051948,0.16233766233766234
48,경상남도,창원시성산구,사파동,사파동제8투,2253,1642,524,922,139,42,1,1628,14,611,32.186732186732186,56.63390663390664,8.538083538083537,2.5798525798525795,0.06142506142506143
49,경상남도,창원시성산구,사파동,사파동제9투,2541,1915,717,991,147,42,3,1900,15,626,37.73684210526316,52.1578947368421,7.7368421052631575,2.2105263157894735,0.15789473684210525
50,경상남도,창원시성산구,사파동,사파동제10투,2162,1728,725,833,126,35,0,1719,9,434,42.175683536940085,48.45840605002908,7.329842931937172,2.036067481093659,0.0
51,경상남도,창원시성산구,사파동,사파동제11투,2718,2149,890,974,221,46,7,2138,11,569,41.62768942937324,45.55659494855004,10.336763330215154,2.1515434985968196,0.32740879326473343
52,경상남도,창원시성산구,가음정동,관내사전투표,6671,6671,4115,1858,551,98,0,6622,49,0,62.14134702506795,28.057988523104804,8.320749018423438,1.4799154334038054,0.0
53,경상남도,창원시성산구,가음정동,가음정동제1투,1844,1362,476,683,176,12,3,1350,12,482,35.25925925925926,50.59259259259259,13.037037037037036,0.8888888888888888,0.2222222222222222
54,경상남도,창원시성산구,가음정동,가음정동제2투,2689,2241,891,1020,276,39,2,2228,13,448,39.99102333931777,45.78096947935368,12.387791741472173,1.7504488330341115,0.08976660682226212
55,경상남도,창원시성산구,가음정동,가음정동제3투,2690,2132,747,1126,195,42,5,2115,17,558,35.319148936170215,53.2387706855792,9.219858156028367,1.9858156028368796,0.2364066193853428
56,경상남도,창원시성산구,가음정동,가음정동제4투,1084,794,247,466,62,17,0,792,2,290,31.186868686868685,58.838383838383834,7.828282828282829,2.146464646464646,0.0
57,경상남도,창원시성산구,가음정동,가음정동제5투,2948,2348,898,1234,165,32,4,2333,15,600,38.49121303043292,52.8932704672096,7.072438919845691,1.3716245177882553,0.17145306472353192
58,경상남도,창원시성산구,가음정동,가음정동제6투,2619,2113,762,1130,168,34,7,2101,12,506,36.26844359828653,53.783912422655874,7.996192289386006,1.618277010947168,0.333174678724417
59,경상남도,창원시성산구,가음정동,가음정동제7투,2357,1877,654,1030,144,32,2,1862,15,480,35.12352309344791,55.316863587540276,7.733619763694952,1.7185821697099892,0.10741138560687433
60,경상남도,창원시성산구,가음정동,가음정동제8투,1793,1217,373,719,98,17,2,1209,8,576,30.851943755169565,59.470636889991724,8.105872622001655,1.4061207609594708,0.1654259718775848
61,경상남도,창원시성산구,가음정동,가음정동제9투,1819,1327,517,635,133,25,2,1312,15,492,39.40548780487805,48.39939024390244,10.13719512195122,1.9054878048780488,0.1524390243902439
62,경상남도,창원시성산구,가음정동,가음정동제10투,2665,2041,703,1122,154,41,2,2022,19,624,34.767556874381796,55.48961424332344,7.6162215628091,2.0276953511374876,0.09891196834817012
63,경상남도,창원시성산구,성주동,관내사전투표,3878,3878,2366,1072,341,69,8,3856,22,0,61.358921161825734,27.800829875518673,8.843360995850622,1.7894190871369293,0.2074688796680498
64,경상남도,창원시성산구,성주동,성주동제1투,2879,2234,670,1276,237,29,2,2214,20,645,30.26196928635953,57.63324299909666,10.70460704607046,1.3098464317976515,0.09033423667570009
65,경상남도,창원시성산구,성주동,성주동제2투,1986,1356,505,680,138,18,0,1341,15,630,37.65846383296048,50.70842654735272,10.290827740492169,1.342281879194631,0.0
66,경상남도,창원시성산구,성주동,성주동제3투,2389,1710,678,861,135,24,3,1701,9,679,39.85890652557319,50.617283950617285,7.936507936507936,1.4109347442680775,0.1763668430335097
67,경상남도,창원시성산구,성주동,성주동제4투,3302,2577,980,1284,234,41,4,2543,34,725,38.537160833661034,50.491545418796704,9.201730239874164,1.6122689736531655,0.15729453401494298
68,경상남도,창원시성산구,성주동,성주동제5투,2598,2108,715,1142,206,32,2,2097,11,490,34.096328087744396,54.45875059608966,9.823557463042441,1.5259895088221267,0.09537434430138292
69,경상남도,창원시성산구,성주동,성주동제6투,2305,1854,624,1009,172,33,1,1839,15,451,33.931484502446985,54.866775421424684,9.352909189777053,1.794453507340946,0.0543773790103317
70,경상남도,창원시성산구,웅남동,관내사전투표,1755,1755,949,605,155,29,2,1740,15,0,54.54022988505747,34.770114942528735,8.908045977011495,1.6666666666666667,0.11494252873563218
71,경상남도,창원시성산구,웅남동,웅남동제1투,852,564,125,395,38,1,1,560,4,288,22.321428571428573,70.53571428571429,6.785714285714286,0.17857142857142858,0.17857142857142858
72,경상남도,창원시성산구,웅남동,웅남동제2투,1574,1164,377,659,99,19,4,1158,6,410,32.55613126079447,56.90846286701209,8.549222797927461,1.6407599309153715,0.3454231433506045
73,경상남도,창원시성산구,웅남동,웅남동제3투,1402,1019,286,650,59,9,0,1004,15,383,28.48605577689243,64.7410358565737,5.876494023904383,0.8964143426294822,0.0
74,경상남도,창원시성산구,웅남동,웅남동제4투,445,320,60,212,40,2,1,315,5,125,19.047619047619047,67.3015873015873,12.698412698412698,0.6349206349206349,0.31746031746031744
75,경상남도,창원시성산구,잘못 투입·구분된 투표지,,0,0,0,0,0,0,0,0,0,0,0.0,0.0,0.0,0.0,0.0
0,경상남도,창원시마산합포구,거소·선상투표,,433,416,143,190,56,6,7,402,14,17,35.57213930348259,47.2636815920398,13.930348258706468,1.4925373134328357,1.7412935323383085
1,경상남도,창원시마산합포구,관외사전투표,,11813,11811,5526,4496,1519,131,14,11686,125,2,47.28735238747219,38.47338695875406,12.998459695361971,1.1209994865651207,0.11980147184665411
2,경상남도,창원시마산합포구,재외투표,,822,525,312,149,53,6,0,520,5,297,60.0,28.653846153846153,10.192307692307692,1.153846153846154,0.0
3,경상남도,창원시마산합포구,구산면,관내사전투표,662,662,245,379,27,6,1,658,4,0,37.234042553191486,57.598784194528875,4.103343465045593,0.911854103343465,0.1519756838905775
4,경상남도,창원시마산합포구,구산면,구산면제1투,946,649,105,510,19,4,3,641,8,297,16.380655226209047,79.5631825273011,2.9641185647425896,0.62402496099844,0.46801872074883
5,경상남도,창원시마산합포구,구산면,구산면제2투,1692,1148,170,917,29,6,1,1123,25,544,15.138023152270705,81.65627782724845,2.5823686553873553,0.5342831700801425,0.08904719501335707
6,경상남도,창원시마산합포구,진동면,관내사전투표,2668,2668,1320,1168,137,17,1,2643,25,0,49.94324631101021,44.19220582671207,5.183503594400303,0.6432084752175559,0.037835792659856225
7,경상남도,창원시마산합포구,진동면,진동면제1투,704,524,90,405,15,7,1,518,6,180,17.374517374517374,78.18532818532819,2.8957528957528957,1.3513513513513513,0.19305019305019305
8,경상남도,창원시마산합포구,진동면,진동면제2투,2217,1502,352,1075,58,7,0,1492,10,715,23.59249329758713,72.05093833780161,3.8873994638069704,0.4691689008042895,0.0
9,경상남도,창원시마산합포구,진동면,진동면제3투,1399,898,159,700,31,2,0,892,6,501,17.825112107623315,78.47533632286996,3.4753363228699556,0.2242152466367713,0.0
10,경상남도,창원시마산합포구,진동면,진동면제4투,2304,1601,484,995,104,7,1,1591,10,703,30.421118793211814,62.53928346951603,6.536769327467002,0.43997485857950974,0.06285355122564425
11,경상남도,창원시마산합포구,진북면,관내사전투표,653,653,271,345,26,5,0,647,6,0,41.88562596599691,53.32302936630603,4.01854714064915,0.7727975270479135,0.0
12,경상남도,창원시마산합포구,진북면,진북면제1투,1477,953,141,773,22,6,1,943,10,524,14.952279957582185,81.97242841993638,2.332979851537646,0.6362672322375398,0.10604453870625664
13,경상남도,창원시마산합포구,진북면,진북면제2투,613,402,63,311,14,6,1,395,7,211,15.949367088607595,78.73417721518987,3.5443037974683547,1.5189873417721518,0.25316455696202533
14,경상남도,창원시마산합포구,진전면,관내사전투표,747,747,251,433,40,9,2,735,12,0,34.14965986394558,58.911564625850346,5.442176870748299,1.2244897959183674,0.27210884353741494
15,경상남도,창원시마산합포구,진전면,진전면제1투,1256,826,132,659,23,7,0,821,5,430,16.07795371498173,80.26796589524969,2.8014616321559074,0.8526187576126675,0.0
16,경상남도,창원시마산합포구,진전면,진전면제2투,1052,760,113,605,26,3,1,748,12,292,15.106951871657753,80.88235294117648,3.4759358288770055,0.4010695187165776,0.1336898395721925
17,경상남도,창원시마산합포구,현동,관내사전투표,3319,3319,1768,1284,214,30,3,3299,20,0,53.59199757502273,38.92088511670203,6.486814186117005,0.9093664746892999,0.09093664746892997
18,경상남도,창원시마산합포구,현동,현동제1투,2098,1552,517,917,94,10,2,1540,12,546,33.57142857142857,59.54545454545455,6.103896103896104,0.6493506493506493,0.12987012987012986
19,경상남도,창원시마산합포구,현동,현동제2투,2362,1608,377,1132,79,15,3,1606,2,754,23.474470734744706,70.4856787048568,4.919053549190536,0.933997509339975,0.18679950186799502
20,경상남도,창원시마산합포구,현동,현동제3투,2125,1586,601,822,135,18,1,1577,9,539,38.11033608116677,52.124286620164874,8.560558021559924,1.14140773620799,0.06341154090044387
21,경상남도,창원시마산합포구,가포동,관내사전투표,1468,1468,784,511,145,18,0,1458,10,0,53.77229080932785,35.0480109739369,9.945130315500686,1.2345679012345678,0.0
22,경상남도,창원시마산합포구,가포동,가포동투표소,2762,1840,504,1108,181,22,2,1817,23,922,27.73802971931756,60.97963676389653,9.96147495872317,1.2107870115575123,0.1100715465052284
23,경상남도,창원시마산합포구,월영동,관내사전투표,6847,6847,3440,2814,476,69,8,6807,40,0,50.53621272219774,41.33979726751873,6.9928015278389895,1.0136624063464081,0.11752607609813426
24,경상남도,창원시마산합포구,월영동,월영동제1투,1777,1062,200,749,92,13,2,1056,6,715,18.939393939393938,70.9280303030303,8.712121212121213,1.231060606060606,0.1893939393939394
25,경상남도,창원시마산합포구,월영동,월영동제2투,1471,975,219,703,38,9,3,972,3,496,22.530864197530864,72.32510288065843,3.909465020576132,0.9259259259259258,0.30864197530864196
26,경상남도,창원시마산합포구,월영동,월영동제3투,2478,1793,530,1094,146,17,0,1787,6,685,29.65864577504197,61.21992165640739,8.17011751538892,0.9513150531617236,0.0
27,경상남도,창원시마산합포구,월영동,월영동제4투,2326,1592,410,1073,92,9,2,1586,6,734,25.851197982345525,67.65447667087011,5.800756620428752,0.5674653215636822,0.12610340479192939
28,경상남도,창원시마산합포구,월영동,월영동제5투,1800,1373,337,940,75,9,0,1361,12,427,24.76120499632623,69.06686260102866,5.510653930933137,0.6612784717119765,0.0
29,경상남도,창원시마산합포구,월영동,월영동제6투,2393,1695,412,1136,113,20,4,1685,10,698,24.451038575667656,67.41839762611276,6.706231454005934,1.1869436201780417,0.2373887240356083
30,경상남도,창원시마산합포구,월영동,월영동제7투,3623,2554,698,1642,175,24,1,2540,14,1069,27.48031496062992,64.64566929133858,6.889763779527559,0.9448818897637795,0.03937007874015748
31,경상남도,창원시마산합포구,월영동,월영동제8투,3278,2689,1055,1337,253,23,1,2669,20,589,39.52791307605845,50.09366804046459,9.47920569501686,0.8617459722742601,0.03746721618583739
32,경상남도,창원시마산합포구,월영동,월영동제9투,3000,2361,915,1218,191,20,0,2344,17,639,39.0358361774744,51.96245733788396,8.148464163822526,0.8532423208191127,0.0
33,경상남도,창원시마산합포구,문화동,관내사전투표,3252,3252,1434,1496,263,21,6,3220,32,0,44.534161490683225,46.45962732919255,8.167701863354038,0.6521739130434783,0.18633540372670807
34,경상남도,창원시마산합포구,문화동,문화동제1투,2199,1401,263,1019,97,8,2,1389,12,798,18.934485241180706,73.36213102951764,6.983441324694025,0.5759539236861051,0.14398848092152627
35,경상남도,창원시마산합포구,문화동,문화동제2투,1749,1140,242,816,68,7,0,1133,7,609,21.35922330097087,72.02118270079436,6.001765225066196,0.617828773168579,0.0
36,경상남도,창원시마산합포구,문화동,문화동제3투,2616,1737,381,1226,100,18,0,1725,12,879,22.086956521739133,71.07246376811595,5.797101449275362,1.0434782608695654,0.0
37,경상남도,창원시마산합포구,반월중앙동,관내사전투표,2455,2455,1143,1138,131,22,4,2438,17,0,46.882690730106646,46.67760459392945,5.373256767842493,0.9023789991796556,0.16406890894175555
38,경상남도,창원시마산합포구,반월중앙동,반월중앙동제1투,2729,1965,484,1333,110,21,1,1949,16,764,24.83324781939456,68.39404822986147,5.643919958953309,1.07747562852745,0.0513083632632119
39,경상남도,창원시마산합포구,반월중앙동,반월중앙동제2투,844,511,84,395,23,8,0,510,1,333,16.470588235294116,77.45098039215686,4.509803921568627,1.5686274509803921,0.0
40,경상남도,창원시마산합포구,반월중앙동,반월중앙동제3투,2089,1481,330,1046,68,19,4,1467,14,608,22.494887525562373,71.30197682344922,4.635310156782549,1.2951601908657124,0.27266530334015
41,경상남도,창원시마산합포구,반월중앙동,반월중앙동제4투,2552,1957,480,1360,94,14,2,1950,7,595,24.615384615384617,69.74358974358974,4.82051282051282,0.717948717948718,0.10256410256410256
42,경상남도,창원시마산합포구,완월동,관내사전투표,2468,2468,1133,1114,170,25,3,2445,23,0,46.33946830265849,45.56237218813906,6.952965235173824,1.0224948875255624,0.1226993865030675
43,경상남도,창원시마산합포구,완월동,완월동제1투,1145,736,143,539,41,4,0,727,9,409,19.669876203576344,74.14030261348006,5.639614855570839,0.5502063273727648,0.0
44,경상남도,창원시마산합포구,완월동,완월동제2투,1859,1287,243,951,76,11,0,1281,6,572,18.969555035128806,74.23887587822014,5.932864949258392,0.858704137392662,0.0
45,경상남도,창원시마산합포구,완월동,완월동제3투,2330,1591,386,1086,87,17,2,1578,13,739,24.461343472750315,68.8212927756654,5.513307984790875,1.0773130544993663,0.12674271229404308
46,경상남도,창원시마산합포구,자산동,관내사전투표,1934,1934,816,988,102,14,4,1924,10,0,42.41164241164241,51.35135135135135,5.301455301455301,0.7276507276507277,0.2079002079002079
47,경상남도,창원시마산합포구,자산동,자산동제1투,2737,1855,341,1403,91,9,0,1844,11,882,18.492407809110627,76.08459869848157,4.934924078091106,0.4880694143167028,0.0
48,경상남도,창원시마산합포구,자산동,자산동제2투,2756,1764,356,1292,84,14,2,1748,16,992,20.36613272311213,73.91304347826086,4.805491990846682,0.8009153318077803,0.11441647597254005
49,경상남도,창원시마산합포구,오동동,관내사전투표,2833,2833,1109,1536,148,18,6,2817,16,0,39.36812211572595,54.526091586794465,5.2538161164359245,0.6389776357827476,0.21299254526091588
50,경상남도,창원시마산합포구,오동동,오동동제1투,2621,1519,254,1156,89,6,1,1506,13,1102,16.865869853917662,76.75962815405046,5.909694555112882,0.398406374501992,0.06640106241699867
51,경상남도,창원시마산합포구,오동동,오동동제2투,2074,1506,352,1056,73,13,2,1496,10,568,23.52941176470588,70.58823529411765,4.879679144385027,0.8689839572192514,0.1336898395721925
52,경상남도,창원시마산합포구,오동동,오동동제3투,1689,1338,303,935,81,10,1,1330,8,351,22.781954887218046,70.30075187969925,6.090225563909774,0.7518796992481203,0.07518796992481204
53,경상남도,창원시마산합포구,오동동,오동동제4투,1879,1237,259,912,47,6,1,1225,12,642,21.142857142857142,74.44897959183675,3.8367346938775513,0.4897959183673469,0.0816326530612245
54,경상남도,창원시마산합포구,오동동,오동동제5투,2437,1548,414,990,117,11,1,1533,15,889,27.00587084148728,64.57925636007828,7.632093933463796,0.7175472928897586,0.06523157208088715
55,경상남도,창원시마산합포구,오동동,오동동제6투,1328,795,156,595,37,2,0,790,5,533,19.746835443037973,75.31645569620254,4.6835443037974684,0.25316455696202533,0.0
56,경상남도,창원시마산합포구,교방동,관내사전투표,3017,3016,1474,1267,226,30,2,2999,17,1,49.149716572190734,42.247415805268425,7.5358452817605865,1.0003334444814937,0.06668889629876625
57,경상남도,창원시마산합포구,교방동,교방동제1투,3684,2622,597,1801,168,32,4,2602,20,1062,22.943889315910837,69.21598770176787,6.456571867794005,1.2298232129131437,0.15372790161414296
58,경상남도,창원시마산합포구,교방동,교방동제2투,2601,1957,581,1174,166,21,3,1945,12,644,29.871465295629818,60.3598971722365,8.534704370179949,1.0796915167095116,0.15424164524421594
59,경상남도,창원시마산합포구,교방동,교방동제3투,2689,2091,585,1330,138,21,0,2074,17,598,28.206364513018322,64.12729026036644,6.653809064609451,1.0125361620057858,0.0
60,경상남도,창원시마산합포구,교방동,교방동제4투,1950,1265,237,953,52,9,2,1253,12,685,18.9146049481245,76.05746209098164,4.150039904229849,0.7182761372705506,0.1596169193934557
61,경상남도,창원시마산합포구,합포동,관내사전투표,1902,1901,867,893,109,21,2,1892,9,1,45.82452431289641,47.19873150105708,5.761099365750528,1.1099365750528543,0.10570824524312897
62,경상남도,창원시마산합포구,합포동,합포동제1투,2768,1882,482,1242,129,15,2,1870,12,886,25.775401069518715,66.41711229946524,6.898395721925134,0.8021390374331552,0.10695187165775401
63,경상남도,창원시마산합포구,합포동,합포동제2투,1242,729,124,569,26,7,0,726,3,513,17.079889807162534,78.37465564738292,3.581267217630854,0.9641873278236914,0.0
64,경상남도,창원시마산합포구,산호동,관내사전투표,2150,2150,939,1020,148,18,3,2128,22,0,44.12593984962406,47.93233082706767,6.954887218045112,0.8458646616541353,0.14097744360902253
65,경상남도,창원시마산합포구,산호동,산호동제1투,1891,1350,325,939,47,24,5,1340,10,541,24.253731343283583,70.07462686567165,3.5074626865671643,1.791044776119403,0.3731343283582089
66,경상남도,창원시마산합포구,산호동,산호동제2투,1604,1055,255,717,60,9,0,1041,14,549,24.495677233429394,68.87608069164266,5.763688760806916,0.8645533141210375,0.0
67,경상남도,창원시마산합포구,산호동,산호동제3투,2169,1501,363,1025,84,13,2,1487,14,668,24.41156691324815,68.93073301950236,5.648957632817754,0.8742434431741762,0.13449899125756556
68,경상남도,창원시마산합포구,산호동,산호동제4투,1691,1043,218,751,57,8,1,1035,8,648,21.06280193236715,72.56038647342994,5.507246376811594,0.7729468599033816,0.0966183574879227
69,경상남도,창원시마산합포구,잘못 투입·구분된 투표지,,0,0,0,0,0,0,0,0,0,0,0.0,0.0,0.0,0.0,0.0
0,경상남도,창원시마산회원구,거소·선상투표,,380,352,95,156,72,3,5,331,21,28,28.700906344410875,47.129909365558916,21.75226586102719,0.906344410876133,1.5105740181268883
1,경상남도,창원시마산회원구,관외사전투표,,13369,13368,6174,5081,1792,147,31,13225,143,1,46.68431001890359,38.41965973534972,13.55009451795841,1.111531190926276,0.23440453686200377
2,경상남도,창원시마산회원구,재외투표,,533,417,277,94,40,4,0,415,2,116,66.74698795180723,22.650602409638555,9.63855421686747,0.9638554216867471,0.0
3,경상남도,창원시마산회원구,내서읍,관내사전투표,6955,6955,3940,2440,481,51,7,6919,36,0,56.9446451799393,35.26521173579997,6.951871657754011,0.7371007371007371,0.10117068940598353
4,경상남도,창원시마산회원구,내서읍,내서읍제1투,369,291,54,227,7,2,0,290,1,78,18.620689655172416,78.27586206896552,2.413793103448276,0.6896551724137931,0.0
5,경상남도,창원시마산회원구,내서읍,내서읍제2투,3341,2582,847,1480,203,33,3,2566,16,759,33.008573655494935,57.67731878409976,7.9111457521434145,1.2860483242400622,0.11691348402182386
6,경상남도,창원시마산회원구,내서읍,내서읍제3투,1978,1452,443,862,113,14,6,1438,14,526,30.806675938803895,59.944367176634216,7.858136300417246,0.9735744089012517,0.4172461752433936
7,경상남도,창원시마산회원구,내서읍,내서읍제4투,2916,2423,893,1320,170,30,1,2414,9,493,36.99254349627174,54.681027340513666,7.042253521126761,1.2427506213753108,0.041425020712510356
8,경상남도,창원시마산회원구,내서읍,내서읍제5투,2730,1995,584,1238,126,24,5,1977,18,735,29.53970662620132,62.62013151239252,6.373292867981791,1.2139605462822458,0.25290844714213456
9,경상남도,창원시마산회원구,내서읍,내서읍제6투,2058,1568,439,1027,74,16,0,1556,12,490,28.213367609254497,66.00257069408741,4.755784061696658,1.0282776349614395,0.0
10,경상남도,창원시마산회원구,내서읍,내서읍제7투,2591,1757,405,1234,102,6,0,1747,10,834,23.18259874069834,70.63537492844877,5.838580423583286,0.34344590726960506,0.0
11,경상남도,창원시마산회원구,내서읍,내서읍제8투,2539,1804,529,1129,106,27,1,1792,12,735,29.520089285714285,63.00223214285714,5.915178571428571,1.5066964285714286,0.055803571428571425
12,경상남도,창원시마산회원구,내서읍,내서읍제9투,1942,1334,345,893,64,11,2,1315,19,608,26.23574144486692,67.90874524714829,4.866920152091255,0.8365019011406843,0.1520912547528517
13,경상남도,창원시마산회원구,내서읍,내서읍제10투,3763,2771,953,1569,188,36,3,2749,22,992,34.66715169152419,57.07530010913059,6.838850491087668,1.30956711531466,0.10913059294288831
14,경상남도,창원시마산회원구,내서읍,내서읍제11투,2466,1835,674,989,127,32,4,1826,9,631,36.91128148959474,54.16210295728368,6.955093099671412,1.7524644030668126,0.21905805038335158
15,경상남도,창원시마산회원구,내서읍,내서읍제12투,3305,2515,865,1411,182,27,4,2489,26,790,34.752912816392126,56.68943350743271,7.312173563680193,1.0847730012053034,0.16070711128967458
16,경상남도,창원시마산회원구,내서읍,내서읍제13투,3412,2627,944,1437,185,41,4,2611,16,785,36.15472998851015,55.03638452700115,7.085407889697434,1.5702795863653771,0.15319800842589046
17,경상남도,창원시마산회원구,내서읍,내서읍제14투,3226,2476,1040,1210,179,25,3,2457,19,750,42.32804232804233,49.24704924704925,7.285307285307285,1.0175010175010175,0.1221001221001221
18,경상남도,창원시마산회원구,내서읍,내서읍제15투,632,484,101,353,24,3,0,481,3,148,20.997920997921,73.38877338877339,4.98960498960499,0.6237006237006237,0.0
19,경상남도,창원시마산회원구,회원1동,관내사전투표,2020,2020,819,1087,86,13,2,2007,13,0,40.80717488789238,54.1604384653712,4.285002491280518,0.6477329347284505,0.0996512207274539
20,경상남도,창원시마산회원구,회원1동,회원1동제1투,2260,1637,293,1260,64,10,2,1629,8,623,17.986494782074892,77.34806629834254,3.9287906691221606,0.6138735420503376,0.12277470841006752
21,경상남도,창원시마산회원구,회원1동,회원1동제2투,2209,1436,268,1082,63,10,3,1426,10,773,18.79382889200561,75.8765778401122,4.417952314165498,0.7012622720897616,0.21037868162692847
22,경상남도,창원시마산회원구,회원1동,회원1동제3투,1671,1072,219,771,61,11,2,1064,8,599,20.582706766917294,72.4624060150376,5.733082706766917,1.0338345864661653,0.18796992481203006
23,경상남도,창원시마산회원구,회원2동,관내사전투표,1764,1764,803,835,101,9,2,1750,14,0,45.885714285714286,47.714285714285715,5.771428571428571,0.5142857142857142,0.1142857142857143
24,경상남도,창원시마산회원구,회원2동,회원2동제1투,1773,1191,260,851,54,12,2,1179,12,582,22.05258693808312,72.17981340118745,4.580152671755725,1.0178117048346056,0.16963528413910092
25,경상남도,창원시마산회원구,회원2동,회원2동제2투,2475,1810,506,1115,148,15,3,1787,23,665,28.315612758813653,62.395075545607156,8.282036933407946,0.8393956351426972,0.16787912702853947
26,경상남도,창원시마산회원구,회원2동,회원2동제3투,1544,1022,193,776,45,3,1,1018,4,522,18.958742632612964,76.2278978388998,4.4204322200392925,0.29469548133595286,0.09823182711198428
27,경상남도,창원시마산회원구,석전동,관내사전투표,2996,2996,1389,1373,180,27,6,2975,21,0,46.689075630252105,46.15126050420168,6.050420168067227,0.9075630252100839,0.20168067226890757
28,경상남도,창원시마산회원구,석전동,석전동제1투,943,682,173,455,36,12,3,679,3,261,25.47864506627393,67.0103092783505,5.3019145802650955,1.7673048600883652,0.4418262150220913
29,경상남도,창원시마산회원구,석전동,석전동제2투,2955,2375,714,1411,195,29,3,2352,23,580,30.357142857142854,59.99149659863946,8.290816326530612,1.2329931972789114,0.12755102040816327
30,경상남도,창원시마산회원구,석전동,석전동제3투,1343,954,224,663,46,10,4,947,7,389,23.65364308342133,70.01055966209081,4.857444561774024,1.0559662090813093,0.42238648363252373
31,경상남도,창원시마산회원구,석전동,석전동제4투,1072,754,159,552,26,7,0,744,10,318,21.370967741935484,74.19354838709677,3.494623655913978,0.9408602150537635,0.0
32,경상남도,창원시마산회원구,석전동,석전동제5투,1224,798,127,612,42,11,0,792,6,426,16.035353535353536,77.27272727272727,5.303030303030303,1.3888888888888888,0.0
33,경상남도,창원시마산회원구,석전동,석전동제6투,2368,1556,349,1102,81,12,3,1547,9,812,22.559793148028444,71.23464770523594,5.235940530058177,0.7756948933419522,0.19392372333548805
34,경상남도,창원시마산회원구,회성동,관내사전투표,1371,1371,559,727,70,5,3,1364,7,0,40.98240469208211,53.2991202346041,5.131964809384164,0.36656891495601174,0.21994134897360706
35,경상남도,창원시마산회원구,회성동,회성동제1투,1587,1066,213,797,44,1,3,1058,8,521,20.13232514177694,75.33081285444234,4.158790170132325,0.0945179584120983,0.28355387523629494
36,경상남도,창원시마산회원구,회성동,회성동제2투,1271,842,153,625,47,8,0,833,9,429,18.367346938775512,75.03001200480192,5.642256902761105,0.9603841536614646,0.0
37,경상남도,창원시마산회원구,회성동,회성동제3투,425,290,59,221,7,3,0,290,0,135,20.344827586206897,76.20689655172413,2.413793103448276,1.0344827586206897,0.0
38,경상남도,창원시마산회원구,양덕1동,관내사전투표,2145,2145,932,1053,131,13,1,2130,15,0,43.75586854460094,49.436619718309856,6.150234741784037,0.6103286384976526,0.046948356807511735
39,경상남도,창원시마산회원구,양덕1동,양덕1동제1투,3364,2262,509,1587,127,17,2,2242,20,1102,22.702943800178414,70.7850133809099,5.664585191793042,0.7582515611061552,0.08920606601248886
40,경상남도,창원시마산회원구,양덕1동,양덕1동제2투,2903,1815,381,1338,80,8,2,1809,6,1088,21.06135986733002,73.96351575456053,4.422332780541736,0.44223327805417356,0.11055831951354339
41,경상남도,창원시마산회원구,양덕2동,관내사전투표,4778,4778,2472,1881,337,49,5,4744,34,0,52.1079258010118,39.65008431703204,7.103709949409781,1.0328836424957841,0.10539629005059022
42,경상남도,창원시마산회원구,양덕2동,양덕2동제1투,2970,2272,714,1340,180,22,3,2259,13,698,31.606905710491368,59.31828242585214,7.968127490039841,0.9738822487826472,0.13280212483399734
43,경상남도,창원시마산회원구,양덕2동,양덕2동제2투,2449,1878,521,1200,125,22,3,1871,7,571,27.846071619454836,64.13682522715125,6.680919294494922,1.1758417958311065,0.16034206306787815
44,경상남도,창원시마산회원구,양덕2동,양덕2동제3투,1871,1314,283,945,67,9,1,1305,9,557,21.685823754789272,72.41379310344827,5.134099616858237,0.6896551724137931,0.07662835249042146
45,경상남도,창원시마산회원구,양덕2동,양덕2동제4투,2834,2269,774,1234,202,36,5,2251,18,565,34.384717903154154,54.82007996446024,8.973789426921368,1.5992892047978675,0.2221235006663705
46,경상남도,창원시마산회원구,양덕2동,양덕2동제5투,3242,2316,700,1354,216,26,2,2298,18,926,30.461270670147954,58.920800696257615,9.39947780678851,1.1314186248912097,0.08703220191470844
47,경상남도,창원시마산회원구,양덕2동,양덕2동제6투,3366,2733,639,1868,192,18,0,2717,16,633,23.518586676481412,68.7523003312477,7.066617592933383,0.6624953993375046,0.0
48,경상남도,창원시마산회원구,양덕2동,양덕2동제7투,3048,2486,767,1501,183,21,3,2475,11,562,30.98989898989899,60.64646464646465,7.3939393939393945,0.8484848484848486,0.12121212121212122
49,경상남도,창원시마산회원구,합성1동,관내사전투표,2241,2241,1054,994,147,21,3,2219,22,0,47.49887336638125,44.79495268138801,6.624605678233439,0.9463722397476341,0.135196034249662
50,경상남도,창원시마산회원구,합성1동,합성1동제1투,1789,1111,213,820,56,10,0,1099,12,678,19.381255686988172,74.61328480436761,5.095541401273886,0.9099181073703366,0.0
51,경상남도,창원시마산회원구,합성1동,합성1동제2투,3271,2284,580,1498,167,21,1,2267,17,987,25.584472871636528,66.07851786501985,7.366563740626378,0.9263343625937362,0.044111160123511246
52,경상남도,창원시마산회원구,합성2동,관내사전투표,2105,2105,873,1038,165,16,1,2093,12,0,41.71046344959388,49.59388437649307,7.883420926899188,0.7644529383659818,0.047778308647873864
53,경상남도,창원시마산회원구,합성2동,합성2동제1투,2142,1410,312,998,74,9,4,1397,13,732,22.333571939871153,71.4387974230494,5.2970651395848245,0.644237652111668,0.28632784538296346
54,경상남도,창원시마산회원구,합성2동,합성2동제2투,3142,2041,471,1376,155,19,5,2026,15,1101,23.247778874629812,67.91707798617966,7.650542941757157,0.9378084896347483,0.24679170779861795
55,경상남도,창원시마산회원구,구암1동,관내사전투표,1613,1613,742,751,82,25,1,1601,12,0,46.34603372891943,46.90818238600875,5.1217988757026855,1.5615240474703311,0.06246096189881324
56,경상남도,창원시마산회원구,구암1동,구암1동제1투,1705,1131,256,801,55,7,0,1119,12,574,22.87756925826631,71.58176943699732,4.915102770330653,0.6255585344057194,0.0
57,경상남도,창원시마산회원구,구암1동,구암1동제2투,1383,997,243,686,49,7,3,988,9,386,24.595141700404856,69.4331983805668,4.959514170040486,0.708502024291498,0.30364372469635625
58,경상남도,창원시마산회원구,구암1동,구암1동제3투,2312,1694,459,1107,89,25,2,1682,12,618,27.288941736028537,65.81450653983353,5.291319857312723,1.4863258026159334,0.11890606420927466
59,경상남도,창원시마산회원구,구암2동,관내사전투표,1480,1480,720,632,99,15,2,1468,12,0,49.04632152588556,43.05177111716621,6.743869209809264,1.021798365122616,0.13623978201634876
60,경상남도,창원시마산회원구,구암2동,구암2동제1투,1952,1399,376,892,101,17,2,1388,11,553,27.089337175792505,64.26512968299711,7.2766570605187315,1.2247838616714697,0.1440922190201729
61,경상남도,창원시마산회원구,구암2동,구암2동제2투,2345,1654,457,1057,103,18,4,1639,15,691,27.88285539963392,64.49054301403294,6.284319707138499,1.0982306284319707,0.24405125076266015
62,경상남도,창원시마산회원구,구암2동,구암2동제3투,1194,859,211,576,59,8,0,854,5,335,24.707259953161593,67.44730679156909,6.908665105386416,0.936768149882904,0.0
63,경상남도,창원시마산회원구,봉암동,관내사전투표,905,905,476,339,68,10,1,894,11,0,53.24384787472036,37.919463087248324,7.606263982102908,1.1185682326621924,0.11185682326621924
64,경상남도,창원시마산회원구,봉암동,봉암동제1투,818,519,141,338,32,4,1,516,3,299,27.325581395348834,65.50387596899225,6.2015503875969,0.7751937984496124,0.1937984496124031
65,경상남도,창원시마산회원구,봉암동,봉암동제2투,1108,711,163,496,40,5,1,705,6,397,23.120567375886523,70.35460992907801,5.673758865248227,0.7092198581560284,0.14184397163120568
66,경상남도,창원시마산회원구,잘못 투입·구분된 투표지,,0,1,1,0,0,0,0,1,0,-1,100.0,0.0,0.0,0.0,0.0
0,경상남도,창원시진해구,거소·선상투표,,1352,1320,361,508,366,16,7,1258,62,32,28.696343402225754,40.38155802861685,29.093799682034977,1.2718600953895072,0.5564387917329093
1,경상남도,창원시진해구,관외사전투표,,10969,10966,5435,3696,1560,131,22,10844,122,3,50.119881962375516,34.083364072298046,14.385835485060863,1.2080413131685726,0.2028771670970122
2,경상남도,창원시진해구,재외투표,,646,490,289,121,67,4,1,482,8,156,59.95850622406639,25.103734439834025,13.900414937759336,0.8298755186721992,0.2074688796680498
3,경상남도,창원시진해구,충무동,관내사전투표,3075,3075,1465,1083,436,25,10,3019,56,0,48.52600198741305,35.87280556475655,14.441868168267638,0.8280887711162637,0.33123550844650546
4,경상남도,창원시진해구,충무동,충무동제1투,2747,1833,390,1336,77,16,1,1820,13,914,21.428571428571427,73.4065934065934,4.230769230769231,0.8791208791208791,0.054945054945054944
5,경상남도,창원시진해구,충무동,충무동제2투,2923,1880,515,1101,223,18,3,1860,20,1043,27.688172043010752,59.193548387096776,11.989247311827956,0.967741935483871,0.16129032258064516
6,경상남도,창원시진해구,충무동,충무동제3투,1784,1263,300,874,66,10,1,1251,12,521,23.980815347721823,69.86410871302957,5.275779376498801,0.7993605115907274,0.07993605115907274
7,경상남도,창원시진해구,충무동,충무동제4투,1723,1285,355,840,67,4,1,1267,18,438,28.018942383583266,66.29834254143645,5.288082083662194,0.31570639305445936,0.07892659826361484
8,경상남도,창원시진해구,여좌동,관내사전투표,1844,1844,814,865,133,12,1,1825,19,0,44.602739726027394,47.397260273972606,7.287671232876712,0.6575342465753425,0.0547945205479452
9,경상남도,창원시진해구,여좌동,여좌동제1투,930,634,137,461,28,4,1,631,3,296,21.71156893819334,73.05863708399366,4.437400950871632,0.6339144215530903,0.15847860538827258
10,경상남도,창원시진해구,여좌동,여좌동제2투,1766,1166,249,844,58,9,0,1160,6,600,21.465517241379313,72.75862068965517,5.0,0.7758620689655172,0.0
11,경상남도,창원시진해구,여좌동,여좌동제3투,2265,1570,351,1110,77,11,3,1552,18,695,22.6159793814433,71.52061855670104,4.961340206185567,0.7087628865979382,0.19329896907216496
12,경상남도,창원시진해구,태백동,관내사전투표,1080,1080,487,528,58,3,0,1076,4,0,45.260223048327134,49.07063197026022,5.390334572490707,0.2788104089219331,0.0
13,경상남도,창원시진해구,태백동,태백동제1투,1670,1086,227,792,52,7,1,1079,7,584,21.03799814643188,73.40129749768303,4.819277108433735,0.6487488415199258,0.09267840593141798
14,경상남도,창원시진해구,태백동,태백동제2투,577,389,86,270,28,3,0,387,2,188,22.22222222222222,69.76744186046511,7.235142118863049,0.7751937984496124,0.0
15,경상남도,창원시진해구,경화동,관내사전투표,2300,2300,1176,921,160,23,1,2281,19,0,51.55633494081543,40.377027619465146,7.014467338886453,1.0083296799649275,0.04384042086804033
16,경상남도,창원시진해구,경화동,경화동제1투,2072,1292,290,923,59,11,0,1283,9,780,22.60327357755261,71.94076383476228,4.5985970381917385,0.857365549493375,0.0
17,경상남도,창원시진해구,경화동,경화동제2투,3730,2550,760,1535,209,31,4,2539,11,1180,29.93304450571091,60.45687278456086,8.231587239070501,1.2209531311539976,0.15754233950374164
18,경상남도,창원시진해구,병암동,관내사전투표,1736,1736,885,690,118,30,4,1727,9,0,51.24493341053851,39.95367689635206,6.832657788071801,1.7371163867979156,0.23161551823972204
19,경상남도,창원시진해구,병암동,병암동제1투,1852,1288,386,817,68,6,0,1277,11,564,30.227094753328114,63.978073610023486,5.324980422866092,0.4698512137823023,0.0
20,경상남도,창원시진해구,병암동,병암동제2투,2099,1332,365,848,88,18,1,1320,12,767,27.65151515151515,64.24242424242425,6.666666666666667,1.3636363636363635,0.07575757575757576
21,경상남도,창원시진해구,석동,관내사전투표,3281,3281,1833,1107,281,29,1,3251,30,0,56.382651491848655,34.051061211934794,8.643494309443248,0.8920332205475239,0.030759766225776686
22,경상남도,창원시진해구,석동,석동제1투,3345,2078,611,1267,160,27,4,2069,9,1267,29.531174480425328,61.237312711454805,7.7332044465925565,1.304978250362494,0.1933301111648139
23,경상남도,창원시진해구,석동,석동제2투,3278,2299,754,1306,204,26,0,2290,9,979,32.92576419213974,57.03056768558952,8.90829694323144,1.1353711790393013,0.0
24,경상남도,창원시진해구,석동,석동제3투,2953,2330,802,1319,179,26,1,2327,3,623,34.4649763644177,56.682423721529865,7.6923076923076925,1.1173184357541899,0.04297378599054577
25,경상남도,창원시진해구,이동,관내사전투표,1550,1550,757,674,92,18,1,1542,8,0,49.09208819714656,43.7094682230869,5.966277561608301,1.1673151750972763,0.06485084306095978
26,경상남도,창원시진해구,이동,이동제1투,1889,1132,279,747,82,12,0,1120,12,757,24.910714285714285,66.69642857142857,7.321428571428572,1.0714285714285714,0.0
27,경상남도,창원시진해구,이동,이동제2투,1609,1011,243,690,60,14,1,1008,3,598,24.107142857142858,68.45238095238095,5.952380952380952,1.3888888888888888,0.0992063492063492
28,경상남도,창원시진해구,이동,이동제3투,1886,1303,309,898,74,10,0,1291,12,583,23.93493415956623,69.55848179705654,5.731990704879938,0.774593338497289,0.0
29,경상남도,창원시진해구,자은동,관내사전투표,3324,3324,1820,1224,224,38,4,3310,14,0,54.98489425981873,36.97885196374622,6.767371601208459,1.148036253776435,0.12084592145015105
30,경상남도,창원시진해구,자은동,자은동제1투,2324,1547,387,1030,107,12,1,1537,10,777,25.178919973975276,67.01366297983084,6.961613532856213,0.7807417046193884,0.06506180871828238
31,경상남도,창원시진해구,자은동,자은동제2투,3065,2060,612,1255,149,26,3,2045,15,1005,29.926650366748163,61.36919315403423,7.286063569682151,1.2713936430317847,0.1466992665036675
32,경상남도,창원시진해구,자은동,자은동제3투,3119,2548,1153,1139,203,35,0,2530,18,571,45.573122529644266,45.019762845849804,8.023715415019762,1.383399209486166,0.0
33,경상남도,창원시진해구,자은동,자은동제4투,2964,2155,742,1218,152,23,5,2140,15,809,34.67289719626168,56.91588785046729,7.102803738317758,1.074766355140187,0.23364485981308408
34,경상남도,창원시진해구,덕산동,관내사전투표,2042,2042,1048,804,156,17,4,2029,13,0,51.65105963528832,39.62543124691966,7.6885165105963535,0.8378511582060127,0.19714144898965008
35,경상남도,창원시진해구,덕산동,덕산동제1투,2991,2053,596,1277,150,20,0,2043,10,938,29.172785119921684,62.50611845325502,7.342143906020558,0.978952520802741,0.0
36,경상남도,창원시진해구,덕산동,덕산동제2투,2183,1430,384,933,89,11,2,1419,11,753,27.061310782241016,65.75052854122622,6.272022551092318,0.7751937984496124,0.14094432699083861
37,경상남도,창원시진해구,풍호동,관내사전투표,4533,4533,2580,1484,385,44,11,4504,29,0,57.282415630550624,32.94849023090586,8.547957371225577,0.9769094138543518,0.24422735346358795
38,경상남도,창원시진해구,풍호동,풍호동제1투,3040,2185,622,1392,131,24,1,2170,15,855,28.663594470046082,64.14746543778801,6.0368663594470044,1.1059907834101383,0.04608294930875576
39,경상남도,창원시진해구,풍호동,풍호동제2투,2660,1988,577,1250,115,29,4,1975,13,672,29.215189873417724,63.29113924050633,5.822784810126582,1.4683544303797469,0.20253164556962028
40,경상남도,창원시진해구,풍호동,풍호동제3투,3693,2691,957,1492,184,33,2,2668,23,1002,35.869565217391305,55.92203898050975,6.896551724137931,1.23688155922039,0.07496251874062969
41,경상남도,창원시진해구,풍호동,풍호동제4투,3616,2793,1125,1378,237,29,1,2770,23,823,40.61371841155235,49.74729241877257,8.55595667870036,1.0469314079422383,0.036101083032490974
42,경상남도,창원시진해구,웅천동,관내사전투표,2590,2590,1402,977,174,16,2,2571,19,0,54.531310774017896,38.00077790742902,6.76779463243874,0.6223259432127577,0.07779074290159471
43,경상남도,창원시진해구,웅천동,웅천동제1투,1729,1072,208,795,54,11,0,1068,4,657,19.475655430711612,74.43820224719101,5.056179775280898,1.0299625468164793,0.0
44,경상남도,창원시진해구,웅천동,웅천동제2투,2990,2175,803,1143,185,24,1,2156,19,815,37.244897959183675,53.01484230055659,8.580705009276437,1.1131725417439702,0.0463821892393321
45,경상남도,창원시진해구,웅천동,웅천동제3투,2735,1824,638,979,161,26,4,1808,16,911,35.28761061946903,54.14823008849557,8.904867256637168,1.4380530973451326,0.22123893805309736
46,경상남도,창원시진해구,웅동1동,관내사전투표,1754,1754,975,625,131,6,3,1740,14,0,56.03448275862068,35.91954022988506,7.528735632183908,0.3448275862068966,0.1724137931034483
47,경상남도,창원시진해구,웅동1동,웅동1동투표소,4503,2823,845,1776,160,24,1,2806,17,1680,30.114041339985743,63.29294369208838,5.702066999287242,0.8553100498930863,0.03563791874554526
48,경상남도,창원시진해구,웅동2동,관내사전투표,6778,6778,4498,1781,412,49,4,6744,34,0,66.69632265717675,26.408659549228947,6.109134045077106,0.7265717674970344,0.05931198102016608
49,경상남도,창원시진해구,웅동2동,웅동2동제1투,1399,740,228,461,36,8,2,735,5,659,31.020408163265305,62.72108843537415,4.8979591836734695,1.0884353741496597,0.27210884353741494
50,경상남도,창원시진해구,웅동2동,웅동2동제2투,3973,2645,1057,1385,169,20,2,2633,12,1328,40.144322066084314,52.60159513862514,6.418533991644512,0.759589821496392,0.0759589821496392
51,경상남도,창원시진해구,웅동2동,웅동2동제3투,3542,2531,1102,1243,137,26,2,2510,21,1011,43.90438247011952,49.52191235059761,5.458167330677291,1.0358565737051793,0.0796812749003984
52,경상남도,창원시진해구,웅동2동,웅동2동제4투,2805,1811,755,887,129,16,7,1794,17,994,42.08472686733556,49.44258639910814,7.190635451505016,0.8918617614269788,0.39018952062430323
53,경상남도,창원시진해구,웅동2동,웅동2동제5투,2101,1415,544,751,95,14,3,1407,8,686,38.6638237384506,53.37597725657427,6.751954513148544,0.9950248756218906,0.21321961620469082
54,경상남도,창원시진해구,웅동2동,웅동2동제6투,3260,1460,504,809,128,9,0,1450,10,1800,34.758620689655174,55.79310344827586,8.827586206896552,0.6206896551724138,0.0
55,경상남도,창원시진해구,웅동2동,웅동2동제7투,4322,2808,1300,1256,201,29,4,2790,18,1514,46.59498207885305,45.017921146953405,7.204301075268817,1.039426523297491,0.14336917562724014
56,경상남도,창원시진해구,웅동2동,웅동2동제8투,4300,2883,1357,1237,229,40,2,2865,18,1417,47.36474694589878,43.17626527050611,7.993019197207679,1.3961605584642234,0.06980802792321117
57,경상남도,창원시진해구,잘못 투입·구분된 투표지,,0,2,2,0,0,0,0,2,0,-2,100.0,0.0,0.0,0.0,0.0
0,제주특별자치도,제주시,거소·선상투표,,1090,1011,477,259,180,19,8,943,68,79,50.58324496288441,27.465535524920465,19.088016967126194,2.014846235418876,0.8483563096500532
1,제주특별자치도,제주시,관외사전투표,,23460,23456,12621,6104,3975,381,36,23117,339,4,54.59618462603279,26.404810312756844,17.19513777739326,1.6481377341350523,0.1557295496820522
2,제주특별자치도,제주시,재외투표,,3161,2018,1284,491,166,51,2,1994,24,1143,64.39317953861585,24.623871614844532,8.324974924774322,2.5576730190571713,0.10030090270812438
3,제주특별자치도,제주시,한림읍,관내사전투표,5415,5415,3631,1257,412,75,4,5379,36,0,67.50325339282395,23.36865588399331,7.6594162483733035,1.3943112102621305,0.07436326454731362
4,제주특별자치도,제주시,한림읍,한림읍제1투,1068,662,241,365,33,16,1,656,6,406,36.73780487804878,55.640243902439025,5.0304878048780495,2.4390243902439024,0.1524390243902439
5,제주특별자치도,제주시,한림읍,한림읍제2투,881,499,234,232,20,8,0,494,5,382,47.368421052631575,46.963562753036435,4.048582995951417,1.6194331983805668,0.0
6,제주특별자치도,제주시,한림읍,한림읍제3투,1545,803,349,378,64,4,2,797,6,742,43.7892095357591,47.42785445420326,8.030112923462985,0.5018820577164366,0.2509410288582183
7,제주특별자치도,제주시,한림읍,한림읍제4투,576,367,196,150,15,4,0,365,2,209,53.6986301369863,41.0958904109589,4.10958904109589,1.095890410958904,0.0
8,제주특별자치도,제주시,한림읍,한림읍제5투,1082,614,219,359,26,7,1,612,2,468,35.78431372549019,58.66013071895425,4.248366013071895,1.1437908496732025,0.16339869281045752
9,제주특별자치도,제주시,한림읍,한림읍제6투,925,553,247,261,34,3,1,546,7,372,45.23809523809524,47.8021978021978,6.227106227106227,0.5494505494505495,0.18315018315018314
10,제주특별자치도,제주시,한림읍,한림읍제7투,1188,633,265,316,35,9,1,626,7,555,42.33226837060703,50.47923322683706,5.5910543130990416,1.4376996805111821,0.1597444089456869
11,제주특별자치도,제주시,한림읍,한림읍제8투,804,535,222,255,35,14,0,526,9,269,42.20532319391635,48.47908745247148,6.653992395437262,2.6615969581749046,0.0
12,제주특별자치도,제주시,한림읍,한림읍제9투,1357,695,327,308,43,10,3,691,4,662,47.32272069464544,44.57308248914617,6.2228654124457305,1.447178002894356,0.43415340086830684
13,제주특별자치도,제주시,한림읍,한림읍제10투,1142,582,236,298,40,4,0,578,4,560,40.830449826989614,51.55709342560554,6.920415224913495,0.6920415224913495,0.0
14,제주특별자치도,제주시,한림읍,한림읍제11투,95,66,7,53,3,1,0,64,2,29,10.9375,82.8125,4.6875,1.5625,0.0
15,제주특별자치도,제주시,한림읍,한림읍제12투,399,243,100,122,17,2,1,242,1,156,41.32231404958678,50.413223140495866,7.024793388429752,0.8264462809917356,0.4132231404958678
16,제주특별자치도,제주시,한림읍,한림읍제13투,431,276,109,135,20,7,0,271,5,155,40.22140221402214,49.815498154981555,7.380073800738007,2.5830258302583027,0.0
17,제주특별자치도,제주시,애월읍,관내사전투표,4972,4972,3502,1026,338,62,9,4937,35,0,70.93376544460199,20.78185132671663,6.84626291270002,1.2558233745189387,0.18229694146242656
18,제주특별자치도,제주시,애월읍,애월읍제1투,1902,969,415,466,65,11,1,958,11,933,43.31941544885177,48.643006263048015,6.784968684759916,1.1482254697286012,0.10438413361169101
19,제주특별자치도,제주시,애월읍,애월읍제2투,900,574,268,262,24,14,2,570,4,326,47.01754385964912,45.96491228070175,4.2105263157894735,2.456140350877193,0.3508771929824561
20,제주특별자치도,제주시,애월읍,애월읍제3투,2229,1325,586,606,108,18,0,1318,7,904,44.46130500758726,45.97875569044006,8.19423368740516,1.3657056145675266,0.0
21,제주특별자치도,제주시,애월읍,애월읍제4투,2865,1856,885,767,160,22,1,1835,21,1009,48.228882833787466,41.798365122615806,8.71934604904632,1.1989100817438691,0.05449591280653951
22,제주특별자치도,제주시,애월읍,애월읍제5투,962,669,343,267,39,10,2,661,8,293,51.8910741301059,40.39334341906203,5.900151285930408,1.5128593040847202,0.30257186081694404
23,제주특별자치도,제주시,애월읍,애월읍제6투,2991,1890,949,739,159,33,0,1880,10,1101,50.47872340425532,39.308510638297875,8.457446808510639,1.7553191489361704,0.0
24,제주특별자치도,제주시,애월읍,애월읍제7투,837,556,258,259,29,7,1,554,2,281,46.57039711191336,46.75090252707581,5.234657039711191,1.263537906137184,0.18050541516245489
25,제주특별자치도,제주시,애월읍,애월읍제8투,1067,688,335,288,42,8,2,675,13,379,49.629629629629626,42.66666666666667,6.222222222222222,1.1851851851851851,0.2962962962962963
26,제주특별자치도,제주시,애월읍,애월읍제9투,919,584,246,283,38,11,2,580,4,335,42.41379310344828,48.79310344827586,6.551724137931035,1.896551724137931,0.3448275862068966
27,제주특별자치도,제주시,애월읍,애월읍제10투,927,592,274,272,30,11,0,587,5,335,46.678023850085175,46.33730834752981,5.110732538330494,1.8739352640545146,0.0
28,제주특별자치도,제주시,애월읍,애월읍제11투,3294,2074,1060,806,159,33,2,2060,14,1220,51.45631067961165,39.126213592233015,7.718446601941747,1.6019417475728155,0.0970873786407767
29,제주특별자치도,제주시,애월읍,애월읍제12투,1205,794,412,316,45,12,2,787,7,411,52.35069885641678,40.15247776365947,5.717916137229987,1.5247776365946633,0.25412960609911056
30,제주특별자치도,제주시,애월읍,애월읍제13투,1043,673,360,262,36,6,3,667,6,370,53.973013493253376,39.280359820089956,5.397301349325337,0.8995502248875562,0.4497751124437781
31,제주특별자치도,제주시,구좌읍,관내사전투표,2958,2958,1909,793,181,53,5,2941,17,0,64.90989459367562,26.963617817069025,6.15436926215573,1.8021081264875893,0.17001020061203673
32,제주특별자치도,제주시,구좌읍,구좌읍제1투,1679,1082,448,524,63,24,4,1063,19,597,42.144873000940734,49.29444967074318,5.9266227657572905,2.257761053621825,0.37629350893697083
33,제주특별자치도,제주시,구좌읍,구좌읍제2투,1122,624,251,318,37,9,0,615,9,498,40.8130081300813,51.707317073170735,6.016260162601626,1.4634146341463417,0.0
34,제주특별자치도,제주시,구좌읍,구좌읍제3투,708,363,135,186,29,4,2,356,7,345,37.92134831460674,52.24719101123596,8.146067415730338,1.1235955056179776,0.5617977528089888
35,제주특별자치도,제주시,구좌읍,구좌읍제4투,891,562,300,210,39,6,0,555,7,329,54.054054054054056,37.83783783783784,7.027027027027027,1.0810810810810811,0.0
36,제주특별자치도,제주시,구좌읍,구좌읍제5투,1400,725,268,389,47,13,1,718,7,675,37.32590529247911,54.1782729805014,6.545961002785515,1.8105849582172702,0.1392757660167131
37,제주특별자치도,제주시,구좌읍,구좌읍제6투,955,529,215,277,30,7,0,529,0,426,40.64272211720227,52.36294896030246,5.671077504725898,1.3232514177693762,0.0
38,제주특별자치도,제주시,구좌읍,구좌읍제7투,730,454,215,200,22,12,1,450,4,276,47.77777777777778,44.44444444444444,4.888888888888889,2.666666666666667,0.2222222222222222
39,제주특별자치도,제주시,구좌읍,구좌읍제8투,503,324,132,168,16,7,0,323,1,179,40.86687306501548,52.012383900928796,4.953560371517028,2.1671826625387,0.0
40,제주특별자치도,제주시,구좌읍,구좌읍제9투,711,426,144,255,13,3,2,417,9,285,34.53237410071942,61.15107913669065,3.117505995203837,0.7194244604316548,0.4796163069544364
41,제주특별자치도,제주시,조천읍,관내사전투표,6252,6252,4223,1471,407,91,4,6196,56,0,68.15687540348611,23.741123305358293,6.5687540348612,1.4686894770819885,0.06455777921239508
42,제주특별자치도,제주시,조천읍,조천읍제1투,2924,1833,850,778,148,38,4,1818,15,1091,46.754675467546754,42.7942794279428,8.14081408140814,2.0902090209020905,0.22002200220022
43,제주특별자치도,제주시,조천읍,조천읍제2투,1380,756,298,387,50,9,2,746,10,624,39.946380697050934,51.87667560321716,6.702412868632708,1.2064343163538873,0.2680965147453083
44,제주특별자치도,제주시,조천읍,조천읍제3투,1460,905,405,428,53,11,2,899,6,555,45.05005561735261,47.60845383759733,5.89543937708565,1.2235817575083427,0.22246941045606228
45,제주특별자치도,제주시,조천읍,조천읍제4투,1052,709,305,331,51,12,3,702,7,343,43.44729344729345,47.150997150997156,7.264957264957266,1.7094017094017095,0.4273504273504274
46,제주특별자치도,제주시,조천읍,조천읍제5투,871,557,255,261,33,4,2,555,2,314,45.94594594594595,47.02702702702703,5.9459459459459465,0.7207207207207207,0.36036036036036034
47,제주특별자치도,제주시,조천읍,조천읍제6투,2157,1348,577,645,86,22,4,1334,14,809,43.25337331334333,48.35082458770615,6.446776611694154,1.6491754122938531,0.29985007496251875
48,제주특별자치도,제주시,조천읍,조천읍제7투,1538,882,382,412,67,14,1,876,6,656,43.60730593607306,47.03196347031963,7.648401826484018,1.5981735159817352,0.1141552511415525
49,제주특별자치도,제주시,조천읍,조천읍제8투,2573,1535,649,706,137,27,2,1521,14,1038,42.66929651545036,46.41683103221565,9.007232084155161,1.7751479289940828,0.13149243918474687
50,제주특별자치도,제주시,한경면,관내사전투표,1910,1909,1322,448,93,31,2,1896,13,1,69.72573839662446,23.628691983122362,4.90506329113924,1.6350210970464136,0.10548523206751054
51,제주특별자치도,제주시,한경면,한경면제1투,579,398,184,181,25,5,1,396,2,181,46.464646464646464,45.707070707070706,6.313131313131313,1.2626262626262625,0.25252525252525254
52,제주특별자치도,제주시,한경면,한경면제2투,771,527,225,258,31,4,4,522,5,244,43.103448275862064,49.42528735632184,5.938697318007663,0.7662835249042145,0.7662835249042145
53,제주특별자치도,제주시,한경면,한경면제3투,1330,743,340,351,35,9,0,735,8,587,46.25850340136054,47.755102040816325,4.761904761904762,1.2244897959183674,0.0
54,제주특별자치도,제주시,한경면,한경면제4투,1165,717,345,316,39,8,1,709,8,448,48.66008462623414,44.56981664315938,5.500705218617771,1.1283497884344147,0.14104372355430184
55,제주특별자치도,제주시,한경면,한경면제5투,1544,946,382,485,59,9,0,935,11,598,40.855614973262036,51.87165775401069,6.310160427807486,0.9625668449197862,0.0
56,제주특별자치도,제주시,추자면,관내사전투표,464,464,288,132,33,6,2,461,3,0,62.47288503253796,28.633405639913235,7.158351409978309,1.3015184381778742,0.43383947939262474
57,제주특별자치도,제주시,추자면,추자면제1투,445,244,105,131,4,1,0,241,3,201,43.56846473029046,54.356846473029044,1.6597510373443984,0.4149377593360996,0.0
58,제주특별자치도,제주시,추자면,추자면제2투,353,205,92,103,5,0,1,201,4,148,45.77114427860697,51.243781094527364,2.4875621890547266,0.0,0.4975124378109453
59,제주특별자치도,제주시,우도면,관내사전투표,562,562,377,141,31,8,1,558,4,0,67.56272401433692,25.268817204301076,5.555555555555555,1.4336917562724014,0.17921146953405018
60,제주특별자치도,제주시,우도면,우도면투표소,732,342,137,175,21,1,0,334,8,390,41.01796407185629,52.39520958083832,6.287425149700598,0.29940119760479045,0.0
61,제주특별자치도,제주시,일도1동,관내사전투표,1339,1339,820,394,94,15,2,1325,14,0,61.886792452830186,29.735849056603776,7.09433962264151,1.1320754716981132,0.1509433962264151
62,제주특별자치도,제주시,일도1동,일도1동투표소,1262,618,250,331,23,6,1,611,7,644,40.91653027823241,54.173486088379704,3.764320785597381,0.9819967266775778,0.16366612111292964
63,제주특별자치도,제주시,일도2동,관내사전투표,5994,5992,3859,1570,427,94,6,5956,36,2,64.7918065815984,26.35997313633311,7.169241101410343,1.57824042981867,0.10073875083948958
64,제주특별자치도,제주시,일도2동,일도2동제1투,1664,1045,527,420,76,10,0,1033,12,619,51.016456921587604,40.658276863504355,7.357212003872217,0.9680542110358179,0.0
65,제주특별자치도,제주시,일도2동,일도2동제2투,2024,1065,483,475,80,17,3,1058,7,959,45.65217391304348,44.896030245746694,7.561436672967864,1.606805293005671,0.28355387523629494
66,제주특별자치도,제주시,일도2동,일도2동제3투,1701,1116,499,503,82,21,0,1105,11,585,45.158371040723985,45.52036199095023,7.420814479638009,1.9004524886877827,0.0
67,제주특별자치도,제주시,일도2동,일도2동제4투,1991,1150,464,552,108,18,2,1144,6,841,40.55944055944056,48.25174825174825,9.44055944055944,1.5734265734265735,0.17482517482517482
68,제주특별자치도,제주시,일도2동,일도2동제5투,1541,1027,463,441,89,14,1,1008,19,514,45.932539682539684,43.75,8.829365079365079,1.3888888888888888,0.0992063492063492
69,제주특별자치도,제주시,일도2동,일도2동제6투,2023,1313,586,591,108,17,0,1302,11,710,45.00768049155146,45.39170506912442,8.294930875576037,1.30568356374808,0.0
70,제주특별자치도,제주시,일도2동,일도2동제7투,2420,1719,895,634,152,24,0,1705,14,701,52.49266862170088,37.184750733137825,8.914956011730206,1.4076246334310851,0.0
71,제주특별자치도,제주시,일도2동,일도2동제8투,2467,1762,876,705,141,23,4,1749,13,705,50.08576329331046,40.308747855917666,8.061749571183533,1.315037164093768,0.22870211549456831
72,제주특별자치도,제주시,일도2동,일도2동제9투,1832,1359,620,586,119,29,0,1354,5,473,45.79025110782865,43.279172821270315,8.78877400295421,2.1418020679468244,0.0
73,제주특별자치도,제주시,이도1동,관내사전투표,2134,2134,1398,531,155,26,4,2114,20,0,66.13055818353831,25.118259224219493,7.332071901608325,1.229895931882687,0.1892147587511826
74,제주특별자치도,제주시,이도1동,이도1동제1투,1263,635,226,344,54,6,0,630,5,628,35.87301587301587,54.6031746031746,8.571428571428571,0.9523809523809524,0.0
75,제주특별자치도,제주시,이도1동,이도1동제2투,1592,921,354,447,93,18,1,913,8,671,38.77327491785323,48.95947426067908,10.186199342825848,1.9715224534501645,0.10952902519167579
76,제주특별자치도,제주시,이도1동,이도1동제3투,1430,868,358,415,78,11,1,863,5,562,41.48319814600232,48.08806488991888,9.038238702201621,1.2746234067207416,0.11587485515643105
77,제주특별자치도,제주시,이도2동,관내사전투표,8896,8896,5722,2035,879,147,16,8799,97,0,65.03011705875667,23.127628139561313,9.989771564950562,1.6706443914081146,0.1818388453233322
78,제주특별자치도,제주시,이도2동,이도2동제1투,2368,1480,648,652,145,24,1,1470,10,888,44.08163265306123,44.353741496598644,9.863945578231291,1.6326530612244898,0.06802721088435373
79,제주특별자치도,제주시,이도2동,이도2동제2투,4318,2994,1532,1140,248,42,2,2964,30,1324,51.686909581646425,38.46153846153847,8.367071524966262,1.417004048582996,0.06747638326585695
80,제주특별자치도,제주시,이도2동,이도2동제3투,2697,1525,694,637,157,18,2,1508,17,1172,46.02122015915119,42.241379310344826,10.411140583554376,1.1936339522546418,0.1326259946949602
81,제주특별자치도,제주시,이도2동,이도2동제4투,3342,2246,1091,876,210,42,2,2221,25,1096,49.12201710941018,39.44169293111211,9.45520036019811,1.8910400720396219,0.09004952723998198
82,제주특별자치도,제주시,이도2동,이도2동제5투,2238,1561,850,495,156,38,6,1545,16,677,55.016181229773466,32.038834951456316,10.097087378640776,2.459546925566343,0.3883495145631068
83,제주특별자치도,제주시,이도2동,이도2동제6투,1972,1195,504,578,83,16,2,1183,12,777,42.60355029585799,48.85883347421809,7.016060862214708,1.3524936601859678,0.16906170752324598
84,제주특별자치도,제주시,이도2동,이도2동제7투,3036,1877,885,766,176,30,6,1863,14,1159,47.50402576489533,41.116478797638216,9.447128287707999,1.610305958132045,0.322061191626409
85,제주특별자치도,제주시,이도2동,이도2동제8투,2332,1678,724,742,170,32,2,1670,8,654,43.35329341317365,44.4311377245509,10.179640718562874,1.9161676646706587,0.11976047904191617
86,제주특별자치도,제주시,이도2동,이도2동제9투,967,554,257,242,42,11,0,552,2,413,46.55797101449276,43.84057971014493,7.608695652173914,1.9927536231884055,0.0
87,제주특별자치도,제주시,이도2동,이도2동제10투,3178,2128,1038,845,196,36,1,2116,12,1050,49.05482041587902,39.93383742911153,9.262759924385634,1.7013232514177694,0.04725897920604915
88,제주특별자치도,제주시,삼도1동,관내사전투표,3609,3609,2295,1012,218,56,6,3587,22,0,63.98104265402843,28.21299135768051,6.077502090883747,1.5611931976582103,0.16727069974909395
89,제주특별자치도,제주시,삼도1동,삼도1동제1투,1907,1161,503,534,91,27,2,1157,4,746,43.47450302506482,46.15384615384615,7.865168539325842,2.33362143474503,0.17286084701815038
90,제주특별자치도,제주시,삼도1동,삼도1동제2투,1548,968,434,439,75,11,0,959,9,580,45.25547445255474,45.776850886339936,7.820646506777893,1.1470281543274243,0.0
91,제주특별자치도,제주시,삼도1동,삼도1동제3투,1856,1037,446,452,109,19,1,1027,10,819,43.427458617332036,44.01168451801363,10.613437195715676,1.8500486854917235,0.09737098344693282
92,제주특별자치도,제주시,삼도1동,삼도1동제4투,1683,990,400,473,87,18,1,979,11,693,40.85801838610828,48.31460674157304,8.88661899897855,1.8386108273748722,0.10214504596527069
93,제주특별자치도,제주시,삼도2동,관내사전투표,1850,1850,1276,399,130,25,3,1833,17,0,69.6126568466994,21.76759410801964,7.092198581560284,1.3638843426077467,0.16366612111292964
94,제주특별자치도,제주시,삼도2동,삼도2동제1투,1613,862,344,416,68,19,0,847,15,751,40.61393152302244,49.11452184179457,8.028335301062574,2.2432113341204247,0.0
95,제주특별자치도,제주시,삼도2동,삼도2동제2투,1111,659,288,327,39,2,0,656,3,452,43.90243902439025,49.84756097560975,5.945121951219512,0.3048780487804878,0.0
96,제주특별자치도,제주시,삼도2동,삼도2동제3투,1837,1180,529,530,98,12,1,1170,10,657,45.21367521367522,45.2991452991453,8.376068376068375,1.0256410256410255,0.08547008547008547
97,제주특별자치도,제주시,용담1동,관내사전투표,1576,1576,1007,429,104,19,2,1561,15,0,64.50992953235107,27.482383087764255,6.662395900064061,1.2171684817424726,0.12812299807815503
98,제주특별자치도,제주시,용담1동,용담1동제1투,1313,663,283,333,36,8,1,661,2,650,42.81391830559758,50.378214826021186,5.446293494704992,1.2102874432677762,0.15128593040847202
99,제주특별자치도,제주시,용담1동,용담1동제2투,1192,635,285,285,53,7,1,631,4,557,45.16640253565768,45.16640253565768,8.399366085578446,1.109350237717908,0.15847860538827258
100,제주특별자치도,제주시,용담1동,용담1동제3투,1222,690,281,331,61,14,1,688,2,532,40.843023255813954,48.11046511627907,8.866279069767442,2.0348837209302326,0.14534883720930233
101,제주특별자치도,제주시,용담2동,관내사전투표,2882,2882,1803,832,192,28,4,2859,23,0,63.06400839454355,29.101084295208114,6.715634837355719,0.9793634137810423,0.13990905911157747
102,제주특별자치도,제주시,용담2동,용담2동제1투,1499,860,369,410,48,19,2,848,12,639,43.514150943396224,48.34905660377358,5.660377358490567,2.240566037735849,0.2358490566037736
103,제주특별자치도,제주시,용담2동,용담2동제2투,1644,887,381,423,63,11,2,880,7,757,43.29545454545455,48.06818181818181,7.159090909090909,1.25,0.22727272727272727
104,제주특별자치도,제주시,용담2동,용담2동제3투,1507,914,400,418,74,13,1,906,8,593,44.150110375275936,46.13686534216336,8.167770419426049,1.434878587196468,0.11037527593818984
105,제주특별자치도,제주시,용담2동,용담2동제4투,1424,834,335,393,80,15,1,824,10,590,40.65533980582524,47.69417475728155,9.70873786407767,1.820388349514563,0.12135922330097086
106,제주특별자치도,제주시,용담2동,용담2동제5투,1622,1018,440,483,73,12,0,1008,10,604,43.65079365079365,47.91666666666667,7.242063492063493,1.1904761904761905,0.0
107,제주특별자치도,제주시,건입동,관내사전투표,2723,2723,1775,713,182,36,2,2708,15,0,65.54652880354506,26.329394387001475,6.72082717872969,1.329394387001477,0.07385524372230429
108,제주특별자치도,제주시,건입동,건입동제1투,464,240,85,125,26,1,0,237,3,224,35.86497890295359,52.742616033755276,10.970464135021098,0.42194092827004215,0.0
109,제주특별자치도,제주시,건입동,건입동제2투,1179,610,250,312,35,6,1,604,6,569,41.390728476821195,51.65562913907284,5.7947019867549665,0.9933774834437087,0.16556291390728478
110,제주특별자치도,제주시,건입동,건입동제3투,1778,1151,506,531,75,20,1,1133,18,627,44.66019417475729,46.8667255075022,6.619593998234776,1.7652250661959399,0.088261253309797
111,제주특별자치도,제주시,건입동,건입동제4투,1281,774,356,357,46,8,1,768,6,507,46.35416666666667,46.484375,5.989583333333334,1.0416666666666665,0.13020833333333331
112,제주특별자치도,제주시,화북동,관내사전투표,4599,4599,3130,1049,317,51,7,4554,45,0,68.73078612209046,23.03469477382521,6.960913482652613,1.1198945981554678,0.15371102327624067
113,제주특별자치도,제주시,화북동,화북동제1투,1364,837,389,357,62,13,1,822,15,527,47.323600973236005,43.43065693430657,7.542579075425791,1.5815085158150852,0.12165450121654502
114,제주특별자치도,제주시,화북동,화북동제2투,2443,1490,713,612,126,16,2,1469,21,953,48.53641933287951,41.660993873383255,8.577263444520081,1.0891763104152483,0.13614703880190604
115,제주특별자치도,제주시,화북동,화북동제3투,909,555,265,223,52,8,0,548,7,354,48.35766423357664,40.693430656934304,9.48905109489051,1.4598540145985401,0.0
116,제주특별자치도,제주시,화북동,화북동제4투,1587,950,429,419,74,17,1,940,10,637,45.63829787234043,44.57446808510638,7.872340425531915,1.8085106382978722,0.10638297872340426
117,제주특별자치도,제주시,화북동,화북동제5투,1610,1176,600,427,111,27,3,1168,8,434,51.369863013698634,36.55821917808219,9.503424657534246,2.3116438356164384,0.2568493150684931
118,제주특별자치도,제주시,화북동,화북동제6투,1739,1123,590,409,97,17,0,1113,10,616,53.00988319856245,36.74752920035939,8.7151841868823,1.527403414195867,0.0
119,제주특별자치도,제주시,화북동,화북동제7투,2732,1846,996,650,155,31,3,1835,11,886,54.27792915531335,35.42234332425068,8.446866485013624,1.6893732970027249,0.16348773841961853
120,제주특별자치도,제주시,삼양동,관내사전투표,6456,6456,4549,1299,488,75,4,6415,41,0,70.91192517537023,20.24941543257989,7.607170693686671,1.1691348402182384,0.06235385814497272
121,제주특별자치도,제주시,삼양동,삼양동제1투,1843,1137,488,506,108,23,0,1125,12,706,43.37777777777777,44.977777777777774,9.6,2.0444444444444447,0.0
122,제주특별자치도,제주시,삼양동,삼양동제2투,3013,1712,871,657,142,29,1,1700,12,1301,51.23529411764706,38.64705882352941,8.352941176470589,1.7058823529411766,0.0588235294117647
123,제주특별자치도,제주시,삼양동,삼양동제3투,2567,1638,833,591,169,23,3,1619,19,929,51.451513279802356,36.504014823965406,10.438542310067943,1.4206300185299567,0.1852995676343422
124,제주특별자치도,제주시,삼양동,삼양동제4투,480,308,137,142,22,4,1,306,2,172,44.771241830065364,46.40522875816993,7.18954248366013,1.3071895424836601,0.32679738562091504
125,제주특별자치도,제주시,삼양동,삼양동제5투,1836,1325,764,383,150,21,0,1318,7,511,57.96661608497724,29.05918057663126,11.380880121396055,1.5933232169954477,0.0
126,제주특별자치도,제주시,삼양동,삼양동제6투,2895,1946,1081,645,171,36,0,1933,13,949,55.923435075012925,33.36782203828246,8.84635281945163,1.8623900672529745,0.0
127,제주특별자치도,제주시,봉개동,관내사전투표,3084,3084,2126,663,230,43,2,3064,20,0,69.38642297650131,21.63838120104439,7.506527415143603,1.4033942558746737,0.06527415143603134
128,제주특별자치도,제주시,봉개동,봉개동제1투,2084,1262,559,536,130,21,4,1250,12,822,44.72,42.88,10.4,1.68,0.32
129,제주특별자치도,제주시,봉개동,봉개동제2투,432,280,139,115,21,1,0,276,4,152,50.36231884057971,41.66666666666667,7.608695652173914,0.36231884057971014,0.0
130,제주특별자치도,제주시,봉개동,봉개동제3투,213,161,68,78,7,5,0,158,3,52,43.037974683544306,49.36708860759494,4.430379746835443,3.1645569620253164,0.0
131,제주특별자치도,제주시,아라동,관내사전투표,10926,10926,7490,2060,1113,171,12,10846,80,0,69.05771713073943,18.99317720818735,10.261847685782776,1.5766181080582704,0.11063986723215931
132,제주특별자치도,제주시,아라동,아라동제1투,4452,2491,1093,986,326,49,2,2456,35,1961,44.50325732899022,40.14657980456026,13.273615635179153,1.9951140065146578,0.08143322475570033
133,제주특별자치도,제주시,아라동,아라동제2투,3515,2301,1156,845,231,45,3,2280,21,1214,50.70175438596492,37.06140350877193,10.131578947368421,1.9736842105263157,0.13157894736842105
134,제주특별자치도,제주시,아라동,아라동제3투,4353,2736,1393,999,257,63,4,2716,20,1617,51.28865979381443,36.7820324005891,9.462444771723122,2.3195876288659796,0.14727540500736377
135,제주특별자치도,제주시,아라동,아라동제4투,1655,1080,564,399,92,17,1,1073,7,575,52.56290773532153,37.18546132339236,8.574091332712023,1.5843429636533086,0.09319664492078285
136,제주특별자치도,제주시,아라동,아라동제5투,5194,3219,1524,1256,352,60,0,3192,27,1975,47.744360902255636,39.34837092731829,11.027568922305765,1.8796992481203008,0.0
137,제주특별자치도,제주시,오라동,관내사전투표,6910,6910,4715,1526,518,98,8,6865,45,0,68.68171886380189,22.228696285506192,7.545520757465404,1.4275309541150765,0.11653313911143481
138,제주특별자치도,제주시,오라동,오라동제1투,2637,1572,654,722,151,32,1,1560,12,1065,41.92307692307693,46.282051282051285,9.67948717948718,2.051282051282051,0.0641025641025641
139,제주특별자치도,제주시,오라동,오라동제2투,4915,3100,1596,1082,324,58,6,3066,34,1815,52.054794520547944,35.290280495759944,10.567514677103718,1.8917155903457272,0.19569471624266144
140,제주특별자치도,제주시,연동,관내사전투표,11347,11347,7565,2595,936,156,9,11261,86,0,67.17875854719829,23.044134623923277,8.311872835449782,1.3853121392416303,0.07992185418701714
141,제주특별자치도,제주시,연동,연동제1투,2319,1224,487,600,108,17,1,1213,11,1095,40.14839241549876,49.464138499587804,8.903544929925804,1.4014839241549877,0.08244023083264633
142,제주특별자치도,제주시,연동,연동제2투,3757,2197,976,970,211,27,3,2187,10,1560,44.627343392775494,44.35299497027892,9.647919524462734,1.2345679012345678,0.1371742112482853
143,제주특별자치도,제주시,연동,연동제3투,2610,1528,652,724,121,17,2,1516,12,1082,43.007915567282325,47.75725593667546,7.981530343007916,1.121372031662269,0.13192612137203166
144,제주특별자치도,제주시,연동,연동제4투,3115,1482,583,731,131,19,2,1466,16,1633,39.76807639836289,49.86357435197817,8.935879945429742,1.296043656207367,0.1364256480218281
145,제주특별자치도,제주시,연동,연동제5투,3250,2050,997,824,171,31,2,2025,25,1200,49.23456790123456,40.69135802469136,8.444444444444445,1.5308641975308643,0.09876543209876544
146,제주특별자치도,제주시,연동,연동제6투,2428,1383,667,530,146,27,1,1371,12,1045,48.650619985412106,38.6579139314369,10.649161196207148,1.9693654266958425,0.07293946024799416
147,제주특별자치도,제주시,연동,연동제7투,3515,1688,726,766,152,25,0,1669,19,1827,43.49910125823847,45.89574595566207,9.107249850209707,1.4979029358897544,0.0
148,제주특별자치도,제주시,연동,연동제8투,4017,2529,1122,1103,252,31,1,2509,20,1488,44.719011558389795,43.961737744121166,10.0438421681945,1.2355520127540853,0.03985651654045436
149,제주특별자치도,제주시,노형동,관내사전투표,9501,9499,6476,1874,937,121,11,9419,80,2,68.75464486675867,19.895954984605584,9.947977492302792,1.2846374349718654,0.11678522136107866
150,제주특별자치도,제주시,노형동,노형동제1투,1618,1014,500,402,84,17,2,1005,9,604,49.75124378109453,40.0,8.358208955223882,1.691542288557214,0.1990049751243781
151,제주특별자치도,제주시,노형동,노형동제2투,2327,1484,695,611,143,23,0,1472,12,843,47.21467391304348,41.50815217391305,9.714673913043478,1.5625,0.0
152,제주특별자치도,제주시,노형동,노형동제3투,4438,2502,1033,1081,297,48,8,2467,35,1936,41.87271990271585,43.81840291852453,12.038913660316174,1.9456830158086746,0.3242805026347791
153,제주특별자치도,제주시,노형동,노형동제4투,3455,2595,1244,1027,272,36,2,2581,14,860,48.19837272375048,39.79077876791941,10.53855094924448,1.3948082138705928,0.07748934521503294
154,제주특별자치도,제주시,노형동,노형동제5투,2888,1807,866,718,166,35,1,1786,21,1081,48.488241881299,40.201567749160134,9.29451287793953,1.9596864501679732,0.055991041433370664
155,제주특별자치도,제주시,노형동,노형동제6투,4772,3008,1423,1207,288,52,8,2978,30,1764,47.78374748153123,40.53055742108798,9.670920080591,1.7461383478844863,0.2686366689053056
156,제주특별자치도,제주시,노형동,노형동제7투,1297,845,407,357,64,12,0,840,5,452,48.45238095238095,42.5,7.6190476190476195,1.4285714285714286,0.0
157,제주특별자치도,제주시,노형동,노형동제8투,3753,2405,1110,985,237,50,4,2386,19,1348,46.52137468566639,41.28248113998323,9.932942162615257,2.095557418273261,0.16764459346186086
158,제주특별자치도,제주시,노형동,노형동제9투,2602,1688,834,664,151,24,2,1675,13,914,49.791044776119406,39.64179104477612,9.014925373134329,1.4328358208955223,0.11940298507462686
159,제주특별자치도,제주시,노형동,노형동제10투,3580,2532,1266,954,276,27,1,2524,8,1048,50.15847860538827,37.79714738510302,10.935023771790808,1.06973058637084,0.039619651347068144
160,제주특별자치도,제주시,외도동,관내사전투표,7473,7473,5470,1289,552,98,3,7412,61,0,73.79924446842956,17.390717754991904,7.447382622773881,1.3221802482460874,0.040474905558553695
161,제주특별자치도,제주시,외도동,외도동제1투,3396,1865,930,687,197,32,2,1848,17,1531,50.324675324675326,37.17532467532468,10.66017316017316,1.7316017316017316,0.10822510822510822
162,제주특별자치도,제주시,외도동,외도동제2투,1503,933,502,323,88,11,1,925,8,570,54.270270270270274,34.91891891891892,9.513513513513514,1.1891891891891893,0.10810810810810811
163,제주특별자치도,제주시,외도동,외도동제3투,3944,2401,1204,877,256,32,6,2375,26,1543,50.69473684210526,36.92631578947368,10.778947368421052,1.3473684210526315,0.25263157894736843
164,제주특별자치도,제주시,외도동,외도동제4투,2276,1601,854,533,173,27,2,1589,12,675,53.74449339207048,33.54310887350535,10.887350534927627,1.6991818753933292,0.12586532410320958
165,제주특별자치도,제주시,이호동,관내사전투표,1850,1850,1294,404,124,14,1,1837,13,0,70.44093630919978,21.992378878606424,6.750136091453457,0.7621121393576483,0.05443658138268917
166,제주특별자치도,제주시,이호동,이호동제1투,706,399,167,185,34,10,1,397,2,307,42.0654911838791,46.59949622166247,8.564231738035264,2.518891687657431,0.2518891687657431
167,제주특별자치도,제주시,이호동,이호동제2투,1659,1045,490,448,89,6,1,1034,11,614,47.38878143133462,43.32688588007737,8.6073500967118,0.5802707930367506,0.09671179883945842
168,제주특별자치도,제주시,도두동,관내사전투표,1552,1552,1094,323,112,15,0,1544,8,0,70.85492227979275,20.919689119170982,7.253886010362693,0.9715025906735751,0.0
169,제주특별자치도,제주시,도두동,도두동제1투,1147,635,262,303,49,12,1,627,8,512,41.78628389154705,48.32535885167464,7.814992025518341,1.9138755980861244,0.1594896331738437
170,제주특별자치도,제주시,도두동,도두동제2투,582,405,198,166,30,8,0,402,3,177,49.25373134328358,41.29353233830846,7.462686567164178,1.9900497512437811,0.0
171,제주특별자치도,제주시,잘못 투입·구분된 투표지,,0,4,3,1,0,0,0,4,0,-4,75.0,25.0,0.0,0.0,0.0
0,제주특별자치도,서귀포시,거소·선상투표,,348,327,141,112,49,7,1,310,17,21,45.483870967741936,36.12903225806451,15.806451612903224,2.258064516129032,0.3225806451612903
1,제주특별자치도,서귀포시,관외사전투표,,13078,13077,6891,3921,1864,201,23,12900,177,1,53.418604651162795,30.3953488372093,14.449612403100776,1.5581395348837208,0.17829457364341086
2,제주특별자치도,서귀포시,재외투표,,1247,790,504,193,66,19,3,785,5,457,64.20382165605095,24.585987261146496,8.40764331210191,2.420382165605096,0.3821656050955414
3,제주특별자치도,서귀포시,대정읍,관내사전투표,3850,3849,2411,1057,268,78,1,3815,34,1,63.19790301441678,27.706422018348626,7.0249017038007855,2.0445609436435124,0.02621231979030144
4,제주특별자치도,서귀포시,대정읍,대정읍제1투,2126,1198,458,640,71,16,0,1185,13,928,38.64978902953587,54.008438818565395,5.9915611814346,1.350210970464135,0.0
5,제주특별자치도,서귀포시,대정읍,대정읍제2투,1505,819,294,457,53,10,1,815,4,686,36.07361963190184,56.07361963190184,6.5030674846625764,1.2269938650306749,0.1226993865030675
6,제주특별자치도,서귀포시,대정읍,대정읍제3투,932,552,258,248,30,8,0,544,8,380,47.42647058823529,45.588235294117645,5.514705882352941,1.4705882352941175,0.0
7,제주특별자치도,서귀포시,대정읍,대정읍제4투,420,288,105,163,12,5,0,285,3,132,36.84210526315789,57.19298245614035,4.2105263157894735,1.7543859649122806,0.0
8,제주특별자치도,서귀포시,대정읍,대정읍제5투,2783,1614,547,921,123,17,1,1609,5,1169,33.99627097576135,57.24052206339342,7.64449968924798,1.0565568676196395,0.06215040397762585
9,제주특별자치도,서귀포시,대정읍,대정읍제6투,138,98,45,45,6,2,0,98,0,40,45.91836734693878,45.91836734693878,6.122448979591836,2.0408163265306123,0.0
10,제주특별자치도,서귀포시,대정읍,대정읍제7투,527,342,136,185,17,1,1,340,2,185,40.0,54.41176470588235,5.0,0.29411764705882354,0.29411764705882354
11,제주특별자치도,서귀포시,대정읍,대정읍제8투,1607,803,309,416,64,6,0,795,8,804,38.86792452830189,52.327044025157235,8.050314465408805,0.7547169811320755,0.0
12,제주특별자치도,서귀포시,대정읍,대정읍제9투,353,235,83,134,12,3,0,232,3,118,35.775862068965516,57.758620689655174,5.172413793103448,1.293103448275862,0.0
13,제주특별자치도,서귀포시,대정읍,대정읍제10투,410,274,131,123,11,4,1,270,4,136,48.51851851851852,45.55555555555556,4.074074074074074,1.4814814814814816,0.3703703703703704
14,제주특별자치도,서귀포시,대정읍,대정읍제11투,284,216,124,73,11,4,0,212,4,68,58.490566037735846,34.43396226415094,5.188679245283019,1.8867924528301887,0.0
15,제주특별자치도,서귀포시,대정읍,대정읍제12투,724,445,160,239,42,2,1,444,1,279,36.03603603603604,53.82882882882883,9.45945945945946,0.45045045045045046,0.22522522522522523
16,제주특별자치도,서귀포시,남원읍,관내사전투표,3546,3546,2334,910,241,38,4,3527,19,0,66.17521973348455,25.80096399206124,6.833002551743691,1.0774028919761838,0.11341083073433512
17,제주특별자치도,서귀포시,남원읍,남원읍제1투,519,316,135,157,14,4,2,312,4,203,43.269230769230774,50.32051282051282,4.487179487179487,1.282051282051282,0.641025641025641
18,제주특별자치도,서귀포시,남원읍,남원읍제2투,840,494,212,244,24,7,2,489,5,346,43.353783231083845,49.897750511247445,4.9079754601226995,1.4314928425357873,0.408997955010225
19,제주특별자치도,서귀포시,남원읍,남원읍제3투,645,423,182,199,32,2,1,416,7,222,43.75,47.83653846153847,7.6923076923076925,0.4807692307692308,0.2403846153846154
20,제주특별자치도,서귀포시,남원읍,남원읍제4투,2089,1141,469,542,95,22,3,1131,10,948,41.46772767462423,47.92219274977896,8.399646330680813,1.9451812555260832,0.2652519893899204
21,제주특별자치도,서귀포시,남원읍,남원읍제5투,1072,712,288,348,54,14,1,705,7,360,40.85106382978723,49.361702127659576,7.659574468085106,1.9858156028368796,0.14184397163120568
22,제주특별자치도,서귀포시,남원읍,남원읍제6투,1084,671,288,316,49,5,1,659,12,413,43.70257966616085,47.95144157814871,7.435508345978755,0.7587253414264037,0.15174506828528073
23,제주특별자치도,서귀포시,남원읍,남원읍제7투,529,309,101,181,22,2,0,306,3,220,33.006535947712415,59.150326797385624,7.18954248366013,0.6535947712418301,0.0
24,제주특별자치도,서귀포시,남원읍,남원읍제8투,1498,912,399,433,61,10,1,904,8,586,44.13716814159292,47.89823008849557,6.7477876106194685,1.1061946902654867,0.11061946902654868
25,제주특별자치도,서귀포시,남원읍,남원읍제9투,344,233,95,115,14,1,1,226,7,111,42.0353982300885,50.88495575221239,6.1946902654867255,0.4424778761061947,0.4424778761061947
26,제주특별자치도,서귀포시,남원읍,남원읍제10투,448,262,108,134,17,3,0,262,0,186,41.221374045801525,51.14503816793893,6.488549618320611,1.1450381679389312,0.0
27,제주특별자치도,서귀포시,남원읍,남원읍제11투,247,160,75,66,13,4,0,158,2,87,47.46835443037975,41.77215189873418,8.227848101265822,2.5316455696202533,0.0
28,제주특별자치도,서귀포시,남원읍,남원읍제12투,375,213,98,100,9,1,0,208,5,162,47.11538461538461,48.07692307692308,4.326923076923077,0.4807692307692308,0.0
29,제주특별자치도,서귀포시,남원읍,남원읍제13투,338,214,114,85,10,3,2,214,0,124,53.271028037383175,39.719626168224295,4.672897196261682,1.4018691588785046,0.9345794392523363
30,제주특별자치도,서귀포시,남원읍,남원읍제14투,261,192,96,80,13,1,0,190,2,69,50.526315789473685,42.10526315789473,6.842105263157896,0.5263157894736842,0.0
31,제주특별자치도,서귀포시,성산읍,관내사전투표,2904,2904,1715,973,150,45,6,2889,15,0,59.36310141917619,33.679473866389756,5.192107995846314,1.557632398753894,0.20768431983385255
32,제주특별자치도,서귀포시,성산읍,성산읍제1투,970,590,198,360,24,1,1,584,6,380,33.9041095890411,61.64383561643836,4.10958904109589,0.17123287671232876,0.17123287671232876
33,제주특별자치도,서귀포시,성산읍,성산읍제2투,562,330,97,209,19,3,0,328,2,232,29.573170731707314,63.71951219512195,5.7926829268292686,0.9146341463414633,0.0
34,제주특별자치도,서귀포시,성산읍,성산읍제3투,2076,1037,394,551,74,11,0,1030,7,1039,38.25242718446602,53.49514563106796,7.184466019417475,1.0679611650485437,0.0
35,제주특별자치도,서귀포시,성산읍,성산읍제4투,757,461,175,256,21,5,0,457,4,296,38.29321663019694,56.01750547045952,4.595185995623632,1.0940919037199124,0.0
36,제주특별자치도,서귀포시,성산읍,성산읍제5투,737,432,140,237,40,5,4,426,6,305,32.863849765258216,55.633802816901415,9.389671361502346,1.1737089201877933,0.9389671361502347
37,제주특별자치도,서귀포시,성산읍,성산읍제6투,686,418,187,197,13,13,2,412,6,268,45.38834951456311,47.81553398058252,3.1553398058252426,3.1553398058252426,0.48543689320388345
38,제주특별자치도,서귀포시,성산읍,성산읍제7투,424,269,92,156,11,5,0,264,5,155,34.84848484848485,59.09090909090909,4.166666666666666,1.893939393939394,0.0
39,제주특별자치도,서귀포시,성산읍,성산읍제8투,332,209,66,125,11,4,1,207,2,123,31.88405797101449,60.38647342995169,5.314009661835748,1.932367149758454,0.4830917874396135
40,제주특별자치도,서귀포시,성산읍,성산읍제9투,455,261,77,165,12,2,0,256,5,194,30.078125,64.453125,4.6875,0.78125,0.0
41,제주특별자치도,서귀포시,성산읍,성산읍제10투,392,253,99,132,16,2,0,249,4,139,39.75903614457831,53.01204819277109,6.425702811244979,0.8032128514056224,0.0
42,제주특별자치도,서귀포시,성산읍,성산읍제11투,696,409,141,231,27,5,2,406,3,287,34.72906403940887,56.896551724137936,6.65024630541872,1.2315270935960592,0.49261083743842365
43,제주특별자치도,서귀포시,성산읍,성산읍제12투,398,264,95,138,21,5,0,259,5,134,36.67953667953668,53.28185328185329,8.108108108108109,1.9305019305019304,0.0
44,제주특별자치도,서귀포시,안덕면,관내사전투표,2685,2685,1839,609,179,38,2,2667,18,0,68.95388076490438,22.83464566929134,6.7116610423697045,1.4248218972628421,0.07499062617172854
45,제주특별자치도,서귀포시,안덕면,안덕면제1투,1546,894,376,420,71,15,1,883,11,652,42.582106455266135,47.56511891279728,8.040770101925254,1.698754246885617,0.11325028312570783
46,제주특별자치도,서귀포시,안덕면,안덕면제2투,1446,819,319,415,52,19,3,808,11,627,39.48019801980198,51.36138613861386,6.435643564356436,2.3514851485148514,0.3712871287128713
47,제주특별자치도,서귀포시,안덕면,안덕면제3투,712,457,150,256,33,11,2,452,5,255,33.1858407079646,56.63716814159292,7.300884955752212,2.433628318584071,0.4424778761061947
48,제주특별자치도,서귀포시,안덕면,안덕면제4투,763,457,198,218,27,7,1,451,6,306,43.90243902439025,48.33702882483371,5.986696230598669,1.5521064301552108,0.22172949002217296
49,제주특별자치도,서귀포시,안덕면,안덕면제5투,774,445,202,192,42,4,1,441,4,329,45.80498866213152,43.53741496598639,9.523809523809524,0.9070294784580499,0.22675736961451248
50,제주특별자치도,서귀포시,안덕면,안덕면제6투,365,237,109,110,11,6,0,236,1,128,46.186440677966104,46.61016949152542,4.661016949152542,2.5423728813559325,0.0
51,제주특별자치도,서귀포시,안덕면,안덕면제7투,449,275,129,118,18,4,3,272,3,174,47.42647058823529,43.38235294117647,6.61764705882353,1.4705882352941175,1.1029411764705883
52,제주특별자치도,서귀포시,안덕면,안덕면제8투,759,456,189,186,57,20,2,454,2,303,41.629955947136565,40.969162995594715,12.555066079295155,4.405286343612335,0.4405286343612335
53,제주특별자치도,서귀포시,표선면,관내사전투표,3243,3243,2056,893,232,26,3,3210,33,0,64.04984423676012,27.819314641744548,7.2274143302180685,0.809968847352025,0.09345794392523366
54,제주특별자치도,서귀포시,표선면,표선면제1투,2875,1541,591,798,111,28,1,1529,12,1334,38.65271419228254,52.19097449313277,7.259646827992151,1.831262262916939,0.06540222367560497
55,제주특별자치도,서귀포시,표선면,표선면제2투,659,394,147,218,25,2,0,392,2,265,37.5,55.61224489795919,6.377551020408164,0.5102040816326531,0.0
56,제주특별자치도,서귀포시,표선면,표선면제3투,808,523,217,278,17,5,0,517,6,285,41.97292069632495,53.77176015473888,3.2882011605415857,0.9671179883945842,0.0
57,제주특별자치도,서귀포시,표선면,표선면제4투,494,335,135,179,13,6,0,333,2,159,40.54054054054054,53.753753753753756,3.903903903903904,1.8018018018018018,0.0
58,제주특별자치도,서귀포시,표선면,표선면제5투,745,504,259,210,25,4,0,498,6,241,52.00803212851406,42.168674698795186,5.020080321285141,0.8032128514056224,0.0
59,제주특별자치도,서귀포시,표선면,표선면제6투,290,208,102,77,16,9,0,204,4,82,50.0,37.745098039215684,7.8431372549019605,4.411764705882353,0.0
60,제주특별자치도,서귀포시,표선면,표선면제7투,404,257,90,140,21,3,1,255,2,147,35.294117647058826,54.90196078431373,8.235294117647058,1.1764705882352942,0.39215686274509803
61,제주특별자치도,서귀포시,표선면,표선면제8투,316,213,102,95,13,2,0,212,1,103,48.113207547169814,44.81132075471698,6.132075471698113,0.9433962264150944,0.0
62,제주특별자치도,서귀포시,표선면,표선면제9투,140,105,38,56,6,4,0,104,1,35,36.53846153846153,53.84615384615385,5.769230769230769,3.8461538461538463,0.0
63,제주특별자치도,서귀포시,송산동,관내사전투표,1192,1192,778,304,90,15,2,1189,3,0,65.43313708999159,25.5677039529016,7.5693860386879726,1.2615643397813288,0.16820857863751051
64,제주특별자치도,서귀포시,송산동,송산동제1투,994,502,192,271,26,7,0,496,6,492,38.70967741935484,54.63709677419355,5.241935483870968,1.411290322580645,0.0
65,제주특별자치도,서귀포시,송산동,송산동제2투,1243,775,286,435,42,7,0,770,5,468,37.142857142857146,56.493506493506494,5.454545454545454,0.9090909090909091,0.0
66,제주특별자치도,서귀포시,정방동,관내사전투표,842,842,550,194,76,10,2,832,10,0,66.10576923076923,23.317307692307693,9.134615384615383,1.201923076923077,0.2403846153846154
67,제주특별자치도,서귀포시,정방동,정방동투표소,1245,579,229,299,40,6,1,575,4,666,39.82608695652174,52.0,6.956521739130435,1.0434782608695654,0.17391304347826086
68,제주특별자치도,서귀포시,중앙동,관내사전투표,1493,1493,902,443,114,14,0,1473,20,0,61.23557365919892,30.074677528852682,7.739307535641547,0.9504412763068567,0.0
69,제주특별자치도,서귀포시,중앙동,중앙동투표소,1765,863,340,454,53,7,0,854,9,902,39.812646370023415,53.161592505854806,6.206088992974239,0.819672131147541,0.0
70,제주특별자치도,서귀포시,천지동,관내사전투표,1611,1611,1006,466,99,31,2,1604,7,0,62.71820448877805,29.052369077306732,6.172069825436409,1.9326683291770574,0.12468827930174563
71,제주특별자치도,서귀포시,천지동,천지동제1투,1758,898,329,478,68,14,0,889,9,860,37.00787401574803,53.768278965129355,7.64904386951631,1.574803149606299,0.0
72,제주특별자치도,서귀포시,천지동,천지동제2투,187,122,67,46,7,2,0,122,0,65,54.91803278688525,37.704918032786885,5.737704918032787,1.639344262295082,0.0
73,제주특별자치도,서귀포시,효돈동,관내사전투표,2104,2104,1295,633,127,29,2,2086,18,0,62.08053691275168,30.34515819750719,6.088207094918505,1.3902205177372962,0.09587727708533077
74,제주특별자치도,서귀포시,효돈동,효돈동제1투,1230,711,275,383,42,8,1,709,2,519,38.787023977433,54.01974612129761,5.923836389280677,1.1283497884344147,0.14104372355430184
75,제주특별자치도,서귀포시,효돈동,효돈동제2투,1496,908,371,458,56,9,2,896,12,588,41.40625,51.11607142857143,6.25,1.0044642857142858,0.2232142857142857
76,제주특별자치도,서귀포시,영천동,관내사전투표,1911,1911,1217,511,143,25,1,1897,14,0,64.15392725355825,26.937269372693727,7.538218239325251,1.3178703215603584,0.05271481286241434
77,제주특별자치도,서귀포시,영천동,영천동제1투,1983,1074,432,536,85,12,1,1066,8,909,40.52532833020638,50.28142589118198,7.973733583489681,1.125703564727955,0.09380863039399624
78,제주특별자치도,서귀포시,영천동,영천동제2투,464,303,104,170,21,5,0,300,3,161,34.66666666666667,56.666666666666664,7.000000000000001,1.6666666666666667,0.0
79,제주특별자치도,서귀포시,영천동,영천동제3투,317,184,67,101,10,5,0,183,1,133,36.6120218579235,55.19125683060109,5.46448087431694,2.73224043715847,0.0
80,제주특별자치도,서귀포시,동홍동,관내사전투표,4798,4798,3227,1094,391,51,6,4769,29,0,67.66617739568044,22.939819668693644,8.198783812119942,1.0694065841895575,0.12581253931641853
81,제주특별자치도,서귀포시,동홍동,동홍동제1투,2622,1423,632,644,117,18,2,1413,10,1199,44.72753007784855,45.57678697806086,8.280254777070063,1.2738853503184715,0.14154281670205238
82,제주특별자치도,서귀포시,동홍동,동홍동제2투,3508,1830,820,779,185,22,4,1810,20,1678,45.30386740331492,43.03867403314917,10.220994475138122,1.2154696132596685,0.22099447513812157
83,제주특별자치도,서귀포시,동홍동,동홍동제3투,2852,1654,729,730,152,24,1,1636,18,1198,44.559902200489,44.62102689486552,9.290953545232274,1.466992665036675,0.061124694376528114
84,제주특별자치도,서귀포시,동홍동,동홍동제4투,2394,1474,636,685,101,30,1,1453,21,920,43.77150722642808,47.143840330351,6.951135581555403,2.064693737095664,0.06882312456985547
85,제주특별자치도,서귀포시,서홍동,관내사전투표,2941,2941,1944,729,196,45,1,2915,26,0,66.68953687821613,25.008576329331046,6.723842195540309,1.5437392795883362,0.03430531732418524
86,제주특별자치도,서귀포시,서홍동,서홍동제1투,3255,1893,893,785,167,25,0,1870,23,1362,47.75401069518716,41.97860962566845,8.930481283422461,1.3368983957219251,0.0
87,제주특별자치도,서귀포시,서홍동,서홍동제2투,2007,1158,490,549,89,13,1,1142,16,849,42.90718038528897,48.07355516637478,7.793345008756567,1.138353765323993,0.08756567425569177
88,제주특별자치도,서귀포시,대륜동,관내사전투표,5723,5723,3868,1257,475,66,4,5670,53,0,68.21869488536156,22.169312169312168,8.37742504409171,1.164021164021164,0.07054673721340389
89,제주특별자치도,서귀포시,대륜동,대륜동제1투,1608,938,355,495,70,8,1,929,9,670,38.213132400430574,53.283100107642625,7.534983853606028,0.8611410118406888,0.1076426264800861
90,제주특별자치도,서귀포시,대륜동,대륜동제2투,2684,1625,709,726,148,23,0,1606,19,1059,44.14694894146949,45.20547945205479,9.21544209215442,1.432129514321295,0.0
91,제주특별자치도,서귀포시,대륜동,대륜동제3투,1490,937,380,460,81,9,2,932,5,553,40.772532188841204,49.35622317596567,8.690987124463518,0.9656652360515022,0.2145922746781116
92,제주특별자치도,서귀포시,대륜동,대륜동제4투,1683,1014,412,495,85,14,0,1006,8,669,40.95427435387674,49.20477137176938,8.449304174950298,1.3916500994035785,0.0
93,제주특별자치도,서귀포시,대천동,관내사전투표,1593,1593,1072,366,125,19,1,1583,10,0,67.7195198989261,23.12065698041693,7.896399241945673,1.2002526847757422,0.06317119393556538
94,제주특별자치도,서귀포시,대천동,대천동제1투,1202,726,314,335,62,6,1,718,8,476,43.73259052924791,46.65738161559889,8.635097493036211,0.8356545961002786,0.1392757660167131
95,제주특별자치도,서귀포시,대천동,대천동제2투,995,602,237,298,47,12,1,595,7,393,39.831932773109244,50.08403361344538,7.899159663865546,2.0168067226890756,0.16806722689075632
96,제주특별자치도,서귀포시,대천동,대천동제3투,535,311,123,150,28,5,1,307,4,224,40.06514657980456,48.85993485342019,9.120521172638437,1.6286644951140066,0.32573289902280134
97,제주특별자치도,서귀포시,대천동,대천동제4투,340,228,112,95,15,2,0,224,4,112,50.0,42.410714285714285,6.696428571428571,0.8928571428571428,0.0
98,제주특별자치도,서귀포시,대천동,대천동제5투,3533,2137,926,927,225,37,0,2115,22,1396,43.78250591016549,43.829787234042556,10.638297872340425,1.7494089834515367,0.0
99,제주특별자치도,서귀포시,중문동,관내사전투표,3168,3168,2167,660,266,38,3,3134,34,0,69.14486279514996,21.059349074664965,8.487555839183154,1.2125079770261646,0.09572431397574985
100,제주특별자치도,서귀포시,중문동,중문동제1투,4043,2331,1015,1035,214,33,3,2300,31,1712,44.130434782608695,45.0,9.304347826086957,1.434782608695652,0.13043478260869568
101,제주특별자치도,서귀포시,중문동,중문동제2투,1194,695,275,346,58,8,2,689,6,499,39.912917271407835,50.2177068214804,8.417997097242381,1.1611030478955007,0.29027576197387517
102,제주특별자치도,서귀포시,중문동,중문동제3투,799,539,264,220,38,7,3,532,7,260,49.62406015037594,41.35338345864661,7.142857142857142,1.3157894736842104,0.5639097744360901
103,제주특별자치도,서귀포시,중문동,중문동제4투,373,240,91,134,12,2,0,239,1,133,38.07531380753138,56.06694560669456,5.02092050209205,0.8368200836820083,0.0
104,제주특별자치도,서귀포시,예래동,관내사전투표,1088,1088,692,286,88,11,1,1078,10,0,64.19294990723562,26.53061224489796,8.16326530612245,1.0204081632653061,0.0927643784786642
105,제주특별자치도,서귀포시,예래동,예래동제1투,684,392,164,190,27,5,3,389,3,292,42.159383033419026,48.84318766066838,6.940874035989718,1.2853470437017995,0.7712082262210797
106,제주특별자치도,서귀포시,예래동,예래동제2투,1099,572,217,311,32,7,1,568,4,527,38.20422535211267,54.75352112676056,5.633802816901409,1.232394366197183,0.17605633802816903
107,제주특별자치도,서귀포시,예래동,예래동제3투,268,179,91,68,19,0,0,178,1,89,51.12359550561798,38.20224719101123,10.674157303370785,0.0,0.0
108,제주특별자치도,서귀포시,잘못 투입·구분된 투표지,,0,0,0,0,0,0,0,0,0,0,0.0,0.0,0.0,0.0,0.0
